发布者;真实一级评论数;真实点赞数;边数;最大边数;集群密度
这个人有点憨132;1;4;5;40790;0.00012257906349595488
游离磷酸基团;3;31;34;40790;0.0008335376317724932
一只小黄桑;12;92;104;40790;0.0025496445207158617
轻宸QAQ;21;867;888;40790;0.02177004167688159
名字都被老鼠啃了;28;2442;2470;40790;0.060554057367001715
樱木森林泽;3;7;10;40790;0.00024515812699190976
白嫖协会乄鸡你奥利给;1;9;10;40790;0.00024515812699190976
和雕;7;35;42;40790;0.0010296641333660211
竽圆不吃鱼;36;466;502;40790;0.01230693797499387
风skydust;11;221;232;40790;0.005687668546212307
-竹离-;5;122;127;40790;0.0031135082127972543
凌空之云-壮志凌云;5;10;15;40790;0.00036773719048786466
快居各份;3;30;33;40790;0.0008090218190733023
狐狸Tail;12;121;133;40790;0.0032606030889924
沉默Lwe;3;16;19;40790;0.00046580044128462857
靓仔MILK;35;339;374;40790;0.009168913949497426
宜渔则渔meow;3;27;30;40790;0.0007354743809757293
-波动宇宙起司-;29;351;380;40790;0.009316008825692572
某科学的SCP;2;32;34;40790;0.0008335376317724932
瓦岗寨主坑爹李;48;1497;1545;40790;0.03787693062025006
太热了吗;3;11;14;40790;0.0003432213777886737
南二北三;7;31;38;40790;0.0009316008825692571
今天也要想小鹿;9;84;93;40790;0.002279970581024761
DASADSDASADSASD;3;9;12;40790;0.00029418975239029176
V随-缘V;25;170;195;40790;0.0047805834763422405
阿岷有双桃花眼;14;144;158;40790;0.0038734984064721745
icewonderful;2;6;8;40790;0.00019612650159352783
路过的歪魔;1;10;11;40790;0.00026967393969110076
琇瑕;110;333;443;40790;0.010860505025741603
世界不存在速度;1;2;3;40790;7.354743809757294e-05
暮山子;33;3306;3339;40790;0.08185829860259868
老达OldDa;23;653;676;40790;0.016572689384653103
一只萌呆的潜艇;3;6;9;40790;0.0002206423142927188
艾仑亚特斯克;253;20000;20253;40790;0.4965187545967149
夜疯猫;47;1979;2026;40790;0.049669036528560924
落寞楼长曾经也是神话;3;42;45;40790;0.001103211571463594
12345上山哒老虎;2;1;3;40790;7.354743809757294e-05
XSH墨言;9;135;144;40790;0.003530277028683501
常规流体;14;537;551;40790;0.013508212797254228
雪域圣师;7;37;44;40790;0.001078695758764403
果之_233;16;77;93;40790;0.002279970581024761
西木太太;132;6437;6569;40790;0.16104437362098553
Q歪上线中;1;16;17;40790;0.0004167688158862466
扌并多多伪方;1;6;7;40790;0.00017161068889433686
金狗--;5;178;183;40790;0.004486393723951949
爱养花的仲宇;5;41;46;40790;0.001127727384162785
坍缩态的剑;13;45;58;40790;0.0014219171365530768
lxy黄泉路边的花;26;88;114;40790;0.0027948026477077714
辉Grey;49;745;794;40790;0.019465555283157635
icewonderful;16;138;154;40790;0.0037754351556754107
混沌椰子;1;7;8;40790;0.00019612650159352783
怪谈家小黑;2;11;13;40790;0.0003187055650894827
楼也不是yellow;29;418;447;40790;0.010958568276538367
白川花朝;10;107;117;40790;0.0028683500858053446
产品黄叔;2;32;34;40790;0.0008335376317724932
暗之幻象;3;4;7;40790;0.00017161068889433686
沧澜的炽潮;5;68;73;40790;0.0017896543270409413
是锦鲤呀love;82;254;336;40790;0.00823731306692817
東蓮雪Official;81;210;291;40790;0.007134101495464575
76556798201_bili;33;122;155;40790;0.0037999509683746017
彩云小梦;111;478;589;40790;0.014439813679823487
彩云小梦;67;564;631;40790;0.015469477813189508
六杆笔;55;1187;1242;40790;0.030448639372395194
彩云小梦;234;464;698;40790;0.017112037264035304
彩云小梦;1091;2879;3970;40790;0.09732777641578819
BroErnst;16;1563;1579;40790;0.038710468252022553
icewonderful;180;668;848;40790;0.02078940916891395
Tpwdb;235;11000;11235;40790;0.27543515567541066
想把多肉养的胖胖白白;281;3983;4264;40790;0.10453542534935033
铭瀚丶;4;178;182;40790;0.004461877911252758
某才是纯鹿人;21;868;889;40790;0.02179455748958078
小老虎不怕滑铲;71;2322;2393;40790;0.05866633978916401
bilbil小风呀;11;65;76;40790;0.0018632017651385143
1680的创世结晶;19;416;435;40790;0.010664378524148076
primrose酸菜鱼;16;41;57;40790;0.0013974013238538857
摸鱼事务所;790;40000;40790;40790;1.0
真得死吧;1;4;5;40790;0.00012257906349595488
克里斯蒂娜_丶;11;17;28;40790;0.0006864427555773474
--歪比巴卜--;36;1947;1983;40790;0.04861485658249571
以引-以翼;6;17;23;40790;0.0005638636920813925
时刻想静静;5;62;67;40790;0.0016425594508457956
猫宰治元帅;62;1202;1264;40790;0.030987987251777396
初始小兵;1;5;6;40790;0.00014709487619514588
一个普通的小小小人;2;6;8;40790;0.00019612650159352783
游离幽灵在吟唱;2;13;15;40790;0.00036773719048786466
MSIE8;30;1152;1182;40790;0.028977690610443738
暖暖的夜空;1;6;7;40790;0.00017161068889433686
菲姆人;12;109;121;40790;0.0029664133366021084
观澜鳘鱼;4;18;22;40790;0.0005393478793822015
喻泥;151;5752;5903;40790;0.14471684236332436
子祯k;29;1491;1520;40790;0.03726403530277029
还在努力的小方;1;29;30;40790;0.0007354743809757293
一只善变的人类;1;6;7;40790;0.00017161068889433686
夜空中的云天明;1;2;3;40790;7.354743809757294e-05
取名字好麻烦啊t;4;8;12;40790;0.00029418975239029176
缺稿子的网文责编粽子;22;112;134;40790;0.0032851189016915913
徐lu不咕;3;13;16;40790;0.00039225300318705567
天子瑶;3;13;16;40790;0.00039225300318705567
gozero;1;3;4;40790;9.806325079676392e-05
清橙云吧;10;67;77;40790;0.0018877175778377053
Losserk;1;9;10;40790;0.00024515812699190976
我是白炽OvO;3;5;8;40790;0.00019612650159352783
江生月;3;18;21;40790;0.0005148320666830106
无糖球员;10;46;56;40790;0.0013728855111546949
这辈子没这么无语过呢;5;52;57;40790;0.0013974013238538857
名字真的是无语;1;5;6;40790;0.00014709487619514588
空_慕纸;3;56;59;40790;0.0014464329492522678
宜渔则渔meow;2;8;10;40790;0.00024515812699190976
松原ユーコ;1;2;3;40790;7.354743809757294e-05
郑老师heast;1;1;2;40790;4.903162539838196e-05
傲慢GHOST;8;32;40;40790;0.000980632507967639
竹风溪;2;10;12;40790;0.00029418975239029176
狼勒蓓;3;11;14;40790;0.0003432213777886737
F1oatX;2;5;7;40790;0.00017161068889433686
Lam_Anna;10;17;27;40790;0.0006619269428781564
洗jio盆_;1;6;7;40790;0.00017161068889433686
一只迷路的五月;4;55;59;40790;0.0014464329492522678
逐风wind-driven;6;382;388;40790;0.009512135327286099
NATO二点零;1;3;4;40790;9.806325079676392e-05
灿烂小星光;4;27;31;40790;0.0007599901936749203
蒟蒻中的蒟蒻;1;1;2;40790;4.903162539838196e-05
Puton2018;7;12;19;40790;0.00046580044128462857
屑之屑渣渣;2;16;18;40790;0.0004412846285854376
负零点二七五三四九;152;6675;6827;40790;0.16736945329737682
橘猫泡茶叫橘猫茶;2;8;10;40790;0.00024515812699190976
嘉心堂收藏;228;7431;7659;40790;0.1877666094631037
甜子柚茶;2;59;61;40790;0.0014954645746506497
热乎乎面包;2;4;6;40790;0.00014709487619514588
衫雨落;8;23;31;40790;0.0007599901936749203
瓦岗寨主坑爹李;45;1737;1782;40790;0.04368717822995832
心碎见蓝天Looooo;11;6;17;40790;0.0004167688158862466
ly雪凌羽;6;26;32;40790;0.0007845060063741113
一只叫阿岚的阿岚;1;5;6;40790;0.00014709487619514588
菲姆人;7;116;123;40790;0.0030154449620004905
连营姜;3;25;28;40790;0.0006864427555773474
全能的Legend_Lou;1;2;3;40790;7.354743809757294e-05
古见同学喜欢我;4;74;78;40790;0.0019122333905368964
窗中の少年;1;4;5;40790;0.00012257906349595488
宜渔则渔meow;2;5;7;40790;0.00017161068889433686
盟军指挥官233;1;1;2;40790;4.903162539838196e-05
今天也要想小鹿;3;25;28;40790;0.0006864427555773474
层云渐染;2;33;35;40790;0.0008580534444716843
子君天下002;1;2;3;40790;7.354743809757294e-05
乔知学;1;4;5;40790;0.00012257906349595488
qw哦家小wp;1;6;7;40790;0.00017161068889433686
熊本熊aaaa;1;6;7;40790;0.00017161068889433686
一烟落城;2;4;6;40790;0.00014709487619514588
Sffgfhhg;1;2;3;40790;7.354743809757294e-05
某知名小可爱不可爱;1;1;2;40790;4.903162539838196e-05
114514号Carmen;2;1;3;40790;7.354743809757294e-05
一万只沈梦溪;3;4;7;40790;0.00017161068889433686
北漠風玲;1;7;8;40790;0.00019612650159352783
宏宏2011;1;1;2;40790;4.903162539838196e-05
没shr就吃溜溜梅;5;29;34;40790;0.0008335376317724932
鶴归无望;1;4;5;40790;0.00012257906349595488
乱码奔腾-;64;2341;2405;40790;0.058960529541554306
momo不存在;2;4;6;40790;0.00014709487619514588
赫子12;2;11;13;40790;0.0003187055650894827
菲姆人;13;318;331;40790;0.008114734003432213
XJ物语;4;9;13;40790;0.0003187055650894827
看看我视频吧-;1;3;4;40790;9.806325079676392e-05
吴克在䯥墢;1;5;6;40790;0.00014709487619514588
书云酱;3;14;17;40790;0.0004167688158862466
乱码奔腾-;14;323;337;40790;0.00826182887962736
某智子;2;12;14;40790;0.0003432213777886737
B站子泪;1;3;4;40790;9.806325079676392e-05
bili_688698560;3;28;31;40790;0.0007599901936749203
小温睡醒了;1;2;3;40790;7.354743809757294e-05
森林之子_Virginia;2;1;3;40790;7.354743809757294e-05
陈年浊夕;1;6;7;40790;0.00017161068889433686
溟荃涣;16;47;63;40790;0.0015444962000490316
派大星破防比奇堡;1;7;8;40790;0.00019612650159352783
洛luo克ke;3;36;39;40790;0.0009561166952684482
友奈赛高;35;74;109;40790;0.0026722235842118166
竹天黑本白;2;6;8;40790;0.00019612650159352783
平平有奇的塑料盆;8;16;24;40790;0.0005883795047805835
卡面来打喵;1;68;69;40790;0.0016915910762441775
太后速速来我岛;1;3;4;40790;9.806325079676392e-05
立秋_晓风;3;24;27;40790;0.0006619269428781564
古见同学喜欢我;2;42;44;40790;0.001078695758764403
王俞至;1;3;4;40790;9.806325079676392e-05
彩云小梦;12;189;201;40790;0.004927678352537387
与花莉;1;5;6;40790;0.00014709487619514588
是洛兮酱啊;1;3;4;40790;9.806325079676392e-05
次昵称不合法;15;52;67;40790;0.0016425594508457956
かくさんへんい;4;19;23;40790;0.0005638636920813925
暮色城堡的守望;1;4;5;40790;0.00012257906349595488
十一的月兔;3;7;10;40790;0.00024515812699190976
卡面来打喵;2;56;58;40790;0.0014219171365530768
甜甜的西瓜_vr83;4;44;48;40790;0.001176759009561167
北地詩僊夜白;1;1;2;40790;4.903162539838196e-05
82年的CO2Fe;1;2;3;40790;7.354743809757294e-05
Xishensoft;2;8;10;40790;0.00024515812699190976
风香乃智;1;4;5;40790;0.00012257906349595488
The__Rainbow;1;2;3;40790;7.354743809757294e-05
Nat-victory;2;3;5;40790;0.00012257906349595488
楼也不是yellow;2;11;13;40790;0.0003187055650894827
我画不出来捏;21;108;129;40790;0.0031625398381956364
和泉羽;2;11;13;40790;0.0003187055650894827
聪明的屑;1;12;13;40790;0.0003187055650894827
miao小琳;8;79;87;40790;0.002132875704829615
愉悦的TSJ;6;74;80;40790;0.001961265015935278
乱叫的猫草;1;15;16;40790;0.00039225300318705567
水墨砂糖;3;42;45;40790;0.001103211571463594
DMLENT;1;6;7;40790;0.00017161068889433686
绿灯香水;3;27;30;40790;0.0007354743809757293
江湫纪叶;1;8;9;40790;0.0002206423142927188
一块牛jio包;1;4;5;40790;0.00012257906349595488
这辈子没这么无语过呢;24;60;84;40790;0.0020593282667320423
Skyjoe_Official;20;669;689;40790;0.016891394949742584
汐芸汐;18;470;488;40790;0.011963716597205198
萌酷帅流心糖-Lemoy;1;11;12;40790;0.00029418975239029176
星岚辞江Venti;1;10;11;40790;0.00026967393969110076
染墨-Sakura;2;10;12;40790;0.00029418975239029176
水墨砂糖;4;7;11;40790;0.00026967393969110076
崇祯和光绪的狗;2;8;10;40790;0.00024515812699190976
幻-_-风;2;18;20;40790;0.0004903162539838195
上天的星铉;445;16000;16445;40790;0.4031625398381956
右目砂;2;8;10;40790;0.00024515812699190976
拉缪-卡道蓝;1;1;2;40790;4.903162539838196e-05
QAQ狒狒QAQ;2;16;18;40790;0.0004412846285854376
睡不着了呢;14;56;70;40790;0.0017161068889433686
AiKaCl;5;16;21;40790;0.0005148320666830106
Stierlitz_;1;2;3;40790;7.354743809757294e-05
超意大利炮;11;103;114;40790;0.0027948026477077714
啃阿瓦达的橘子;2;8;10;40790;0.00024515812699190976
吃仓鼠的蘑菇;1;1;2;40790;4.903162539838196e-05
Whitedreamfox白梦狐;1;3;4;40790;9.806325079676392e-05
12345上山哒老虎;1;2;3;40790;7.354743809757294e-05
一个默默无闻的人-_-;1;3;4;40790;9.806325079676392e-05
鹰扬翾飞;1;5;6;40790;0.00014709487619514588
剑圣三面龙;3;5;8;40790;0.00019612650159352783
阿馬喜歡調馬耶嗚;2;22;24;40790;0.0005883795047805835
植物小分队ef;1;7;8;40790;0.00019612650159352783
再见了我的6硬币;3;2;5;40790;0.00012257906349595488
不会画画Iris;8;62;70;40790;0.0017161068889433686
菲姆人;20;515;535;40790;0.013115959794067173
奥利龟呀;1;116;117;40790;0.0028683500858053446
漾漾漾词儿;6;19;25;40790;0.0006128953174797745
星萤花;1;3;4;40790;9.806325079676392e-05
容易韩国;16;156;172;40790;0.004216719784260848
meliooado;1;2;3;40790;7.354743809757294e-05
露申;2;7;9;40790;0.0002206423142927188
游戏wan家;2;8;10;40790;0.00024515812699190976
是阿鱼啊4;1;1;2;40790;4.903162539838196e-05
黑夜中看不见伤痕;1;2;3;40790;7.354743809757294e-05
乱世逞英豪;1;3;4;40790;9.806325079676392e-05
zxwLH凌霍;1;3;4;40790;9.806325079676392e-05
苏泽ze;1;2;3;40790;7.354743809757294e-05
十月影业OV;4;12;16;40790;0.00039225300318705567
月色nice;2;3;5;40790;0.00012257906349595488
超高校级的王妃;38;155;193;40790;0.004731551850943858
江雪千年;3;15;18;40790;0.0004412846285854376
星云神级;14;36;50;40790;0.001225790634959549
不赢人;20;313;333;40790;0.008163765628830595
LegendCasillas;1;3;4;40790;9.806325079676392e-05
不想会后悔;3;6;9;40790;0.0002206423142927188
彩云小梦;60;412;472;40790;0.011571463594018143
屑之屑渣渣;4;18;22;40790;0.0005393478793822015
盖大书;1;5;6;40790;0.00014709487619514588
山石木乔_岩桥;6;16;22;40790;0.0005393478793822015
小猫种大鱼;6;61;67;40790;0.0016425594508457956
浅浅的中个奖;1;1;2;40790;4.903162539838196e-05
疯狂的joker;1;5;6;40790;0.00014709487619514588
红烧小派蒙-;1;9;10;40790;0.00024515812699190976
仙草菠萝果;3;2;5;40790;0.00012257906349595488
