label;一级评论;真实二级评论数;真实点赞数;边数;最大边数;集群密度
0;计算机二级证书岂不是废纸一张;11;46;57;23972;0.0023777740697480394
12;这不得把wps爆死啊;20;41;61;23972;0.002544635407975972
34;在哪儿看，我用的365;6;0;6;23972;0.0002502920073418989
41;不知道gpt有没有背锅能力，事情搞砸了，领导怪罪能不能让gpt背锅;1;0;1;23972;4.171533455698315e-05
43;国内怎么用？;3;1;4;23972;0.0001668613382279326
47;想用的前提估计是要用付费版office365，498一年，AI是否单独收费，未知;3;1;4;23972;0.0001668613382279326
51;有必要重新思考那句老话“人是万物之灵”灵的是什么呢？现在看肯定不是逻辑，推理的思维了;1;3;4;23972;0.0001668613382279326
53;我们什么时候能用上;2;2;4;23972;0.0001668613382279326
56;国内可以马上用吗;3;0;3;23972;0.00012514600367094945
61;现在好像国内没办法用啊？;1;0;1;23972;4.171533455698315e-05
65;国内用不了吧？;2;0;2;23972;8.34306691139663e-05
86;这种真的好吗？众所周知GPT绝无可能在自己电脑上运行而国内又没有他们的服务器，意思以后要用就得把你的所有资料双手奉上放心把主权国家绝对不允许这样的事情发生;16;4;20;23972;0.0008343066911396629
103;怎么下载，国内怎么用;5;2;7;23972;0.00029200734189888203
109;六六六啊啊啊啊啊啊啊，我想要这个东西，系主任让我做的ppt就可以直接生成了。;1;0;1;23972;4.171533455698315e-05
111;看来以后只能用WPS了不能轻易相信人工智能，否则，企业一点机密都没有了，特别是那些上市公司;1;0;1;23972;4.171533455698315e-05
123;0;1;0;1;23972;4.171533455698315e-05
126;我按照步骤弄完了，却没见到copilot;3;3;6;23972;0.0002502920073418989
130;没见到注册表修改教程;1;2;3;23972;0.00012514600367094945
132;用这么麻烦吗直接弹出来不过只能用10次;1;0;1;23972;4.171533455698315e-05
141;买微软的电脑，你就会拥有365的正版周一就回公司试试我的365;38;128;166;23972;0.006924745536459202
180;文职类工作直接裁员90，特别是微型企业，;9;175;184;23972;0.0076756215584848995
190;我为什么帮老板的女儿策划毕业party;1;0;1;23972;4.171533455698315e-05
192;是copilot和outlook，不是copiloter和outerlooker，口音还是最好注意下，不然所有清辅音结尾的单词你全会自动加上er;29;36;65;23972;0.0027114967462039045
222;不是还没release吗;4;50;54;23972;0.00225262806607709
227;国内又用不了，还是先用着wps吧;4;0;4;23972;0.0001668613382279326
232;英文水平直接影响和未来的交流;4;12;16;23972;0.0006674453529117303
237;压力来到了WPS这边，金山说：得加钱要不wps的aiCopilot就是一个弱智的siri；当你充了钱发现它还只是一个小爱同学；要升级会员等级，按场景分类最终等级有100多级，当你花了相当于一个正版office365的套餐后，才发现，它只是一个通过接口调用文心一言的马甲你才是它的copilot呢;2;30;32;23972;0.0013348907058234607
240;0;5;5;10;23972;0.00041715334556983145
246;wps怎么办呢;22;0;22;23972;0.0009177373602536292
269;10刀一个月;4;4;8;23972;0.0003337226764558652
274;现在是企业公测吧我的家庭版也没有呀;2;10;12;23972;0.0005005840146837978
277;那么问题来了，KMS能搞定它么？;4;3;7;23972;0.00029200734189888203
282;会不会用的，从哪搞？;10;0;10;23972;0.00041715334556983145
293;太麻烦，人工智能最终形态不是这样的;5;4;9;23972;0.0003754380110128483
299;它的office软件界面都和我的不一样;4;2;6;23972;0.0002502920073418989
304;怎样装，我本身是正版，要装国际版，找不到;3;6;9;23972;0.0003754380110128483
309;为了用copilot买了个365企业版结果还没出;1;0;1;23972;4.171533455698315e-05
311;科技是把双刃剑，用得好就是科技进步，用不好就是科技侵略，会被割伤。;1;1;2;23972;8.34306691139663e-05
313;请注明，此智能软件，只适合英文，中文怕是识别的乱七八糟;1;0;1;23972;4.171533455698315e-05
315;目前不支持中文;1;0;1;23972;4.171533455698315e-05
317;现在可以了吗;1;0;1;23972;4.171533455698315e-05
319;这个什么时候发布哇？;1;1;2;23972;8.34306691139663e-05
321;Whatev这对于公司的效率有大幅提升啊;1;0;1;23972;4.171533455698315e-05
323;四六级即视感;1;0;1;23972;4.171533455698315e-05
325;我买的就是微软的笔记本。有了没？好像还没有把。;1;0;1;23972;4.171533455698315e-05
327;耶ye应用文邀请函有着落了;1;0;1;23972;4.171533455698315e-05
329;有说什么时候发布吗;1;0;1;23972;4.171533455698315e-05
331;叮当这个ppt制作太强了;1;0;1;23972;4.171533455698315e-05
334;为啥我的copilot只能在word里面出现呢？怎么操作ppt呢？;2;1;3;23972;0.00012514600367094945
337;现在这玩意可以用了么;1;0;1;23972;4.171533455698315e-05
339;老板的口吻不是这样的。含糊不清，没做好就是你的问题。;1;0;1;23972;4.171533455698315e-05
341;翻译组;1;0;1;23972;4.171533455698315e-05
343;MAC可以用吗;1;0;1;23972;4.171533455698315e-05
345;果然微软不会让人失望这个合作很帅;1;0;1;23972;4.171533455698315e-05
347;不错不错;1;0;1;23972;4.171533455698315e-05
349;不会英语;1;0;1;23972;4.171533455698315e-05
351;国内能用？;1;0;1;23972;4.171533455698315e-05
353;《扣拍勒特》;1;0;1;23972;4.171533455698315e-05
356;mac可以吗？;1;0;1;23972;4.171533455698315e-05
358;目前不是只有商用的才有，;1;0;1;23972;4.171533455698315e-05
360;这就是翻译的外网视频;1;1;2;23972;8.34306691139663e-05
362;科技本来是让人们越来越轻松的，结果科技进步之后，人们越来越累了;1;1;2;23972;8.34306691139663e-05
364;Win10能用吗;1;0;1;23972;4.171533455698315e-05
366;中国还用不了吧;1;0;1;23972;4.171533455698315e-05
368;幸亏没买wps会员;1;0;1;23972;4.171533455698315e-05
370;下载新版本就行么？;3;1;4;23972;0.0001668613382279326
375;小方不想胖不错不错;3;0;3;23972;0.00012514600367094945
379;不支持中文;1;0;1;23972;4.171533455698315e-05
381;国内能用？;3;0;3;23972;0.00012514600367094945
385;今年好好学不然就失业;1;0;1;23972;4.171533455698315e-05
387;Z;1;0;1;23972;4.171533455698315e-05
389;“帕尔忒”是什么;1;0;1;23972;4.171533455698315e-05
391;有中文了吗;1;0;1;23972;4.171533455698315e-05
394;牛逼;1;0;1;23972;4.171533455698315e-05
396;本来想买，发现一年400多会员。我就想使用一下看看怎么样好用就买，没想到中国没上这功能;1;0;1;23972;4.171533455698315e-05
398;下面应该有掌声;1;0;1;23972;4.171533455698315e-05
400;中国区什么时候上线？;1;0;1;23972;4.171533455698315e-05
402;目前还没中文版;1;0;1;23972;4.171533455698315e-05
404;需要暴露的隐私太多了;1;0;1;23972;4.171533455698315e-05
406;365的教育版账号能登录直接用吗？;3;1;4;23972;0.0001668613382279326
410;用Microsoftloop啊，;1;0;1;23972;4.171533455698315e-05
413;AI最终会消灭人类。现在就已经开始消灭人类的思考能力和寻找能力;1;0;1;23972;4.171533455698315e-05
415;国内目前用不了;1;0;1;23972;4.171533455698315e-05
417;给换个中文名吧，考拍乐;1;0;1;23972;4.171533455698315e-05
419;666洗哥我們就是用Office365;1;0;1;23972;4.171533455698315e-05
421;1、素材涉及好多个人隐私信息，是否安全呢？2、生成的文字、版式是程序预设置的呢？还是它学习后输出的呢？;1;0;1;23972;4.171533455698315e-05
423;今天你头秃了吗俺哥肯定需要;2;0;2;23972;8.34306691139663e-05
427;mac可以吗;3;1;4;23972;0.0001668613382279326
431;现在e5测试的能用吗;1;0;1;23972;4.171533455698315e-05
433;我刚用上;1;0;1;23972;4.171533455698315e-05
435;让我滚去看论文真是解放双手;10;0;10;23972;0.00041715334556983145
447;没有用，办公环境里其他设备安装的还是2007;2;0;2;23972;8.34306691139663e-05
450;不支持中文;1;0;1;23972;4.171533455698315e-05
452;有点长懒得看;1;0;1;23972;4.171533455698315e-05
454;国内的版本没有这个功能吧，;1;0;1;23972;4.171533455698315e-05
456;我要牺牲20天的零用钱才能付费，怎么办;1;0;1;23972;4.171533455698315e-05
458;估计卡的不行，网络原因;1;0;1;23972;4.171533455698315e-05
460;需要付费，用不了;1;0;1;23972;4.171533455698315e-05
462;我365是企业版;1;1;2;23972;8.34306691139663e-05
464;拿copilot写过代码，效果一般。生成的代码里竟然还带着别人作者名字的注释也不知道它从哪复制粘贴的;2;1;3;23972;0.00012514600367094945
467;好与不好马斯克已经说了，这东西只要把资料和照片在云端存储，死了的人都能在朋友圈再活20年不是问题;1;0;1;23972;4.171533455698315e-05
469;直接升级office365？;1;0;1;23972;4.171533455698315e-05
471;啪忒;1;0;1;23972;4.171533455698315e-05
473;肘文王渡边临失业咯;2;0;2;23972;8.34306691139663e-05
476;4月1日了，还不能用;1;0;1;23972;4.171533455698315e-05
478;正式发布了？;1;0;1;23972;4.171533455698315e-05
480;不是会不会用的问题，是我没有的问题;1;1;2;23972;8.34306691139663e-05
482;留个记号;1;0;1;23972;4.171533455698315e-05
484;这个国内的office365可否使用;1;0;1;23972;4.171533455698315e-05
486;一身冷汗有可能气虚，可以买点花胶补一补;1;0;1;23972;4.171533455698315e-05
488;星星不眨眼瓶邪有雾的夜晚否kkkzhang2牛啊，坐等发布;1;0;1;23972;4.171533455698315e-05
490;有中文的吗;1;0;1;23972;4.171533455698315e-05
492;回我打算换微软的电脑了;1;0;1;23972;4.171533455698315e-05
494;这个是真厉害;1;1;2;23972;8.34306691139663e-05
496;于是机器开始控制人;1;0;1;23972;4.171533455698315e-05
498;都会解决？;1;0;1;23972;4.171533455698315e-05
500;家有柒柒;1;0;1;23972;4.171533455698315e-05
503;很哇塞，明天就试试;1;0;1;23972;4.171533455698315e-05
506;坚决不打工;1;0;1;23972;4.171533455698315e-05
508;Office再好还是更喜欢wps;1;0;1;23972;4.171533455698315e-05
510;可以用中文描述不;2;0;2;23972;8.34306691139663e-05
513;mac也需要;1;0;1;23972;4.171533455698315e-05
515;我以前买的电脑是2016版的能用这个嘛;1;0;1;23972;4.171533455698315e-05
517;PEPE快来学习;1;1;2;23972;8.34306691139663e-05
519;和齐司礼贴贴我当场换专业;4;0;4;23972;0.0001668613382279326
524;目前的法律法规，这个功能很难在国内落地;1;0;1;23972;4.171533455698315e-05
526;努力的白菜姐你必看;2;0;2;23972;8.34306691139663e-05
529;中国地区能用吗;2;1;3;23972;0.00012514600367094945
532;还没上架呢我买的word都没有;1;0;1;23972;4.171533455698315e-05
534;copilot烫嘴是吧;3;0;3;23972;0.00012514600367094945
538;拼车的能用不;3;0;3;23972;0.00012514600367094945
542;凹凸鲁克是什么，发邮件不是打开QQ邮箱吗？;1;0;1;23972;4.171533455698315e-05
544;祥子Amoeba好高级;1;0;1;23972;4.171533455698315e-05
546;这是不是得买付费版的office全家桶;2;0;2;23972;8.34306691139663e-05
549;暂时还用不了;1;0;1;23972;4.171533455698315e-05
551;现在是测试版还没有发布;1;0;1;23972;4.171533455698315e-05
553;Microsoft，麦克罗索芙特。outlook，奥特路可。庆祝趴忒。;7;0;7;23972;0.00029200734189888203
561;阿噜永远吃不饱;1;0;1;23972;4.171533455698315e-05
563;卧槽，太强了;3;1;4;23972;0.0001668613382279326
567;能写专业文章吗？;1;0;1;23972;4.171533455698315e-05
569;更新了吗？;1;0;1;23972;4.171533455698315e-05
571;可以用了？？？;1;0;1;23972;4.171533455698315e-05
573;copalarter;1;0;1;23972;4.171533455698315e-05
575;真的绝了;1;0;1;23972;4.171533455698315e-05
577;我想知道如何申请使用，我的是365家庭版。;2;1;3;23972;0.00012514600367094945
580;就是玩6呀;7;0;7;23972;0.00029200734189888203
588;朝暮晟言涵总我是幸运大王是喜欢还是不甘心倾寒N牛啊;3;1;4;23972;0.0001668613382279326
592;outerlooker;1;0;1;23972;4.171533455698315e-05
594;可怜的塔莎;1;0;1;23972;4.171533455698315e-05
596;还没有个人版吧;3;0;3;23972;0.00012514600367094945
600;我想知道Mac版本的365会不会有;1;0;1;23972;4.171533455698315e-05
602;英语发音说得挺好的;1;0;1;23972;4.171533455698315e-05
604;太强了;1;0;1;23972;4.171533455698315e-05
606;会用也没用公司不让用office;3;0;3;23972;0.00012514600367094945
610;太复杂，我只要贾维斯;1;0;1;23972;4.171533455698315e-05
612;感觉并不高效;1;0;1;23972;4.171533455698315e-05
614;奕lililiiiii这AI要逆天了;1;0;1;23972;4.171533455698315e-05
616;能不能弄个中文的;1;0;1;23972;4.171533455698315e-05
618;直接问它怎么啥也不干搞一个亿;2;0;2;23972;8.34306691139663e-05
621;谢丝塔的助手太强了;2;0;2;23972;8.34306691139663e-05
624;这不考研英语小作文;1;0;1;23972;4.171533455698315e-05
626;Reset我才知道已经整合进一个软件了;1;0;1;23972;4.171533455698315e-05
628;国内可用？;2;0;2;23972;8.34306691139663e-05
631;笔记本赠送的可以用吗;1;0;1;23972;4.171533455698315e-05
634;国内用不了;1;0;1;23972;4.171533455698315e-05
636;淘宝二百多一年的365，六个人各自独立1Tonedrive，每人一年不到四十，有啥好纠结的么;8;4;12;23972;0.0005005840146837978
645;能给我做上课的课件吗？应该怎么提要求呢？;3;3;6;23972;0.0002502920073418989
649;淘宝买个账号，体验一下;1;0;1;23972;4.171533455698315e-05
651;艾伦耶格尔;1;1;2;23972;8.34306691139663e-05
653;oranLinglingDdnnnnny艾玛;4;1;5;23972;0.00020857667278491573
658;魔龙dz又变强了;3;1;4;23972;0.0001668613382279326
662;错过移动端浪潮的微软准确抓住了AI这波浪潮;1;0;1;23972;4.171533455698315e-05
666;喜杨杨仔细看嘛;2;0;2;23972;8.34306691139663e-05
669;不会英文;1;0;1;23972;4.171533455698315e-05
671;这是哪个版本的Office;3;0;3;23972;0.00012514600367094945
675;copilot用法;1;0;1;23972;4.171533455698315e-05
677;扣拍了特;1;0;1;23972;4.171533455698315e-05
679;还没有实装呢;3;0;3;23972;0.00012514600367094945
683;那么与互联网隔绝的那些网和人怎么办呢;4;1;5;23972;0.00020857667278491573
688;这个宣传视频是ai制作的吗？;1;0;1;23972;4.171533455698315e-05
690;我缺的是正版的钱;1;0;1;23972;4.171533455698315e-05
692;疯啦;1;0;1;23972;4.171533455698315e-05
694;需要科技么？;2;2;4;23972;0.0001668613382279326
698;Kepler狗狗狗勾狗勾狗子;4;0;4;23972;0.0001668613382279326
703;ZPP;1;0;1;23972;4.171533455698315e-05
705;Chuck;1;0;1;23972;4.171533455698315e-05
707;徽仟味悦悦;1;0;1;23972;4.171533455698315e-05
709;0;1;0;1;23972;4.171533455698315e-05
711;糖三岁;1;0;1;23972;4.171533455698315e-05
713;无;1;1;2;23972;8.34306691139663e-05
715;二多er;1;0;1;23972;4.171533455698315e-05
717;萧逸的萧小五别叫醒小文恶作剧让我再睡一觉额嗯burnerrrrr溯兮风起雨落qq沐所有与夜的梦郭倚晴爹爹松月ccrabbit5空柚宝plus神谕;2;2;4;23972;0.0001668613382279326
720;初夏;1;0;1;23972;4.171533455698315e-05
722;呐呐娜;1;0;1;23972;4.171533455698315e-05
724;一碗饭;3;0;3;23972;0.00012514600367094945
729;0;1;0;1;23972;4.171533455698315e-05
731;Bellefille1;1;0;1;23972;4.171533455698315e-05
733;LauLanKwan;1;0;1;23972;4.171533455698315e-05
735;冰糖草莓小福娃梅子红花Angelia可别小乔我;1;1;2;23972;8.34306691139663e-05
737;明明没有小鱼干;1;0;1;23972;4.171533455698315e-05
739;喵;1;0;1;23972;4.171533455698315e-05
741;RobbinTattoo;1;0;1;23972;4.171533455698315e-05
743;小李柿柿如意;1;0;1;23972;4.171533455698315e-05
745;Elk乔;4;1;5;23972;0.00020857667278491573
750;她喜欢吃冰激凌;1;0;1;23972;4.171533455698315e-05
752;Yooky;1;0;1;23972;4.171533455698315e-05
754;Dvdujsbsvdimcm;1;0;1;23972;4.171533455698315e-05
756;刘丽丽;2;0;2;23972;8.34306691139663e-05
759;炳莹;1;0;1;23972;4.171533455698315e-05
761;水饱饱;1;0;1;23972;4.171533455698315e-05
763;瓜子er;1;0;1;23972;4.171533455698315e-05
765;新大睡美男小鲤鱼乔尼不会吧，寄了;1;0;1;23972;4.171533455698315e-05
767;炒鸡忙的Daniel;1;0;1;23972;4.171533455698315e-05
769;Nothinglasts;1;0;1;23972;4.171533455698315e-05
771;不记仇的忠会69岁美艳小妈宫潇潇汐;2;2;4;23972;0.0001668613382279326
774;欣欣子;1;0;1;23972;4.171533455698315e-05
776;反而反而;1;0;1;23972;4.171533455698315e-05
779;三细;1;0;1;23972;4.171533455698315e-05
782;晨曦冯彪心动浅安思念成海;1;0;1;23972;4.171533455698315e-05
784;真Book思议呢;1;0;1;23972;4.171533455698315e-05
786;拿下哥说球;1;0;1;23972;4.171533455698315e-05
788;啊童的日常穿搭小小范最最最帅的谢谢谢谢谢谢凡小草不吃吴翰文;1;0;1;23972;4.171533455698315e-05
790;徐徐XuXu;2;1;3;23972;0.00012514600367094945
793;Angann;1;0;1;23972;4.171533455698315e-05
795;Min;1;0;1;23972;4.171533455698315e-05
797;林森。;1;0;1;23972;4.171533455698315e-05
799;hjtcjitdgu无敌大圆圆;1;0;1;23972;4.171533455698315e-05
801;Kadeu;1;1;2;23972;8.34306691139663e-05
803;LifeSuck;1;0;1;23972;4.171533455698315e-05
805;Cya憾迟;3;0;3;23972;0.00012514600367094945
810;斐迪南大公业邑;3;0;3;23972;0.00012514600367094945
814;美女今天学习了嘛嘛嘛;1;0;1;23972;4.171533455698315e-05
816;Shine;1;0;1;23972;4.171533455698315e-05
818;0;1;0;1;23972;4.171533455698315e-05
820;咕咕叽灯呀英雄姐姐宵宫brooo;4;1;5;23972;0.00020857667278491573
825;lin。;1;0;1;23972;4.171533455698315e-05
827;無線愛;1;0;1;23972;4.171533455698315e-05
830;hellozeroz;1;0;1;23972;4.171533455698315e-05
832;我联想送的office全家桶怎么没看见这些，总不能是盗版的吧;6;3;9;23972;0.0003754380110128483
839;某文心：哟，又来活了，赶紧套壳;2;16;18;23972;0.0007508760220256966
842;可不可以先把copilot念明白了;4;8;12;23972;0.0005005840146837978
847;这个copilot发音听的我太难受了。。。那么多工具，配音前把这几个单词好好学一下发音不可以么？;3;6;9;23972;0.0003754380110128483
851;所以我用的学校买的学生版365，能免费升级coplit嘛;5;0;5;23972;0.00020857667278491573
857;我这个以前激活的正版有吗？;4;0;4;23972;0.0001668613382279326
862;国内允许使用？不会阉割？;4;0;4;23972;0.0001668613382279326
867;不懂就问，使用copilot需要魔法吗;3;0;3;23972;0.00012514600367094945
871;为什么我的outlook找不到copilot;3;0;3;23972;0.00012514600367094945
875;如果进国内了，是不是得兼容中文庞大的古诗词库才行，还有各种经典古文，成语、谚语、歇后语等等;3;0;3;23972;0.00012514600367094945
879;几块钱买一个365的永久使用;3;0;3;23972;0.00012514600367094945
883;目前可以通过改注册表实现copilot，但是只支持英文指令;3;0;3;23972;0.00012514600367094945
887;小小姐革命开始;2;0;2;23972;8.34306691139663e-05
890;copilot可以连接家庭wifi么copilot可以连接互联网么;1;1;2;23972;8.34306691139663e-05
892;米扣臊服特;2;0;2;23972;8.34306691139663e-05
895;有80100的毕业party吗？;1;0;1;23972;4.171533455698315e-05
897;想太多了，根本不会放给中国;1;0;1;23972;4.171533455698315e-05
899;这个发布会我看了，当中有一个女讲官说他用copilot写一篇祝贺女儿毕业的演讲词;1;0;1;23972;4.171533455698315e-05
901;遗憾的是在国内用不了;1;0;1;23972;4.171533455698315e-05
903;需要搭梯子吧？;1;0;1;23972;4.171533455698315e-05
905;老板：很好，再帮我写个人员精简计划;1;0;1;23972;4.171533455698315e-05
907;Office365在哪里下载;1;0;1;23972;4.171533455698315e-05
909;国内还是要用codegeex;1;0;1;23972;4.171533455698315e-05
911;Copilot在哪里下载安装;1;0;1;23972;4.171533455698315e-05
913;扣拍乐特;1;0;1;23972;4.171533455698315e-05
915;咋買;1;0;1;23972;4.171533455698315e-05
917;这;1;0;1;23972;4.171533455698315e-05
919;5贝利;1;0;1;23972;4.171533455698315e-05
921;我有正版365坐等发布;1;0;1;23972;4.171533455698315e-05
923;怎么安装copilot;1;0;1;23972;4.171533455698315e-05
925;Copilot需要单独购买吗;1;0;1;23972;4.171533455698315e-05
927;我一直买的正版office是不是就可以用了这个不用chatGTP叭;1;0;1;23972;4.171533455698315e-05
929;在哪下载;1;0;1;23972;4.171533455698315e-05
931;还是不够细致，不知道什么时候支持中文;1;0;1;23972;4.171533455698315e-05
933;把读音稍微练一下吧，听着太难受了;1;0;1;23972;4.171533455698315e-05
935;微软已经裁掉了百分之95的员工，全部交给这个机器人来办公。;1;0;1;23972;4.171533455698315e-05
937;看了半天你就是把Demo解说了一遍。也没教我们怎么在实际上用到Copilot啊;1;0;1;23972;4.171533455698315e-05
939;塔莎毕业，我听成了，她SB耶，有没有和我一样的;1;0;1;23972;4.171533455698315e-05
941;这点隐私眼看就不够用了;1;0;1;23972;4.171533455698315e-05
943;还是有点人工智障给我继续优化;1;0;1;23972;4.171533455698315e-05
945;中国无法用;1;0;1;23972;4.171533455698315e-05
947;这里貌似是中文国家;1;0;1;23972;4.171533455698315e-05
949;首先，目前功能还不成熟，做出来的作品勉强能看。但是最后一定会越来越强大，密集型文员企业会裁员，但是不会都裁完，毕竟还是需要人输入大纲，检查调整的，只是更卷了，三个人的活儿一个人干，三天的活儿一天干。然后需要深度思考，文案类岗位必定不会被淘汰，因为有的文案是需要深度思考，写有含金量的方案的。不是简单的会文档排版、ppt操作，重点是内容。我们公司，四线城市小微公司，已经在实验阶段，预计6月推广使用。我只能对我来说暂时没有价值。我文案岗，ai目前这个水平不太行。可能再过2年我会用。;1;0;1;23972;4.171533455698315e-05
951;请告诉我，中国怎么用到，而不是怎么用;1;0;1;23972;4.171533455698315e-05
957;本来PPT就是展示的为什么要执着于做PPT呢我看到这个非常感叹，真好，可以省很多力，让数据更快可视。为了选配图而浪费的时间也可以节省;51;4105;4156;23972;0.17336893041882195
1009;谁懂有了chatgpt上seminar划水的快乐用它设计的问卷还被夸excellent;14;335;349;23972;0.014558651760387118
1024;现在我们能用到吗？还是需要再等几个月啊？;4;1;5;23972;0.00020857667278491573
1029;做ppt很难吗？真正难的是一次做出领导想看的ppt;45;1278;1323;23972;0.055189387618888704
1075;某度连夜两班倒，保证人工智能正常运转;18;604;622;23972;0.025946938094443518
1094;为啥国内不让用？;6;1;7;23972;0.00029200734189888203
1101;那么问题来了，你们单位有几个会用gpt了;56;442;498;23972;0.02077423660937761
1158;微软估计要全线起飞，下载暴涨;9;9;18;23972;0.0007508760220256966
1168;不是生产力爆炸，而是很快不需要人了;6;70;76;23972;0.003170365426330719
1175;生产力爆炸？生产了什么？;24;18;42;23972;0.001752044051393292
1200;你没说李彦宏的ppt是不是用chatgpt4做的;2;194;196;23972;0.008176205573168697
1203;金山怎么办？我的wps;8;19;27;23972;0.001126314033038545
1212;还好没有自动拉肠粉的，不然我店要没了;3;14;17;23972;0.0007091606874687135
1216;终于ppt浪费时间;1;113;114;23972;0.004755548139496079
1218;不如文心一言;6;49;55;23972;0.002294343400634073
1225;会收集用户数据吗，微软会不会拿用户的数据去训练更强大的GPT5;6;2;8;23972;0.0003337226764558652
1234;晨晨失业了;2;0;2;23972;8.34306691139663e-05
1245;不吃蛋挞边边可以划水了;1;0;1;23972;4.171533455698315e-05
1252;SnowcanCatchU卧槽想要;1;0;1;23972;4.171533455698315e-05
1260;消遣日记二级office可以不用考了;1;1;2;23972;8.34306691139663e-05
1262;碓氷拓海关掉月亮吧吴姥姥橘子小狗赛高;1;0;1;23972;4.171533455698315e-05
1266;Ryan真不错;1;0;1;23972;4.171533455698315e-05
1273;Qann卧槽;1;0;1;23972;4.171533455698315e-05
1277;国内版又用不了吧;3;0;3;23972;0.00012514600367094945
1282;你们放心，企业会适应这个浪潮的，到时候只会更卷，除非资源分配变了;3;6;9;23972;0.0003754380110128483
1286;克莱因蓝我靠;1;1;2;23972;8.34306691139663e-05
1289;收费么;1;0;1;23972;4.171533455698315e-05
1292;请让我更沙雕一点麻了;1;1;2;23972;8.34306691139663e-05
1298;老龄化真的是个问题吗。我说有ai的国家;1;4;5;23972;0.00020857667278491573
1304;栗子蛋你的ppt副业;1;0;1;23972;4.171533455698315e-05
1315;是需要花钱交会员才能用嘛？;1;1;2;23972;8.34306691139663e-05
1317;心机之蛙完蛋，大学生的核心竞争力没了;1;0;1;23972;4.171533455698315e-05
1319;AAA沙坡头香菜批发容姐雄安裴珠泫打游戏第一名璐璐噜噜吖微软大好人;1;2;3;23972;0.00012514600367094945
1321;马云说的对，以后大家只需要学艺术，创造即可;3;4;7;23972;0.00029200734189888203
1327;气氛学九零太好了;2;1;3;23972;0.00012514600367094945
1334;快帮我做课件，谢谢why;1;0;1;23972;4.171533455698315e-05
1337;天才小丸不加糖陈精神给新安排上不眠不休做;1;0;1;23972;4.171533455698315e-05
1340;走走走走很远完了完了，一共就会这么一点，全部取代了;1;0;1;23972;4.171533455698315e-05
1344;洋丸纸快看;1;0;1;23972;4.171533455698315e-05
1346;土木永不为奴;1;0;1;23972;4.171533455698315e-05
1348;怎么用啊，评论区大佬们，求个方法;5;2;7;23972;0.00029200734189888203
1355;哇偶阿拉雷;1;0;1;23972;4.171533455698315e-05
1357;刘宇小分队1好了，用起来;3;0;3;23972;0.00012514600367094945
1363;说吧，买这个多少钱;1;0;1;23972;4.171533455698315e-05
1369;基础的原始数据从哪里来，不管用不用系统，是不是还得人来输入。应该是代替了分析数据的那部分工作。;1;2;3;23972;0.00012514600367094945
1373;手可摘晶晶地里吧热啊小组作业有福了;2;1;3;23972;0.00012514600367094945
1376;我就想知道，这样会不会容易泄密？;5;1;6;23972;0.0002502920073418989
1382;利好什么票呢？;2;0;2;23972;8.34306691139663e-05
1394;懒羊羊刘秘书;5;0;5;23972;0.00020857667278491573
1400;该喂猫啦太方便了;1;0;1;23972;4.171533455698315e-05
1402;kismit人均计二;1;0;1;23972;4.171533455698315e-05
1409;从来不觉得做好ppt有多怎么样以前大学也是有的同学ppt做的很花里胡哨看得出来确实花了心思但是本末倒置了里面的内容没有突出时间全花在特效上了;1;0;1;23972;4.171533455698315e-05
1411;早就该出现这种功能了;2;7;9;23972;0.0003754380110128483
1416;大公司不敢用，小公司没钱用;2;0;2;23972;8.34306691139663e-05
1423;不能引进，我们要保证农民工的饭碗;1;0;1;23972;4.171533455698315e-05
1426;毒斧地的杀手？？？;1;0;1;23972;4.171533455698315e-05
1428;华智冰呢，是时候对抗一下了;1;0;1;23972;4.171533455698315e-05
1436;用户6339418280530你要吃饼吗周游精神守村人杀了一个大菠萝乌乌记得填写昵称彤你妈喊你回家吃饭失业啦;1;0;1;23972;4.171533455698315e-05
1440;曼达林Ale2山中蠢驴用起来;1;0;1;23972;4.171533455698315e-05
1447;sunshine喵小姐;1;0;1;23972;4.171533455698315e-05
1455;na000002来喽;1;0;1;23972;4.171533455698315e-05
1460;半夜里咳嗽的狼我真的感觉电脑相关的岗要提前退休了;1;0;1;23972;4.171533455698315e-05
1463;ppt应该去繁归简。那些花哨的动画，文字，应该要越来越简单才是。只提供必须的信息和图表。不然就是忘记初心。;6;15;21;23972;0.000876022025696646
1471;米苏提拉先马住，后面万一有需要;1;0;1;23972;4.171533455698315e-05
1475;波比哇;1;0;1;23972;4.171533455698315e-05
1484;上岸去看花;1;0;1;23972;4.171533455698315e-05
1490;成诚有个好运气;1;0;1;23972;4.171533455698315e-05
1493;桃子味的气泡水西柚吖是鑫鑫吖;1;1;2;23972;8.34306691139663e-05
1503;一一小猫咪;1;0;1;23972;4.171533455698315e-05
1507;青灯奕;1;0;1;23972;4.171533455698315e-05
1509;文氓;1;0;1;23972;4.171533455698315e-05
1515;m7;3;0;3;23972;0.00012514600367094945
1528;Kkkkkai;1;0;1;23972;4.171533455698315e-05
1532;六串鱼丸丸丸kv3;1;0;1;23972;4.171533455698315e-05
1534;尝尝我意大利面;1;0;1;23972;4.171533455698315e-05
1551;开膛手;1;0;1;23972;4.171533455698315e-05
1555;比熊铁子哥;2;0;2;23972;8.34306691139663e-05
1563;咸;2;0;2;23972;8.34306691139663e-05
1566;GEMCZJ山山而川b张星宇;1;0;1;23972;4.171533455698315e-05
1573;Yuliiiiiiiiiiiii;2;0;2;23972;8.34306691139663e-05
1580;人生得意徐尽欢;1;0;1;23972;4.171533455698315e-05
1582;微笑的苦瓜;1;0;1;23972;4.171533455698315e-05
1587;7;1;1;2;23972;8.34306691139663e-05
1589;不要在峡谷追着我打好吗板烧小卢堡闪电男孩;1;0;1;23972;4.171533455698315e-05
1591;CiCi;2;0;2;23972;8.34306691139663e-05
1596;AR挂件惊宸慕了那个宸Ginkgo;1;1;2;23972;8.34306691139663e-05
1598;狡猾狐狸狸;1;0;1;23972;4.171533455698315e-05
1600;问心;1;0;1;23972;4.171533455698315e-05
1604;陪小七仔一起旅行赊月Wyingj;1;0;1;23972;4.171533455698315e-05
1608;momo我呀要鼠鼠啦;1;0;1;23972;4.171533455698315e-05
1610;春挽穗;1;0;1;23972;4.171533455698315e-05
1620;H;1;0;1;23972;4.171533455698315e-05
1625;阳光大楠孩;1;0;1;23972;4.171533455698315e-05
1628;啊林俊杰的大迷妹应忘忧;1;0;1;23972;4.171533455698315e-05
1630;Paradise;1;0;1;23972;4.171533455698315e-05
1638;阿沐iiibiw25闲闲坏兔子麻辣土豆丝诶哟;1;1;2;23972;8.34306691139663e-05
1645;大菠萝;1;0;1;23972;4.171533455698315e-05
1649;傻波一大树老婆;1;0;1;23972;4.171533455698315e-05
1660;Timi儿;2;0;2;23972;8.34306691139663e-05
1675;我是豆啊周慧Kitty妈狂踹瘸子那条好腿纯爱战神版;1;0;1;23972;4.171533455698315e-05
1679;170621迷人小祖宗小浣熊很好吃;1;0;1;23972;4.171533455698315e-05
1687;咸鱼打扑棱;1;0;1;23972;4.171533455698315e-05
1693;怕什么，我们有文心一言;58;1232;1290;23972;0.05381278157850826
1752;文心一言只会语音搜索功能，小爱小爱我要搜，搞笑;8;73;81;23972;0.0033789420991156348
1761;别在封锁了，解放入口吧不然差距越来越大;5;13;18;23972;0.0007508760220256966
1767;一两页A4能讲完的事情，实在的公司不玩ppt;3;9;12;23972;0.0005005840146837978
1772;我天天都在用，比百度方便;3;2;5;23972;0.00020857667278491573
1776;说实话，数据透视是我最不会用的excel功能;2;4;6;23972;0.0002502920073418989
1779;是曦曦呀我准备花点钱买家庭版office365了，我们可以一起用;3;0;3;23972;0.00012514600367094945
1783;你这个可不行喵ongonglzn妮精分少女可云山止川行风禾尽起;2;0;2;23972;8.34306691139663e-05
1786;国内人口基数大，能干的就那么多活，将来后果不敢设想;1;0;1;23972;4.171533455698315e-05
1788;放心，编制单位不会有不用这种技术、因为涉及到泄密;1;0;1;23972;4.171533455698315e-05
1791;难道就不怕会被盗数据？;1;0;1;23972;4.171533455698315e-05
1793;神里糖期待下以后的CAD，BIM等软件;1;0;1;23972;4.171533455698315e-05
1795;Akiba颀md还说有时间学哈ppt制作现在直接开摆了;1;0;1;23972;4.171533455698315e-05
1798;肢缠;1;0;1;23972;4.171533455698315e-05
1800;zhccccc;1;0;1;23972;4.171533455698315e-05
1802;Luna;1;0;1;23972;4.171533455698315e-05
1804;0;1;0;1;23972;4.171533455698315e-05
1806;辅助能赢吗寒冰刺心慌了慌了;1;0;1;23972;4.171533455698315e-05
1944;如果所有数据都传到后台，这么强的人工智能，企业也就没啥隐私了;2;0;2;23972;8.34306691139663e-05
1948;芜湖奥利奥爱睡觉mistletoe什锦馅饺子未及的梦地底人;3;0;3;23972;0.00012514600367094945
1957;我相信将来有一天人工智能会结合超声诊断，ct等直接分析人体病变，然后给出治疗方案，甚至直接立体全息扫描后机器人自己动手给患者开药，甚至手术;1;0;1;23972;4.171533455698315e-05
1964;有福的Gemini1745101蟑螂嘴好点的鸡蛋饼导导Tera七粒糯米;2;0;2;23972;8.34306691139663e-05
1972;我很需要;1;0;1;23972;4.171533455698315e-05
1985;Heidi也是宜昌菇凉;1;0;1;23972;4.171533455698315e-05
1988;Sober;1;0;1;23972;4.171533455698315e-05
1994;以后简历怎么写啊;1;0;1;23972;4.171533455698315e-05
1996;ArielleirA呀啊啊啊啊啊啊啊啊啊啊啊我的authorpresentation有救了;1;0;1;23972;4.171533455698315e-05
2003;性感小恶霸要下岗了;2;0;2;23972;8.34306691139663e-05
2007;alonewolf;1;0;1;23972;4.171533455698315e-05
2010;怎么感觉chatgpt后ai大范围应用啊;1;0;1;23972;4.171533455698315e-05
2012;pikaboomboomFutureishere;2;0;2;23972;8.34306691139663e-05
2015;落落我真的很需要这个;1;0;1;23972;4.171533455698315e-05
2021;请问为什么还是没有呢;1;0;1;23972;4.171533455698315e-05
2023;一模一样的操作我的为什么没出现copilot;1;0;1;23972;4.171533455698315e-05
2032;怎么申请使用啊;8;1;9;23972;0.0003754380110128483
2041;中文？;1;0;1;23972;4.171533455698315e-05
2043;老板：帮我写封辞退信;1;0;1;23972;4.171533455698315e-05
2047;全都是复制别人的视频发的作品服了;1;0;1;23972;4.171533455698315e-05
2049;请加粉丝群;50;6;56;23972;0.0023360587351910563
2100;这个dogfood属实难用;4;16;20;23972;0.0008343066911396629
2213;文件;1;0;1;23972;4.171533455698315e-05
2425;文件;1;0;1;23972;4.171533455698315e-05
2511;文件;1;0;1;23972;4.171533455698315e-05
2569;东辰;2;0;2;23972;8.34306691139663e-05
2602;powerautomate不香吗？;1;0;1;23972;4.171533455698315e-05
2658;弱弱的问一句中文可用不？;1;0;1;23972;4.171533455698315e-05
2697;文件;1;0;1;23972;4.171533455698315e-05
2721;文件;1;0;1;23972;4.171533455698315e-05
2730;更新到2303检测不到新版本了;1;0;1;23972;4.171533455698315e-05
2759;文件;1;0;1;23972;4.171533455698315e-05
2786;文件，感谢;1;0;1;23972;4.171533455698315e-05
2831;文件;1;0;1;23972;4.171533455698315e-05
2834;文件;1;0;1;23972;4.171533455698315e-05
2840;Mac版可以用嘛;1;0;1;23972;4.171533455698315e-05
2886;Mac版能不能推送一个;1;0;1;23972;4.171533455698315e-05
2893;Mac能用吗;1;0;1;23972;4.171533455698315e-05
2903;文件;1;0;1;23972;4.171533455698315e-05
2913;文件，感谢;1;0;1;23972;4.171533455698315e-05
2963;文件;1;0;1;23972;4.171533455698315e-05
2965;文件;1;0;1;23972;4.171533455698315e-05
2982;需要魔法么;1;0;1;23972;4.171533455698315e-05
2985;文件;1;0;1;23972;4.171533455698315e-05
3009;文件;1;0;1;23972;4.171533455698315e-05
3047;文件，谢谢楼主;1;0;1;23972;4.171533455698315e-05
3054;买笔记本电脑送的那个全家桶能升级为365吗;1;0;1;23972;4.171533455698315e-05
3069;能讲下mac如何处理吗;1;0;1;23972;4.171533455698315e-05
3091;mac可以吗;1;0;1;23972;4.171533455698315e-05
3118;要爬楼梯吗;1;0;1;23972;4.171533455698315e-05
3137;大家不要急，现在不支持中文。花钱搞订阅版有点早了;1;0;1;23972;4.171533455698315e-05
3200;文件;1;0;1;23972;4.171533455698315e-05
3242;Excel能用了吗？;1;0;1;23972;4.171533455698315e-05
3281;虚拟机能用么;1;0;1;23972;4.171533455698315e-05
3316;需要魔法吗;2;0;2;23972;8.34306691139663e-05
3378;Ppt能不能用啊;1;0;1;23972;4.171533455698315e-05
3388;文件;1;0;1;23972;4.171533455698315e-05
3434;现在是只支持英文是吗？;1;0;1;23972;4.171533455698315e-05
3436;文件;1;0;1;23972;4.171533455698315e-05
3438;文件;2;0;2;23972;8.34306691139663e-05
3442;文件;2;0;2;23972;8.34306691139663e-05
3458;mac可以吗;2;0;2;23972;8.34306691139663e-05
3461;是正式版吗？还是只是体验版？;10;11;21;23972;0.000876022025696646
3472;主册表在哪，，;2;6;8;23972;0.0003337226764558652
3475;绿泡泡违规了;1;0;1;23972;4.171533455698315e-05
3477;我的19，控制面板里的图标已经变了;2;1;3;23972;0.00012514600367094945
3480;mac支持？;6;0;6;23972;0.0002502920073418989
3487;要魔法吗？;1;1;2;23972;8.34306691139663e-05
3489;求文件;1;0;1;23972;4.171533455698315e-05
3527;求;1;0;1;23972;4.171533455698315e-05
3536;文件;1;0;1;23972;4.171533455698315e-05
3538;文件;1;0;1;23972;4.171533455698315e-05
3565;现在只是内测吧，正式官方体验版应该在67月份推出可以去MS官网博客了解;1;1;2;23972;8.34306691139663e-05
3661;文件;2;0;2;23972;8.34306691139663e-05
3727;文件;1;0;1;23972;4.171533455698315e-05
3737;文件;1;0;1;23972;4.171533455698315e-05
3739;文件;1;0;1;23972;4.171533455698315e-05
3742;文件;1;0;1;23972;4.171533455698315e-05
3744;文件;1;0;1;23972;4.171533455698315e-05
3746;文件;1;0;1;23972;4.171533455698315e-05
3748;文件;1;0;1;23972;4.171533455698315e-05
3750;文件;1;0;1;23972;4.171533455698315e-05
3752;office2023有没有啊，必须是365才行吗;2;1;3;23972;0.00012514600367094945
3755;文件;1;0;1;23972;4.171533455698315e-05
3758;文件;1;0;1;23972;4.171533455698315e-05
3760;文件;1;0;1;23972;4.171533455698315e-05
3762;文件;1;1;2;23972;8.34306691139663e-05
3764;文件;1;0;1;23972;4.171533455698315e-05
3766;文件;1;0;1;23972;4.171533455698315e-05
3768;文件;1;0;1;23972;4.171533455698315e-05
3770;文件;1;0;1;23972;4.171533455698315e-05
3773;文件;1;0;1;23972;4.171533455698315e-05
3775;文件;1;0;1;23972;4.171533455698315e-05
3777;文件;1;0;1;23972;4.171533455698315e-05
3780;文件;1;0;1;23972;4.171533455698315e-05
3796;文件;2;0;2;23972;8.34306691139663e-05
3799;文件;1;0;1;23972;4.171533455698315e-05
3810;文件;1;0;1;23972;4.171533455698315e-05
3812;文件;1;0;1;23972;4.171533455698315e-05
3815;文件;1;0;1;23972;4.171533455698315e-05
3820;文件;1;0;1;23972;4.171533455698315e-05
3822;求文件;1;0;1;23972;4.171533455698315e-05
3827;文件;1;1;2;23972;8.34306691139663e-05
3837;文件;1;0;1;23972;4.171533455698315e-05
3841;文件;1;0;1;23972;4.171533455698315e-05
3843;文件;1;0;1;23972;4.171533455698315e-05
3846;文件;1;0;1;23972;4.171533455698315e-05
3848;文件;1;0;1;23972;4.171533455698315e-05
3852;文件;1;0;1;23972;4.171533455698315e-05
3854;文件;1;0;1;23972;4.171533455698315e-05
3856;文件;1;0;1;23972;4.171533455698315e-05
3858;文件;1;0;1;23972;4.171533455698315e-05
3863;文件;1;0;1;23972;4.171533455698315e-05
3867;文件;1;0;1;23972;4.171533455698315e-05
3869;文件;1;0;1;23972;4.171533455698315e-05
3871;文件;1;0;1;23972;4.171533455698315e-05
3926;文件;1;0;1;23972;4.171533455698315e-05
3928;文件;1;0;1;23972;4.171533455698315e-05
3937;有免费小可以长按视频发噢;4;16;20;23972;0.0008343066911396629
3942;被你这样一说，我感觉人都有点多余了。;8;124;132;23972;0.005506424161521775
3951;坐等微软给定价策略，以后应该比招个人便宜，就是不能背锅;9;100;109;23972;0.004546971466711163
3962;科技只会让你的工作越来越累，本来你一天做一个PPT就可以下班了，现在科技发达了，你必须每天做100个PPT才能下班。;5;64;69;23972;0.002878358084431837
3968;挺好，你电脑里所有的东西都是他的了;3;71;74;23972;0.003086934757216753
3972;文员70是女性;1;0;1;23972;4.171533455698315e-05
3974;对呀，有了这玩意，老板以后都自己干活了，都不用请员工，我真是个大聪明;1;80;81;23972;0.0033789420991156348
3976;说到底也只是一种工具，还是需要人去操作的;7;35;42;23972;0.001752044051393292
3984;这个AI是在线使用的吗？如果是企业核心数据，会不会因为AI在线而导致数据泄漏？;7;15;22;23972;0.0009177373602536292
3992;我坚信每一个人产品发明工具的前提是减少我们在工作上投入的时间，减少因为加班喝咖啡的次数，有更多的时间去享受生活。;4;5;9;23972;0.0003754380110128483
3997;AI只是把那些耗费时间但是没有多少意义的事情帮人做了，核心还是要人自己来做;3;11;14;23972;0.0005840146837977641
4001;小点声，你吵到我的TNT了;2;13;15;23972;0.0006257300183547472
4004;少有的自己砸自己饭碗的主播;1;9;10;23972;0.00041715334556983145
4006;真的吗？我毕业论文也能AI出来么;3;2;5;23972;0.00020857667278491573
4010;对我来说，AI一直不能满足我满意度。我的想法是独一无二的，AI是不能的;2;3;5;23972;0.00020857667278491573
4013;大部分文员、策划本身就很水，这边说的是小单位、小公司。有这么个东西是好事;1;5;6;23972;0.0002502920073418989
4015;就和制造业一样，以前一台设备一个人，现在十台设备一个人，还是需要人，只是需要的少了所以很多人确实可以辞退他们了，剩下的钱加点工资;1;5;6;23972;0.0002502920073418989
4017;港币540;2;0;2;23972;8.34306691139663e-05
4038;数据安全吗？;1;0;1;23972;4.171533455698315e-05
4042;然后就会有长期的核对工作确认AI接收到的是不是自己要的指令;1;0;1;23972;4.171533455698315e-05
4044;论文还用自己写吗;1;0;1;23972;4.171533455698315e-05
4048;海森堡连续刷了好几个ai视频了;1;0;1;23972;4.171533455698315e-05
4052;可以写代码吗;1;0;1;23972;4.171533455698315e-05
4057;小扇贝我要失业了;1;1;2;23972;8.34306691139663e-05
4062;XXXHolic唐不甩真好我也想要;1;0;1;23972;4.171533455698315e-05
4066;这个算吗？手机自带的，;3;0;3;23972;0.00012514600367094945
4070;国内不能用;1;0;1;23972;4.171533455698315e-05
4074;45块钱一个月啊;1;0;1;23972;4.171533455698315e-05
4081;哈喽西百吖都嘎巴;2;0;2;23972;8.34306691139663e-05
4085;喷射阿杀姆sunsetglow糖炒莉子好了，还没毕业就要先失业了gpt4;2;0;2;23972;8.34306691139663e-05
4090;炭烧冰激凌口袋中的小妖怪失业了;1;0;1;23972;4.171533455698315e-05
4095;Mist卧槽;1;0;1;23972;4.171533455698315e-05
4101;目前只支持英文，中文应该还是不那么容易;1;0;1;23972;4.171533455698315e-05
4103;OrzZyc失业又近了一步;2;0;2;23972;8.34306691139663e-05
4107;它能替我挨骂和背锅吗;1;0;1;23972;4.171533455698315e-05
4109;对我来说是提升效距，不会抢我饭碗;1;0;1;23972;4.171533455698315e-05
4111;嘿我的小狗叫慌慌呜啦啦啦啦啦啦啦啦GT文职没前途了;1;0;1;23972;4.171533455698315e-05
4113;这玩意用来考计算机一级那不是轻轻松松;1;0;1;23972;4.171533455698315e-05
4116;这个是不是跟之前什么清华大学做的软件一样;1;0;1;23972;4.171533455698315e-05
4119;那么问题来了，数据传哪儿去了？数据泄露给谁了？;1;0;1;23972;4.171533455698315e-05
4121;看看我的公司有没有钱买哈哈哈哈哈正版系统都舍不得;2;0;2;23972;8.34306691139663e-05
4141;三哥win11都搞成这样，office回搞成什么样我很好奇;1;1;2;23972;8.34306691139663e-05
4156;那你告诉我怎么用我今天刚更新的系统？;4;0;4;23972;0.0001668613382279326
4162;有没有危机感;2;1;3;23972;0.00012514600367094945
4167;中国能用么;1;0;1;23972;4.171533455698315e-05
4169;等以后接入语音，真的就是说句话，要什么信息就给什么信息，大部分数据工作可以被接替了，焦虑制造机赶紧找找新的出路;6;8;14;23972;0.0005840146837977641
4178;，;1;0;1;23972;4.171533455698315e-05
4180;小莫唐尼;1;0;1;23972;4.171533455698315e-05
4187;东;1;1;2;23972;8.34306691139663e-05
4196;可以做工程报价吗？;1;0;1;23972;4.171533455698315e-05
4198;vlookup用身份证号筛选只会对照前15位么会不会出现前15位重复导致数据错误;2;0;2;23972;8.34306691139663e-05
4204;浔雾;1;0;1;23972;4.171533455698315e-05
4212;注意安全;1;0;1;23972;4.171533455698315e-05
4214;今天不熬夜（毕业倒计时版）mrslli（心事版）;3;0;3;23972;0.00012514600367094945
4218;二十一世纪冤种战士;1;0;1;23972;4.171533455698315e-05
4222;自我;1;0;1;23972;4.171533455698315e-05
4228;工作版;1;0;1;23972;4.171533455698315e-05
4231;见你说句6;1;0;1;23972;4.171533455698315e-05
4237;阿咩咩咩鼠鼠我啊哎;1;0;1;23972;4.171533455698315e-05
4240;呱猪油泡猴Ve什么时候起床;2;0;2;23972;8.34306691139663e-05
4248;你的名字达拉崩吧闰晶;4;0;4;23972;0.0001668613382279326
4255;无撸可;1;0;1;23972;4.171533455698315e-05
4270;zzs;1;0;1;23972;4.171533455698315e-05
4274;思思;1;1;2;23972;8.34306691139663e-05
4278;0;5;0;5;23972;0.00020857667278491573
4284;别想太多这个要收费公司会给你买吗;1;2;3;23972;0.00012514600367094945
4286;本來很喜歡你的，現在開始吹營銷號的風，真的是;2;0;2;23972;8.34306691139663e-05
4290;滴滴滴滴我来了;1;0;1;23972;4.171533455698315e-05
4292;告诉我ppt永久密钥;1;0;1;23972;4.171533455698315e-05
4337;老板肯定需要我，因为我gpt用的六;1;0;1;23972;4.171533455698315e-05
4339;又在贩卖焦虑你直接说你在贩卖什么课程;1;0;1;23972;4.171533455698315e-05
4341;我不觉得这个东东有人敢用你工作上那么多秘密，难道不怕？;1;0;1;23972;4.171533455698315e-05
4343;哪里下载;1;0;1;23972;4.171533455698315e-05
4347;等着我们弯道超车;23;52;75;23972;0.003128650091773736
4371;讲个笑话，文言一心;5;43;48;23972;0.002002336058735191
4378;不懂就问：WPS会集成文心一言吗;7;14;21;23972;0.000876022025696646
4386;还要人干嘛;6;4;10;23972;0.00041715334556983145
4394;是不是要付费使用;12;1;13;23972;0.0005422993492407809
4407;新型毒素使人成巨婴;4;1;5;23972;0.00020857667278491573
4452;会有越来越多的人找不到合适自己的岗位了;1;0;1;23972;4.171533455698315e-05
4462;华为，百度才是遥遥领先;1;1;2;23972;8.34306691139663e-05
4475;那还要人干嘛文员都可以打包回家了;5;6;11;23972;0.0004588686801268146
4481;人类过度依赖AI会出大乱;9;0;9;23972;0.0003754380110128483
4495;国内又不能用;1;0;1;23972;4.171533455698315e-05
4535;我觉得这不是大结局，而是刚刚开始;1;44;45;23972;0.0018771900550642415
4537;这是谁的大结局后面在出第二季第三季怎么办呢;7;10;17;23972;0.0007091606874687135
4545;今年底买微软笔记本，应该有革新后的软件可用吧？;1;0;1;23972;4.171533455698315e-05
4547;影响到我工厂大螺丝吗？;9;3;12;23972;0.0005005840146837978
4557;放心吧ai還不會倒咖啡和清潔地方;6;2;8;23972;0.0003337226764558652
4564;只需要按几个命令或说几句语音，让AI干体力活;1;0;1;23972;4.171533455698315e-05
4566;再简化的工作，再智能老板一个人也做不完工作，只能说AI帮我们提升工作效率而已;9;1;10;23972;0.00041715334556983145
4576;一个不能用的东西无所谓;5;2;7;23972;0.00029200734189888203
4582;能不能，脑子一闪灵光，它就帮我做好了？;3;2;5;23972;0.00020857667278491573
4586;就是说这个功能直接能用了嘛，还是要等几年;4;0;4;23972;0.0001668613382279326
4592;那个词我一直以为读扣了特。;2;1;3;23972;0.00012514600367094945
4595;大结局？这只是开始，如果和机器结合，视觉结婚，不晓得可以代替多少人工;1;2;3;23972;0.00012514600367094945
4599;微软流产的项目比没有一千也有一万了吧;1;2;3;23972;0.00012514600367094945
4601;再这样下去，以后竞争最激烈的工作就是扫马路了。;1;2;3;23972;0.00012514600367094945
4609;怎么下载;1;0;1;23972;4.171533455698315e-05
4623;国内能用吗;2;0;2;23972;8.34306691139663e-05
4634;作为一个网红，是不是要搞一搞头发再拍视频;1;1;2;23972;8.34306691139663e-05
4642;玩了，我的wps会员;1;2;3;23972;0.00012514600367094945
4650;50一个月的家庭版，有这些吗？;1;1;2;23972;8.34306691139663e-05
4653;copylot;1;1;2;23972;8.34306691139663e-05
4656;我想知道什么时候能用;1;1;2;23972;8.34306691139663e-05
4658;现实手工定制要比机械手制作的贵的多，;1;1;2;23972;8.34306691139663e-05
4666;秘书永远不会下岗，特别是女秘书;1;2;3;23972;0.00012514600367094945
4669;门槛是有多低才会被软件炒鱿鱼？;1;1;2;23972;8.34306691139663e-05
4672;大结局？？问问文心一言;1;1;2;23972;8.34306691139663e-05
4709;如何使用copilot呢，现在下载了office365，但是没有人工智能的选项啊;8;2;10;23972;0.00041715334556983145
4719;试了，早起版，烂的要死;7;105;112;23972;0.0046721174703821125
4727;我建议先问问公司让不让用，因为这个东西是会收集你们公司的数据的，要是泄露一些关键数据，那可能要吃官司的;7;20;27;23972;0.001126314033038545
4735;那么微软365是不是得氪金？;1;0;1;23972;4.171533455698315e-05
4737;没事，学校帮我们买了;1;8;9;23972;0.0003754380110128483
4739;买电脑自带的应该是正版吧;1;7;8;23972;0.0003337226764558652
4741;我看谁还不会注册;2;2;4;23972;0.0001668613382279326
4744;刚试了和GPT的差距有点大;1;1;2;23972;8.34306691139663e-05
4746;有没有韭菜说下体验;1;0;1;23972;4.171533455698315e-05
4761;免费的GPT不香么接个验证码才12;7;1;8;23972;0.0003337226764558652
4769;程序员上个月已经用上了cto在分享会上疯狂安利太离谱了;3;2;5;23972;0.00020857667278491573
4773;盗版可以么;3;0;3;23972;0.00012514600367094945
4777;周报这种东西根本就不应该存在于这个世界;1;1;2;23972;8.34306691139663e-05
4780;带什么路？进去一次，简讯验证一次;1;0;1;23972;4.171533455698315e-05
4784;国内不能用啊;4;7;11;23972;0.0004588686801268146
4789;这个侧边栏要怎么才能在国内使用，不魔法的情况下;3;2;5;23972;0.00020857667278491573
4793;要魔法，而且有时候还要清一下缓存;1;0;1;23972;4.171533455698315e-05
4797;你用魔法了吗;1;0;1;23972;4.171533455698315e-05
4799;不用想了，这个openai不够智能，有些东西胡说八道，所以用不了;1;2;3;23972;0.00012514600367094945
4809;国内不能使用吧;1;0;1;23972;4.171533455698315e-05
4813;是不是不用候补名单了？之前没试过，今天一个新邮箱直接就能用newbing聊天功能了;1;1;2;23972;8.34306691139663e-05
4817;强迫症患者改注册表把那个图标去掉了;1;0;1;23972;4.171533455698315e-05
4826;我用WPS;1;3;4;23972;0.0001668613382279326
4834;什么时候可以把人淘汰了;1;0;1;23972;4.171533455698315e-05
4843;付费的吧;2;0;2;23972;8.34306691139663e-05
4846;0;1;0;1;23972;4.171533455698315e-05
4848;真要是普及啦一大批文员直接失业;1;0;1;23972;4.171533455698315e-05
4856;求代码;1;1;2;23972;8.34306691139663e-05
4860;求代码;1;0;1;23972;4.171533455698315e-05
4866;那工作时间是不是可以缩短了，那么快不就没事可做了;2;0;2;23972;8.34306691139663e-05
4869;什么时候上线;1;0;1;23972;4.171533455698315e-05
4913;只是方便很多岗位干活而已，不会有什么影响。;21;21;42;23972;0.001752044051393292
4935;国内用不了;5;3;8;23972;0.0003337226764558652
4941;其实国企21年的时候，很多表格都是机器人在做了，当时取消了好几个三方单位;3;0;3;23972;0.00012514600367094945
4945;又有多少前台小妹要变成包厢小妹;4;7;11;23972;0.0004588686801268146
4952;365套餐要涨价了;3;1;4;23972;0.0001668613382279326
4956;以后招聘条件就两条：35岁以下，会用GPT;5;0;5;23972;0.00020857667278491573
4962;借用微软的一段话，人最大的价值是创造，而现在多少人浪费在重复性工作上;1;5;6;23972;0.0002502920073418989
4964;很多老板字都不会打;4;0;4;23972;0.0001668613382279326
4969;团结就是力量打不过知识就是力量了;1;3;4;23972;0.0001668613382279326
4971;我们有机会能用的上吗？;1;2;3;23972;0.00012514600367094945
4973;不得了;1;1;2;23972;8.34306691139663e-05
4975;服了服了;1;1;2;23972;8.34306691139663e-05
4977;我让它设计一座一百层的大楼，它能行不;1;1;2;23972;8.34306691139663e-05
4979;多出来的时间卷了;1;0;1;23972;4.171533455698315e-05
4981;365订阅制的;1;3;4;23972;0.0001668613382279326
4983;这东西真的挺吓人的;1;0;1;23972;4.171533455698315e-05
4985;就跟汽车出来时和机器出来时淘汰的情况一样;1;0;1;23972;4.171533455698315e-05
4987;好消息;1;3;4;23972;0.0001668613382279326
4990;提高效率及ppt品质，为什么会想到被取代工作呢？;1;0;1;23972;4.171533455698315e-05
4992;机器吃人到人工智能吃人;1;0;1;23972;4.171533455698315e-05
4996;能影响我每月3000块吗;1;0;1;23972;4.171533455698315e-05
4998;让更多的人进去服务业;1;0;1;23972;4.171533455698315e-05
5004;厉害国肯定墙掉了;3;7;10;23972;0.00041715334556983145
5008;我现在用的就是这个，无限白嫖的;3;4;7;23972;0.00029200734189888203
5012;我有微软office激活器;2;1;3;23972;0.00012514600367094945
5015;文案策划，文员可以退伍了;1;1;2;23972;8.34306691139663e-05
5017;放心吧，老板绝对不会用PPT，他们连电脑都不会用，他们根本不知道要说什么。让员工写PPT，然后胡乱瞎批评，其实就是他们让员工把问题解释给他们听的过程，他们根本连问题是什么都不知道。;2;3;5;23972;0.00020857667278491573
5020;再厉害也会404;1;2;3;23972;0.00012514600367094945
5022;你认为资本主义是什么？;2;0;2;23972;8.34306691139663e-05
5025;可恶的美国人;1;2;3;23972;0.00012514600367094945
5027;国内用不了，因为有一堵墙啊，外企估计可以;1;2;3;23972;0.00012514600367094945
5029;早晚代替全部行业。人类最后只能为如何保命而努力。;1;0;1;23972;4.171533455698315e-05
5031;这一波，我站文心一言。首先，国家的立场，就是我的立场。其次，我欣赏它文不由心，一派胡言的气质。;1;1;2;23972;8.34306691139663e-05
5033;谷歌哭了，掌握着海量的数据却没有做出最先进的人工智能，被有一个名不见经传的openai甩在身后，又让微软这个坐地户拿到足够的投资份额，;1;0;1;23972;4.171533455698315e-05
5041;微软还是大哥;2;3;5;23972;0.00020857667278491573
5044;AI不能创新，只是搜索引擎，如果所有人都用它，那么它将再也得不到新的知识，最后会变成什么;2;1;3;23972;0.00012514600367094945
5048;您好，国内现在可以用到吗？;1;0;1;23972;4.171533455698315e-05
5050;对抗的意思通常是实力相当;1;0;1;23972;4.171533455698315e-05
5052;能用了吗;1;0;1;23972;4.171533455698315e-05
5054;没人？;1;1;2;23972;8.34306691139663e-05
5057;百度会员VIP功能;6;2;8;23972;0.0003337226764558652
5064;你以为人家40是刚出的其实人家35的是已经有40了;3;0;3;23972;0.00012514600367094945
5068;就看中国区能不能使用这个功能了;1;4;5;23972;0.00020857667278491573
5077;现在只想用国产的，用国外的数据都上传到国外服务器了;8;5;13;23972;0.0005422993492407809
5088;几点上线？;1;0;1;23972;4.171533455698315e-05
5091;这种炫酷的亚克力效果，在Windows100之前能实机用上吗;1;0;1;23972;4.171533455698315e-05
5097;所有数据都可能传到国外服务器;1;1;2;23972;8.34306691139663e-05
5121;听那些大傻，说什么取代程序员，开什么国际玩笑;1;0;1;23972;4.171533455698315e-05
5123;国内什么时候能用？;1;0;1;23972;4.171533455698315e-05
5125;但是这个造成泄密，工作就丢了;7;5;12;23972;0.0005005840146837978
5134;我需要修改表;1;0;1;23972;4.171533455698315e-05
5136;PPT能用了吗？中文能用了吗？;3;0;3;23972;0.00012514600367094945
5140;111需要;1;0;1;23972;4.171533455698315e-05
5142;现在不是chatgpt大部分账号都不给用了么;1;2;3;23972;0.00012514600367094945
5144;为啥我的是2303没有2305;2;0;2;23972;8.34306691139663e-05
5147;有365密钥吗;2;0;2;23972;8.34306691139663e-05
5150;升级为2305beta版本后，更改了第二步的注册表信息，一样没有copilot出现。;1;1;2;23972;8.34306691139663e-05
5154;需要修改表;1;0;1;23972;4.171533455698315e-05
5159;需要;1;0;1;23972;4.171533455698315e-05
5166;需要;1;0;1;23972;4.171533455698315e-05
5168;需要;1;0;1;23972;4.171533455698315e-05
5170;需要;1;0;1;23972;4.171533455698315e-05
5173;需要;1;0;1;23972;4.171533455698315e-05
5175;需要;1;0;1;23972;4.171533455698315e-05
5177;需要;1;0;1;23972;4.171533455698315e-05
5180;需要;1;0;1;23972;4.171533455698315e-05
5183;需要;1;0;1;23972;4.171533455698315e-05
5185;需要;1;1;2;23972;8.34306691139663e-05
5188;兄弟们我有个问题就是我点这个新建空白文档以后它就进入到一个网页，但这个网页还进不去显示我可能是网络不好;2;0;2;23972;8.34306691139663e-05
5191;应该要梯子吧？;2;0;2;23972;8.34306691139663e-05
5194;不用梯子是吧老兄;1;0;1;23972;4.171533455698315e-05
5196;我今天买了一个号，试用了一下，真的很不错;1;0;1;23972;4.171533455698315e-05
5198;这个网站比gpt门槛高，不是随便开个节点就行的;21;32;53;23972;0.002210912731520107
5220;第一个门槛就拦住了魔法有了、候补名单有了，网页都死活打不开;13;6;19;23972;0.0007925913565826798
5234;这不是用来写代码的吗;1;0;1;23972;4.171533455698315e-05
5236;我需要一直都不是Word、PPT这些都有替代品，我要的是Excel;6;52;58;23972;0.0024194894043050225
5243;都是跳到cn，;6;4;10;23972;0.00041715334556983145
5250;请问使用mac访问newbing时网页自动跳转cnbing如何解决;1;0;1;23972;4.171533455698315e-05
5252;别误导，每天限制200次对话。;5;4;9;23972;0.0003754380110128483
5258;他不支持中文;10;2;12;23972;0.0005005840146837978
5269;能做PPT吗？;10;0;10;23972;0.00041715334556983145
5280;我的三个点里都没有“侧栏”这一个选项;6;1;7;23972;0.00029200734189888203
5287;为什么我的网页有20条的限制呢;5;3;8;23972;0.0003337226764558652
5293;不能用呀;7;0;7;23972;0.00029200734189888203
5301;点聊天出错聊请重试;5;1;6;23972;0.0002502920073418989
5307;我有个疑问，侧边栏文章撰写有字数限制，如果对话模式可以要求继续，侧边栏就卡住了，咋弄;4;2;6;23972;0.0002502920073418989
5312;我咋找不到怎么用呢找不到入口;4;1;5;23972;0.00020857667278491573
5317;直讲干货，一针见血，互联网清流，希望作者一直坚持;2;0;2;23972;8.34306691139663e-05
5320;你可以问问newbing如何在microsoft365中使用copilot;3;0;3;23972;0.00012514600367094945
5324;小妾给我个魔法;5;0;5;23972;0.00020857667278491573
5330;我让他画几个早安图，当要求使用中文“早安”字样的时候，就瞎搞了完全做不了。;1;0;1;23972;4.171533455698315e-05
5332;你这个网页版的word菜单栏怎么弄成中文，我试了翻译不了;1;0;1;23972;4.171533455698315e-05
5334;不想用edge，，等google的Bard做好一点吧;1;0;1;23972;4.171533455698315e-05
5336;全局不是魔法吗？;1;0;1;23972;4.171533455698315e-05
5340;为什么我已经登陆了，还是提示我登录以继续;1;0;1;23972;4.171533455698315e-05
5342;全局魔法怎么开;1;0;1;23972;4.171533455698315e-05
5348;现在魔法都失效了，根本就是不想让我等接触;1;0;1;23972;4.171533455698315e-05
5352;为啥我的叫他画图回答所在区域还没开通;1;0;1;23972;4.171533455698315e-05
5354;怎么让侧边栏有聊天呀？;1;0;1;23972;4.171533455698315e-05
5356;地区不支持怎么搞;1;0;1;23972;4.171533455698315e-05
5358;侧边栏没有生成页面要点的选项;1;0;1;23972;4.171533455698315e-05
5360;魔法收费吗？试过很多办法，都会转到cn;1;0;1;23972;4.171533455698315e-05
5362;第一步就卡了同樣是進入newbing我的介面就跟你的不一樣就沒有你說的選項;6;0;6;23972;0.0002502920073418989
5369;为啥我的必应没有聊天的这个功能;6;0;6;23972;0.0002502920073418989
5376;打不开;1;0;1;23972;4.171533455698315e-05
5378;已经在用了;2;0;2;23972;8.34306691139663e-05
5382;我就不用edge我就用360极速X;1;1;2;23972;8.34306691139663e-05
5385;用了一个多月，嗯。。。写论文的助力不太大，相当于更好的百度百科。;1;1;2;23972;8.34306691139663e-05
5389;好东西;1;0;1;23972;4.171533455698315e-05
5391;我的魔法也打不开;5;0;5;23972;0.00020857667278491573
5397;怎么魔法;1;0;1;23972;4.171533455698315e-05
5399;留个记号;1;0;1;23972;4.171533455698315e-05
5401;就这个网站就没法进;1;0;1;23972;4.171533455698315e-05
5403;出错了。请重试。;1;0;1;23972;4.171533455698315e-05
5405;我用我的老账号各种改各种不行，新注册一个账号直接行了;3;0;3;23972;0.00012514600367094945
5409;你们这些人教别人一点诚意也没有，都不说重点，害我研究了半天才;3;0;3;23972;0.00012514600367094945
5413;为啥我打开的不一样;3;0;3;23972;0.00012514600367094945
5417;，;1;0;1;23972;4.171533455698315e-05
5419;可以画PCB吗？;2;1;3;23972;0.00012514600367094945
5422;每次对话限制15次;8;0;8;23972;0.0003337226764558652
5431;需要魔法吗;1;0;1;23972;4.171533455698315e-05
5433;打不开啊，聊天魔法开了啊;2;0;2;23972;8.34306691139663e-05
5437;牛比;1;0;1;23972;4.171533455698315e-05
5439;用魔法都打不开newbing。。。;2;0;2;23972;8.34306691139663e-05
5442;这个绘图真不是无限免费;1;0;1;23972;4.171533455698315e-05
5444;我把他邮件屏蔽了，天天给我发邮件。。。;1;1;2;23972;8.34306691139663e-05
5446;改有问题我只希望他在第一次生成四张图中某一张去做修改貌似不行，说了要求每次都是画新造型给我。;1;0;1;23972;4.171533455698315e-05
5448;我这个对话框里长期生成失败要不就是不显示;1;0;1;23972;4.171533455698315e-05
5451;0;1;0;1;23972;4.171533455698315e-05
5454;我一直是候补名单;1;0;1;23972;4.171533455698315e-05
5456;有时候这东西抽风，;1;0;1;23972;4.171533455698315e-05
5458;这波图片版权商哭晕在厕所;1;0;1;23972;4.171533455698315e-05
5461;copilot需要调用api才可以用;2;0;2;23972;8.34306691139663e-05
5464;我用过了。代码基本上都对。关于中国的很多信息都是错的;1;0;1;23972;4.171533455698315e-05
5468;求一个魔法，好人一生发财;2;0;2;23972;8.34306691139663e-05
5471;都是需要魔法的;1;0;1;23972;4.171533455698315e-05
5473;我的edge浏览器设置里没有打开bing图标的选项怎么回事;1;0;1;23972;4.171533455698315e-05
5475;不用魔法吗？;4;0;4;23972;0.0001668613382279326
5480;帮我画一张百万英镑;1;0;1;23972;4.171533455698315e-05
5482;网页连不上;1;0;1;23972;4.171533455698315e-05
5484;我连newbing都打不开;3;0;3;23972;0.00012514600367094945
5489;你它叫阉割版？;4;0;4;23972;0.0001668613382279326
5494;我还是没有使用资格;1;0;1;23972;4.171533455698315e-05
5497;新必应现在不仅插件不能用了，而且得用全局模式，太麻烦了。所以我选择SD;1;0;1;23972;4.171533455698315e-05
5499;中午看完下午用，牛逼plus;1;0;1;23972;4.171533455698315e-05
5501;现在不用排队预约，直接就可加入使用new了;1;0;1;23972;4.171533455698315e-05
5504;手机版的为什么不能画;1;0;1;23972;4.171533455698315e-05
5506;侧边栏添加不了哦;1;0;1;23972;4.171533455698315e-05
5508;这个就是newbing吗？？我也一直在用，不知道它可以画画;1;0;1;23972;4.171533455698315e-05
5510;可以教如何使用newbing做ppt吗;1;0;1;23972;4.171533455698315e-05
5513;开了魔法还是cn不知道怎么回事，试了很多次都没用。;1;0;1;23972;4.171533455698315e-05
5515;他的图片没有创造性而且不能用都是引擎搜过来的，有版权问题，midjourney是有独特创造性的版权属于会员者的;1;0;1;23972;4.171533455698315e-05
5518;画画不是限制25次吗，现在不限了？;1;0;1;23972;4.171533455698315e-05
5520;明天就试一试，目前只能用Chrome打开newbing;1;0;1;23972;4.171533455698315e-05
5522;我登录不上为啥;1;1;2;23972;8.34306691139663e-05
5524;360浏览器大哥，我快要顶不住了，不是你不香，这次确实是微软给太多了。。。。。;6;0;6;23972;0.0002502920073418989
5531;现在newbing打不开了了;1;0;1;23972;4.171533455698315e-05
5533;为什么我不会自动生成文章要点;4;0;4;23972;0.0001668613382279326
5538;还好申请得早;3;0;3;23972;0.00012514600367094945
5542;newbing注册不了，;2;0;2;23972;8.34306691139663e-05
5545;up主这种头像是怎么画出来的呀什么关键词;2;0;2;23972;8.34306691139663e-05
5549;用了挺长时间，现在才知道可以画画;5;0;5;23972;0.00020857667278491573
5556;让我排队是什么鬼;1;0;1;23972;4.171533455698315e-05
5558;怎么打开网页版word？;1;1;2;23972;8.34306691139663e-05
5560;0;1;0;1;23972;4.171533455698315e-05
5562;表哥;1;0;1;23972;4.171533455698315e-05
5564;我作为程序员，比较支持读成copilot;1;0;1;23972;4.171533455698315e-05
5566;不用魔法可以登陆newbing吗？;2;0;2;23972;8.34306691139663e-05
5569;我的new病病了一直不给过;1;2;3;23972;0.00012514600367094945
5571;魔法要全局;1;0;1;23972;4.171533455698315e-05
5573;我的一直在候选;2;1;3;23972;0.00012514600367094945
5576;问题是一直打开的是搜索页，没有ai的那个聊天页。;3;0;3;23972;0.00012514600367094945
5580;这个网址打不开啊;4;0;4;23972;0.0001668613382279326
5585;还要啥自行车啊;3;0;3;23972;0.00012514600367094945
5589;bing绘画有次数的，每天一百次;3;0;3;23972;0.00012514600367094945
5593;完全调不出Bing的图标;1;0;1;23972;4.171533455698315e-05
5595;都是gtp时代了;1;0;1;23972;4.171533455698315e-05
5597;一直显示cnbing;4;0;4;23972;0.0001668613382279326
5602;为什么我的Bing点开始聊天就出错，每次都是，一直叫我重试;3;0;3;23972;0.00012514600367094945
5607;大神，画图提示所在区域不支持是咋回事？;2;0;2;23972;8.34306691139663e-05
5610;谁说不限次数？每天五十次;2;0;2;23972;8.34306691139663e-05
5613;你说的都没有;1;0;1;23972;4.171533455698315e-05
5616;手机bingapp可以用吗？;7;0;7;23972;0.00029200734189888203
5624;所在区域没有推出映像创作咋回事;2;0;2;23972;8.34306691139663e-05
5627;为何我实测newbing的clpilot不支持中文提示词作画？;1;2;3;23972;0.00012514600367094945
5629;newbing打不开怎么办;2;0;2;23972;8.34306691139663e-05
5632;我的bing只能聊不能生成图，为啥;1;0;1;23972;4.171533455698315e-05
5634;国内不需要魔法;1;0;1;23972;4.171533455698315e-05
5636;ppt呢？主要想ppt和表格;1;0;1;23972;4.171533455698315e-05
5638;画画显示你所在的区域即将推出映像创建，是什么情况;1;0;1;23972;4.171533455698315e-05
5640;不好用，太卡啦。;2;0;2;23972;8.34306691139663e-05
5643;为什么我侧边栏用不了;1;0;1;23972;4.171533455698315e-05
5645;我的有这个图标，但是是灰白色的;2;0;2;23972;8.34306691139663e-05
5648;回话扣积分的吧;1;0;1;23972;4.171533455698315e-05
5650;谢谢博主的及时更新;2;0;2;23972;8.34306691139663e-05
5653;画还是要英语;3;0;3;23972;0.00012514600367094945
5657;Bing还能这样用;3;0;3;23972;0.00012514600367094945
5661;还能这样用，牛;1;0;1;23972;4.171533455698315e-05
5663;主要是免费;1;0;1;23972;4.171533455698315e-05
5666;微软这个对于普通人更实用;4;0;4;23972;0.0001668613382279326
5671;二哥的青春;1;0;1;23972;4.171533455698315e-05
5673;忘羡;1;0;1;23972;4.171533455698315e-05
5675;KKKimberly;1;0;1;23972;4.171533455698315e-05
5677;leegodan;1;0;1;23972;4.171533455698315e-05
5679;YuN、;1;0;1;23972;4.171533455698315e-05
5681;就很生气;1;0;1;23972;4.171533455698315e-05
5683;于苗苗苗苗儿;1;0;1;23972;4.171533455698315e-05
5685;0;1;0;1;23972;4.171533455698315e-05
5687;0;1;0;1;23972;4.171533455698315e-05
5689;palt;1;0;1;23972;4.171533455698315e-05
5692;yiyangtan;1;1;2;23972;8.34306691139663e-05
5694;盯着你干什么宁波大表姐桃桃烏龍茶你大霞姐;1;0;1;23972;4.171533455698315e-05
5696;kelvin凯文;1;0;1;23972;4.171533455698315e-05
5698;我的不能绘画呢;1;0;1;23972;4.171533455698315e-05
5700;0;1;0;1;23972;4.171533455698315e-05
5702;0;1;0;1;23972;4.171533455698315e-05
5704;楚楚楚楚鹅;1;0;1;23972;4.171533455698315e-05
5706;bing可以用但是侧边栏的bing用不了，这是为什么？;1;1;2;23972;8.34306691139663e-05
5708;空山;2;0;2;23972;8.34306691139663e-05
5711;永远小孩多好;1;0;1;23972;4.171533455698315e-05
5713;0;1;0;1;23972;4.171533455698315e-05
5715;。;1;0;1;23972;4.171533455698315e-05
5718;能讲讲我们的软件吗？自动生成整个解决方案，现在市面上各种AI工具只是生成了部分的代码片段;4;0;4;23972;0.0001668613382279326
5723;loop直接用啊，要。什么。copilot;3;0;3;23972;0.00012514600367094945
5727;我看谁还不会;2;0;2;23972;8.34306691139663e-05
5730;asong彭指导专用;1;1;2;23972;8.34306691139663e-05
5732;已经强制com，但是把总是会失灵呢;2;0;2;23972;8.34306691139663e-05
5735;改区域刀中国以外，光开梯子不行;1;1;2;23972;8.34306691139663e-05
5737;newbing打不开;2;0;2;23972;8.34306691139663e-05
5740;骗流量的，大部分人都用不了;2;0;2;23972;8.34306691139663e-05
5743;怎么折腾都是转到cnbing;1;0;1;23972;4.171533455698315e-05
5745;大家好，请问我花了160买了个plus40版本，是不是买贵了？;1;0;1;23972;4.171533455698315e-05
5747;为什么告诉我失败;1;0;1;23972;4.171533455698315e-05
5749;设置国家为美国;1;0;1;23972;4.171533455698315e-05
5751;确实牛bing;1;0;1;23972;4.171533455698315e-05
5753;微软的尿性，没有个368的年费是别想赢;1;0;1;23972;4.171533455698315e-05
5755;給外國人訓練中文資料庫偷中華文明;1;0;1;23972;4.171533455698315e-05
5765;0;1;0;1;23972;4.171533455698315e-05
5767;请问怎么弄？;1;2;3;23972;0.00012514600367094945
5769;要魔法吗;2;0;2;23972;8.34306691139663e-05
5773;请问要怎么弄;1;0;1;23972;4.171533455698315e-05
5775;啊？哪里有啊;4;1;5;23972;0.00020857667278491573
5781;不如beautifulai，但都还处在初级阶段;2;45;47;23972;0.001960620724178208
5784;这ppt能用？;9;173;182;23972;0.007592190889370932
5794;怎么能使用啊？;2;0;2;23972;8.34306691139663e-05
5797;咋搞;14;2;16;23972;0.0006674453529117303
5812;国内不能使用;15;4;19;23972;0.0007925913565826798
5828;咱就是说，你首先提供一个靠谱的国内登录chatGPT的方式吧;10;0;10;23972;0.00041715334556983145
5839;代升plus;7;1;8;23972;0.0003337226764558652
5847;真不如自己做。。。;1;20;21;23972;0.000876022025696646
5849;我的4怎么还没有？;13;4;17;23972;0.0007091606874687135
5864;不是禁了吗？;6;4;10;23972;0.00041715334556983145
5871;都上不去。。。;4;1;5;23972;0.00020857667278491573
5876;GPT可以生成图片了吗？;12;0;12;23972;0.0005005840146837978
5889;plus网页版没有是吗，去哪下载应用呢;10;1;11;23972;0.0004588686801268146
5900;gtp是不能生成图片的;6;0;6;23972;0.0002502920073418989
5907;如何安装呢;3;1;4;23972;0.0001668613382279326
5911;4现在官方多少;2;1;3;23972;0.00012514600367094945
5914;账号都没有了;3;0;3;23972;0.00012514600367094945
5928;想问没有vba宏是不是弄不了？;2;0;2;23972;8.34306691139663e-05
5932;这样写ppt老板说可以回家一直睡;1;2;3;23972;0.00012514600367094945
5939;怎么用;2;1;3;23972;0.00012514600367094945
5945;我也尝试过很多渠道貌似没办法使用到;1;3;4;23972;0.0001668613382279326
5956;国内都用不了，还帮我写东西;2;0;2;23972;8.34306691139663e-05
5965;这个需要正版才能用吧？;2;0;2;23972;8.34306691139663e-05
5970;国内能用了吗;1;0;1;23972;4.171533455698315e-05
5972;你这个是puls版嘛;1;1;2;23972;8.34306691139663e-05
5976;问个小白的问题。如果你把视频的问题再重新问一遍它生成的东西会一样的么;2;0;2;23972;8.34306691139663e-05
5984;适合体制内吗;1;1;2;23972;8.34306691139663e-05
5991;也是很好的训练ChatGPT的方法，ChatGPT资本推广太厉害了，还搞饥饿营销;1;1;2;23972;8.34306691139663e-05
5998;先我得申请;1;0;1;23972;4.171533455698315e-05
6002;怎么使用？;2;1;3;23972;0.00012514600367094945
6017;主要是不知道怎么用，怎么注册，什么网站;2;0;2;23972;8.34306691139663e-05
6020;图片没办法显示啊;1;1;2;23972;8.34306691139663e-05
6025;不过还是没百度厉害;9;12;21;23972;0.000876022025696646
6036;为啥我的gpt4他说他是语言模型没办法出图;3;0;3;23972;0.00012514600367094945
6041;他可以直接生成图片？;3;0;3;23972;0.00012514600367094945
6045;365我们可以用吗？;4;0;4;23972;0.0001668613382279326
6050;不是plus可以吗;1;0;1;23972;4.171533455698315e-05
6055;登不上;2;1;3;23972;0.00012514600367094945
6061;我的ai为啥不能生成图片;1;1;2;23972;8.34306691139663e-05
6063;施工VBA代码老是报错;1;0;1;23972;4.171533455698315e-05
6073;德云社编外成员吉隆坡;1;0;1;23972;4.171533455698315e-05
6084;如何下载;2;1;3;23972;0.00012514600367094945
6088;onlyone;1;0;1;23972;4.171533455698315e-05
6093;哈库呐玛塔塔想睡觉;1;0;1;23972;4.171533455698315e-05
6095;mmmmmmh;1;0;1;23972;4.171533455698315e-05
6103;宝西彤Jocky;1;0;1;23972;4.171533455698315e-05
6106;浅浅浮6;1;0;1;23972;4.171533455698315e-05
6108;茜茜;1;0;1;23972;4.171533455698315e-05
6115;这个怎么回答不了;2;0;2;23972;8.34306691139663e-05
6133;瞎说八道，你用过ChatGPT吗？;8;4;12;23972;0.0005005840146837978
6142;前面操作都很牛逼，最后生成的有点那啥;2;6;8;23972;0.0003337226764558652
6145;我在手机上用了魔法也打不开网页是咋回事啊，换了edge浏览器也不行。;9;0;9;23972;0.0003754380110128483
6155;就想问哪里找到真正的ChatGPT？不是收会员的那种;5;0;5;23972;0.00020857667278491573
6161;免费版的能生成图片吗？;2;0;2;23972;8.34306691139663e-05
6164;这玩意能发图了？;1;1;2;23972;8.34306691139663e-05
6166;这图片哪天被告侵权了都不知道;2;0;2;23972;8.34306691139663e-05
6172;35能用vba;1;0;1;23972;4.171533455698315e-05
6177;你的大门开了;1;0;1;23972;4.171533455698315e-05
6257;怎么注册下载才是重点;1;0;1;23972;4.171533455698315e-05
6259;到哪里下载？;1;0;1;23972;4.171533455698315e-05
6261;你怎么用chatgpt的;1;0;1;23972;4.171533455698315e-05
6263;2016的不行吗？一定要365？;1;0;1;23972;4.171533455698315e-05
6265;问题是打不开chatgpt;1;0;1;23972;4.171533455698315e-05
6267;先说说怎么科学上网;1;0;1;23972;4.171533455698315e-05
6271;不知道中国人嗨啥，你把商业机密都交通过GPT“狗屁通”交给老外，还帮着别人训练AI准确率;1;0;1;23972;4.171533455698315e-05
6273;0;1;0;1;23972;4.171533455698315e-05
6275;微软慢慢把所有系统以及软件集成gpt，以后他们布局完善了，大家想用就不能再用盗版了;3;3;6;23972;0.0002502920073418989
6279;能用了吗？;3;1;4;23972;0.0001668613382279326
6283;可以预见，国内一时半会用不上;1;1;2;23972;8.34306691139663e-05
6287;可惜的是我的工作估计GPT理解不了，幸运的是GPT取代不了我;1;0;1;23972;4.171533455698315e-05
6292;这样子就更不敢用office了;6;0;6;23972;0.0002502920073418989
6299;如果在国内普及了，wps不是要完;1;3;4;23972;0.0001668613382279326
6301;怎么下载这个;2;0;2;23972;8.34306691139663e-05
6304;想多了，它也会吃掉你的数据并上传;1;0;1;23972;4.171533455698315e-05
6312;卖ppt模板的要失业了;26;363;389;23972;0.016227265142666446
6339;取代你的不是AI是会使用AI的人。;13;146;159;23972;0.00663273819456032
6353;说真文心一言上线能被国内大厂接受其实是受到国家政策要求全部软件改国产;1;1;2;23972;8.34306691139663e-05
6355;难道不是百度发布了文心一言，他们都慌了抢着发布吗？;12;1;13;23972;0.0005422993492407809
6368;改变世界还得是硅谷，还需要相信的是，华人也在其中做出了巨大的贡献;10;68;78;23972;0.0032537960954446853
6379;打工人不是很开森，工作要丢了;8;1;9;23972;0.0003754380110128483
6388;这WPS还怎么打？;12;67;79;23972;0.0032955114300016685
6401;以后只有一个岗位微调员只负责微调;6;31;37;23972;0.0015434673786083764
6408;感觉这些大战让国内的互联网企业有种想参加却使不上力的感觉;4;35;39;23972;0.0016268980477223427
6413;只有国内还在等开源吗;6;22;28;23972;0.0011680293675955281
6420;农民，厨子，清洁工，建筑工这些劳动力看来要翻身;12;2;14;23972;0.0005840146837977641
6433;copilot现在可以用了吗;2;1;3;23972;0.00012514600367094945
6437;office接入ai，间谍即将无孔不入中国;4;3;7;23972;0.00029200734189888203
6442;这下真的是遥遥落后了，国内有什么科技展示下的吗？;4;2;6;23972;0.0002502920073418989
6447;不怕，我们马上就会遥遥领先;3;3;6;23972;0.0002502920073418989
6451;国内怎么用;2;0;2;23972;8.34306691139663e-05
6454;这个咋用呢;3;0;3;23972;0.00012514600367094945
6467;我感觉一下子就和人家拉开差距了我们该怎么办，我的老天;2;4;6;23972;0.0002502920073418989
6471;后边会普及到更多行业领域，pcb自动布线会变的更称心如意，还画什么板子说需求就生成。。。。。。;1;1;2;23972;8.34306691139663e-05
6477;数据安全怎么办？;2;1;3;23972;0.00012514600367094945
6487;琼琼就是瓶盖儿倒霉版这以后还咋摸鱼;1;0;1;23972;4.171533455698315e-05
6496;需要科学上网吗;3;0;3;23972;0.00012514600367094945
6503;送的学生版可以升级吗？;1;0;1;23972;4.171533455698315e-05
6505;可以编程序，互联网的结束;3;3;6;23972;0.0002502920073418989
6509;可惜国内用不了;4;0;4;23972;0.0001668613382279326
6515;苹果怎么还没动作;9;0;9;23972;0.0003754380110128483
6528;Dream;1;0;1;23972;4.171533455698315e-05
6538;Dec;1;0;1;23972;4.171533455698315e-05
6540;TOPrettyx做不了小熊软糖;1;0;1;23972;4.171533455698315e-05
6547;打工人是挺开心的，因为没有工可以打了，哪里还需要那么多人？1个人就能写整个公司所有人的报告了。;17;14;31;23972;0.0012931753712664776
6565;说的365不要钱一样;5;0;5;23972;0.00020857667278491573
6571;开心个屁，工具越智能，工作量越大;3;1;4;23972;0.0001668613382279326
6575;人口红利变成人口累赘;1;2;3;23972;0.00012514600367094945
6577;这次GPT4开放api，可以说是AI工业革命的开始，据说各行业都会受到威胁提示工程能力看来越来越必备了，在学了，学了就能用400多个各行业AI工具了，棒给博主加多点热度，让更多人看到你的视频;1;2;3;23972;0.00012514600367094945
6579;怎么感觉像清朝时睁眼看世界呢？降维打击;1;1;2;23972;8.34306691139663e-05
6581;一想到你这种视频可能是几分钟自动生成的我就直接划走了;1;1;2;23972;8.34306691139663e-05
6583;别炒作小孩，它可调信息也可调你银行卡，它功能是人都可以做的，一个公司用这财务资金存在严重风险;1;1;2;23972;8.34306691139663e-05
6590;刚冲动买了20美元chatGPT40的plus会员，买了又不知道干啥了，想用用账号可以和我讲;1;0;1;23972;4.171533455698315e-05
6592;说的好听是解放人类能养着人类，不好听就是。。。;1;0;1;23972;4.171533455698315e-05
6622;等着他们都发不完我们就要开始弯道超车了;1;0;1;23972;4.171533455698315e-05
6640;哈哈，为什么一定要支持中文？;23;54;77;23972;0.003212080760887702
6664;第一步就毁了，完全不会魔法;10;10;20;23972;0.0008343066911396629
6675;apikey调用需要费用吗？;1;1;2;23972;8.34306691139663e-05
6677;用api大概率封号;6;1;7;23972;0.00029200734189888203
6684;gpt用不用付费;11;0;11;23972;0.0004588686801268146
6696;免费版的GPT可以在文档里添加吗;1;0;1;23972;4.171533455698315e-05
6698;现在还没玩明白账号;4;7;11;23972;0.0004588686801268146
6703;是不是要付费apikey才行？;1;25;26;23972;0.0010845986984815619
6705;为啥我点击获取插件没反应;4;2;6;23972;0.0002502920073418989
6710;中文版直接拉低了人家的档次;4;8;12;23972;0.0005005840146837978
6715;Excel可以吗;4;0;4;23972;0.0001668613382279326
6720;如何安装？;4;0;4;23972;0.0001668613382279326
6725;国内能用？;3;0;3;23972;0.00012514600367094945
6733;ppt能用吗？;1;0;1;23972;4.171533455698315e-05
6747;用来实战了，发现字数有上限。;1;0;1;23972;4.171533455698315e-05
6751;社长，安装好之后怎么使用呢？可否出个教程？;1;0;1;23972;4.171533455698315e-05
6756;api接口的都是30吧？;1;0;1;23972;4.171533455698315e-05
6758;是不是要正版office啊;1;0;1;23972;4.171533455698315e-05
6765;不是国内ip用apikey不会封号吗？？？;2;0;2;23972;8.34306691139663e-05
6768;请问一下怎么连接office，根据您说地这个已经在谷歌文档中编辑好了，但是和word还是有区别的;2;0;2;23972;8.34306691139663e-05
6771;谁给个plus账号咯;1;0;1;23972;4.171533455698315e-05
6773;自己帐号也要升级gpt4的吧;1;0;1;23972;4.171533455698315e-05
6775;chatgpt，ppt怎么做;1;0;1;23972;4.171533455698315e-05
6780;第一步就毁了，完全不会魔法;1;0;1;23972;4.171533455698315e-05
6796;无法更新，告诉我已经是最新了是为什么;4;7;11;23972;0.0004588686801268146
6801;现在还可以用吗;3;0;3;23972;0.00012514600367094945
6805;买了365，现在也装不了;1;0;1;23972;4.171533455698315e-05
6807;好想用好想用;4;0;4;23972;0.0001668613382279326
6812;mac可以吗？;1;1;2;23972;8.34306691139663e-05
6814;我购买后，还用修改注册表吗？;1;0;1;23972;4.171533455698315e-05
6816;有免费的吗？;1;1;2;23972;8.34306691139663e-05
6818;注册表怎么改;1;0;1;23972;4.171533455698315e-05
6820;office其他版本可以吗;1;0;1;23972;4.171533455698315e-05
6822;可以教一下吗;1;0;1;23972;4.171533455698315e-05
6824;现在用不了了？;1;0;1;23972;4.171533455698315e-05
6826;买完后呢;1;0;1;23972;4.171533455698315e-05
6828;bgm声音大过说话了;1;0;1;23972;4.171533455698315e-05
6830;国内网络可以直接用吗？;1;0;1;23972;4.171533455698315e-05
6833;救我;2;0;2;23972;8.34306691139663e-05
6840;0;1;0;1;23972;4.171533455698315e-05
6843;为什么我的弄完也没有显示copilot，练编辑器都是不可用的，我是刚买的个人版365;1;0;1;23972;4.171533455698315e-05
6847;粉丝群曲;2;0;2;23972;8.34306691139663e-05
6850;主要是能免费用吗？;3;0;3;23972;0.00012514600367094945
6854;已领取，非常非常非常感谢;2;0;2;23972;8.34306691139663e-05
6857;待激活，回到工具箱点击激活好像也不行哦;1;0;1;23972;4.171533455698315e-05
6859;怎么搞;1;0;1;23972;4.171533455698315e-05
6862;麻烦各位领完记得评论：已领到;1;0;1;23972;4.171533455698315e-05
6900;365;1;0;1;23972;4.171533455698315e-05
6906;365;1;0;1;23972;4.171533455698315e-05
6909;365;1;0;1;23972;4.171533455698315e-05
6911;365;1;0;1;23972;4.171533455698315e-05
6913;365;1;0;1;23972;4.171533455698315e-05
6915;365;4;0;4;23972;0.0001668613382279326
6929;365;1;0;1;23972;4.171533455698315e-05
6931;365;1;0;1;23972;4.171533455698315e-05
6933;365;2;0;2;23972;8.34306691139663e-05
6937;365;1;0;1;23972;4.171533455698315e-05
6978;365;1;0;1;23972;4.171533455698315e-05
7051;365;2;0;2;23972;8.34306691139663e-05
7056;365;1;0;1;23972;4.171533455698315e-05
7060;365;1;0;1;23972;4.171533455698315e-05
7062;365;1;0;1;23972;4.171533455698315e-05
7068;365;2;0;2;23972;8.34306691139663e-05
7074;365;1;0;1;23972;4.171533455698315e-05
7076;365;1;0;1;23972;4.171533455698315e-05
7078;365;1;0;1;23972;4.171533455698315e-05
7080;365;1;0;1;23972;4.171533455698315e-05
7082;365;1;0;1;23972;4.171533455698315e-05
7084;365;5;0;5;23972;0.00020857667278491573
7094;365;2;0;2;23972;8.34306691139663e-05
7098;365;1;0;1;23972;4.171533455698315e-05
7100;365;1;0;1;23972;4.171533455698315e-05
7103;365;3;0;3;23972;0.00012514600367094945
7108;365;1;0;1;23972;4.171533455698315e-05
7111;365;1;0;1;23972;4.171533455698315e-05
7134;365;1;0;1;23972;4.171533455698315e-05
7136;365;1;0;1;23972;4.171533455698315e-05
7138;365;1;0;1;23972;4.171533455698315e-05
7141;365;1;0;1;23972;4.171533455698315e-05
7143;365;1;0;1;23972;4.171533455698315e-05
7145;365;1;0;1;23972;4.171533455698315e-05
7147;365;1;0;1;23972;4.171533455698315e-05
7149;365;1;0;1;23972;4.171533455698315e-05
7151;365;1;0;1;23972;4.171533455698315e-05
7153;365;1;1;2;23972;8.34306691139663e-05
7155;365;1;0;1;23972;4.171533455698315e-05
7161;365;1;0;1;23972;4.171533455698315e-05
7163;365;1;0;1;23972;4.171533455698315e-05
7165;365;1;0;1;23972;4.171533455698315e-05
7167;365;1;0;1;23972;4.171533455698315e-05
7169;365;1;0;1;23972;4.171533455698315e-05
7171;365;1;0;1;23972;4.171533455698315e-05
7173;365;1;0;1;23972;4.171533455698315e-05
7175;365;1;0;1;23972;4.171533455698315e-05
7177;365;1;0;1;23972;4.171533455698315e-05
7179;365;1;0;1;23972;4.171533455698315e-05
7181;365;1;0;1;23972;4.171533455698315e-05
7183;365;1;0;1;23972;4.171533455698315e-05
7185;365;1;0;1;23972;4.171533455698315e-05
7187;365;1;0;1;23972;4.171533455698315e-05
7189;mac365;1;0;1;23972;4.171533455698315e-05
7192;365;1;0;1;23972;4.171533455698315e-05
7194;365;3;0;3;23972;0.00012514600367094945
7198;365;1;0;1;23972;4.171533455698315e-05
7200;365;2;0;2;23972;8.34306691139663e-05
7203;365;3;0;3;23972;0.00012514600367094945
7215;国内的edge能用吗？;1;0;1;23972;4.171533455698315e-05
7217;得学习英文;5;2;7;23972;0.00029200734189888203
7223;实测呢;3;1;4;23972;0.0001668613382279326
7227;这文案怎么我在别的视频刷到过，谁抄谁;1;0;1;23972;4.171533455698315e-05
7231;公司的PPT大神要歇菜了;1;4;5;23972;0.00020857667278491573
7235;怎么这个视频显示是广告啊;3;0;3;23972;0.00012514600367094945
7241;以后再也不用做PPT了，因为已经被裁了;1;1;2;23972;8.34306691139663e-05
7248;漫烂这样以后做PPT就简单了;1;2;3;23972;0.00012514600367094945
7252;所有数据都安全了。人长得挺精神。;1;0;1;23972;4.171533455698315e-05
7257;估计要收费;1;0;1;23972;4.171533455698315e-05
7261;在哪下载啊;1;0;1;23972;4.171533455698315e-05
7270;实测呢;1;1;2;23972;8.34306691139663e-05
7274;是的，ai革命会让很多人失业;3;0;3;23972;0.00012514600367094945
7281;chatGTP不是禁用了么;1;0;1;23972;4.171533455698315e-05
7288;MacBookProM2了可以装吗;6;0;6;23972;0.0002502920073418989
7295;之前可以，现在卡在给手机发送验证短信那里就进行不下去了;1;8;9;23972;0.0003754380110128483
7307;云懿你是不是从这里搞的;1;1;2;23972;8.34306691139663e-05
7309;在进入azure管理访问权限的时候，说我无权限访问怎么办啊;2;0;2;23972;8.34306691139663e-05
7316;下载不了啊;1;0;1;23972;4.171533455698315e-05
7318;激活后不能登录;1;0;1;23972;4.171533455698315e-05
7327;心劫这是教程1;1;0;1;23972;4.171533455698315e-05
7332;wps几十块开个会员也不错;33;21;54;23972;0.00225262806607709
7366;怎么续订？注册过，现在到期了，不懂怎么弄了;15;8;23;23972;0.0009594526948106124
7382;到期怎么续订呢？能不能做一期讲解呀;7;0;7;23972;0.00029200734189888203
7390;麻烦问下我到了转到订阅那一步，输入账号后，提示你无权访问此该如何解决呢？;4;1;5;23972;0.00020857667278491573
7395;office卡死了;6;0;6;23972;0.0002502920073418989
7402;激活工具直接激活没什么复杂的;2;4;6;23972;0.0002502920073418989
7405;wps更好用;3;1;4;23972;0.0001668613382279326
7409;创建域是什么填什么;2;2;4;23972;0.0001668613382279326
7412;注册的e5账号登陆提示账号不存在;2;1;3;23972;0.00012514600367094945
7415;前提是不是系统是正版？;3;0;3;23972;0.00012514600367094945
7419;按照你的步骤，点转到订阅，说我无权限访问;3;0;3;23972;0.00012514600367094945
7424;我记得申请公司，然后再申请使用就可以免费使用了;1;0;1;23972;4.171533455698315e-05
7426;怎么续订呀？;1;0;1;23972;4.171533455698315e-05
7428;登录之后显示要购买Office或者密钥才能激活;1;0;1;23972;4.171533455698315e-05
7432;为什么158，133137手机号都验证不了;1;0;1;23972;4.171533455698315e-05
7439;JAKER薛就这个;1;0;1;23972;4.171533455698315e-05
7441;拼多多十几元;1;0;1;23972;4.171533455698315e-05
7455;到期了怎么白嫖;1;0;1;23972;4.171533455698315e-05
7457;建议各位不要把工作文档存到这些云存储上。也许有人觉得小公司无所谓不怕一万就怕万一;4;2;6;23972;0.0002502920073418989
7462;中铁建板WPS，非常好，不让用OFFICE;3;2;5;23972;0.00020857667278491573
7466;可惜美系有安全风险;1;2;3;23972;0.00012514600367094945
7469;三个月之后呢？花钱买？;1;1;2;23972;8.34306691139663e-05
7476;3个月后，续订缴费么？;1;0;1;23972;4.171533455698315e-05
7478;全集团都在用WPS;1;0;1;23972;4.171533455698315e-05
7480;我们集团O365集中授权。;1;0;1;23972;4.171533455698315e-05
7482;电脑上已有正版office2019，还能安装这个订阅的365吗？;1;0;1;23972;4.171533455698315e-05
7505;公务员写公文也轻松了;18;16;34;23972;0.001418321374937427
7524;文员危险了;6;21;27;23972;0.001126314033038545
7532;那么大部分人要失业啦。;1;24;25;23972;0.0010428833639245787
7534;会不会大家写成一样;1;4;5;23972;0.00020857667278491573
7537;我试了，完全不对，数据弄的乱七八糟我每一项都得重新检查不如我自己写分析报告;2;4;6;23972;0.0002502920073418989
7540;二倍怎么没有互动，汤姆猫三浪开始了吗;1;2;3;23972;0.00012514600367094945
7545;利好白酒;2;0;2;23972;8.34306691139663e-05
7549;wps这些年都在研究什么？;1;1;2;23972;8.34306691139663e-05
7551;难道没有人怀疑偷资料吗？;1;1;2;23972;8.34306691139663e-05
7553;如果像设计软件也加入，如ps类似的，是不是很多学设计的要失业啊;1;1;2;23972;8.34306691139663e-05
7606;会不会泄米呢;1;0;1;23972;4.171533455698315e-05
7625;为什么革命性的发明创新，通常都出自于外国人之手？;8;1;9;23972;0.0003754380110128483
7637;百度的文心一言呢？;1;0;1;23972;4.171533455698315e-05
7663;程序员要失业了;316;927;1243;23972;0.05185216085433005
7980;神奇吗？通过偷github上的项目代码分析出来的。虽然用起来很爽，但带着原罪;99;1098;1197;23972;0.04993325546470883
8080;以前的我：CV工程师，现在的我：Tab工程师;55;1009;1064;23972;0.04438511596863007
8136;说个笑话，程序员用程序把程序员干失业了;51;828;879;23972;0.036667779075588186
8188;你申请多久下来的？我咋的申请几个月了也没动静;52;178;230;23972;0.009594526948106124
8241;面向注释开发;24;345;369;23972;0.015392958451526781
8266;这样会让自己写代码能力下降;50;95;145;23972;0.006048723510762556
8317;程序员狠起来，连自己的命都要革;8;152;160;23972;0.006674453529117303
8326;这个东西有时候乱提示，也非常烦人;4;136;140;23972;0.0058401468379776405
8331;这玩意儿用多了我是不是就可以退休了;4;80;84;23972;0.003504088102786584
8336;idea有这个插件吗;12;28;40;23972;0.0016686133822793258
8349;Copilot不是github搞的vscode插件嘛，这说是微软的是不是有点不严谨了;11;27;38;23972;0.0015851827131653595
8361;咱就说这种插件会不会给人用傻了;5;50;55;23972;0.002294343400634073
8367;如果ai对边界处理的不友好，上线出问题绩效立马null了;5;41;46;23972;0.0019189053896212249
8373;所以未来的AI代码工具发展方向是不是从写代码变成了写注释what;5;42;47;23972;0.001960620724178208
8379;音抖炫就刷上了;1;0;1;23972;4.171533455698315e-05
8381;在物质还没有丰富到一定程度的时候，虚拟的生产力先发展了，也不知道是好是坏。;1;0;1;23972;4.171533455698315e-05
8396;为什么写程序是英文？而不能是中文;1;0;1;23972;4.171533455698315e-05
8398;时隔一年ChatGPT接入了office全家桶;1;2;3;23972;0.00012514600367094945
8409;评论区的有没有大佬会网站开发的;1;1;2;23972;8.34306691139663e-05
8411;怎么下载;2;0;2;23972;8.34306691139663e-05
8418;怎么弄;1;0;1;23972;4.171533455698315e-05
8426;试用结束，要收费了;5;1;6;23972;0.0002502920073418989
8435;我就想问一句，自己项目的代码会不会成为别人库;2;0;2;23972;8.34306691139663e-05
8443;码农从此不加班;2;1;3;23972;0.00012514600367094945
8446;程序猿把程序猿干失业了冷漠迟早宁作吾;1;0;1;23972;4.171533455698315e-05
8451;小摆interesting;2;0;2;23972;8.34306691139663e-05
8457;很久没见的老朋友突然来了电话帮你写代码;2;0;2;23972;8.34306691139663e-05
8460;这不是微软的，谢谢，只是一个vscode插件;1;0;1;23972;4.171533455698315e-05
8468;这只会让程序员越来越不熟悉代码;1;1;2;23972;8.34306691139663e-05
8496;Asteroid我还是喜欢你辛羽如若风子哇塞你们看;2;0;2;23972;8.34306691139663e-05
8503;我靠，哪个同行要革自己的命;1;0;1;23972;4.171533455698315e-05
8507;这是vscode的插件吗;1;0;1;23972;4.171533455698315e-05
8511;Hero这个好;1;0;1;23972;4.171533455698315e-05
8519;我就想问问，用的键盘是什么键盘，这个声音爱了;1;0;1;23972;4.171533455698315e-05
8533;每天固定在抖音学习一小时小山;1;0;1;23972;4.171533455698315e-05
8536;小Y超级困你看;1;0;1;23972;4.171533455698315e-05
8538;《我用中文写代码》;1;0;1;23972;4.171533455698315e-05
8545;英语不考140不改网名;2;1;3;23972;0.00012514600367094945
8553;就是擅自扒github别人的代码，有的代码连注释都和原作者一模一样;5;1;6;23972;0.0002502920073418989
8559;丶手握聖光现在是这么码代码的？;1;0;1;23972;4.171533455698315e-05
8566;可爱粥的蜗降低入门门槛了;1;0;1;23972;4.171533455698315e-05
8579;小薯条这这这;1;0;1;23972;4.171533455698315e-05
8587;东野你去申请没;2;0;2;23972;8.34306691139663e-05
8590;睡觉时候刷到了，它支持php和jscss吗？;3;0;3;23972;0.00012514600367094945
8602;想问下up用的是什么键盘呀声音好清脆;2;1;3;23972;0.00012514600367094945
8605;Cher雪儿你能用吗;1;0;1;23972;4.171533455698315e-05
8609;Python和JS支持吗;2;0;2;23972;8.34306691139663e-05
8621;学习中文就够了北海;1;1;2;23972;8.34306691139663e-05
8623;在我拼音变量面前没用的;2;3;5;23972;0.00020857667278491573
8626;php支持吗;2;0;2;23972;8.34306691139663e-05
8632;为啥我的是一行一行出来的嘞;1;0;1;23972;4.171533455698315e-05
8634;这是编辑器吗还是插件;1;0;1;23972;4.171533455698315e-05
8651;说实话，我看完了，但是我完全看不懂;1;0;1;23972;4.171533455698315e-05
8655;一天申请就下来了，香;1;0;1;23972;4.171533455698315e-05
8663;快来看。这有一堆不是程序员的人在讨论Al？;2;3;5;23972;0.00020857667278491573
8667;真好，以后我给后端开发的下任务，再跟我说要两周工期，我就把这条视频转给他。然后让人力资源部把招聘计划改一改，少招点中级的，初级也能干。;3;0;3;23972;0.00012514600367094945
8691;秋衣塞在秋裤里我知道呀Lucia啊哦打动我了;3;1;4;23972;0.0001668613382279326
8701;飞青;1;0;1;23972;4.171533455698315e-05
8703;一个会飞的程序员lee侠肝义胆程序员牛叉啊;1;0;1;23972;4.171533455698315e-05
8714;为什么我申请过了，插件也安装了，写代码还是没有提示呢？;1;0;1;23972;4.171533455698315e-05
8720;沙子我感觉自己会写代码了;2;7;9;23972;0.0003754380110128483
8724;公司里不能用的。代码安全有问题。怕他把代码传走了。;4;13;17;23972;0.0007091606874687135
8729;不怕一万就怕万一出错啊;14;7;21;23972;0.000876022025696646
8744;卧槽大哥何德何能让我发现了你;1;178;179;23972;0.007467044885699983
8746;一切尽在山海;1;0;1;23972;4.171533455698315e-05
8748;莫哈哈;1;0;1;23972;4.171533455698315e-05
8757;狐狸半面添辣子;1;1;2;23972;8.34306691139663e-05
8760;精丶魂;1;0;1;23972;4.171533455698315e-05
8762;秋鹤鸣;2;0;2;23972;8.34306691139663e-05
8771;抱走珍妮;1;0;1;23972;4.171533455698315e-05
8774;wxl;2;0;2;23972;8.34306691139663e-05
8777;已读不回花开未曾花落嗷呜嗷呜吃;1;0;1;23972;4.171533455698315e-05
8781;岁岁用户1941286992137Paychopath;1;1;2;23972;8.34306691139663e-05
8786;扣子;2;0;2;23972;8.34306691139663e-05
8797;斑马斑马;1;1;2;23972;8.34306691139663e-05
8800;chihiro;1;0;1;23972;4.171533455698315e-05
8809;小熊奶饼w;1;1;2;23972;8.34306691139663e-05
8812;楷罡行逸Purity越沉;1;0;1;23972;4.171533455698315e-05
8818;心钥礼你怎么肥事;1;0;1;23972;4.171533455698315e-05
8824;翻滚吧吃吃饭;3;0;3;23972;0.00012514600367094945
8830;绣球不是球;1;0;1;23972;4.171533455698315e-05
8833;Murder;1;0;1;23972;4.171533455698315e-05
8840;麻瓜。Lovina金世佳的额头坑我是坏蛋蛋oO我想吃薯片;1;0;1;23972;4.171533455698315e-05
8845;孔;1;0;1;23972;4.171533455698315e-05
8848;XiaoYuuuuu;1;0;1;23972;4.171533455698315e-05
8852;呜哩哇啦;1;0;1;23972;4.171533455698315e-05
8854;一笑丶南北;2;0;2;23972;8.34306691139663e-05
8859;快乐水;2;0;2;23972;8.34306691139663e-05
8864;春山可望;1;1;2;23972;8.34306691139663e-05
8870;AAA帅猫无心暴打AAA帅猫;6;0;6;23972;0.0002502920073418989
8879;谁动了我的bug;1;0;1;23972;4.171533455698315e-05
8882;浅陌;1;0;1;23972;4.171533455698315e-05
8884;是小梦啊;1;0;1;23972;4.171533455698315e-05
8886;翻斗花园小美女;1;0;1;23972;4.171533455698315e-05
8889;偲博也许吧;1;0;1;23972;4.171533455698315e-05
8891;Demo家饲养员;3;0;3;23972;0.00012514600367094945
8901;流沙灬;1;0;1;23972;4.171533455698315e-05
8908;白白白zzzz;1;0;1;23972;4.171533455698315e-05
8910;Arthur;3;0;3;23972;0.00012514600367094945
8915;本是天涯同根生;2;0;2;23972;8.34306691139663e-05
8918;微软的visualstudio默认带这个东西了。写一点他自动就提示。一直按tab就可以了;44;314;358;23972;0.014934089771399966
8963;我想要3个老婆;13;92;105;23972;0.0043801101284832306
8977;时间旅行者很爽我已经用起来了;3;0;3;23972;0.00012514600367094945
8981;菲菲宝贝这就是刚给你下载的插件;1;1;2;23972;8.34306691139663e-05
8983;谈雅星明你们怎么看？;2;0;2;23972;8.34306691139663e-05
8986;桌桌爱花花哇塞甜心我去;1;0;1;23972;4.171533455698315e-05
8988;神明也未宠溺C;1;0;1;23972;4.171533455698315e-05
8990;是我吗baba;1;0;1;23972;4.171533455698315e-05
8992;买的佛冷人工智能真正的奇点来了。深度发展下去程序就会自己进化;1;0;1;23972;4.171533455698315e-05
8994;售卖copilot;1;0;1;23972;4.171533455698315e-05
8996;肆意。;1;0;1;23972;4.171533455698315e-05
9102;用户5157949448125适合你;1;0;1;23972;4.171533455698315e-05
9104;GYH;1;0;1;23972;4.171533455698315e-05
9116;怪我咯打不死的皓皓君;1;0;1;23972;4.171533455698315e-05
9120;DrJ;1;0;1;23972;4.171533455698315e-05
9122;麻布口袋野生的章鱼哥。;2;0;2;23972;8.34306691139663e-05
9125;用了几天放弃了这个东西有严重的泄露代码风险为了省点事以后被公司发律师函值得吗;1;0;1;23972;4.171533455698315e-05
9167;AY丶CL;1;0;1;23972;4.171533455698315e-05
9171;跟AI结婚。。啊不我的意思是结对。;2;0;2;23972;8.34306691139663e-05
9175;越用越不会写代码了豹酷康乐;1;0;1;23972;4.171533455698315e-05
9181;你不认得我哟（居家摆烂版）哈哈哈哈哈哈这也太狠了;1;0;1;23972;4.171533455698315e-05
9186;DOOM酸酸苦苦捏捏好强;1;0;1;23972;4.171533455698315e-05
9189;用半年了，离不开了;3;0;3;23972;0.00012514600367094945
9193;阿凡提不吃羊肉串;1;0;1;23972;4.171533455698315e-05
9207;小懒孩姚秭归;1;0;1;23972;4.171533455698315e-05
9224;lemon我感觉我要失业了;1;0;1;23972;4.171533455698315e-05
9237;ayxiay卧槽这个，面向注释变成这太行了;1;0;1;23972;4.171533455698315e-05
9242;Nat丿Martini;2;0;2;23972;8.34306691139663e-05
9245;hapood;1;0;1;23972;4.171533455698315e-05
9249;迷茫的阿三卑鄙的外乡人这;1;0;1;23972;4.171533455698315e-05
9251;Deltazzz不知名指弹选手;1;0;1;23972;4.171533455698315e-05
9258;霏君;1;0;1;23972;4.171533455698315e-05
9260;用户2772605678642;1;0;1;23972;4.171533455698315e-05
9270;楼主，有没有idea插件;1;0;1;23972;4.171533455698315e-05
9283;杨名特悬崖边缘离谱;1;0;1;23972;4.171533455698315e-05
9293;失业的开头热爱;1;0;1;23972;4.171533455698315e-05
9295;可口可乐k好运的云挽如初Y;1;0;1;23972;4.171533455698315e-05
9300;枫叶叶啾啾快来瞅瞅;1;0;1;23972;4.171533455698315e-05
9312;pengpengpeng;1;0;1;23972;4.171533455698315e-05
9318;ArchangelNYGugugu飞鱼转身;2;0;2;23972;8.34306691139663e-05
9323;这就是用中文写代码吗;3;0;3;23972;0.00012514600367094945
9332;今天练腿;1;0;1;23972;4.171533455698315e-05
9335;中文写代码的时代来了？;2;0;2;23972;8.34306691139663e-05
9344;小聋瞎快一年没敲代码了;1;0;1;23972;4.171533455698315e-05
9347;已阅，速删;1;0;1;23972;4.171533455698315e-05
9352;汤圆掉地上啦;2;0;2;23972;8.34306691139663e-05
9360;Chupacabra;1;0;1;23972;4.171533455698315e-05
9365;的啊叮呤咣啷刘德伟;1;0;1;23972;4.171533455698315e-05
9368;井号Lindom全糖不加冰LhcACURA函塔Q凝神各干各的吼这么6？？;2;0;2;23972;8.34306691139663e-05
9371;这玩意儿要是直接植入机器人芯片那不就是Alice吗？;1;0;1;23972;4.171533455698315e-05
9374;pmz明河见影这个是不是很牛逼啊;1;0;1;23972;4.171533455698315e-05
9381;1039;1;0;1;23972;4.171533455698315e-05
9387;slouches宅神kin;1;0;1;23972;4.171533455698315e-05
9390;golang用他，爽到飞起;2;0;2;23972;8.34306691139663e-05
9397;vue工程师;1;0;1;23972;4.171533455698315e-05
9404;看起来编码效率会提高但是我可能会废;2;0;2;23972;8.34306691139663e-05
9410;嘻嘻哈哈;1;0;1;23972;4.171533455698315e-05
9415;小蓝小蓝学;2;0;2;23972;8.34306691139663e-05
9423;嗯呐;1;0;1;23972;4.171533455698315e-05
9429;丶那只戳熊居然我靠;1;0;1;23972;4.171533455698315e-05
9433;柯学家斜风SoarLiang;2;0;2;23972;8.34306691139663e-05
9449;圐圙;1;0;1;23972;4.171533455698315e-05
9471;雪松;1;0;1;23972;4.171533455698315e-05
9473;zhi漠夕辞去好用啊;1;0;1;23972;4.171533455698315e-05
9483;鱼愈愚御卧槽这也太舒服了吧;3;0;3;23972;0.00012514600367094945
9490;刘文文文文文文失业了;1;1;2;23972;8.34306691139663e-05
9497;新一咱可以退学了;1;0;1;23972;4.171533455698315e-05
9502;键盘是什么，声音挺好听的;2;0;2;23972;8.34306691139663e-05
9506;Six、宝宝，他在干嘛;1;0;1;23972;4.171533455698315e-05
9519;tabnine都很多年了支持很多语言微软只是最近版本才更新;1;0;1;23972;4.171533455698315e-05
9525;卧槽，那不全中文搞不就好了;1;0;1;23972;4.171533455698315e-05
9534;枫叶城厉害啊;1;0;1;23972;4.171533455698315e-05
9544;汉卿丶大佬;1;0;1;23972;4.171533455698315e-05
9550;kite。好用不;3;0;3;23972;0.00012514600367094945
9554;Kelly好牛;1;0;1;23972;4.171533455698315e-05
9562;我申请了两周下来了，但不知道为啥开着没反应;3;0;3;23972;0.00012514600367094945
9570;i;1;0;1;23972;4.171533455698315e-05
9572;？;1;0;1;23972;4.171533455698315e-05
9581;南风致我意;1;0;1;23972;4.171533455698315e-05
9595;暮冬拾lightcone;2;0;2;23972;8.34306691139663e-05
9600;布吉岛;1;0;1;23972;4.171533455698315e-05
9602;西南以北来;1;0;1;23972;4.171533455698315e-05
9606;屁姜这都给我推;1;0;1;23972;4.171533455698315e-05
9608;beyondup六啊;1;0;1;23972;4.171533455698315e-05
9618;龙小喵521卧槽;1;0;1;23972;4.171533455698315e-05
9635;Sebstian;1;0;1;23972;4.171533455698315e-05
9655;我不懂编程。但这是美国人的东西吧？为什么不用国产的？国产的不香吗？我觉得你们都是崇洋媚外。;1;0;1;23972;4.171533455698315e-05
9657;戏子薄情丶薄如一面;1;0;1;23972;4.171533455698315e-05
9662;爱你3;1;0;1;23972;4.171533455698315e-05
9665;WwM;1;0;1;23972;4.171533455698315e-05
9667;efvdr;1;0;1;23972;4.171533455698315e-05
9672;java能不能用;1;0;1;23972;4.171533455698315e-05
9705;幸福很简单8;1;0;1;23972;4.171533455698315e-05
9708;橙子你会嘛;1;0;1;23972;4.171533455698315e-05
9720;第一种是什么字体啊;3;0;3;23972;0.00012514600367094945
9734;GeerH;1;0;1;23972;4.171533455698315e-05
9740;webstorm能用吗;1;0;1;23972;4.171533455698315e-05
9747;略略略;1;0;1;23972;4.171533455698315e-05
9751;Leon开摆;1;0;1;23972;4.171533455698315e-05
9760;Yyang你看得懂吗？;3;0;3;23972;0.00012514600367094945
9765;骆本;1;0;1;23972;4.171533455698315e-05
9768;拥暖;1;0;1;23972;4.171533455698315e-05
9775;我爱中国;1;0;1;23972;4.171533455698315e-05
9777;星星有点亮大哥，要失业了;1;0;1;23972;4.171533455698315e-05
9780;AsukaLay去申请试试看;1;0;1;23972;4.171533455698315e-05
9784;malice太可怕了;1;0;1;23972;4.171533455698315e-05
9787;vscode有这个插件吗;1;0;1;23972;4.171533455698315e-05
9791;始终保持热爱晚风去申请一个太感动了;2;0;2;23972;8.34306691139663e-05
9794;葡萄A品味人生;1;0;1;23972;4.171533455698315e-05
9796;程序员;1;0;1;23972;4.171533455698315e-05
9811;迟迟;1;0;1;23972;4.171533455698315e-05
9817;这个好像vscode自带了吧？;3;0;3;23972;0.00012514600367094945
9821;K做我的猫Bethesda亿万少女的梦wcwc;2;0;2;23972;8.34306691139663e-05
9824;七崽往事对风叙;1;0;1;23972;4.171533455698315e-05
9830;KeepReal;1;0;1;23972;4.171533455698315e-05
9837;一个饭桶;2;0;2;23972;8.34306691139663e-05
9841;滴滴滴;1;0;1;23972;4.171533455698315e-05
9844;o啵啵鱼o;3;0;3;23972;0.00012514600367094945
9848;陳大怨种sanctuary永远睡不醒的我们俩;2;0;2;23972;8.34306691139663e-05
9864;确实很强，非常强;1;0;1;23972;4.171533455698315e-05
9882;用了一个月了，真的离不开了，以后如果出订阅的话估计我会买的;1;0;1;23972;4.171533455698315e-05
9886;尚星;7;0;7;23972;0.00029200734189888203
9897;闻屁大师;1;0;1;23972;4.171533455698315e-05
9900;这家伙挺厉害;2;0;2;23972;8.34306691139663e-05
9905;idbdlcbrdpcjdbrkdob;1;0;1;23972;4.171533455698315e-05
9909;Cy牛啊牛啊;1;0;1;23972;4.171533455698315e-05
9915;这玩意联网会泄露代码吗;1;0;1;23972;4.171533455698315e-05
9917;ero;1;0;1;23972;4.171533455698315e-05
9938;gotofly琴酒大大缩减了copy的时间;1;0;1;23972;4.171533455698315e-05
9943;Y緈諨、誰能給;1;0;1;23972;4.171533455698315e-05
9946;桶桐;1;0;1;23972;4.171533455698315e-05
9951;IT老邪讲编程看看这东西好玩不？;1;0;1;23972;4.171533455698315e-05
9960;Alex19684;1;0;1;23972;4.171533455698315e-05
9965;前天申请的，第二天就通过了;2;0;2;23972;8.34306691139663e-05
9976;我怕这玩意把我取代了老板一给需求ai直接搞出代码;1;0;1;23972;4.171533455698315e-05
9984;句号Fyus;1;0;1;23972;4.171533455698315e-05
9988;叶叶叶叶子;1;0;1;23972;4.171533455698315e-05
9994;0;1;0;1;23972;4.171533455698315e-05
10006;这么看都是些比较简单通用的判断;1;0;1;23972;4.171533455698315e-05
10009;撇丿捺Wanderer;1;0;1;23972;4.171533455698315e-05
10024;幼儿园一班完了;1;0;1;23972;4.171533455698315e-05
10026;吃了吐;1;0;1;23972;4.171533455698315e-05
10034;Fade别写了;1;0;1;23972;4.171533455698315e-05
10051;Python大战C加加激烈大战版;1;0;1;23972;4.171533455698315e-05
10062;Zzz垃圾桶小偷沈先生一点两点戒戒戒戒戒戒;2;0;2;23972;8.34306691139663e-05
10069;Chen;1;0;1;23972;4.171533455698315e-05
10074;Victor卧槽卧槽好牛逼这个;1;0;1;23972;4.171533455698315e-05
10076;欲言又止不知所云要喝姜茶吗;2;0;2;23972;8.34306691139663e-05
10079;L甜兴儿再来一瓶小路的老张我日;1;0;1;23972;4.171533455698315e-05
10083;星河揽怀;3;0;3;23972;0.00012514600367094945
10088;啾啾自得;2;0;2;23972;8.34306691139663e-05
10094;我记得申请的时候第二天就通过，可能我申请的早，一看到有新闻出来就申请了;1;0;1;23972;4.171533455698315e-05
10098;祈;1;0;1;23972;4.171533455698315e-05
10104;MrChen;1;0;1;23972;4.171533455698315e-05
10107;咋感觉越来越智能了，以后写代码真不需要程序员了;3;0;3;23972;0.00012514600367094945
10115;为啥我一直没有申请下来？;1;0;1;23972;4.171533455698315e-05
10122;QcHenKang;1;1;2;23972;8.34306691139663e-05
10128;卧槽，爱你，这个震撼我全家;2;0;2;23972;8.34306691139663e-05
10139;大哥这个啥编辑器啊;1;0;1;23972;4.171533455698315e-05
10148;山哥起的真早呀;1;0;1;23972;4.171533455698315e-05
10153;这个是插件吗，还是;1;0;1;23972;4.171533455698315e-05
10157;免费吗;3;0;3;23972;0.00012514600367094945
10162;后端能用吗;1;0;1;23972;4.171533455698315e-05
10167;这个是正版还是盗版;6;18;24;23972;0.0010011680293675956
10174;大佬这样整确实能激活，但是在kms那步激活成功时，已经显示给你的office自动降级到了2016版了怎么给升到365呢5T云盘等呢;2;7;9;23972;0.0003754380110128483
10177;冒昧的问一下，新买的戴尔笔记本电脑，出厂预装的是office365到期后，我不想续费如何继续使用正版的office呢？不续费的话系统会给我直接降级到2021么？这种情况该怎么办;2;1;3;23972;0.00012514600367094945
10180;提示不是VL版无法使用KMS激活;1;2;3;23972;0.00012514600367094945
10182;激活出现，当前MicrosoftOffice不是VL版，无法使用KMS激活;1;2;3;23972;0.00012514600367094945
10185;安装失败office怎么回事;1;1;2;23972;8.34306691139663e-05
10195;360提示HEU有木马什么鬼;1;0;1;23972;4.171533455698315e-05
10201;余玖，小邹努力减肥中好东西分享给你们;1;0;1;23972;4.171533455698315e-05
10203;程子不甜;1;0;1;23972;4.171533455698315e-05
10205;憨崽小蔡;1;0;1;23972;4.171533455698315e-05
10210;还不如直接官网正版下载，找我要个账户密码，登录就激活了;5;5;10;23972;0.00041715334556983145
10216;Office365家庭版有拼车的同学吗，onedrive1t云空间，还有位置;7;1;8;23972;0.0003337226764558652
10225;风筝顾科技废材这破玩意我弄了几个小时;1;0;1;23972;4.171533455698315e-05
10232;mac咋搞啊谁懂啊家人们;3;1;4;23972;0.0001668613382279326
10236;收费太贵了;3;0;3;23972;0.00012514600367094945
10367;很多人想象程序员工作时都是在敲键盘，其实，呆着想问题才是工作常态。;48;975;1023;23972;0.04267478725179376
10416;你这是是copilot，去年就可以用了，基于GTP3的，新的X是基于GPT4的，主要功能是对话编程;23;453;476;23972;0.019856499249123978
10441;说明本身程序员的工作;46;111;157;23972;0.006549307525446354
10488;好消息：程序员的工作效率提高了坏消息：老板觉得可以少雇点人了;15;192;207;23972;0.00863507425329551
10505;公司不让用的，它会把公司的代码偷传到GitHub;11;74;85;23972;0.0035458034373435673
10517;cv工程晋升为tab工程师哈哈哈;3;67;70;23972;0.0029200734189888202
10521;能探测路径和文件名，自动补全路径，会记住代码以前的变量名，写出来的代码基本都是对的。真的震惊一整年;21;59;80;23972;0.0033372267645586516
10543;昨晚刷到个视频，底下的一堆程序员在评论，说很多人已经失业了，而且再找基本不可能了;18;26;44;23972;0.0018354747205072584
10562;咱就是说能不能不要用python这种实际没有什么业务场景的语言。。。java啊;38;1;39;23972;0.0016268980477223427
10601;需要注意的是，你的代码会被ai上传，作为他的食物，消化吸收后分享给其他用ai的人;5;7;12;23972;0.0005005840146837978
10607;写错了要删好多，逻辑错了要改好久;2;30;32;23972;0.0013348907058234607
10610;你啥都没干，AI就自动帮你把公司代码传给微软了;3;10;13;23972;0.0005422993492407809
10614;编程纯小白，偶尔写点处理文件的小程序从来没超过100行，自己看了几个小时的python买这个有用吗，对编程有点爱好;8;4;12;23972;0.0005005840146837978
10623;我以前写程序，想几个小时做程序设计，两个小时手不会停就能全部写完，有时候白天想一天加上和其他人讨论，晚上加个班把别人预计一周的活干完了，写代码是最简单的，如何设计和更好的和前后端配合以及考虑各种异常并发才是关键;1;22;23;23972;0.0009594526948106124
10625;如何使用这个，有教程吗;6;1;7;23972;0.00029200734189888203
10632;Idea能装么铁子写java已经习惯了idea;4;2;6;23972;0.0002502920073418989
10642;通义文心哪家强？;1;1;2;23972;8.34306691139663e-05
10646;这个是真的牛批;1;1;2;23972;8.34306691139663e-05
10649;学编程的，还没毕业的咋整;1;1;2;23972;8.34306691139663e-05
10653;用了半年了，只是个更强的代码补全而已，复杂点的要么自己写要么像stablediffusion一样念咒语，念咒语完了还得费劲检查。当然，这个项目未来可期;2;4;6;23972;0.0002502920073418989
10657;国内用不了吧？;3;0;3;23972;0.00012514600367094945
10668;是不是用的人越来越多，回答问题越来越完善？;1;7;8;23972;0.0003337226764558652
10678;编译运行一下全是warning;3;1;4;23972;0.0001668613382279326
10685;不是，这不去年就有了么;1;0;1;23972;4.171533455698315e-05
10696;还是收费的？;1;2;3;23972;0.00012514600367094945
10698;放心吧，目前很多东西离开了人为操作还是不行的;1;2;3;23972;0.00012514600367094945
10701;你是怎么搞到试用的;1;1;2;23972;8.34306691139663e-05
10707;这是不是收费的，我记得;1;0;1;23972;4.171533455698315e-05
10710;公司不让用;4;1;5;23972;0.00020857667278491573
10717;？？可以用了x了吗，我怎么找不到入口;3;1;4;23972;0.0001668613382279326
10723;还是需要程序员的不是程序员根本不会用;1;0;1;23972;4.171533455698315e-05
10729;原本就有copilot的是不是直接就升级了;1;1;2;23972;8.34306691139663e-05
10732;比较好的是可以出方案，能够定制化代码。自动修复得bug。无条件快速适配产品的需求。做到这些程序员才可以下岗;1;1;2;23972;8.34306691139663e-05
10736;我写的变量名，全是中文拼音的首字母这样AI也能写吗？;1;0;1;23972;4.171533455698315e-05
10740;ai只要是不能达到人类思考的水平，就永远替代不了;1;1;2;23972;8.34306691139663e-05
10743;程序员有很多工作是ai替代不了的，比如改行送外卖快递;2;1;3;23972;0.00012514600367094945
10748;目前入门级别的相当于苦力。必须要有自己的算法和专利来对抗ai。;1;16;17;23972;0.0007091606874687135
10754;怎么更新呀？;1;0;1;23972;4.171533455698315e-05
10756;你说的这个copilot不是早就能做到了，copilotx有什么改进？;1;23;24;23972;0.0010011680293675956
10758;你就买了？;3;0;3;23972;0.00012514600367094945
10766;这玩意一个月20美元是不是;2;0;2;23972;8.34306691139663e-05
10774;aliao;1;0;1;23972;4.171533455698315e-05
10779;GWD;2;0;2;23972;8.34306691139663e-05
10782;菜菜儿;1;0;1;23972;4.171533455698315e-05
10787;SeanYibo（）;1;0;1;23972;4.171533455698315e-05
10793;律小杨要上进;1;0;1;23972;4.171533455698315e-05
10796;去年就有的东西，写代码最主要前期构思，真开始写，就算没这个，谷歌也能搜到;2;5;7;23972;0.00029200734189888203
10799;我第一次测试的时候，写了一个要求，那个要求我表达的很差，自己都觉得并不通顺，结果chatgpt不仅先写了一下它对我表达的理解，又给出了逻辑完全正确的代码。未来大量行业人员要转型是必然趋势了。但一定会有新行业出现，就看能不能抓住了，说不定未来文科生又强势起来;7;0;7;23972;0.00029200734189888203
10807;到今天才尝鲜，你的工作看来肯定是保不住的了;4;0;4;23972;0.0001668613382279326
10812;去年的插件今年才用还杀疯了这博主什么成分我真不懂;3;0;3;23972;0.00012514600367094945
10816;说明你的工作就只是增删改查;1;2;3;23972;0.00012514600367094945
10822;AI真的杀疯了？;1;0;1;23972;4.171533455698315e-05
10857;请问下，昨天我订阅了office365个人版为什么里面没有copilot功能呢？;6;7;13;23972;0.0005422993492407809
10864;2021和365那个好一点呢;2;1;3;23972;0.00012514600367094945
10867;这个是不还得买正版的;2;1;3;23972;0.00012514600367094945
10870;每年都要付费;1;3;4;23972;0.0001668613382279326
10873;支持国产wps;1;2;3;23972;0.00012514600367094945
10881;这个啥情况;1;0;1;23972;4.171533455698315e-05
10883;价格侠呢？;1;0;1;23972;4.171533455698315e-05
10900;文心一言啥时候可以用;8;14;22;23972;0.0009177373602536292
10909;国内能用了会发教程和接入方式;5;6;11;23972;0.0004588686801268146
10915;奇技淫巧奇技淫巧;2;8;10;23972;0.00041715334556983145
10918;王炸吗？;3;2;5;23972;0.00020857667278491573
10923;学文科的被理科的撅掉饭碗了;1;9;10;23972;0.00041715334556983145
10926;如何使用;1;3;4;23972;0.0001668613382279326
10929;咱们的chatppt多久整合到wps啊？;1;3;4;23972;0.0001668613382279326
10946;用了用，我觉得已经超过我了;29;406;435;23972;0.01814617053228767
10976;程序猿狠起来连自己的饭碗都不放过;11;313;324;23972;0.013515768396462539
10988;他可不是副驾驶，我是他的副驾驶，他控制方向我踩油门就行，他生成我按tab;7;339;346;23972;0.014433505756716168
10996;能不能写前端;10;37;47;23972;0.001960620724178208
11007;只有刚刚入行或者没入行的人会说这玩意能让程序员失业，其实是大大方便了程序员，人程序员更不可或缺;5;33;38;23972;0.0015851827131653595
11013;这个插件，其实我是不建议用的，别问为啥，我弄了一下，智能是智能，但是特别鸡肋。尝新鲜还可以，。刚开始我就玩玩，后期感觉也就那样，还耽误写代码。就卸了;7;21;28;23972;0.0011680293675955281
11021;说的是AI，其实是把整个Github作为学习对象，从各个项目里爬代码，连注释都一样;3;27;30;23972;0.0012514600367094944
11025;申请的第二天就下来了，确实好用;3;22;25;23972;0.0010428833639245787
11029;还支持中文注释？;4;13;17;23972;0.0007091606874687135
11034;用了，太方便了，入门不建议，容易有依赖性;2;9;11;23972;0.0004588686801268146
11039;什么快捷键跳到单行末尾的啊;2;2;4;23972;0.0001668613382279326
11042;支持哪些语言;1;4;5;23972;0.00020857667278491573
11064;毕设就靠这个完成的算法部分;2;1;3;23972;0.00012514600367094945
11073;申请到了，也安装了，就是用不了;1;0;1;23972;4.171533455698315e-05
11081;可以让它画个冰墩墩麼;1;0;1;23972;4.171533455698315e-05
11086;球是个啥适合你们;1;1;2;23972;8.34306691139663e-05
11095;沫兮兮我是废物;1;0;1;23972;4.171533455698315e-05
11098;你们试试拿这个刷力扣;1;0;1;23972;4.171533455698315e-05
11102;大脸胖宝妙啊;1;1;2;23972;8.34306691139663e-05
11112;适应性头盔多放香菜快来看;1;0;1;23972;4.171533455698315e-05
11116;壁纸叫啥;1;0;1;23972;4.171533455698315e-05
11125;求求来一个java学霸帮我讲讲题可以吗;2;0;2;23972;8.34306691139663e-05
11137;我昨天才和公司大佬聊到这个今天就刷到你了，大数据这么牛了吗;1;0;1;23972;4.171533455698315e-05
11142;伊恩浅忆牛逼;1;0;1;23972;4.171533455698315e-05
11149;他18岁？;1;0;1;23972;4.171533455698315e-05
11153;鱼皮，有用的是什么语言啊;1;0;1;23972;4.171533455698315e-05
11155;我想起来上次codeforces有次官方赛，有个ai智能也参赛了，现在连ai都开始写算法了;1;0;1;23972;4.171533455698315e-05
11158;迷人的橙子卧槽太神奇了;2;0;2;23972;8.34306691139663e-05
11161;杰克爱;1;0;1;23972;4.171533455698315e-05
11165;离线能用不？为啥我离线不行;2;0;2;23972;8.34306691139663e-05
11175;《关于鱼皮才18岁这件事》;1;2;3;23972;0.00012514600367094945
11190;小鬼你可以下岗了;1;0;1;23972;4.171533455698315e-05
11196;我一个对象有collection和payment，在payment上双斜杠，会直接生成支付之类的，若先在collection上注释为项目收款，然后在payment上打上双斜杠，就会出现项目支出;2;0;2;23972;8.34306691139663e-05
11209;prprprprprAI已经超越我了;3;0;3;23972;0.00012514600367094945
11228;Cancer輝周星星;1;0;1;23972;4.171533455698315e-05
11230;逗逗飞wxr。;1;0;1;23972;4.171533455698315e-05
11232;摸鱼校尉001;2;0;2;23972;8.34306691139663e-05
11235;不知名网友叽里呱啦;1;0;1;23972;4.171533455698315e-05
11240;郑不戳;3;0;3;23972;0.00012514600367094945
11246;初一大脑门。蛋清;1;0;1;23972;4.171533455698315e-05
11251;季我心;2;0;2;23972;8.34306691139663e-05
11256;奈斯;1;0;1;23972;4.171533455698315e-05
11260;九夏丶神姒zero;2;0;2;23972;8.34306691139663e-05
11268;小垚、;1;0;1;23972;4.171533455698315e-05
11275;1039云鹤游天（致敬英雄）OG山君;1;0;1;23972;4.171533455698315e-05
11284;小博哥;1;0;1;23972;4.171533455698315e-05
11291;哎？;1;0;1;23972;4.171533455698315e-05
11293;新手去世器，感觉大佬们在下一盘大棋;7;116;123;23972;0.005130986150508927
11301;用不了，vscode遇到usernotauthorized;3;0;3;23972;0.00012514600367094945
11371;询问前端监控，后端采集数据除了influxDBtelegraf有没有更light的方案做个毕设想不到这么累;1;0;1;23972;4.171533455698315e-05
11373;我写个注释他在后台不停的检索，会占用我多少内存呢。;1;0;1;23972;4.171533455698315e-05
11375;华子哥;1;0;1;23972;4.171533455698315e-05
11380;AIoffice人工智能办公，先注册一个office365版本吧;2;4;6;23972;0.0002502920073418989
11383;手机无法获取验证码;3;6;9;23972;0.0003754380110128483
11388;下手晚了，都到发验证码那一步了，卡住了;2;0;2;23972;8.34306691139663e-05
11391;为了省400。。;2;0;2;23972;8.34306691139663e-05
11395;哇，值得期待;1;0;1;23972;4.171533455698315e-05
11397;点击给验证码无反应等于下不了;1;0;1;23972;4.171533455698315e-05
11399;那不是变相免费使GpT4，值得期待。;1;0;1;23972;4.171533455698315e-05
11414;收不到短信了，等了一下午了;1;0;1;23972;4.171533455698315e-05
11429;你问问政府用那个软件，然后服务器怎么管理;2;0;2;23972;8.34306691139663e-05
11444;冲呀;2;0;2;23972;8.34306691139663e-05
11448;无法获取验证码;4;1;5;23972;0.00020857667278491573
11467;还敢用吗？唉;5;0;5;23972;0.00020857667278491573
11473;那些需要保密的文件以后不在是秘密，全被老美掌控之中;2;0;2;23972;8.34306691139663e-05
11476;我用激活工具激活office365;2;0;2;23972;8.34306691139663e-05
11479;点赞评论给大师;1;0;1;23972;4.171533455698315e-05
11481;手机号无法验证，我尝试了下直接购买，发现个人版一年12984元，家庭版18400元。有这么贵吗？;1;0;1;23972;4.171533455698315e-05
11491;都要收费的;24;14;38;23972;0.0015851827131653595
11516;大哥威武;5;1;6;23972;0.0002502920073418989
11522;我最新就是16227;2;1;3;23972;0.00012514600367094945
11525;要用魔法吗;3;3;6;23972;0.0002502920073418989
11529;就说站在的破解升级后肯定没用了呗？;1;6;7;23972;0.00029200734189888203
11531;是不是只支持英文？;1;0;1;23972;4.171533455698315e-05
11533;国内也能用？;3;0;3;23972;0.00012514600367094945
11537;能不能把数字统计生成图形？;1;3;4;23972;0.0001668613382279326
11539;咋样才能用到啊;2;0;2;23972;8.34306691139663e-05
11542;那么问题来了，我们的双手还能干其他什么重要的事呢？;1;1;2;23972;8.34306691139663e-05
11548;用的gpt4？;1;0;1;23972;4.171533455698315e-05
11560;那个圈圈轨迹是怎么弄的？;1;0;1;23972;4.171533455698315e-05
11569;这些功能还不如动手快;1;0;1;23972;4.171533455698315e-05
11572;我的mac怎么没有;1;0;1;23972;4.171533455698315e-05
11590;更新不了2305的版本;1;0;1;23972;4.171533455698315e-05
11594;是预览版本？;1;0;1;23972;4.171533455698315e-05
11601;这个家庭版能用吗;1;0;1;23972;4.171533455698315e-05
11607;国内怎么用呢，花钱无所谓，主要是不懂;2;0;2;23972;8.34306691139663e-05
11610;开放体验了？我也要;1;0;1;23972;4.171533455698315e-05
11622;路过;1;2;3;23972;0.00012514600367094945
11654;我的365咋更新不了这个;1;0;1;23972;4.171533455698315e-05
11659;可以自己做数据分析模型吗？;1;0;1;23972;4.171533455698315e-05
11717;大哥，白嫖怎么操作。一键三连。;2;2;4;23972;0.0001668613382279326
11754;能不能让他自动提炼文档做成ppt;2;0;2;23972;8.34306691139663e-05
11761;手机上可以用吗;1;0;1;23972;4.171533455698315e-05
11763;厉害了我的哥，我记得copilot只能对应e4e5版本使用吧;1;0;1;23972;4.171533455698315e-05
11765;国内支持嘛？;1;0;1;23972;4.171533455698315e-05
11773;自从用了WPS，OFFICE就彻底卸载掉了;105;159;264;23972;0.01101284832304355
11879;wps比较好，但是整个会员收费就恶心了;24;54;78;23972;0.0032537960954446853
11904;用過DOS版的WPS，自從有了Office，放棄WPS，看過同事在用WPS，感覺界面亂糟糟，中不中，洋不洋的公司的所有辦公電，都給大家安裝了2019版的office，標配，系統Win11;19;15;34;23972;0.001418321374937427
11924;office20002003永远是神;3;40;43;23972;0.0017937593859502752
11928;我一直用2003，100多兆安装软件，小巧好用;3;21;24;23972;0.0010011680293675956
11932;还是wps好，能自动检查文件内容，防止我犯错误;6;6;12;23972;0.0005005840146837978
11939;wps广告满天飞;6;7;13;23972;0.0005422993492407809
11946;97是yyds不接受反驳;2;15;17;23972;0.0007091606874687135
11949;唉，我觉得还是2003最好用;1;18;19;23972;0.0007925913565826798
11951;WPS很好，但是我用office;2;13;15;23972;0.0006257300183547472
11954;win10安21会不会运行卡顿啊;5;1;6;23972;0.0002502920073418989
11960;不能打开pdf;3;3;6;23972;0.0002502920073418989
11964;网爆：WPS曾经把一个网络作家的文件锁死了，说她违规了。;1;9;10;23972;0.00041715334556983145
11966;365没有visio和project吧。;2;2;4;23972;0.0001668613382279326
11990;用office很多年了;1;0;1;23972;4.171533455698315e-05
11997;说03版本好用的，估计都是用的情怀，效率和使用上肯定是最新版的好用;1;3;4;23972;0.0001668613382279326
12023;office2021怎么能让多个文件同时出现在一个文档中？比如我正在打开多个excel文件。怎么才能让他们想浏览网页一样，都集中在一起，方便来回切换，而不用在屏幕最下方点击切换文件？;2;0;2;23972;8.34306691139663e-05
12032;wps就是借用office的excel加模板加会员收费，没有什么创新;1;0;1;23972;4.171533455698315e-05
12036;老师看到你朦胧的双眼兼职令我着迷能出一期详细的bios教程吗;1;0;1;23972;4.171533455698315e-05
12041;Wps有的功能更加人性化;1;0;1;23972;4.171533455698315e-05
12044;wps已经进入学校课程了;1;0;1;23972;4.171533455698315e-05
12050;我选永中;1;2;3;23972;0.00012514600367094945
12079;白说;1;0;1;23972;4.171533455698315e-05
12085;老师你有365免费分享给我，便宜点的价格吗？;4;0;4;23972;0.0001668613382279326
12090;有免费的版本吗？可以贡献一个2019版本给我吗，便宜点;3;0;3;23972;0.00012514600367094945
12095;我是97开始用的。;1;1;2;23972;8.34306691139663e-05
12097;不好意思，政企都不给用office的。;2;0;2;23972;8.34306691139663e-05
12108;我还有office97和officexp的光盘;1;0;1;23972;4.171533455698315e-05
12110;能不能给我们一个办公软件要2019或者2021的版本都可以;1;0;1;23972;4.171533455698315e-05
12112;WPS狗都不用;1;0;1;23972;4.171533455698315e-05
12114;office会和谐文档吗？;1;0;1;23972;4.171533455698315e-05
12116;365是上了云，账户按月付费，但也容易被卡脖子，账户禁用了就什么都没了。;1;0;1;23972;4.171533455698315e-05
12244;开始确实成功了，，怎么没用两天成2016版本了;15;17;32;23972;0.0013348907058234607
12260;为啥打开后右上角账户有个感叹号说登录失败;6;5;11;23972;0.0004588686801268146
12267;是永久的吗;3;6;9;23972;0.0003754380110128483
12271;最后一步卡住了，一直OSPP正在运行，请稍候;2;2;4;23972;0.0001668613382279326
12274;下载不知道出了什么问题，进度条卡住了;3;0;3;23972;0.00012514600367094945
12278;教程有效已经安装成功，这个能用多久;3;0;3;23972;0.00012514600367094945
12285;我的没有激活？也能用怎么？;1;1;2;23972;8.34306691139663e-05
12287;安装不显示工具箱;1;1;2;23972;8.34306691139663e-05
12292;那个，提示错误是为什么;1;0;1;23972;4.171533455698315e-05
12324;谢谢，激活成功啦;1;0;1;23972;4.171533455698315e-05
12331;太快了，又模糊，对我这个反应慢的人，太难了;1;0;1;23972;4.171533455698315e-05
12340;激活要钱;1;0;1;23972;4.171533455698315e-05
12344;让填密钥呢;1;0;1;23972;4.171533455698315e-05
12357;公众号是什么;1;0;1;23972;4.171533455698315e-05
12365;麻烦问下，试一次搞定，以后还需要定期激活吗？;1;0;1;23972;4.171533455698315e-05
12367;忘记激活了怎么办;1;0;1;23972;4.171533455698315e-05
12370;船长先生;2;0;2;23972;8.34306691139663e-05
12395;wps全搞定，，，;14;10;24;23972;0.0010011680293675956
12410;每年都拼嘛;9;0;9;23972;0.0003754380110128483
12420;真的太喜欢你的衣服了;8;0;8;23972;0.0003337226764558652
12429;已经压箱底了;6;0;6;23972;0.0002502920073418989
12436;我想尝试一下苹果电脑但是应该怎么选啊，官网上7K多的是因为配置不好吗;2;1;3;23972;0.00012514600367094945
12439;然而Windows的office可以破解苹果的可以么？;3;0;3;23972;0.00012514600367094945
12443;想用苹果电脑，但是又离不开win系统的office软件;1;2;3;23972;0.00012514600367094945
12445;也就keynote可以用用，number可太难用了;1;1;2;23972;8.34306691139663e-05
12449;体验苹果电脑过程中，幸好遇到你;1;0;1;23972;4.171533455698315e-05
12451;WPS手机，电脑联动，多好;1;0;1;23972;4.171533455698315e-05
12453;iPad和Mac要分清;1;0;1;23972;4.171533455698315e-05
12455;mac和win用wps编辑的文件内的格式，行距，首行缩进啊之类的有没有区别，会不会出现格式不一样啊;1;0;1;23972;4.171533455698315e-05
12457;黄色海鲜市场是什么;1;0;1;23972;4.171533455698315e-05
12459;有没有买一次性的;1;0;1;23972;4.171533455698315e-05
12461;只有我觉得Office的服务器响应非常慢么，难道我买的微软服务是假的？;1;0;1;23972;4.171533455698315e-05
12463;我是来学习如何找到用优酷下载的视频;1;0;1;23972;4.171533455698315e-05
12465;会员到期了，是不是就不能用了;1;0;1;23972;4.171533455698315e-05
12468;如果有一台微软正版系统的电脑，用这个账号密码登录MAC上的办公三件套还需要交钱吗;1;0;1;23972;4.171533455698315e-05
12474;请问office360可以在苹果电脑和win电脑无缝连接吗？比如说表格啥的。;1;0;1;23972;4.171533455698315e-05
12476;用iwork做好了导出pdf格式不就行了，我一直这样使用;1;0;1;23972;4.171533455698315e-05
12478;淘宝的可以吗;1;0;1;23972;4.171533455698315e-05
12482;黄色的海鲜市场是啥？;1;0;1;23972;4.171533455698315e-05
12486;国产Wps就可以;1;0;1;23972;4.171533455698315e-05
12488;365基本拼两三人已经是上线了，考虑要你手机上还要装，也算设备数，可能你公司电脑也要装，那就;1;0;1;23972;4.171533455698315e-05
12490;明天给我准点直播;1;0;1;23972;4.171533455698315e-05
12492;我有免费的5Tonedrive;6;1;7;23972;0.00029200734189888203
12499;mbpairM1PDDTB教育6000，能入手么？有没入手的，坑不？;5;0;5;23972;0.00020857667278491573
12505;苹果软件从来就没花过钱;5;0;5;23972;0.00020857667278491573
12511;说WPS的真不觉得广告麻烦吗？拼车一年也就几十;4;0;4;23972;0.0001668613382279326
12516;真心话，iWork三件套国外不好说，国内真的就是长得好看，干净漂亮，但是格式不兼容导致我没注意被导师骂得狗血淋头;1;3;4;23972;0.0001668613382279326
12518;Office三件套要钱，苹果的三件套用起来是要命哦那简直了;1;1;2;23972;8.34306691139663e-05
12520;微软的三件套在Mac上也不稳定，word在M1上cpu还经常飙升;1;1;2;23972;8.34306691139663e-05
12522;office365兼容苹果系统吗;1;0;1;23972;4.171533455698315e-05
12524;能不能下载yy;1;0;1;23972;4.171533455698315e-05
12526;武汉疫情的时候，免费注册365，真的很好用;1;0;1;23972;4.171533455698315e-05
12528;不会用wps？;1;0;1;23972;4.171533455698315e-05
12530;看你用的我想送你一套office365;1;0;1;23972;4.171533455698315e-05
12532;有一起拼单的吗？我想拼单;1;0;1;23972;4.171533455698315e-05
12534;这类的视频不要做了，没有啥是拼夕夕，咸鱼解决不了的;1;0;1;23972;4.171533455698315e-05
12542;大家一定要自己独立完成作业虽然Copilot在写一些常见的逻辑的时候很方便，但是用多了的话，对大家编程能力的提升并没有什么帮助哦;2;6;8;23972;0.0003337226764558652
12549;此视频为跳过微软账号登录电脑后激活office的方法。如果用微软账户登录电脑的，打开office可以自动登录和激活，不需要注册，我最新视频有方法。;5;34;39;23972;0.0016268980477223427
12555;我的为什么只有免费试用一个月;152;1444;1596;23972;0.0665776739529451
12708;联想笔记本没有显示产品已激活诶显示的是MicrosoftOffice家庭和学生版2021这个是激活了吗;63;646;709;23972;0.02957617220090105
12772;这样是不是激活了？;111;211;322;23972;0.013432337727348573
12884;我的为什么要钱;69;210;279;23972;0.011638578341398299
12954;这视频也就图一乐，本来就激活过的，视频只是演示了一下注册账号和更新;22;507;529;23972;0.022067411980644085
12977;我为什么一直转圈圈激活不了啊;35;236;271;23972;0.011304855664942434
13013;我的拯救者为什么需要钱啊;23;82;105;23972;0.0043801101284832306
13037;为什么我的要用电子邮件才能用电子邮件怎么整都不晓得;20;78;98;23972;0.004088102786584349
13058;为什么我的不能用手机号码注册;15;82;97;23972;0.0040463874520273654
13074;有没有人帮我看看，我这算激活了吗;20;13;33;23972;0.0013766060403804438
13095;为啥这一系列操作下来，我在进去看，没有显示产品已激活是怎么回事;6;63;69;23972;0.002878358084431837
13102;为什么我的产品信息显示的是家庭和学生版2021，然后我点击激活的时候，它里面显示的是365;21;7;28;23972;0.0011680293675955281
13124;我的是Microsoft365不行;10;28;38;23972;0.0015851827131653595
13135;创建账号那个界面一直加载，打不开怎么办？;7;40;47;23972;0.001960620724178208
13143;我的按照步骤，怎么变成家庭和学生版了，激活了没有啊;3;39;42;23972;0.001752044051393292
13147;用软件一下就激活了，贼快;2;1;3;23972;0.00012514600367094945
13159;kk就是这个，我之前激活了我现在直接崩溃又得激活;2;0;2;23972;8.34306691139663e-05
13166;天选四不送;3;1;4;23972;0.0001668613382279326
13170;我都好像激活了，为什么还是需要钱呢;2;0;2;23972;8.34306691139663e-05
13176;亲们微软的office和wps哪个好用;1;0;1;23972;4.171533455698315e-05
13179;买的二手，已经激活，我能用吗？;1;0;1;23972;4.171533455698315e-05
13181;有没有大佬帮我看看这个是激活好了吗;1;0;1;23972;4.171533455698315e-05
13184;我想用qq邮箱但是没选项怎么办;3;0;3;23972;0.00012514600367094945
13189;你皮燕子发言了吗试试;1;0;1;23972;4.171533455698315e-05
13194;Sean宝贝的好像没激活;1;0;1;23972;4.171533455698315e-05
13197;有没有华硕无畏的激活步骤啊20号以后就弄不了了;8;1;9;23972;0.0003754380110128483
13209;收不到电子邮件的验证码怎么搞，腾讯和网易邮箱的都不行;2;0;2;23972;8.34306691139663e-05
13212;我刚买了电脑激活了office，之后又下载了Wps，在使用时不小心就点到了系统使用wps，现在我想用电脑自带的，该怎么办;2;1;3;23972;0.00012514600367094945
13215;我今天莫名其妙的跟着提示就激活了，我就想知道后续要花钱吗;1;0;1;23972;4.171533455698315e-05
13217;我的开始菜单没有execl在office里打开的没用，怎么回事;1;0;1;23972;4.171533455698315e-05
13219;转半天;3;1;4;23972;0.0001668613382279326
13223;羊驼;1;0;1;23972;4.171533455698315e-05
13226;为什么我的登进去显示没有，是不送，所以没有吗;1;0;1;23972;4.171533455698315e-05
13228;0;1;0;1;23972;4.171533455698315e-05
13231;没有excel怎么办;1;0;1;23972;4.171533455698315e-05
13233;为什么就是收不到代码;3;0;3;23972;0.00012514600367094945
13237;mua激活了没;2;0;2;23972;8.34306691139663e-05
13241;可是为什么客服告诉我不能激活;2;0;2;23972;8.34306691139663e-05
13245;我戴尔的能不能帮我也看下;2;0;2;23972;8.34306691139663e-05
13249;有没有人帮我看看，这样算激活了吗;1;0;1;23972;4.171533455698315e-05
13252;芋泥这样;5;0;5;23972;0.00020857667278491573
13261;请问一下，这样算激活好了吗;4;0;4;23972;0.0001668613382279326
13266;试试看行不;1;0;1;23972;4.171533455698315e-05
13271;为什么我的激活不了，Word用不了;4;0;4;23972;0.0001668613382279326
13284;弄完怎么是2016的;1;0;1;23972;4.171533455698315e-05
13289;仅查看未经授权什么意思;1;1;2;23972;8.34306691139663e-05
13293;0;3;0;3;23972;0.00012514600367094945
13299;为什么我的一直是请稍等;2;1;3;23972;0.00012514600367094945
13302;这样是激活了吗;5;0;5;23972;0.00020857667278491573
13308;帅看这个;1;0;1;23972;4.171533455698315e-05
13313;这个咋弄啊;3;0;3;23972;0.00012514600367094945
13317;歪脸且于晏58你整这个没有;1;0;1;23972;4.171533455698315e-05
13319;拥有office是激活了吧;2;1;3;23972;0.00012514600367094945
13322;不懂就问这样是激活成功吗？;3;0;3;23972;0.00012514600367094945
13327;爱哭包不懂啊;1;0;1;23972;4.171533455698315e-05
13329;这样算是激活了吗;4;0;4;23972;0.0001668613382279326
13340;为啥我的没有word啥的;14;0;14;23972;0.0005840146837977641
13355;笑成本科生你们听这声音像不像凌桂伟琑缪糕从月亮走向月亮冬以后;3;0;3;23972;0.00012514600367094945
13361;酸辣粉米线老公你看一下这个;1;0;1;23972;4.171533455698315e-05
13363;良甘久月我都没弄;1;0;1;23972;4.171533455698315e-05
13365;怎么会这样;11;1;12;23972;0.0005005840146837978
13378;这样是不是激活了？;1;1;2;23972;8.34306691139663e-05
13380;挺好你弄了吗;3;0;3;23972;0.00012514600367094945
13384;南栀学知识;1;0;1;23972;4.171533455698315e-05
13386;o0有时间看看啦激活;1;0;1;23972;4.171533455698315e-05
13389;唯love你激活了吗;1;0;1;23972;4.171533455698315e-05
13391;我恢复出厂设置，这个是不是还要重新注册啊;5;0;5;23972;0.00020857667278491573
13400;我注册日期随便填的未成年，怎么修改;2;0;2;23972;8.34306691139663e-05
13409;chance真是什么状态刷什么视频;2;0;2;23972;8.34306691139663e-05
13412;家人们，这样是永久激活吗;3;0;3;23972;0.00012514600367094945
13421;摆烂小丸沉思中老婆，你的弄了没啊;4;0;4;23972;0.0001668613382279326
13426;这个是什么意思啊;4;0;4;23972;0.0001668613382279326
13431;Gyq完了，一直没激活;1;0;1;23972;4.171533455698315e-05
13433;Sqing额我好像没激活这个电脑放都落灰了;1;1;2;23972;8.34306691139663e-05
13435;wxX注意;1;0;1;23972;4.171533455698315e-05
13444;艹，华硕电脑买完了发现没office;1;2;3;23972;0.00012514600367094945
13446;可是我连这个excel都没有;3;0;3;23972;0.00012514600367094945
13450;嗯对啦我当时不是这样弄的，但是你这样试试，这个好详细;1;0;1;23972;4.171533455698315e-05
13452;为什么我的是未经授权;3;0;3;23972;0.00012514600367094945
13463;所有说这是激活了吗？;2;2;4;23972;0.0001668613382279326
13467;宝宝的激活了吗，没有的话激活一下哦，不然到期了以后要开会员喽;2;0;2;23972;8.34306691139663e-05
13472;能不能给我指导一下我的不一样;3;0;3;23972;0.00012514600367094945
13478;这是不是不送;2;3;5;23972;0.00020857667278491573
13481;槿年巷这样就可以;1;2;3;23972;0.00012514600367094945
13483;为什么天他现在要我卖Microsoft365;2;3;5;23972;0.00020857667278491573
13488;这样算激活吗;3;0;3;23972;0.00012514600367094945
13493;请问我这个是激活了吗;1;1;2;23972;8.34306691139663e-05
13514;登陆了，可这是怎么回事;14;1;15;23972;0.0006257300183547472
13536;Smooth试试？;3;0;3;23972;0.00012514600367094945
13545;为啥我的拯救者里的office说此产品未经授权啊;6;10;16;23972;0.0006674453529117303
13553;联想笔记本没有显示产品已激活诶显示的MicrosoftOffice家庭和学生版2021这个是激活了吗;91;169;260;23972;0.010845986984815618
13645;这是什么意思啊;2;2;4;23972;0.0001668613382279326
13649;这算激活码;6;0;6;23972;0.0002502920073418989
13656;这种算激活了嘛;10;0;10;23972;0.00041715334556983145
13667;为什么我是这样，我问了京东客服，她说是21版本已经激活了;10;0;10;23972;0.00041715334556983145
13678;为什么我的是这样的;13;6;19;23972;0.0007925913565826798
13692;我这个是激活了吗，我说是上面的那个，下面的是之后订阅的;1;0;1;23972;4.171533455698315e-05
13722;言浅;2;0;2;23972;8.34306691139663e-05
13725;小丽同学;1;0;1;23972;4.171533455698315e-05
13735;小杨超哇塞;1;0;1;23972;4.171533455698315e-05
13743;山野都有雾灯;2;0;2;23972;8.34306691139663e-05
13755;麟;1;0;1;23972;4.171533455698315e-05
13766;囡囡哭不出来就笑;2;1;3;23972;0.00012514600367094945
13772;Hik;1;0;1;23972;4.171533455698315e-05
13790;盐王帝菌;1;0;1;23972;4.171533455698315e-05
13792;洛宁鹤;2;0;2;23972;8.34306691139663e-05
13805;0;1;0;1;23972;4.171533455698315e-05
13807;Tang唐;1;0;1;23972;4.171533455698315e-05
13816;北上广第一摆烂;1;0;1;23972;4.171533455698315e-05
13823;记得要早睡;1;0;1;23972;4.171533455698315e-05
13826;婷Ting;1;0;1;23972;4.171533455698315e-05
13835;小秦;1;0;1;23972;4.171533455698315e-05
13839;埼玉;1;0;1;23972;4.171533455698315e-05
13842;一天喝八杯水;1;0;1;23972;4.171533455698315e-05
13846;DlSS小洲;1;0;1;23972;4.171533455698315e-05
13849;情绪取决于你;2;0;2;23972;8.34306691139663e-05
13871;奥特曼;1;0;1;23972;4.171533455698315e-05
13876;对镜梳妆;1;1;2;23972;8.34306691139663e-05
13882;魏巍;1;0;1;23972;4.171533455698315e-05
13890;AAA璃月花臂保安;4;0;4;23972;0.0001668613382279326
13895;书意;1;0;1;23972;4.171533455698315e-05
13900;sky二十一;1;1;2;23972;8.34306691139663e-05
13903;逆光向日葵哦;1;0;1;23972;4.171533455698315e-05
13909;臭烂人罢了;1;0;1;23972;4.171533455698315e-05
13929;芹佟以冬;3;0;3;23972;0.00012514600367094945
13938;橘子味的猫;1;0;1;23972;4.171533455698315e-05
13954;松田阵平;1;0;1;23972;4.171533455698315e-05
13962;小;2;0;2;23972;8.34306691139663e-05
13966;妖灵灵;1;0;1;23972;4.171533455698315e-05
13972;渡枕;4;1;5;23972;0.00020857667278491573
13977;梦西洲;2;0;2;23972;8.34306691139663e-05
13982;张哈哈;1;0;1;23972;4.171533455698315e-05
13986;联想自带的office家庭普通版本，很多功能都用不了，系统也是阉割版的没啥卵用;99;1958;2057;23972;0.08580844318371433
14086;每天睡到自然醒;3;0;3;23972;0.00012514600367094945
14092;我的ppt是这样来的还没想好nie;1;0;1;23972;4.171533455698315e-05
14113;袁湘琴你看嘎子;1;0;1;23972;4.171533455698315e-05
14129;人生寂寞如雪这个咋样？;1;0;1;23972;4.171533455698315e-05
14132;门徒;1;0;1;23972;4.171533455698315e-05
14152;你爱吃螺蛳粉吗;1;0;1;23972;4.171533455698315e-05
14155;尼古拉斯铁柱;1;0;1;23972;4.171533455698315e-05
14164;阿文睡不醒;1;0;1;23972;4.171533455698315e-05
14170;我的怎么这个样;3;0;3;23972;0.00012514600367094945
14183;Tloml;1;0;1;23972;4.171533455698315e-05
14192;0;1;0;1;23972;4.171533455698315e-05
14196;微笑的我;1;0;1;23972;4.171533455698315e-05
14202;oOooO;1;0;1;23972;4.171533455698315e-05
14204;麻烦问一下，我刷了机的怎么用正版;1;0;1;23972;4.171533455698315e-05
14210;为何快看;1;0;1;23972;4.171533455698315e-05
14221;洛城老街坊丶;2;0;2;23972;8.34306691139663e-05
14225;我的要钱;1;0;1;23972;4.171533455698315e-05
14252;为什么我不行;4;0;4;23972;0.0001668613382279326
14275;ISEE;1;0;1;23972;4.171533455698315e-05
14280;周周;1;0;1;23972;4.171533455698315e-05
14286;柠檬不酸;1;0;1;23972;4.171533455698315e-05
14292;没有excel是为啥;1;0;1;23972;4.171533455698315e-05
14295;0;1;0;1;23972;4.171533455698315e-05
14320;这样算激活吗？;3;0;3;23972;0.00012514600367094945
14325;乌鸦坐飞机11你看看你行不行;1;0;1;23972;4.171533455698315e-05
14328;大东看;1;0;1;23972;4.171533455698315e-05
14352;啊？;1;0;1;23972;4.171533455698315e-05
14357;我的也在转圈圈;1;0;1;23972;4.171533455698315e-05
14362;想吃蟹排炒宽粉（酸芹对半;1;0;1;23972;4.171533455698315e-05
14370;不要老说哦;1;0;1;23972;4.171533455698315e-05
14373;我用手机号码登录进去，然后让我填电子邮件，我没有电子邮件，然后我去哪里搞呢？无语;2;0;2;23972;8.34306691139663e-05
14384;来个大佬吧，弄不成;1;0;1;23972;4.171533455698315e-05
14386;可以用QQ邮箱吗？;1;0;1;23972;4.171533455698315e-05
14388;如果已经用QQ邮箱登录了呢，要怎么激活;2;0;2;23972;8.34306691139663e-05
14401;我的第二杯半价;3;0;3;23972;0.00012514600367094945
14406;惜AY;1;0;1;23972;4.171533455698315e-05
14414;我的联想为啥要收费;1;0;1;23972;4.171533455698315e-05
14417;im;2;0;2;23972;8.34306691139663e-05
14420;我这个呢也是2019啊没看见激活啊;1;0;1;23972;4.171533455698315e-05
14433;PIN是啥，我按手机短信上的输了，可一直显示错误，我想重新更改PIN，可问题是我不知道我的PIN是啥呀？有没有什么办法呀，主播;4;0;4;23972;0.0001668613382279326
14438;甜心小肉丸;1;0;1;23972;4.171533455698315e-05
14449;Like啵啵这个是教学;1;0;1;23972;4.171533455698315e-05
14459;拯救者怎么激活啊，没给我这个选项啊直接给我跳到页面;1;0;1;23972;4.171533455698315e-05
14462;主要注册了这个干哈。;1;0;1;23972;4.171533455698315e-05
14464;亲爱的周游。;1;0;1;23972;4.171533455698315e-05
14469;六六没有雅马哈你看看你那能激活不;1;0;1;23972;4.171533455698315e-05
14472;deryyyy;2;0;2;23972;8.34306691139663e-05
14479;大燕;1;0;1;23972;4.171533455698315e-05
14487;今天也不知道吃什么;1;0;1;23972;4.171533455698315e-05
14496;摘星;1;0;1;23972;4.171533455698315e-05
14510;0;1;0;1;23972;4.171533455698315e-05
14513;是小王跟着这个弄可以的;1;0;1;23972;4.171533455698315e-05
14523;白udu;1;0;1;23972;4.171533455698315e-05
14525;丹橘;1;0;1;23972;4.171533455698315e-05
14546;Chiquite;1;0;1;23972;4.171533455698315e-05
14556;否那里我点了是咋办啊;1;0;1;23972;4.171533455698315e-05
14560;primary;1;0;1;23972;4.171533455698315e-05
14589;显慧;1;0;1;23972;4.171533455698315e-05
14592;戏看看;1;0;1;23972;4.171533455698315e-05
14598;Lereys;1;0;1;23972;4.171533455698315e-05
14600;谁能拒绝螺蛳粉呢;1;0;1;23972;4.171533455698315e-05
14617;你的激活了吗;1;0;1;23972;4.171533455698315e-05
14626;jian这个是联想小新的激活;1;0;1;23972;4.171533455698315e-05
14628;只跟傻子互动;1;0;1;23972;4.171533455698315e-05
14631;天选三可以吗;2;0;2;23972;8.34306691139663e-05
14635;千秋雪宝宝，记得看一下，新电脑一般都送的;1;0;1;23972;4.171533455698315e-05
14645;王雪莲;1;0;1;23972;4.171533455698315e-05
14652;五选一;1;0;1;23972;4.171533455698315e-05
14654;0;1;0;1;23972;4.171533455698315e-05
14656;藍;2;0;2;23972;8.34306691139663e-05
14672;奈良就是这个;1;0;1;23972;4.171533455698315e-05
14693;高冷女王你在看一遍;3;0;3;23972;0.00012514600367094945
14698;杰杰;1;0;1;23972;4.171533455698315e-05
14702;imbao;1;0;1;23972;4.171533455698315e-05
14720;七十二時;1;0;1;23972;4.171533455698315e-05
14732;朝朝;1;0;1;23972;4.171533455698315e-05
14741;阳光与绿萝;2;0;2;23972;8.34306691139663e-05
14745;拯救者要钱啊;7;0;7;23972;0.00029200734189888203
14753;我电脑跟这个一模一样，我怎么出现错误;1;0;1;23972;4.171533455698315e-05
14787;还是显示让输入产品密钥进入不了;2;0;2;23972;8.34306691139663e-05
14791;电脑重置过了还可以搞吗？;2;0;2;23972;8.34306691139663e-05
14809;你看看这个;1;0;1;23972;4.171533455698315e-05
14811;0;1;0;1;23972;4.171533455698315e-05
14814;吃冰艺术家弄了吗;2;0;2;23972;8.34306691139663e-05
14821;为什么我的是五天试用啊;3;0;3;23972;0.00012514600367094945
14828;一禾这个过程详细;1;0;1;23972;4.171533455698315e-05
14836;Uy快激活;1;0;1;23972;4.171533455698315e-05
14839;电子邮件可以是qq吗;1;0;1;23972;4.171533455698315e-05
14841;Fioy;1;0;1;23972;4.171533455698315e-05
14854;R;3;0;3;23972;0.00012514600367094945
14861;AAA猪饲料批发小王133659我们是不是搞了哦;1;0;1;23972;4.171533455698315e-05
14863;你爸爸的人字拖;3;0;3;23972;0.00012514600367094945
14867;佳人;1;0;1;23972;4.171533455698315e-05
14894;北岛抹香鲸他们说可以免费;1;0;1;23972;4.171533455698315e-05
14902;呼可以白嫖700多的全套;3;0;3;23972;0.00012514600367094945
14917;Edc;1;0;1;23972;4.171533455698315e-05
14926;吼吼;1;0;1;23972;4.171533455698315e-05
14934;80被骗养老金;2;0;2;23972;8.34306691139663e-05
14957;SSSxle;1;0;1;23972;4.171533455698315e-05
14959;朴橦;1;0;1;23972;4.171533455698315e-05
14963;宏碁的是不送Office吗;3;0;3;23972;0.00012514600367094945
14970;zzz7soien74;2;0;2;23972;8.34306691139663e-05
14975;下一站，只不过是分岔路口;1;0;1;23972;4.171533455698315e-05
14989;牵绊;2;0;2;23972;8.34306691139663e-05
14998;昨日浪漫陈陈不会吃饭正经小李发呆。激活了么;2;0;2;23972;8.34306691139663e-05
15002;嗯嗯嗯;1;0;1;23972;4.171533455698315e-05
15009;可乐不可乐;1;0;1;23972;4.171533455698315e-05
15020;这个激活没啊;3;0;3;23972;0.00012514600367094945
15026;我都没有登入，它一直重复那个登入的;3;0;3;23972;0.00012514600367094945
15033;为什么我点开创建用户是这样的;1;0;1;23972;4.171533455698315e-05
15036;我上面写着家庭学生版激活了吗;8;0;8;23972;0.0003337226764558652
15074;超级无敌霹雳葫芦小兄弟;1;0;1;23972;4.171533455698315e-05
15076;理想是去tg偷apo有啥子就问;1;0;1;23972;4.171533455698315e-05
15079;我登不上去;1;0;1;23972;4.171533455698315e-05
15087;换个电脑可以继续登录同一个账号使用吗;1;0;1;23972;4.171533455698315e-05
15105;宜;1;0;1;23972;4.171533455698315e-05
15111;肥仔小辰;1;0;1;23972;4.171533455698315e-05
15118;AAA建材王姐你的笑激活了吗;2;0;2;23972;8.34306691139663e-05
15124;0;1;0;1;23972;4.171533455698315e-05
15126;yafly牛马6去看看有没有，能白嫖;1;0;1;23972;4.171533455698315e-05
15138;我买的电脑没激活，在找老板他说三个月激活期过了就不能激活了。什么意思有懂的吗？;3;0;3;23972;0.00012514600367094945
15142;永远睡不醒啊哈哈;1;0;1;23972;4.171533455698315e-05
15145;倒霉蛋你激活了吗;1;0;1;23972;4.171533455698315e-05
15151;淺墨丶洛殇;1;0;1;23972;4.171533455698315e-05
15154;长椿月亮小布丁;1;0;1;23972;4.171533455698315e-05
15156;月亮小布丁;1;0;1;23972;4.171533455698315e-05
15158;我的只显示让我购买;1;0;1;23972;4.171533455698315e-05
15163;胡若帆LazyTh你们激活了吗;1;0;1;23972;4.171533455698315e-05
15174;为什么我的下一步就白屏了;2;0;2;23972;8.34306691139663e-05
15177;我点开创建账户以后，就是无法显示此页，为什么呢？;3;0;3;23972;0.00012514600367094945
15186;冰淇林看看;1;0;1;23972;4.171533455698315e-05
15190;我没有显示激活;1;0;1;23972;4.171533455698315e-05
15200;我不会搞怎么办？我好像搞错了;4;0;4;23972;0.0001668613382279326
15207;我的为什么不显示激活？;3;0;3;23972;0.00012514600367094945
15212;酸奶;3;0;3;23972;0.00012514600367094945
15224;为什么一直这个？;1;0;1;23972;4.171533455698315e-05
15230;不想下雨;2;0;2;23972;8.34306691139663e-05
15237;产品未授权;3;0;3;23972;0.00012514600367094945
15243;九亿;2;0;2;23972;8.34306691139663e-05
15248;请给反派吻戏联想小新是有的，我记得。;1;0;1;23972;4.171533455698315e-05
15253;不曾收藏;1;0;1;23972;4.171533455698315e-05
15256;为什么没有手机号注册;2;0;2;23972;8.34306691139663e-05
15259;圆圆不会圆;1;0;1;23972;4.171533455698315e-05
15264;是这个吗翮;1;0;1;23972;4.171533455698315e-05
15267;叶不归宿;1;0;1;23972;4.171533455698315e-05
15269;清风;1;0;1;23972;4.171533455698315e-05
15271;激活后会要钱？;2;0;2;23972;8.34306691139663e-05
15283;我有微软账号的话可以直接登陆注册么？哈哈;1;0;1;23972;4.171533455698315e-05
15285;产品密钥是啥啊？;2;0;2;23972;8.34306691139663e-05
15291;柬子？;1;0;1;23972;4.171533455698315e-05
15293;旷世e没有office;2;0;2;23972;8.34306691139663e-05
15301;家人们，问一下，惠普战66和华硕无畏的笔记本哪个好呢，好迷茫;2;0;2;23972;8.34306691139663e-05
15305;胖大海被谁喝完了;1;0;1;23972;4.171533455698315e-05
15308;陌介个呢;2;0;2;23972;8.34306691139663e-05
15312;梦得帆就是这个之前我问的;1;0;1;23972;4.171533455698315e-05
15318;新买的要购买;1;0;1;23972;4.171533455698315e-05
15321;em这个;2;0;2;23972;8.34306691139663e-05
15328;为啥华硕电脑登进去的时候老是返回界面呢？刚买三天不到;1;0;1;23972;4.171533455698315e-05
15337;棒槌激活一心下;1;0;1;23972;4.171533455698315e-05
15344;二拾三你帮我搞;1;0;1;23972;4.171533455698315e-05
15357;x;2;0;2;23972;8.34306691139663e-05
15360;如果我买新电脑使用旧电脑未激活office的微软账号能激活吗;1;0;1;23972;4.171533455698315e-05
15363;为啥我的不行啊;1;0;1;23972;4.171533455698315e-05
15376;让我选两个相同的方块怎么回事;1;0;1;23972;4.171533455698315e-05
15378;不小心点了是，发送可选数据有关系吗？怎么搞;5;0;5;23972;0.00020857667278491573
15384;为什么我一直出现这个啊;5;0;5;23972;0.00020857667278491573
15390;那我问问已经有账号怎么办，没法注册啊;3;0;3;23972;0.00012514600367094945
15394;为什么创建账户后就一直在加载;5;0;5;23972;0.00020857667278491573
15415;宝贝熊;1;0;1;23972;4.171533455698315e-05
15426;患痹;2;0;2;23972;8.34306691139663e-05
15430;怎么出来的东西不一样;2;0;2;23972;8.34306691139663e-05
15438;要想二两你的自带office吗？;2;0;2;23972;8.34306691139663e-05
15446;leaq;2;0;2;23972;8.34306691139663e-05
15451;778学学;1;0;1;23972;4.171533455698315e-05
15453;天选3有吗？;1;0;1;23972;4.171533455698315e-05
15455;必须是创建账号么？;1;0;1;23972;4.171533455698315e-05
15457;我买电脑送的Office我都没激活，感觉还是wps比较习惯;1;0;1;23972;4.171533455698315e-05
15468;wnxxxxxx;1;0;1;23972;4.171533455698315e-05
15482;手机维修中无原理图，怎么办？？靠猜、靠蒙，靠问，还是靠经验？？都不是。参加《无图维修精讲班》，让你成为大师中的大师，解决别人解决不了的难题。;1;0;1;23972;4.171533455698315e-05
15488;超级无敌暴龙战神普信下头泰迪熊ikun;1;0;1;23972;4.171533455698315e-05
15501;登录了空白;1;0;1;23972;4.171533455698315e-05
15518;橡子哇;1;0;1;23972;4.171533455698315e-05
15525;磊磊;1;0;1;23972;4.171533455698315e-05
15538;为什么暗影精灵8一只显示无法激活Office;1;0;1;23972;4.171533455698315e-05
15540;能不能直接登录;1;0;1;23972;4.171533455698315e-05
15547;我的y9000p2022为什么只能免费试用一个月;2;0;2;23972;8.34306691139663e-05
15554;原来是office;11;0;11;23972;0.0004588686801268146
15571;小董睡不醒你说的是不是这个;1;0;1;23972;4.171533455698315e-05
15573;登录的时候一直转圈圈咋解决啊;3;0;3;23972;0.00012514600367094945
15577;我想用我那个Win7的家庭版装一下win10的专业版。;1;0;1;23972;4.171533455698315e-05
15584;新笔记本用什么下载软件;1;0;1;23972;4.171533455698315e-05
15590;博主你好，我的戴尔电脑是windows11系统，我觉得我激活了，但是没显示“产品已激活”几个字，但是有显示“属于：此设备”，那也是激活了对吗;1;0;1;23972;4.171533455698315e-05
15595;office为什么一定要激活？;1;0;1;23972;4.171533455698315e-05
15598;华硕天选不带office;1;0;1;23972;4.171533455698315e-05
15607;我新买的联想笔记本office家庭学生版2021激活后不显示已激活，也没显示属于此设备，也没有提示需要激活，那我算激活了还是没激活呢？;4;0;4;23972;0.0001668613382279326
15612;那没有的可以买永久吗;1;0;1;23972;4.171533455698315e-05
15619;为什么我的笔记本电脑玩着玩着，右下角英伟达消失了。重启才会有;1;0;1;23972;4.171533455698315e-05
15621;怎么激活windows;1;0;1;23972;4.171533455698315e-05
15623;激活了但老是提示盗版何解？;1;0;1;23972;4.171533455698315e-05
15627;激活不激活都行吗有什么用啊？;4;0;4;23972;0.0001668613382279326
15632;换一台新电脑之后要换新账号激活吗？还是用旧电脑的账号就行;2;0;2;23972;8.34306691139663e-05
15636;我只知道能创建微软就能激活，就像联想，永久免费，轻轻松松激活;1;0;1;23972;4.171533455698315e-05
15639;激活完了以后如果不提示：未激活或者限制使用时间都是已经成功了;14;61;75;23972;0.003128650091773736
15654;office立即更新之后还没显示激活啊;49;147;196;23972;0.008176205573168697
15704;你好怎么判断是否激活;37;20;57;23972;0.0023777740697480394
15742;这个算不算激活;26;21;47;23972;0.001960620724178208
15769;为什么我的一进去显示，“你使用的是盗版许可证，你可能是盗版软件的受害者”;8;110;118;23972;0.004922409477724011
15778;激活后要是重装系统是不是就没了;11;19;30;23972;0.0012514600367094944
15790;为啥我的打开没弹窗;7;15;22;23972;0.0009177373602536292
15798;你好;9;5;14;23972;0.0005840146837977641
15808;我注册玩为什么不行他显示要购买;7;9;16;23972;0.0006674453529117303
15816;我从win10更新到win11就没法用了;8;6;14;23972;0.0005840146837977641
15825;拯救者买了10个月了，没有这个东西，;9;1;10;23972;0.00041715334556983145
15835;拯救者是不是应该有;10;0;10;23972;0.00041715334556983145
15846;怎么判断是永久激活呢？;7;1;8;23972;0.0003337226764558652
15854;请问不知道账号，不知道密码，也创建不了账户怎么办呀;4;4;8;23972;0.0003337226764558652
15859;如果不小心点了“发送可选数据”怎么办;5;2;7;23972;0.00029200734189888203
15867;账号密码不知道怎么办;1;0;1;23972;4.171533455698315e-05
15872;我们这个都是缴费的，现在登陆进去一直在加载，就是进不去，怎么办;1;0;1;23972;4.171533455698315e-05
15882;这个是激活了吗？;1;1;2;23972;8.34306691139663e-05
15885;这样算激活吗？;1;0;1;23972;4.171533455698315e-05
15889;先前是有的，后来用着用着就要交钱了;1;0;1;23972;4.171533455698315e-05
15892;0;4;0;4;23972;0.0001668613382279326
15899;这个是激活成功了吗？;3;0;3;23972;0.00012514600367094945
15903;这是没激活吗？;1;0;1;23972;4.171533455698315e-05
15906;0;6;0;6;23972;0.0002502920073418989
15914;我这样子是已经激活了吗，求求大哥们回;2;0;2;23972;8.34306691139663e-05
15917;未经授权是怎么回事;1;0;1;23972;4.171533455698315e-05
15923;这个算不算永久激活啊？;7;0;7;23972;0.00029200734189888203
15931;我这个算是激活了吗？;4;0;4;23972;0.0001668613382279326
15938;为什么我还要输入代码;1;0;1;23972;4.171533455698315e-05
15940;这样算激活吗;4;0;4;23972;0.0001668613382279326
15946;这样子是已经激活了吗;1;0;1;23972;4.171533455698315e-05
15949;他跟我说激活office是遇到问题怎么办;1;1;2;23972;8.34306691139663e-05
15952;奢望我应该有;1;0;1;23972;4.171533455698315e-05
15957;拯救者为什么登陆也只是显示试用五天;1;0;1;23972;4.171533455698315e-05
15959;word登录界面一直转圈圈怎么办;1;2;3;23972;0.00012514600367094945
15963;为什么我就十天啊，我电脑和你一样的;3;0;3;23972;0.00012514600367094945
15979;这样可咋整呢;2;0;2;23972;8.34306691139663e-05
15987;这样算激活完成吗？;7;0;7;23972;0.00029200734189888203
15995;没有Word怎么办;2;0;2;23972;8.34306691139663e-05
16007;为什么我的不是激活而是Microsoftofffice家庭和学生版2021整了半天也没找着激活office内个选项，我这是激活了吗;1;0;1;23972;4.171533455698315e-05
16011;点了发送怎么办啊;2;1;3;23972;0.00012514600367094945
16015;更新以后怎么还不显示已经激活？;1;0;1;23972;4.171533455698315e-05
16019;这office干啥用的，建议激活吗，激活有无影响;3;0;3;23972;0.00012514600367094945
16024;宏碁暗影骑士有吗;1;0;1;23972;4.171533455698315e-05
16027;为啥我和你们的不一样;6;0;6;23972;0.0002502920073418989
16034;要购买啊;1;0;1;23972;4.171533455698315e-05
16037;旧电脑是惠普的忘记了有没有激活office，现在新电脑天选怎么看能不能用;2;0;2;23972;8.34306691139663e-05
16048;我这到底激没激活;10;2;12;23972;0.0005005840146837978
16059;点了发送会怎么样;2;0;2;23972;8.34306691139663e-05
16064;我的点进去为啥还要下载呢;2;0;2;23972;8.34306691139663e-05
16068;我更新完后和你没更新前一样，没有显示已激活或属于此产品，这怎么办？是已经激活了嘛;1;1;2;23972;8.34306691139663e-05
16070;产品信息office下面没有显示已激活;11;0;11;23972;0.0004588686801268146
16084;为啥你打开好快，我打开好慢;2;0;2;23972;8.34306691139663e-05
16087;试用了几天后要购买，有办法永久激活吗？？;4;0;4;23972;0.0001668613382279326
16092;如果打开的时候已经显示拥有了，但是我又创建了一个账号，会不会对以后的使用有影响;2;0;2;23972;8.34306691139663e-05
16098;只要和你的差不多，就算激活了吧我没有左边那个导航;2;2;4;23972;0.0001668613382279326
16101;没有弹窗？怎么办;2;0;2;23972;8.34306691139663e-05
16104;我点立即更新后再进去还是没有已激活;1;0;1;23972;4.171533455698315e-05
16108;我选了发送可选数据会咋样;2;0;2;23972;8.34306691139663e-05
16114;我的office没显示产品已激活也没有显示需要激活这算什么？;2;1;3;23972;0.00012514600367094945
16119;Win11怎样激活office;1;0;1;23972;4.171533455698315e-05
16121;买电脑送的那个是只能在那个一个电脑上使用吗？如果换电脑了，登录微软帐号还能用吗？;1;0;1;23972;4.171533455698315e-05
16124;r9000p激活了office，半个月后重置系统了，这个office我登陆了microsoft账号就有了，那以后是只能这个电脑用还是这个账户有啊;2;0;2;23972;8.34306691139663e-05
16127;这个立即更新要更新多久啊我好久都没好;1;0;1;23972;4.171533455698315e-05
16129;这东西时隔多年开始收费了;8;0;8;23972;0.0003337226764558652
16138;你这打了马赛克，和没打没有什么区别;1;0;1;23972;4.171533455698315e-05
16140;电脑重置了之后就不免费了吗;1;1;2;23972;8.34306691139663e-05
16144;我之前不懂得，一直没激活。还能激活吗;1;0;1;23972;4.171533455698315e-05
16148;真羡慕你家的网，电脑好快。我也不知道我家里是网络问题还是电脑问题，那玩意反应还没我快;1;0;1;23972;4.171533455698315e-05
16151;要是不小心把那几个软件删了，下回来还能用吗？;4;2;6;23972;0.0002502920073418989
16156;还是不行，让购买;2;0;2;23972;8.34306691139663e-05
16160;如果没有呢;3;0;3;23972;0.00012514600367094945
16164;创建不了账户;3;0;3;23972;0.00012514600367094945
16168;请问一下你是什么电脑呀？好像和我的是一样的，但是我不太确定自己的office是不是激活的状态。;1;0;1;23972;4.171533455698315e-05
16170;老师您好忘记登录密码跟账号咋么办;1;0;1;23972;4.171533455698315e-05
16172;你好我的显示以激活，但是我并没有登录账号，这个是可以永久使用的嘛看看孩子吧;1;0;1;23972;4.171533455698315e-05
16175;你好我激活过了要重新登录账号什么意思;2;0;2;23972;8.34306691139663e-05
16183;王仔小馒头;2;1;3;23972;0.00012514600367094945
16194;嘿;1;0;1;23972;4.171533455698315e-05
16208;陈柏纤;2;0;2;23972;8.34306691139663e-05
16217;自知;1;0;1;23972;4.171533455698315e-05
16224;还是没说关键点，激活与否的标志是啥;3;1;4;23972;0.0001668613382279326
16228;天选要买吗？;2;1;3;23972;0.00012514600367094945
16231;我的电脑显示office是最新版本，但它一直要收费，已经不知道该怎么把它弄成免费的;3;0;3;23972;0.00012514600367094945
16235;baheh激活没;3;0;3;23972;0.00012514600367094945
16239;Word变白了打不开怎么办;1;0;1;23972;4.171533455698315e-05
16241;我这个激活的，很久没用了，但今天突然就让我续订，怎么办啊;1;0;1;23972;4.171533455698315e-05
16243;你好，就是我的office点进去之后，它需要让我安装office，但它是需要付费的那种是怎么回事？;2;0;2;23972;8.34306691139663e-05
16246;登录的账户以前用过office现在买的新机子，提示我要续费怎么办;2;0;2;23972;8.34306691139663e-05
16263;拯救者r9000p要购买？;1;0;1;23972;4.171533455698315e-05
16265;作者，我这边老显示onedrive拒绝链接;1;0;1;23972;4.171533455698315e-05
16267;戴尔官翻可以下载激活永久office吗;1;0;1;23972;4.171533455698315e-05
16269;戴尔游匣G15有没有;1;0;1;23972;4.171533455698315e-05
16271;现在已经改为Microsoft365了;14;94;108;23972;0.00450525613215418
16286;正版365装维自己激活的w10家庭版能正常使用吗？;15;29;44;23972;0.0018354747205072584
16302;我最近买了笔记本电脑，但是不知道为什么会又喊买365了，可以不买吗？;8;19;27;23972;0.001126314033038545
16311;WPS和office有什么区别，不都是打字，表格，PPT，，，，？？？;6;8;14;23972;0.0005840146837977641
16319;用免费的才香;3;14;17;23972;0.0007091606874687135
16323;365上做好了课件，在2016上播放，那些特效动画还能正常播放吗？;2;8;10;23972;0.00041715334556983145
16326;求家庭版组合;1;7;8;23972;0.0003337226764558652
16328;关键是我咋没搜到呢;1;3;4;23972;0.0001668613382279326
16331;748是终身免费的吗;1;0;1;23972;4.171533455698315e-05
16333;Onedrive慢的要命，有什么解决办法吗？;1;0;1;23972;4.171533455698315e-05
16335;2016能打开365吗;1;0;1;23972;4.171533455698315e-05
16349;老美可以实时查询贵公司的任何资料;1;7;8;23972;0.0003337226764558652
16351;eufjd抖音给我推荐这个，我的心在滴血;1;1;2;23972;8.34306691139663e-05
16361;软件激活了office，OneDrive没有1t;1;4;5;23972;0.00020857667278491573
16363;贵死了一年498;1;3;4;23972;0.0001668613382279326
16365;网络传输然并软;1;1;2;23972;8.34306691139663e-05
16376;我的是365家庭版;4;2;6;23972;0.0002502920073418989
16381;使用这个工具写一些工具类，做一些提示真的很厉害，但是终究不能代替人，复杂业务，甚至任何的多表业务，他的代码基本不能用，拿着玩一玩挺好的;76;730;806;23972;0.033622559652928416
16458;程序员用程序把程序员干失业了;143;2545;2688;23972;0.1121308192891707
16602;拿着整个git库做训练模型，无视代码的授权，生成代码的时候连别人作者注释都一摸一样的，已经被抵制了;56;847;903;23972;0.03766894710495578
16659;我一直都不太敢用这个，这种太过智能的工具，用久了很大可能会弱化自己的编程和思考能力。就像学数学一样，从来不是为了让你去买菜，只是为了一直活跃你的思维能力，可以保持清晰的头脑;55;286;341;23972;0.014224929083931253
16715;为什么我有权限也下载安装了不能用;65;277;342;23972;0.014266644418488236
16781;基于copilot的tab工程师。;26;412;438;23972;0.018271316535958617
16808;面试语文编程了兄弟们，中文编程这就是;14;215;229;23972;0.00955281161354914
16823;不是说要申请吗？而且很慢;22;82;104;23972;0.004338394793926247
16846;使用的代码存在版权问题，这个插件风险很大;16;158;174;23972;0.007258468212915067
16863;会上传你代码，公司不让用;15;63;78;23972;0.0032537960954446853
16879;容易产生侵权问题，还有bug但是我依然用的飞起，真的快;4;135;139;23972;0.005798431503420657
16884;刷到这个视屏内心咯噔了一下，刚报班还没两个月，内心慌得一p;12;81;93;23972;0.003879526113799433
16897;创造性的没法写吧，不过也很强了;6;101;107;23972;0.004463540797597197
16904;没想象中那么智能，就是去匹配别人写过的代码，你想新写代码用这个是不可能的;12;41;53;23972;0.002210912731520107
16917;。。。。js能用吗;17;19;36;23972;0.0015017520440513933
16935;理塘在逃王子这个是简易版的之前刷到的人那个ai每天跟几千万人学习敲代码;1;0;1;23972;4.171533455698315e-05
16937;Brave搞一个;1;0;1;23972;4.171533455698315e-05
16950;芭玫瑰到了花期河里吗？;1;1;2;23972;8.34306691139663e-05
16952;星河长明快来给我用vscode;1;2;3;23972;0.00012514600367094945
16954;困死算了转专业还来得及;2;0;2;23972;8.34306691139663e-05
16960;我18岁JY开心沸羊羊Hykes快下雨吧久等了要失业了;2;0;2;23972;8.34306691139663e-05
16965;揽风绳晚安qfliebe攒一口袋星星取名字真难星河方木要失业了;1;0;1;23972;4.171533455698315e-05
16970;小白求问可以用来写前端网页吗;1;0;1;23972;4.171533455698315e-05
16973;收费了;1;1;2;23972;8.34306691139663e-05
16975;沉睡蒙面绅士没睡过觉;1;0;1;23972;4.171533455698315e-05
16978;沈我靠;1;0;1;23972;4.171533455698315e-05
16981;为啥我要收费;1;0;1;23972;4.171533455698315e-05
16984;开始收费了;1;1;2;23972;8.34306691139663e-05
16986;贝壳超爱奶茶看起来貌似对你有帮助;1;1;2;23972;8.34306691139663e-05
16997;笨蛋好用吗？;3;0;3;23972;0.00012514600367094945
17001;怀揣少年梦达达利鸭Python可以用吗;1;0;1;23972;4.171533455698315e-05
17006;wocDylan：）;1;0;1;23972;4.171533455698315e-05
17017;清寒SKFSpringBoot;2;2;4;23972;0.0001668613382279326
17022;锅子阿聂猫靥取个名字这么难马飞;2;0;2;23972;8.34306691139663e-05
17029;okK毕业即搬砖了;1;0;1;23972;4.171533455698315e-05
17033;好听点是AI，简单点就是少了ctrlc;1;0;1;23972;4.171533455698315e-05
17036;EuphoriaZik搞一搞;1;0;1;23972;4.171533455698315e-05
17042;枫叶夕落乐一白色;1;0;1;23972;4.171533455698315e-05
17046;这也就是说程序代码都是固定的只是调用你所需要的这段代码，只需要读懂你所输入的这段话;1;0;1;23972;4.171533455698315e-05
17053;麦兜兜爱小黑以后程序员不吃香了;1;0;1;23972;4.171533455698315e-05
17061;这都是最基本的crud啊;1;0;1;23972;4.171533455698315e-05
17071;冥谢谢已经转行;1;1;2;23972;8.34306691139663e-05
17073;Reality牛逼;1;0;1;23972;4.171533455698315e-05
17075;这。。。;1;1;2;23972;8.34306691139663e-05
17077;李蛇林萧萧（国服孙策）雪月;1;0;1;23972;4.171533455698315e-05
17079;兄弟们不用去尝试了，这个东西现在还在技术预览版，只开放给一小部分人使用;9;18;27;23972;0.001126314033038545
17094;按那个确定啊;2;5;7;23972;0.00029200734189888203
17098;我们的春天来了Echo热忱飞行荷兰人;1;0;1;23972;4.171533455698315e-05
17101;Corleone我有个大胆的想法;1;0;1;23972;4.171533455698315e-05
17111;什么插件;1;0;1;23972;4.171533455698315e-05
17113;程序猿在线失业;1;0;1;23972;4.171533455698315e-05
17123;SherlockT花拾plutot61还没毕业就失业了;1;0;1;23972;4.171533455698315e-05
17126;会不会像wifi密码破解软件一样，其实是将每个用户的代码上传，形成大数据学习，然后给你生成的代码其实是云端别人写过的代码;4;8;12;23972;0.0005005840146837978
17137;芋泥小达人;1;0;1;23972;4.171533455698315e-05
17145;八十年代小怪兽这可以用;1;1;2;23972;8.34306691139663e-05
17148;Isyang你看看;1;0;1;23972;4.171533455698315e-05
17150;还学什么LWJ;3;0;3;23972;0.00012514600367094945
17155;蘇山海;1;0;1;23972;4.171533455698315e-05
17157;二百五trythis哈哈哈哈;1;0;1;23972;4.171533455698315e-05
17175;迟哈哈哈哈哈哈哈;1;0;1;23972;4.171533455698315e-05
17177;爱意永;2;0;2;23972;8.34306691139663e-05
17186;1这个好啊;1;1;2;23972;8.34306691139663e-05
17208;程序员成功把自己的岗位干掉了;1;0;1;23972;4.171533455698315e-05
17211;辞职吧;3;4;7;23972;0.00029200734189888203
17216;断网试试？这应该类似于一个代码共享库吧。通过越来越多的人使用他，他就学得越多。你写的代码也有可能被收集学习。;1;0;1;23972;4.171533455698315e-05
17223;作者用的是什么软件做编程;2;0;2;23972;8.34306691139663e-05
17226;扁担长板凳宽板凳没有扁担长板凳没有扁担长哉qzuser差不多得了毕之贝总弄不回去了我的福音来了;1;1;2;23972;8.34306691139663e-05
17233;紫薯南瓜泥临界三石（抽版）nb;3;1;4;23972;0.0001668613382279326
17241;这个可以上传你的代码，注释的都是大家写过的;1;3;4;23972;0.0001668613382279326
17244;恋路十六夜真的假的;1;0;1;23972;4.171533455698315e-05
17246;KaridaBobbleLiGuNan这个牛逼;1;1;2;23972;8.34306691139663e-05
17252;最後一支血清素我趣？？;1;0;1;23972;4.171533455698315e-05
17254;适用于python和go吗？;4;5;9;23972;0.0003754380110128483
17259;扁桃体永不发言有需要不;1;0;1;23972;4.171533455698315e-05
17262;易烊千鹤;1;1;2;23972;8.34306691139663e-05
17265;明天的彩票号码;25;453;478;23972;0.019939929918237943
17291;好像有那么一个软件，可以帮忙修复bug，但是最后它成精了，直接删掉所有代码，没有代码就没有bug;2;6;8;23972;0.0003337226764558652
17294;用这个插件写力扣，一个字没敲，全给提示出来了;2;14;16;23972;0.0006674453529117303
17298;用不了。没有账号;2;8;10;23972;0.00041715334556983145
17301;这个确实牛，阅读源码的时候，还会给出中文注释;3;53;56;23972;0.0023360587351910563
17305;减少了写一些重复业务代码很好用但是有些时候要看一下不然会有bug;3;17;20;23972;0.0008343066911396629
17309;那是不是不会再有bug了;6;13;19;23972;0.0007925913565826798
17316;想转行了;2;9;11;23972;0.0004588686801268146
17319;我方法名用拼音，他能搞吗;2;21;23;23972;0.0009594526948106124
17322;又能摸鱼了，好烦;4;108;112;23972;0.0046721174703821125
17327;学不会定积分黄聪明a;3;0;3;23972;0.00012514600367094945
17331;lyy;1;0;1;23972;4.171533455698315e-05
17333;林宗毅;1;0;1;23972;4.171533455698315e-05
17335;YGking;1;0;1;23972;4.171533455698315e-05
17344;青橘栀耳星许天越热了;1;0;1;23972;4.171533455698315e-05
17346;高天原小樱花YOUSTOP;1;0;1;23972;4.171533455698315e-05
17350;满心欢喜v;1;1;2;23972;8.34306691139663e-05
17358;勇敢牛牛不怕困难;1;0;1;23972;4.171533455698315e-05
17362;秋水;1;0;1;23972;4.171533455698315e-05
17364;一抹红尘为谁留;1;0;1;23972;4.171533455698315e-05
17371;钢琴家znw。。月亮只是;1;1;2;23972;8.34306691139663e-05
17373;迪迦奥特蛋;1;0;1;23972;4.171533455698315e-05
17376;呀儿呦沼跃鱼凪Zh1zven;2;0;2;23972;8.34306691139663e-05
17381;艺诺;1;0;1;23972;4.171533455698315e-05
17386;zd;4;0;4;23972;0.0001668613382279326
17396;雍;2;0;2;23972;8.34306691139663e-05
17403;时光;1;0;1;23972;4.171533455698315e-05
17409;Killua;1;0;1;23972;4.171533455698315e-05
17413;King莽夫;2;0;2;23972;8.34306691139663e-05
17416;Zxu;1;0;1;23972;4.171533455698315e-05
17422;daihz;1;0;1;23972;4.171533455698315e-05
17430;西蒙当家的（午夜emo天花板）;2;0;2;23972;8.34306691139663e-05
17433;于金虎;1;0;1;23972;4.171533455698315e-05
17437;OldenZz;2;0;2;23972;8.34306691139663e-05
17443;安逸;1;0;1;23972;4.171533455698315e-05
17445;吸引力法则远赴人间温柔;3;0;3;23972;0.00012514600367094945
17453;Vicent;1;0;1;23972;4.171533455698315e-05
17465;灼灼;1;0;1;23972;4.171533455698315e-05
17473;Oo瑶小妖oO;1;0;1;23972;4.171533455698315e-05
17475;不吃香菜聪;1;0;1;23972;4.171533455698315e-05
17477;麦克风;1;1;2;23972;8.34306691139663e-05
17480;阿坡;1;0;1;23972;4.171533455698315e-05
17482;0;1;1;2;23972;8.34306691139663e-05
17486;好名字Dian執念呀哈好人;1;2;3;23972;0.00012514600367094945
17488;隔壁老王;1;0;1;23972;4.171533455698315e-05
17497;许一世蓝颜SIBENreweliding早睡;1;0;1;23972;4.171533455698315e-05
17500;我一直都在那都是很好很好的;1;0;1;23972;4.171533455698315e-05
17502;一杯柠檬加冰少糖Coko于森;1;1;2;23972;8.34306691139663e-05
17520;张小山;1;0;1;23972;4.171533455698315e-05
17528;路明非fal;2;1;3;23972;0.00012514600367094945
17539;葡萄A品味人生;2;0;2;23972;8.34306691139663e-05
17549;娇扈;2;0;2;23972;8.34306691139663e-05
17552;2;1;0;1;23972;4.171533455698315e-05
17555;糖宝不如跳舞奶茶味的草莓巧克力只剪一点点乐不思蜀;1;0;1;23972;4.171533455698315e-05
17558;dbrssgARROGANCE;1;1;2;23972;8.34306691139663e-05
17566;超级无敌干饭王一顿狂炫八碗饭;1;0;1;23972;4.171533455698315e-05
17571;卧槽;2;0;2;23972;8.34306691139663e-05
17574;来放一个屁;2;0;2;23972;8.34306691139663e-05
17577;白鴿vscode是什么用的;2;0;2;23972;8.34306691139663e-05
17580;超不可爱的小朋友山下风我java就是学的他的课;2;0;2;23972;8.34306691139663e-05
17584;你的小宝贝;1;0;1;23972;4.171533455698315e-05
17586;佳啊aaaa君说十点差三分灰色与青长安依在我觉得你们可以拥有;1;0;1;23972;4.171533455698315e-05
17588;酷崽;1;0;1;23972;4.171533455698315e-05
17590;不正经的深情虚空卡比兽;1;0;1;23972;4.171533455698315e-05
17592;mnbvc呀呀呀;1;0;1;23972;4.171533455698315e-05
17594;Ttttt已安装;1;0;1;23972;4.171533455698315e-05
17657;言和失业了失业了;1;0;1;23972;4.171533455698315e-05
17659;小丁是呆瓜sicklove还没工作就准备失业了;1;0;1;23972;4.171533455698315e-05
17669;毛aoMaionette;1;0;1;23972;4.171533455698315e-05
17672;仙城云中落别留遗憾唔西迪西诺言yyds晓秋牛逼;1;0;1;23972;4.171533455698315e-05
17677;麦芽糖;2;0;2;23972;8.34306691139663e-05
17682;垒上头lx福利;1;0;1;23972;4.171533455698315e-05
17690;虽然可以这样，但是也要程序员操作啊;1;0;1;23972;4.171533455698315e-05
17699;Max;1;0;1;23972;4.171533455698315e-05
17702;泠馨;1;0;1;23972;4.171533455698315e-05
17706;富贵阿姨花开仙女试试;1;0;1;23972;4.171533455698315e-05
17709;Geojane;1;0;1;23972;4.171533455698315e-05
17716;2鑫森淼焱垚;1;0;1;23972;4.171533455698315e-05
17721;0;2;0;2;23972;8.34306691139663e-05
17726;Sakur灬a;3;0;3;23972;0.00012514600367094945
17732;卧艹，这这这，我是该激动还是该激动，这;1;0;1;23972;4.171533455698315e-05
17738;写一个12306售票系统我靠，真的搞出来了;1;0;1;23972;4.171533455698315e-05
17752;念言tsuuchan失业了程序员;1;0;1;23972;4.171533455698315e-05
17758;银月岚开这个咋样;1;0;1;23972;4.171533455698315e-05
17762;彼竹小鹿乱撞锦鲤koi华容道没有蜡笔的马良还没毕业就要失业了;3;0;3;23972;0.00012514600367094945
17768;秀儿;1;0;1;23972;4.171533455698315e-05
17770;祀梦可你不用vscode;1;0;1;23972;4.171533455698315e-05
17783;多吃薯条;1;0;1;23972;4.171533455698315e-05
17789;ue少年与梦;2;0;2;23972;8.34306691139663e-05
17799;kidult;4;0;4;23972;0.0001668613382279326
17807;小贝壳00;3;0;3;23972;0.00012514600367094945
17812;0;1;0;1;23972;4.171533455698315e-05
17816;Z梦;1;0;1;23972;4.171533455698315e-05
17820;N1萘基乙二胺盐酸盐黛新染该用户已注销你头发乱了喔账号已被封禁Bram;1;0;1;23972;4.171533455698315e-05
17822;123;1;0;1;23972;4.171533455698315e-05
17830;这个什么软件;2;0;2;23972;8.34306691139663e-05
17833;為什麼能看得懂中文;1;0;1;23972;4.171533455698315e-05
17842;瑶瑶你也可以写代码了;2;0;2;23972;8.34306691139663e-05
17853;三米之外yyyyyyyyyyyy你在逗我HXDOvO;1;0;1;23972;4.171533455698315e-05
17862;挤你胎没JasonBG暗号只爱娜娜;2;0;2;23972;8.34306691139663e-05
17866;神奇的小绿看吧;1;0;1;23972;4.171533455698315e-05
17877;让它写个基于plc的CC的代码试试，Java没啥;3;0;3;23972;0.00012514600367094945
17900;文盛庄路在职007我踏马当场失业;1;0;1;23972;4.171533455698315e-05
17907;0;1;0;1;23972;4.171533455698315e-05
17929;第一次试用这个插件感觉心里发怵，感觉可能会后台上传代码;1;0;1;23972;4.171533455698315e-05
17931;把所有香菜都毁掉;1;0;1;23972;4.171533455698315e-05
17957;木豆;2;0;2;23972;8.34306691139663e-05
17962;我有气球跟我走呗;1;0;1;23972;4.171533455698315e-05
17966;小悲劇温柔李小花雪夜观星辰珍珠奶茶大杯少冰十六岁的耿耿;1;0;1;23972;4.171533455698315e-05
17986;存在即合理哈哈哈哈;1;0;1;23972;4.171533455698315e-05
17992;卡尔;1;0;1;23972;4.171533455698315e-05
17998;11学;1;0;1;23972;4.171533455698315e-05
18007;张有志牛逼;1;0;1;23972;4.171533455698315e-05
18009;xiangxin;1;0;1;23972;4.171533455698315e-05
18011;Python可以吗;1;0;1;23972;4.171533455698315e-05
18015;Elina失业了;1;0;1;23972;4.171533455698315e-05
18025;是潇潇呀;1;0;1;23972;4.171533455698315e-05
18043;早上七点说晚安;2;0;2;23972;8.34306691139663e-05
18046;北北风笙深海;2;0;2;23972;8.34306691139663e-05
18058;鸿;2;0;2;23972;8.34306691139663e-05
18068;忆忆忆忆忆安快下，作业秒做;1;0;1;23972;4.171533455698315e-05
18070;名字太难，不会取试哈有没得用;1;0;1;23972;4.171533455698315e-05
18075;你有好的邻居这个;1;0;1;23972;4.171533455698315e-05
18078;叶大雄;2;0;2;23972;8.34306691139663e-05
18082;狗祖离失业不远了;1;0;1;23972;4.171533455698315e-05
18084;茅小丢李星星不放羊我们还没上班就失业了;1;0;1;23972;4.171533455698315e-05
18094;yayayayaaa我擦;1;0;1;23972;4.171533455698315e-05
18098;奈斯不需要我们了;1;0;1;23972;4.171533455698315e-05
18100;文艺我下载了我可以把自己辞职让他替我上班吗;1;0;1;23972;4.171533455698315e-05
18105;小张没三分;1;0;1;23972;4.171533455698315e-05
18114;Soyoung;2;0;2;23972;8.34306691139663e-05
18117;家中肠胃;1;0;1;23972;4.171533455698315e-05
18127;白夜y去休程序员直接失业;1;0;1;23972;4.171533455698315e-05
18133;瓜。丁丁车科幻松鼠小太阳杰;1;0;1;23972;4.171533455698315e-05
18139;墨白听风看月阿鑫卧槽;2;0;2;23972;8.34306691139663e-05
18142;Lzc，VJ协;1;0;1;23972;4.171533455698315e-05
18156;Corleonewoc;1;0;1;23972;4.171533455698315e-05
18158;鹅搬登基于copilot的tab程序员;1;0;1;23972;4.171533455698315e-05
18161;小5？;1;0;1;23972;4.171533455698315e-05
18184;咘噜咘噜;1;0;1;23972;4.171533455698315e-05
18187;澪晨HaiLan犹记这玩意可以啊;1;0;1;23972;4.171533455698315e-05
18202;爱你哟这个牛逼不;1;0;1;23972;4.171533455698315e-05
18204;疯夜woc;1;0;1;23972;4.171533455698315e-05
18206;Robos六六六六不如喝水;3;0;3;23972;0.00012514600367094945
18219;下辈子我要做一个女人王师傅你怎么看;2;0;2;23972;8.34306691139663e-05
18242;Hannah珩这不就是你想要的吗;1;0;1;23972;4.171533455698315e-05
18252;小叶问凉虾重生之我在校园吃八块懂得遗忘的回憶;1;0;1;23972;4.171533455698315e-05
18254;Vlada;1;0;1;23972;4.171533455698315e-05
18256;不到140不改名Hs为什么四年前没有;3;0;3;23972;0.00012514600367094945
18262;piggggs好屌;1;0;1;23972;4.171533455698315e-05
18266;favourite感觉挺好玩;1;0;1;23972;4.171533455698315e-05
18273;布吉岛;1;0;1;23972;4.171533455698315e-05
18280;马凯woc？;1;0;1;23972;4.171533455698315e-05
18285;芊火焯我刷到好多次了;3;0;3;23972;0.00012514600367094945
18290;那咋办嘛名字正在加载;1;0;1;23972;4.171533455698315e-05
18292;小熊维尼;1;0;1;23972;4.171533455698315e-05
18306;橙子;1;0;1;23972;4.171533455698315e-05
18308;Granty1;2;0;2;23972;8.34306691139663e-05
18328;唯有一郎在床坦腹食卧槽这真nb;1;0;1;23972;4.171533455698315e-05
18337;英文注释我理解，为什么中文也能;1;0;1;23972;4.171533455698315e-05
18344;Goland可以么;1;0;1;23972;4.171533455698315e-05
18348;要不一起吃个饭继续冲冲冲这玩意牛逼;1;0;1;23972;4.171533455698315e-05
18350;一只铁敢敢呀丶艹，快失业了;1;0;1;23972;4.171533455698315e-05
18358;DJYoyoyo;1;0;1;23972;4.171533455698315e-05
18363;吃土群众;2;0;2;23972;8.34306691139663e-05
18372;Tenor青夏芜茗五小点点离谱;1;0;1;23972;4.171533455698315e-05
18379;vlhh;1;0;1;23972;4.171533455698315e-05
18387;妮？;1;0;1;23972;4.171533455698315e-05
18393;kktian艾倫信信日常找bug;2;0;2;23972;8.34306691139663e-05
18405;人族泡泡兵有没有感觉要失业了;1;0;1;23972;4.171533455698315e-05
18420;解语花呀丶试一试吗;1;0;1;23972;4.171533455698315e-05
18422;丿叶湘伦L;1;0;1;23972;4.171533455698315e-05
18436;能写个FPS游戏透视吗？;1;0;1;23972;4.171533455698315e-05
18441;biubiu蕾;1;0;1;23972;4.171533455698315e-05
18444;还要申请;1;0;1;23972;4.171533455698315e-05
18450;pycharm亲测可用，真tm香;3;0;3;23972;0.00012514600367094945
18456;Liked好好学;1;0;1;23972;4.171533455698315e-05
18458;只有程序员能干掉程序员;1;0;1;23972;4.171533455698315e-05
18466;小蓝辞职去吗？;1;0;1;23972;4.171533455698315e-05
18488;需要程序员写注释;1;0;1;23972;4.171533455698315e-05
18498;：篮网公社HelloWorld问雨;2;0;2;23972;8.34306691139663e-05
18540;被窝里玩火机;1;0;1;23972;4.171533455698315e-05
18542;goodgirl教我;1;0;1;23972;4.171533455698315e-05
18562;北洲笑死我了;1;0;1;23972;4.171533455698315e-05
18565;coax;2;0;2;23972;8.34306691139663e-05
18569;EBACK你不用愁作业了;2;0;2;23972;8.34306691139663e-05
18574;创创创创创绯红之王准备下岗了哥;1;0;1;23972;4.171533455698315e-05
18580;适ByAccidentAurora;1;0;1;23972;4.171533455698315e-05
18586;生成支付宝代码;1;0;1;23972;4.171533455698315e-05
18598;南烛北乔你的救星;1;0;1;23972;4.171533455698315e-05
18603;php能用吗;1;0;1;23972;4.171533455698315e-05
18608;竺包卧槽，开挂;1;0;1;23972;4.171533455698315e-05
18610;雾里见;1;0;1;23972;4.171533455698315e-05
18612;walianv;1;0;1;23972;4.171533455698315e-05
18615;H;1;0;1;23972;4.171533455698315e-05
18622;它知道我用的哪个UI框架的哪个版本，写哪种语法？;2;0;2;23972;8.34306691139663e-05
18638;能写C吗;1;0;1;23972;4.171533455698315e-05
18642;丿pimple丶本人已活;1;0;1;23972;4.171533455698315e-05
18664;米斯特Yn;1;0;1;23972;4.171533455698315e-05
18669;灰太狼撕破伤口丶丿撕裂的天堂剩下的盛夏小熊猫学代码两年，只为了一键代码;1;0;1;23972;4.171533455698315e-05
18676;丆这个牛了;1;0;1;23972;4.171533455698315e-05
18683;南温哇;1;0;1;23972;4.171533455698315e-05
18694;Sesv大一知道就好了;1;0;1;23972;4.171533455698315e-05
18697;FuFei;1;0;1;23972;4.171533455698315e-05
18704;蓝南瓜怪兽zzz季雨远辰卧槽;1;0;1;23972;4.171533455698315e-05
18720;陳家楽还有这玩意;1;0;1;23972;4.171533455698315e-05
18727;不会起名;1;0;1;23972;4.171533455698315e-05
18734;幽虞;1;0;1;23972;4.171533455698315e-05
18743;孤烟直王略略;3;0;3;23972;0.00012514600367094945
18756;没用因为他写不了业务但是对前端是真的友好前端不需要业务;1;0;1;23972;4.171533455698315e-05
18767;为啥我的copilot没那么智能;1;0;1;23972;4.171533455698315e-05
18771;北辰Kebin;1;0;1;23972;4.171533455698315e-05
18780;不知道叫什么破名好牛啊这个;1;0;1;23972;4.171533455698315e-05
18783;没啥大用处，复杂逻辑不敢让ai写，简单的ai写完自己也要检查一遍，也没节省多少时间;1;0;1;23972;4.171533455698315e-05
18786;这就是AI自我学习和自我扩展吧未来真能有自主意识了;1;0;1;23972;4.171533455698315e-05
18789;蛋挞边边;1;0;1;23972;4.171533455698315e-05
18795;Coisn;1;0;1;23972;4.171533455698315e-05
18805;增删改查本来就很简单;1;0;1;23972;4.171533455698315e-05
18808;海娜百川i;2;0;2;23972;8.34306691139663e-05
18812;idea提示出来怎么保存啊;1;0;1;23972;4.171533455698315e-05
18818;小林同学L直接失业;1;0;1;23972;4.171533455698315e-05
18830;我看着里面实际实现方法都是空的啊;1;0;1;23972;4.171533455698315e-05
18834;杨博宇;1;0;1;23972;4.171533455698315e-05
18843;中意8不露声色九月前端美少女suger墨渊萍萍魏阿喵yangzhifang白日梦;3;0;3;23972;0.00012514600367094945
18869;迷人的瑞子这个好;1;0;1;23972;4.171533455698315e-05
18873;面向对象;1;0;1;23972;4.171533455698315e-05
18880;初心拥抱这玩意太狠了;1;0;1;23972;4.171533455698315e-05
18886;UF1337;1;0;1;23972;4.171533455698315e-05
18896;强醒;1;0;1;23972;4.171533455698315e-05
18907;恋风;1;0;1;23972;4.171533455698315e-05
18912;阿江呀;1;0;1;23972;4.171533455698315e-05
18926;sweetbaby;1;0;1;23972;4.171533455698315e-05
18933;小魏想拉杆我叫负3;1;0;1;23972;4.171533455698315e-05
18946;蜗牛这流弊啊;1;0;1;23972;4.171533455698315e-05
18956;以后只要写思路就行了，写作文写得好牛逼程序员;1;0;1;23972;4.171533455698315e-05
18960;当时上课怎么就没这东西呢头头头头头头子诶阿舍;1;0;1;23972;4.171533455698315e-05
18963;我已不猜落在何地阿伟这个牛逼;1;0;1;23972;4.171533455698315e-05
18969;视频不能下载;1;0;1;23972;4.171533455698315e-05
18984;万物和你这个可用吗;2;0;2;23972;8.34306691139663e-05
18994;golang能用吗;1;0;1;23972;4.171533455698315e-05
19004;Prode京墨;1;0;1;23972;4.171533455698315e-05
19014;ZL;1;0;1;23972;4.171533455698315e-05
19049;这也没什么，我的VBA也自动帮我写，我还要检查;3;0;3;23972;0.00012514600367094945
19073;章鱼哥你可以试试;1;0;1;23972;4.171533455698315e-05
19076;梦想很大的懒货痣妹郭韵味腰子还不毕业要失业了;1;0;1;23972;4.171533455698315e-05
19080;4luvc适合你;1;0;1;23972;4.171533455698315e-05
19084;酒酿桂花小圆子来谢我;1;0;1;23972;4.171533455698315e-05
19096;力扣终结者;1;0;1;23972;4.171533455698315e-05
19111;你会唱小星星吗有点牛批;1;0;1;23972;4.171533455698315e-05
19113;职业代恋;1;0;1;23972;4.171533455698315e-05
19119;喜欢拉屎这个视频艾特我一下，明天开始卷;1;0;1;23972;4.171533455698315e-05
19122;这个东西就是为了把程序员搞废了，然后哪天打仗了给你停了，让你难受啊;2;0;2;23972;8.34306691139663e-05
19126;男子汉观沧i;1;0;1;23972;4.171533455698315e-05
19130;cpdm147要谦虚好吧，番茄小薯片BTKM今天早睡了没卧槽;1;0;1;23972;4.171533455698315e-05
19136;China103皮皮推荐给你们;4;0;4;23972;0.0001668613382279326
19154;普度有缘人康康大魔王tab工程师从中间开始看;1;0;1;23972;4.171533455698315e-05
19163;叮当galigetgetcunen抖抖抖不停的胖达熊喵Longer来了来了;1;0;1;23972;4.171533455698315e-05
19191;Covets;1;0;1;23972;4.171533455698315e-05
19194;谢呀晚安你们好;1;0;1;23972;4.171533455698315e-05
19199;青衫忆笙;3;0;3;23972;0.00012514600367094945
19208;动态规划总不可能自动;1;0;1;23972;4.171533455698315e-05
19214;施皮尔伯霄失业了;2;0;2;23972;8.34306691139663e-05
19224;lsq是q不是p;1;0;1;23972;4.171533455698315e-05
19231;傻大鹅181秒;1;0;1;23972;4.171533455698315e-05
19233;yuankk;1;0;1;23972;4.171533455698315e-05
19238;Serein23不愉快;2;0;2;23972;8.34306691139663e-05
19248;Laru小哥哥;2;0;2;23972;8.34306691139663e-05
19254;jyffff我已经预感到要失业了;1;0;1;23972;4.171533455698315e-05
19258;匹夫;1;0;1;23972;4.171533455698315e-05
19261;还有什么编程软件可以用这个插件;1;0;1;23972;4.171533455698315e-05
19263;小汤没烦恼天青色李小恩wwww;2;0;2;23972;8.34306691139663e-05
19273;ShadyEForgotten;1;0;1;23972;4.171533455698315e-05
19285;好酷啊，python也行吗;1;0;1;23972;4.171533455698315e-05
19292;loading结束写在then里笑了;4;0;4;23972;0.0001668613382279326
19298;榴莲皮皮猪;3;0;3;23972;0.00012514600367094945
19304;耀灵卧槽真的假的？;1;0;1;23972;4.171533455698315e-05
19312;我真的好饿梦萦绕了谁的灵魂;1;0;1;23972;4.171533455698315e-05
19318;小刘不是程序员小刘讲讲这个，不想失业;1;0;1;23972;4.171533455698315e-05
19321;程序员小山与Bug山哥讲讲这个，不会要失业了吧;1;0;1;23972;4.171533455698315e-05
19330;不谢好东西;1;0;1;23972;4.171533455698315e-05
19338;Spring风息;1;0;1;23972;4.171533455698315e-05
19346;在晨光里这是什么水平;1;0;1;23972;4.171533455698315e-05
19349;遇到的终系你呀;3;0;3;23972;0.00012514600367094945
19354;银行估计用不了;1;0;1;23972;4.171533455698315e-05
19356;万叶超市;2;0;2;23972;8.34306691139663e-05
19360;香菜芫荽汤不会吧不会吧;1;0;1;23972;4.171533455698315e-05
19364;下载地址在哪？;1;0;1;23972;4.171533455698315e-05
19370;notion微软学企鹅了;3;56;59;23972;0.0024612047388620057
19374;wps以后没有竞争力了;6;19;25;23972;0.0010428833639245787
19381;别说跟notion一样，差的还很多;5;1;6;23972;0.0002502920073418989
19387;没想到他们井喷式爆发革新产品包括3d打印发射;4;39;43;23972;0.0017937593859502752
19392;跟notion太像了吧;1;7;8;23972;0.0003337226764558652
19394;我的obsdian不香了;3;6;9;23972;0.0003754380110128483
19399;微软的软件确实做的好;1;6;7;23972;0.00029200734189888203
19401;怎么禁用disabled属性啊;2;1;3;23972;0.00012514600367094945
19406;pwa是啥嘛是单页面吗讲一下汉语嘛;1;2;3;23972;0.00012514600367094945
19413;国内能用吗？;1;0;1;23972;4.171533455698315e-05
19426;why;1;0;1;23972;4.171533455698315e-05
19432;麻烦说人话，不要堆那么多名词;2;2;4;23972;0.0001668613382279326
19435;还是wolai好用更符合国人;2;0;2;23972;8.34306691139663e-05
19444;说好的元宇宙呢、现在又来个gpt;3;0;3;23972;0.00012514600367094945
19461;叶老师视频非常不错有一点建议：某度、某软;1;0;1;23972;4.171533455698315e-05
19463;第二天股价不是涨了吗;1;0;1;23972;4.171533455698315e-05
19466;只想知道，什么时候上线，;1;0;1;23972;4.171533455698315e-05
19470;没有中文版？;2;1;3;23972;0.00012514600367094945
19475;在哪下载？;1;0;1;23972;4.171533455698315e-05
19477;不是新技术叫copilot，而是office更名为copilot。;6;24;30;23972;0.0012514600367094944
19484;完了office收费合理了，微软要发大财了;16;96;112;23972;0.0046721174703821125
19502;大陆人能用吗？多少钱;6;44;50;23972;0.0020857667278491574
19509;金山完了;3;24;27;23972;0.001126314033038545
19513;那风格能改么？比如转圈彩虹马屁;1;0;1;23972;4.171533455698315e-05
19515;你的Word如果让它处理，有没有可能内容就被泄漏了呢？;6;4;10;23972;0.00041715334556983145
19524;能帮我接入VsCode不能替我写代码;3;3;6;23972;0.0002502920073418989
19528;盗版的有么;3;0;3;23972;0.00012514600367094945
19537;要收费的10美元好像;2;0;2;23972;8.34306691139663e-05
19540;是不是不用我了;2;0;2;23972;8.34306691139663e-05
19549;池竹SHAN契诃夫;1;1;2;23972;8.34306691139663e-05
19552;葡萄哇;1;0;1;23972;4.171533455698315e-05
19558;焚颜若水这个看上去好牛逼;1;0;1;23972;4.171533455698315e-05
19561;枝雨意看吧;1;0;1;23972;4.171533455698315e-05
19565;漆黑烬灭的统御者你看吧说了office强于WPS的吧;1;0;1;23972;4.171533455698315e-05
19570;椰子包无敌;1;0;1;23972;4.171533455698315e-05
19581;小小雪梨真棒;1;0;1;23972;4.171533455698315e-05
19584;免费吗;1;0;1;23972;4.171533455698315e-05
19587;backtoflorence;1;0;1;23972;4.171533455698315e-05
19589;hsjcnziao;1;0;1;23972;4.171533455698315e-05
19603;MomokoZ;2;0;2;23972;8.34306691139663e-05
19607;懒猪大王凉儿女士冰激凌狂热fansym199909;2;0;2;23972;8.34306691139663e-05
19610;Vvvi;1;0;1;23972;4.171533455698315e-05
19615;Melissa林黛玉倒拔垂杨柳;1;0;1;23972;4.171533455698315e-05
19619;tongtong;3;0;3;23972;0.00012514600367094945
19623;Mr大宝;1;0;1;23972;4.171533455698315e-05
19625;幸也里约昂無;1;0;1;23972;4.171533455698315e-05
19627;是泽艺呀;1;0;1;23972;4.171533455698315e-05
19630;小哥的忠实脑残粉;1;0;1;23972;4.171533455698315e-05
19632;叫醒耳朵;1;0;1;23972;4.171533455698315e-05
19643;abaaba;1;0;1;23972;4.171533455698315e-05
19646;额，大家用的都是正版专业版office吗;5;5;10;23972;0.00041715334556983145
19652;反正全中文网都在吹多厉害，但是没有一个人说怎么用，没有一个全流程;5;2;7;23972;0.00029200734189888203
19675;visio和office都是激活的吗;5;8;13;23972;0.0005422993492407809
19681;成功啦，感谢;5;2;7;23972;0.00029200734189888203
19687;一切正常成功，但是显示版本不是365，是2016版啊？;3;1;4;23972;0.0001668613382279326
19691;你好，咨询，我们这边激活时错误提示是：软件授权服务报告许可证未安装;1;1;2;23972;8.34306691139663e-05
19718;安装的是365，打开的也是365为什么激活状态是2016呢;1;0;1;23972;4.171533455698315e-05
19749;我的桌面怎么没有快捷方式;1;0;1;23972;4.171533455698315e-05
19751;错误代码：0xC004F074，请教大神这个这个怎么处理;1;0;1;23972;4.171533455698315e-05
19753;好家伙成功了;1;0;1;23972;4.171533455698315e-05
19755;之前看别人讲的中间按enter键的那步它没说然后我就不知到底还怎么弄搞了好久也没弄好;1;0;1;23972;4.171533455698315e-05
19768;激活成功后不知道在哪儿打开啊;1;0;1;23972;4.171533455698315e-05
19774;可以不装visio吗？;1;0;1;23972;4.171533455698315e-05
19777;小白，这个是永久的吗？;1;0;1;23972;4.171533455698315e-05
19779;默认是c盘怎么装到其他盘c盘空间不够;1;0;1;23972;4.171533455698315e-05
19784;只能选office365吗，可以选择office2021不;1;1;2;23972;8.34306691139663e-05
19787;很感谢;1;0;1;23972;4.171533455698315e-05
19790;这个是永久激活吗;1;0;1;23972;4.171533455698315e-05
19795;牛批成功;1;0;1;23972;4.171533455698315e-05
19800;主播好人;1;0;1;23972;4.171533455698315e-05
19803;myfriend;1;0;1;23972;4.171533455698315e-05
19805;主播好棒;1;0;1;23972;4.171533455698315e-05
19807;主播太棒了;1;0;1;23972;4.171533455698315e-05
19809;超棒;1;0;1;23972;4.171533455698315e-05
19818;我的产品密钥没有;2;0;2;23972;8.34306691139663e-05
19821;默认路径是c盘怎么改啊;2;0;2;23972;8.34306691139663e-05
19832;非常感谢之前装了卸卸了装折腾了好多次终于，看了你的教程之后把所有该装的都装好了讲的太详细了;1;0;1;23972;4.171533455698315e-05
19834;感谢;1;0;1;23972;4.171533455698315e-05
19836;日语版的office365也可以吗;1;0;1;23972;4.171533455698315e-05
19838;成功了，感谢大神;1;0;1;23972;4.171533455698315e-05
19852;国内哪里能买;6;0;6;23972;0.0002502920073418989
19860;你正常点观众会更多;1;0;1;23972;4.171533455698315e-05
19863;你好帅啊左老师;1;0;1;23972;4.171533455698315e-05
19868;你又上热门了？;1;0;1;23972;4.171533455698315e-05
19878;早就出来了其实，要收费的;1;1;2;23972;8.34306691139663e-05
19885;你说话好机车哎;1;0;1;23972;4.171533455698315e-05
19887;我来听课了;1;1;2;23972;8.34306691139663e-05
19892;我的猜测是国内立马禁用office，所有国企央企马上换用WPS办公;78;132;210;23972;0.008760220256966461
19971;文心一言;11;30;41;23972;0.001710328716836309
19983;奇技淫巧。坚决赞成禁用搭载GPT的office，时间长了，会养成工具依赖，一旦被“卡脖子”，最基本的技能都不会了，如何是好？;7;4;11;23972;0.0004588686801268146
19991;支持微软，不要惯着任何人，宁愿退出也别屈服;16;59;75;23972;0.003128650091773736
20008;没事，我们可以搞人工后台服务，我们就不缺人，比如文心一言那个聊天记录，不行人顶上。;3;29;32;23972;0.0013348907058234607
20012;封杀微软封杀GPT;5;0;5;23972;0.00020857667278491573
20018;从阿尔法狗到gpt4可以看出国外的人工智能发展到什么程度，如果用到军事上才是无解;14;8;22;23972;0.0009177373602536292
20033;没事，我们也不用正版;5;18;23;23972;0.0009594526948106124
20039;百度火急火燎的发布了个人工智障;1;20;21;23972;0.000876022025696646
20041;杀人诛心;2;15;17;23972;0.0007091606874687135
20044;怎么样才能用微软全家桶;4;2;6;23972;0.0002502920073418989
20049;国外不开源，国内不研发;1;9;10;23972;0.00041715334556983145
20051;这微软AI聊天软件能改变什么？;6;0;6;23972;0.0002502920073418989
20058;会不会数据泄露？;5;0;5;23972;0.00020857667278491573
20064;没事，我会出手的;1;6;7;23972;0.00029200734189888203
20066;我下次直接弄一个能直接做硬件的AI，全球一起失业;2;0;2;23972;8.34306691139663e-05
20071;如果这样是不是员工就可以节省一半了;1;0;1;23972;4.171533455698315e-05
20083;估计直接禁止;1;0;1;23972;4.171533455698315e-05
20088;几十年的老会计，不会用电脑，以前被人嫌弃，以后有机会了。可以语音输入。专职文员的话，准备下车间打螺丝吧;1;0;1;23972;4.171533455698315e-05
20104;各大国企的办公室的是不是可以裁掉了;1;0;1;23972;4.171533455698315e-05
20108;数据谁输入？人工智能会吗？;1;0;1;23972;4.171533455698315e-05
20112;国内禁用OFFICE就解决了;3;0;3;23972;0.00012514600367094945
20116;老板用了可能就没你什么事了哈哈哈哈;1;0;1;23972;4.171533455698315e-05
20118;你都快失业了;2;0;2;23972;8.34306691139663e-05
20121;那么问题来了工资3000受影响么？;4;0;4;23972;0.0001668613382279326
20126;他们怕了，我们强大了;1;0;1;23972;4.171533455698315e-05
20128;百度做广告一流;1;0;1;23972;4.171533455698315e-05
20134;没事遥遥领先;2;0;2;23972;8.34306691139663e-05
20139;然后人变懒了依赖性变强了;2;0;2;23972;8.34306691139663e-05
20142;听说文心一言正在大规模招聘人工客服;2;0;2;23972;8.34306691139663e-05
20146;你身材挺好的哦;1;0;1;23972;4.171533455698315e-05
20151;能不能用到车的导航上;2;1;3;23972;0.00012514600367094945
20155;笑死，百度是对手;1;33;34;23972;0.001418321374937427
20157;卷死那些PPT舔狗。。。;4;3;7;23972;0.00029200734189888203
20163;这就是当初彻底拒绝谷歌、微软等企业的结果。谷歌他们在，不说完全信任这些外企，起码让谷歌微软他们在国内保留部分业务，好歹能当个鲶鱼，把死气沉沉的市场搅和开来，能激发竞争。现在倒好，百度一家独大，成垄断寡头。不思进取，滥用市场支配地位，首页放广告、推医疗、app放贷，全是吸血的产业。钻钱眼里也就罢了，还妄图大言不惭的和行业老前辈同台竞技，殊不知多年来的不思进取已经快毁了自己了，只能苟延残喘的行亡羊补牢之举。;2;3;5;23972;0.00020857667278491573
20166;文心一言发布会的PPT是CHPT40帮忙做的;1;1;2;23972;8.34306691139663e-05
20168;他要是某一天坏了呢;1;1;2;23972;8.34306691139663e-05
20171;窃取中国企业数据分分钟的事，他们还得说声谢谢;2;0;2;23972;8.34306691139663e-05
20176;国内科技巨头忙着和大妈抢菜呢;1;0;1;23972;4.171533455698315e-05
20178;搞得好像文心一言是Gpt做的一样;1;0;1;23972;4.171533455698315e-05
20246;呦呵，情诗也上了;1;0;1;23972;4.171533455698315e-05
20257;不用注册，免费使用体验还不错;1;0;1;23972;4.171533455698315e-05
20260;确实需要民间的活力;6;45;51;23972;0.0021274820624061406
20267;程序员瑟瑟发抖;3;29;32;23972;0.0013348907058234607
20271;你说的很多但是很多人装睡;1;0;1;23972;4.171533455698315e-05
20278;杀人诛心;2;7;9;23972;0.0003754380110128483
20281;大脸陈瑟瑟发抖;1;1;2;23972;8.34306691139663e-05
20285;小朱不打烊;1;0;1;23972;4.171533455698315e-05
20288;wps还在想着卖会员;3;15;18;23972;0.0007508760220256966
20292;按理来说，这种投资周期非常长，研发周期非常长，可能投资后没收益的项目，在集中力量办大事的地方才能得到更好的发展。然而现实是所以不难看出是集中力量给某些人过好日子;1;9;10;23972;0.00041715334556983145
20295;这不是微软投巨资砸出来的么，这不是集中力量办大事么;2;0;2;23972;8.34306691139663e-05
20300;你在这么说战狼就来了;1;0;1;23972;4.171533455698315e-05
20315;本质上和美团一模一样，我不介意吃外卖，但是自己肯定也是要会做的，不然等着被拿捏好了。;1;1;2;23972;8.34306691139663e-05
20317;电视上新闻基本上零播放，都是在短视频上看到新闻，这个太严重了，完全就是降维打击;95;1579;1674;23972;0.06983147004838978
20413;没事，我们都屏蔽了，不知者无畏;51;1487;1538;23972;0.06415818454864008
20466;请务必开源，我要准备遥遥领先了;17;123;140;23972;0.0058401468379776405
20484;时代进步好快，而且还有可能就是一瞬间;28;30;58;23972;0.0024194894043050225
20513;都是要钱的，老贵;5;0;5;23972;0.00020857667278491573
20519;怎么追怎么追？怎么遥遥领先？;18;31;49;23972;0.0020440513932921743
20538;技术爆炸;8;267;275;23972;0.011471717003170366
20547;这个很好玩他甚至可以帮你推演物理模型;7;82;89;23972;0.0037126647755715
20555;讲个笑话，我们要取消孩子英语中考，把头埋进沙子看不见;3;48;51;23972;0.0021274820624061406
20559;又一次科技爆炸有生之年啊;4;111;115;23972;0.004797263474053062
20564;免不免费吧，商用不免费那个人学习呢，可不可以不联网呢;45;6;51;23972;0.0021274820624061406
20610;原来十个人的工作现在一个人就能干了，游戏公司大裁员;8;43;51;23972;0.0021274820624061406
20620;对程序员来说，有copilot的工作效率至少翻十倍。对普通微软其他工具例如wordExcel啥的翻个两三倍也是轻轻松松。;4;28;32;23972;0.0013348907058234607
20625;新工具的出现，相关职业要做的是更有效率的利用这个工具而不是与工具竞争岗位。;5;25;30;23972;0.0012514600367094944
20631;下一步就是贾维斯商用;2;52;54;23972;0.00225262806607709
20634;买了一年失业了没用上;8;0;8;23972;0.0003337226764558652
20644;Ai已经影响到我3000块一个月的工资了;1;1;2;23972;8.34306691139663e-05
20647;Ludwig摸鱼神器来了;1;0;1;23972;4.171533455698315e-05
20649;java入门应该怎么学？最近看着IT挺火的，想从事开发等相关行业。;1;0;1;23972;4.171533455698315e-05
20665;盘古开发的ai比gpt还早。;3;0;3;23972;0.00012514600367094945
20670;机器人会梦见电子羊吗毕业即失业了家人们;1;0;1;23972;4.171533455698315e-05
20675;牛掰这个收费吗;1;0;1;23972;4.171533455698315e-05
20682;以后学写代码再也不用面向百度了，可以面向ai，像我这种敲键盘速度慢的，可以大大的减轻负担，只用负责，想怎么写就可以了，用一天的时间把构思想好，然后面向AI编程，然后测试上线，瞬间成为高级码农。;1;1;2;23972;8.34306691139663e-05
20686;想要一台时光机;1;1;2;23972;8.34306691139663e-05
20695;这绝对是未来十年甚至五十年最大的技术变革;1;7;8;23972;0.0003337226764558652
20703;程序员会失业吗。？;5;0;5;23972;0.00020857667278491573
20710;Hid西方好像真正的迎来了智能时代了。真正的科技变革。;1;2;3;23972;0.00012514600367094945
20715;能预测双色球不;1;0;1;23972;4.171533455698315e-05
20725;一切都要从算力说起算力又被卡了脖子这次很难赢麻了;2;5;7;23972;0.00029200734189888203
20730;豆豆豆豆老婆研究研究吧，不然跟不上时代了。。;1;1;2;23972;8.34306691139663e-05
20736;我都不想学了;2;2;4;23972;0.0001668613382279326
20740;想知道国内行业动态;1;1;2;23972;8.34306691139663e-05
20742;不会有泄密风险吗？;1;0;1;23972;4.171533455698315e-05
20746;文职类工作呢ai能帮忙写各种总结汇报的草稿吗写出来我再自己改改;1;0;1;23972;4.171533455698315e-05
20748;遇到的终系你呀我吃到了红利;3;0;3;23972;0.00012514600367094945
20752;早啊爱吃橙子要失业了;1;0;1;23972;4.171533455698315e-05
20755;是衰也是帅早日转行;1;0;1;23972;4.171533455698315e-05
20757;Moon咱们是不是要失业了;1;0;1;23972;4.171533455698315e-05
20759;双刃剑吧，往大了说这毕竟是国外技术，往小了说，有利于提高生产效率，再现实点说，可以取代一部分人的工作（主要指专业性基础）;1;0;1;23972;4.171533455698315e-05
20765;是不是就不要开发了;1;0;1;23972;4.171533455698315e-05
20768;怎么时候能用;1;0;1;23972;4.171533455698315e-05
20770;致命的是独立思考的根源断了;1;6;7;23972;0.00029200734189888203
20774;俞小贰坏了;1;0;1;23972;4.171533455698315e-05
20778;遥遥领先啊咱们，只要我闭上眼蒙上耳朵，那就是没有;1;0;1;23972;4.171533455698315e-05
20781;恩恩要开心呀i失业了;1;0;1;23972;4.171533455698315e-05
20783;DAOTI刘一飞峰顶秃头卧槽我们要被替代了;1;0;1;23972;4.171533455698315e-05
20785;人家知识大爆炸我们得加油呀;1;0;1;23972;4.171533455698315e-05
20793;ai不是遥遥领先吗;1;0;1;23972;4.171533455698315e-05
20797;完了，今年刚选计算机专业;5;2;7;23972;0.00029200734189888203
20804;我面试能用他吗;1;1;2;23972;8.34306691139663e-05
20810;Blake我怕真要科技爆炸了;1;0;1;23972;4.171533455698315e-05
20816;编程接触过python，由于工作性质用不到，基本忘光了，人工ai出来后，前不久我居然做出了一个小项目;1;0;1;23972;4.171533455698315e-05
20819;怎么申请newbing，想试试;5;1;6;23972;0.0002502920073418989
20826;Bat温温cui子，真的要失业了;1;1;2;23972;8.34306691139663e-05
20831;程序员要失业了;1;4;5;23972;0.00020857667278491573
20834;我们有扫码支付;1;0;1;23972;4.171533455698315e-05
20837;这个能听懂甲方的要求吗？;1;0;1;23972;4.171533455698315e-05
20841;这个收费么;6;0;6;23972;0.0002502920073418989
20851;有啥v能用gpt啊我的俩都说ip不行;7;8;15;23972;0.0006257300183547472
20859;嗯，要失业了;1;1;2;23972;8.34306691139663e-05
20861;我非常焦虑这个事情;1;2;3;23972;0.00012514600367094945
20866;宣传高于实效;3;7;10;23972;0.00041715334556983145
20870;又赞我，你是不是喜欢我？;4;0;4;23972;0.0001668613382279326
20877;测试会不会失业？;7;1;8;23972;0.0003337226764558652
20887;以后想玩游戏了，让AI私人订制一款游戏;3;10;13;23972;0.0005422993492407809
20893;啥时候上线？？？;1;0;1;23972;4.171533455698315e-05
20895;真的是，每天都有突破，每天都是新技术;3;16;19;23972;0.0007925913565826798
20899;office我杂没找到GPT4功能;5;3;8;23972;0.0003337226764558652
20905;百度还在解释自主实现的地方;1;4;5;23972;0.00020857667278491573
20907;一年多了都;1;0;1;23972;4.171533455698315e-05
20909;没啥，我们短视频就喜欢刷美女，刷土味视频，阿Q一下，我们看不到这东西就不存在。;3;10;13;23972;0.0005422993492407809
20913;这太强了，我上学时候有这就好了，自学能力质的飞跃;1;3;4;23972;0.0001668613382279326
20916;唉国外正在日新月异;4;4;8;23972;0.0003337226764558652
20928;我们输入砍一刀会生产出什么代码;6;12;18;23972;0.0007508760220256966
20935;简单的或许可以，复杂点的就不行了;1;0;1;23972;4.171533455698315e-05
20938;那之前的copilot和更新了的copilotx有什么区别;3;2;5;23972;0.00020857667278491573
20944;微软真是有远见。现在的Github可以说比任何时候都有价值。为AI的自我进化提供了最庞大的优质代码源。牛啊;1;85;86;23972;0.0035875187719005505
20948;码农要下岗了;1;1;2;23972;8.34306691139663e-05
20950;离线应该是做不到，那就意味着你debug一次就会进一次数据库;1;0;1;23972;4.171533455698315e-05
20953;国内用不了不用慌我们遥遥领先;4;6;10;23972;0.00041715334556983145
20958;很快人口多将成为一种负担咯;1;10;11;23972;0.0004588686801268146
20960;0;3;6;9;23972;0.0003754380110128483
20967;unity说要接入的，几时能够完成？想制作游戏，不会编程，只能指望ai了;4;3;7;23972;0.00029200734189888203
20973;我去，测试早失业了;1;0;1;23972;4.171533455698315e-05
20981;完了;1;0;1;23972;4.171533455698315e-05
20985;数据安全呢;8;3;11;23972;0.0004588686801268146
20994;落后就要挨打;1;0;1;23972;4.171533455698315e-05
20996;看不懂好着急总感觉应该做点什么但是又对这些完全不懂;6;2;8;23972;0.0003337226764558652
21003;我是废物;1;0;1;23972;4.171533455698315e-05
21005;CopilotX应该是程序员的福音，而不应该担心被替代而焦虑，毕竟程序员苦代码久矣，CopilotX可以帮助程序员从繁杂的重复性基础代码中摆脱出来，一定是利大于弊的。;17;42;59;23972;0.0024612047388620057
21026;我不会编程能用编程吗？;1;0;1;23972;4.171533455698315e-05
21031;ppyzm汀溪兰香清舞起Happiness拆迁专业户琦琦很开心;1;0;1;23972;4.171533455698315e-05
21033;叽叽歪歪;1;0;1;23972;4.171533455698315e-05
21035;不会说谎;1;0;1;23972;4.171533455698315e-05
21038;悉尼第一难过;1;0;1;23972;4.171533455698315e-05
21045;海淀吴彦祖;1;0;1;23972;4.171533455698315e-05
21049;一碗饭;1;0;1;23972;4.171533455698315e-05
21057;油饼食不食;1;0;1;23972;4.171533455698315e-05
21061;小原野玫;1;0;1;23972;4.171533455698315e-05
21064;小飞棍来No哦;1;0;1;23972;4.171533455698315e-05
21070;丸玩玩老蔡的田园记录加拿大生活Manmichan;1;0;1;23972;4.171533455698315e-05
21074;HAL诺嘉;1;0;1;23972;4.171533455698315e-05
21079;小嘴儿抹了蜜;3;0;3;23972;0.00012514600367094945
21085;你啊你;1;0;1;23972;4.171533455698315e-05
21095;Kkkkkkkkk;3;0;3;23972;0.00012514600367094945
21106;这评论区真的一半都是人机啊;4;1;5;23972;0.00020857667278491573
21111;Laity碳酸饮廖大鱼吃小鱼煎蛋橘子味的小鸭子Tao俞白柳今天好困真的好牛逼，革命;1;2;3;23972;0.00012514600367094945
21113;天，无法想象chatGPT会把这个世界改变成什么样？，可能会加速进化。这以后我们怎么追呀？;1;2;3;23972;0.00012514600367094945
21115;文言一心：crane不是鹤吗怎么还起重机呢;2;0;2;23972;8.34306691139663e-05
21118;按这个进度，AI很快就能对人类社会具有巨大威胁。不提核武器，只要它摧毁银行数据，就会瞬间把人类社会降智两百年，人口损失30。。;2;0;2;23972;8.34306691139663e-05
21121;过去偷偷摸摸地抄，不如现在直接外包给gpt;1;1;2;23972;8.34306691139663e-05
21123;时刻更新告诉我是废物;1;1;2;23972;8.34306691139663e-05
21125;等着机器人奥创吧;1;1;2;23972;8.34306691139663e-05
21127;这基本已经是一次工业革命了，希望中国跟上;1;1;2;23972;8.34306691139663e-05
21129;我一个啥都不会的家长，老师喊我写家长会感受，用了下，老师说不错，真香，;1;1;2;23972;8.34306691139663e-05
21140;关起门来吧;1;0;1;23972;4.171533455698315e-05
21142;已经拿到内测;1;0;1;23972;4.171533455698315e-05
21144;哪里可以下载;1;0;1;23972;4.171533455698315e-05
21146;他会帮我安装数据库吗;1;0;1;23972;4.171533455698315e-05
21148;别人都转码，我是真码转行学文去了，认了，真不是学这个的料，学又学不会，现在又整出这个chatgpt，认了认了，就是那一个月三四千的料，不再幻想月薪两万的工作了;1;0;1;23972;4.171533455698315e-05
21150;这个东西光看视频你是感受不到它有多猛的，只有用了才知道。不过好处是你用不上;1;0;1;23972;4.171533455698315e-05
21152;看看国内大厂还在干嘛，使劲出皮肤，圈钱;1;0;1;23972;4.171533455698315e-05
21154;替别人打工的命，还想超越人家;1;0;1;23972;4.171533455698315e-05
21156;你拿copilot帮你搞定优化代码，copilot在你的代码下装了一个后门你都不知道;1;0;1;23972;4.171533455698315e-05
21158;他都能分析对错了，直接让他写不更省事;1;0;1;23972;4.171533455698315e-05
21160;收费的;1;0;1;23972;4.171533455698315e-05
21162;感觉这波技术革命又没我们国家的事;1;0;1;23972;4.171533455698315e-05
21164;新技术革命还是由西方引领;1;0;1;23972;4.171533455698315e-05
21166;辉唉;1;0;1;23972;4.171533455698315e-05
21258;这个激活了只能是免费一个月还是永久？;7;46;53;23972;0.002210912731520107
21266;我的是microsoft365，激活需要钱，或者试用三十天，这个怎么办;18;5;23;23972;0.0009594526948106124
21285;我的华硕激活不了;10;15;25;23972;0.0010428833639245787
21296;为什么回复出厂设置之后激活就没有了;7;7;14;23972;0.0005840146837977641
21304;随便一个账号都可以吗我也是昨天买的电脑，登录我自己的邮箱，要收费;5;9;14;23972;0.0005840146837977641
21311;我怎么要钱;3;2;5;23972;0.00020857667278491573
21316;号码和邮箱怎么不打马赛克啊;1;2;3;23972;0.00012514600367094945
21319;怎么最后激活变成了家庭版的2019的了;2;0;2;23972;8.34306691139663e-05
21328;open你的花钱了咩？;5;0;5;23972;0.00020857667278491573
21347;0;1;0;1;23972;4.171533455698315e-05
21349;我就一直显示不出来最后还上淘宝上花钱激活的;1;0;1;23972;4.171533455698315e-05
21357;我;1;1;2;23972;8.34306691139663e-05
21365;按流程来的，电脑预装office，登陆账号弹出来的不是激活，而是开始免费试用，还有购买microsoft365;5;1;6;23972;0.0002502920073418989
21371;关键是国内现在能用了吗？;7;1;8;23972;0.0003337226764558652
21379;怎么能用;2;1;3;23972;0.00012514600367094945
21382;能不能写标书;1;0;1;23972;4.171533455698315e-05
21385;左上角？;1;0;1;23972;4.171533455698315e-05
21391;我估计博主用的是已订阅的账号默认登陆了，我win11刚刚测试直接部署完是未激活状态。建议用officemondo2016的证书激活，激活完显示这个。这个版本相当于office365的离线版;1;0;1;23972;4.171533455698315e-05
21393;这tm真的是大杀器;1;1;2;23972;8.34306691139663e-05
21402;需要魔法的就拉倒吧违法的;2;2;4;23972;0.0001668613382279326
21416;以后不需要人类了吧;2;0;2;23972;8.34306691139663e-05
21419;0;1;17;18;23972;0.0007508760220256966
21421;这就是迭代的恐怖，我们又被甩开二十年;1;24;25;23972;0.0010428833639245787
21423;未来5年有多少人要失业啊;6;0;6;23972;0.0002502920073418989
21430;我就想问问，AI写出来的代码有Bug吗？要是真的完美运行，那一定得试试;5;0;5;23972;0.00020857667278491573
21436;但是有可能会退出中国;1;5;6;23972;0.0002502920073418989
21444;国外都工业革命了，我后清还八股文玩得起劲呢;4;2;6;23972;0.0002502920073418989
21449;支持一下国产行吗？这样帮人家训练还不是自己会落后，训练自家好吗？;10;0;10;23972;0.00041715334556983145
21461;GPT加持的office不还没发布呢吗;1;0;1;23972;4.171533455698315e-05
21472;这个tokens在哪呀裂开;1;0;1;23972;4.171533455698315e-05
21477;passwd;2;0;2;23972;8.34306691139663e-05
21480;看上你锻炼的机器了，价格多少啊;1;2;3;23972;0.00012514600367094945
21483;你说的不对office2021不止三个应用;1;0;1;23972;4.171533455698315e-05
21487;那个叩派勒，注意发音。;7;0;7;23972;0.00029200734189888203
21495;发了技术参数，被网友们猜中了。;1;1;2;23972;8.34306691139663e-05
21497;你猜我用不用？;1;0;1;23972;4.171533455698315e-05
21499;阿里一直都是中国最好，最值得期待的企业，没有之一。互联网技术这块不敢说世界第一，但第一梯队还是有的，中国第一也不在话下。;3;0;3;23972;0.00012514600367094945
21503;然并卵，越来越累;1;1;2;23972;8.34306691139663e-05
21505;人类科技越来越发达，但是人们并没有轻松，，，;1;1;2;23972;8.34306691139663e-05
21507;Copilot应该可以裁员很多人了。发了功能一览和技术揭秘;1;1;2;23972;8.34306691139663e-05
21513;还是微软引领了时代;2;28;30;23972;0.0012514600367094944
21516;以后要是能帮我打车，点外卖，帮我选衣服，买食品能告诉我这个不能买有添加剂什么的就更完美了;4;7;11;23972;0.0004588686801268146
21521;以后学会运用gpt是大职业;4;5;9;23972;0.0003754380110128483
21526;国内不能用吧;4;1;5;23972;0.00020857667278491573
21531;压力给到了wps，我刚买的wps会员;2;12;14;23972;0.0005840146837977641
21534;中文版啥时候初;4;0;4;23972;0.0001668613382279326
21541;ai是好，但是长期以往人脑不去思考会不会退化很严重;3;0;3;23972;0.00012514600367094945
21546;我们能用吗？;1;1;2;23972;8.34306691139663e-05
21549;中文版怎么用;1;0;1;23972;4.171533455698315e-05
21553;国内能用吗;2;0;2;23972;8.34306691139663e-05
21564;国内不能用;1;0;1;23972;4.171533455698315e-05
21576;国内不准用，领导说自己写，不能用gpt生成;1;2;3;23972;0.00012514600367094945
21587;压力来到了wps这边;2;1;3;23972;0.00012514600367094945
21590;再过几年，vba都不用学了，人工智能会为用户处理得更好更快，有文档就能直出PPT，有数据就能直出统计表、分析表;1;1;2;23972;8.34306691139663e-05
21593;中文版的出了么;1;0;1;23972;4.171533455698315e-05
21595;降维打击么;1;0;1;23972;4.171533455698315e-05
21598;以后人类只做顶层的脑力劳动和底层的体力劳动中间大部分都会被取代;1;0;1;23972;4.171533455698315e-05
21603;中文版什么时候出吧;1;0;1;23972;4.171533455698315e-05
21607;什么时候能用啊我想早点下班;7;30;37;23972;0.0015434673786083764
21615;有没有一种可能？描述比自己操作更麻烦。;7;6;13;23972;0.0005422993492407809
21623;需要升级版本吗？会不会一定要买2023的office;2;0;2;23972;8.34306691139663e-05
21626;中国用不了的，放心;2;8;10;23972;0.00041715334556983145
21629;中国不能用吧;3;0;3;23972;0.00012514600367094945
21633;所以office不得不买正版了;2;6;8;23972;0.0003337226764558652
21643;盗版可以用吗;1;0;1;23972;4.171533455698315e-05
21646;国内不能用;1;0;1;23972;4.171533455698315e-05
21655;wps表示压力很大啊;1;0;1;23972;4.171533455698315e-05
21662;开会员啊，裁员啊;1;4;5;23972;0.00020857667278491573
21664;然而国企已经弃用office;1;3;4;23972;0.0001668613382279326
21666;微软利用ChatGPT彻底干死wps;1;2;3;23972;0.00012514600367094945
21676;这是逼着我买正版的节奏;2;2;4;23972;0.0001668613382279326
21695;失业率又要提高了;2;2;4;23972;0.0001668613382279326
21698;wps绝望了，东施效颦，效到头了;6;22;28;23972;0.0011680293675955281
21705;wps：作业本赶紧给我;7;14;21;23972;0.000876022025696646
21714;多少钱一月;2;3;5;23972;0.00020857667278491573
21717;小度小度：给我讲个笑话;1;9;10;23972;0.00041715334556983145
21720;chatgpt接入特斯拉的视觉雷达系统会怎么样。;2;4;6;23972;0.0002502920073418989
21723;国内能不能用？;2;1;3;23972;0.00012514600367094945
21726;给我的感觉就是，诺基亚市场过渡到苹果市场的感觉;2;3;5;23972;0.00020857667278491573
21729;我能问他接下来几期的彩票的中奖号吗，都这么牛逼，应该算的出来吧;2;1;3;23972;0.00012514600367094945
21732;我们的企业家是啥都想做，尤其是国家给补贴的。结果什么都没做好。;1;3;4;23972;0.0001668613382279326
21734;2023互联网科技大佬之战;1;2;3;23972;0.00012514600367094945
21739;以后就是有文化能创新的人才能不失业了，技能型人才饭碗越来越少;1;1;2;23972;8.34306691139663e-05
21741;wps：不讲武德，还能不能好好玩耍;1;6;7;23972;0.00029200734189888203
21746;没啥用，;1;0;1;23972;4.171533455698315e-05
21751;啥时候能用呀？;1;0;1;23972;4.171533455698315e-05
21756;0;1;0;1;23972;4.171533455698315e-05
21760;火锅六一并排跑;1;0;1;23972;4.171533455698315e-05
21762;时代真的要变了，大家准备了吗;3;2;5;23972;0.00020857667278491573
21767;有试用版吗？我要尝鲜;1;1;2;23972;8.34306691139663e-05
21777;就说得什么价格吧;1;0;1;23972;4.171533455698315e-05
21784;中国宣布禁止使用office，全面推广WPS;20;177;197;23972;0.00821792090772568
21805;国内国外两个世界;1;18;19;23972;0.0007925913565826798
21809;为什么他不用自家的newbing;2;0;2;23972;8.34306691139663e-05
21816;Camellia幼儿园老大海上月;1;1;2;23972;8.34306691139663e-05
21823;完了，估计office也要被禁了，太自信了;1;15;16;23972;0.0006674453529117303
21826;国内的可以用吗;3;1;4;23972;0.0001668613382279326
21830;359632748梦境全地球只有两个地方用不了;1;1;2;23972;8.34306691139663e-05
21849;国内也就几个大公司用的正版吧而且肯定属于付费的;13;11;24;23972;0.0010011680293675956
21867;（调皮）医院装个GPT4。去各科室体检，然后，就能领药了，西医生都应该解聘了，（外伤与手术室保留就好）;11;5;16;23972;0.0006674453529117303
21884;最正宗的大华股份;1;0;1;23972;4.171533455698315e-05
21918;减轻工作压力鸭;1;0;1;23972;4.171533455698315e-05
21925;以后一个公司就一个老板一个这个软件就好了。;1;1;2;23972;8.34306691139663e-05
21940;语数英变成副课，office，编程，自然生物，体育改成主修吧;13;116;129;23972;0.005381278157850826
21954;数学是一个首先要淘汰学科。把科学家从数学和统计学中解放出来，专注自己的专业。;17;3;20;23972;0.0008343066911396629
21972;啊啊啊啊为了这个功能买了个正版，结果国内不给用;5;17;22;23972;0.0009177373602536292
21978;关键是我们想用也用不了;6;25;31;23972;0.0012931753712664776
21985;我微软的电脑能用吗一键鄙视那些会做ppt，表格的的文员们，哈哈哈哈哈哈;6;21;27;23972;0.001126314033038545
21992;挺好，离毁灭又近了一步;3;7;10;23972;0.00041715334556983145
21996;国内好像用不了;2;4;6;23972;0.0002502920073418989
21999;完蛋我不认识英文;4;0;4;23972;0.0001668613382279326
22004;我理解的是gpt它只能成为一个结果，而无法取代过程;1;3;4;23972;0.0001668613382279326
22007;我不是会员能用吗;1;2;3;23972;0.00012514600367094945
22009;请问怎么时候可以用上;1;2;3;23972;0.00012514600367094945
22013;怎么用;1;2;3;23972;0.00012514600367094945
22022;虾仁炒饭哇哦;1;0;1;23972;4.171533455698315e-05
22027;余登登护理计划;1;0;1;23972;4.171533455698315e-05
22033;星野给我买辆法拉利白学了;2;1;3;23972;0.00012514600367094945
22049;苹果没有反应;1;1;2;23972;8.34306691139663e-05
22053;国内啥情况;1;1;2;23972;8.34306691139663e-05
22056;大学课程改改先;1;0;1;23972;4.171533455698315e-05
22058;名字读错了，没有一个音是对的，下次先听听ai怎么读的;1;0;1;23972;4.171533455698315e-05
22060;W;2;0;2;23972;8.34306691139663e-05
22063;你好，我是翁老湿;1;0;1;23972;4.171533455698315e-05
22096;王先生;4;0;4;23972;0.0001668613382279326
22119;我的工作不可能被替代，ai再厉害也不能给领导敬酒;972;23000;23972;23972;1.0
23092;杀人诛心;364;3097;3461;23972;0.14437677290171866
23457;我们还在这疯狂查头盔;4;4;8;23972;0.0003337226764558652
23462;所以九年义务教育英语真的很有必要，文心一言还没有超越;505;3922;4427;23972;0.1846737860837644
23968;ai再能也下不了水;1;2;3;23972;0.00012514600367094945
23970;国内：换皮，开会员，复制文本需要超级会员;159;10000;10159;23972;0.4237860837643918
24130;好像能感受清朝人第一次看见飞机大炮的那种感觉了;226;5148;5374;23972;0.22417820790922743
24357;公摊面积再定义可以一战;66;5053;5119;23972;0.21354079759719674
24424;AI干不了财务和数据统计，因为它做不了假数据;128;1197;1325;23972;0.05527281828800267
24553;这才是科技创新;14;2320;2334;23972;0.09736359085599866
24568;么事，我们在墙里，安全的很;37;1146;1183;23972;0.04934924078091106
24606;文科生彻底失业了;240;96;336;23972;0.014016352411146337
24847;简单，我们把文心一言整合进wps，又遥遥领先;56;1869;1925;23972;0.08030201902219256
24904;没关系，人情世故会出手，5000年的智慧不是200年的文明可以理解的;135;1436;1571;23972;0.06553479058902052
25040;无所谓，我们有张核子;13;1174;1187;23972;0.049516102119139
25054;还是建房发展最快，挣钱最多;20;783;803;23972;0.033497413649257464
25076;我就想问问，支持中文吗？他能彻底理解中文的语境吗？;1;0;1;23972;4.171533455698315e-05
25085;没有WPS，怕是现在还收费;5;1;6;23972;0.0002502920073418989
25095;关键我用不到这么高的技术;4;13;17;23972;0.0007091606874687135
25100;说GPT4很烫嘴吗？;1;18;19;23972;0.0007925913565826798
25103;植入了我考wps能直接问他吗;1;18;19;23972;0.0007925913565826798
25105;越来越先进，越来越方便;1;17;18;23972;0.0007508760220256966
25229;妈的，这个视频有毒，软件2字居然分开读，这AI太漏了;4;0;4;23972;0.0001668613382279326
25234;国内能用吗？;4;0;4;23972;0.0001668613382279326
25239;跟我们有什么关系，又用不了;1;0;1;23972;4.171533455698315e-05
25242;文职失业神器？;1;7;8;23972;0.0003337226764558652
25244;这怎么安装;1;1;2;23972;8.34306691139663e-05
25255;我是个蠢人，我想把对门的刘小花搞到手，人工智能能根据我的条件与她的情况给我制定一个能成功的行动方案吗？能，我就服;1;0;1;23972;4.171533455698315e-05
25264;一边在发展科技，迈向未来，一边在继承愚昧，研究理论创新;1;10;11;23972;0.0004588686801268146
25267;一个工具而已，生产力掌握在人的手中。;2;1;3;23972;0.00012514600367094945
25271;支持封杀抵制;1;1;2;23972;8.34306691139663e-05
25276;这个界面一进去突然觉得前面花这么多时间注册简直不值得用notion它不香吗;1;5;6;23972;0.0002502920073418989
25284;强;1;1;2;23972;8.34306691139663e-05
25288;根本不需要这么麻烦，我两周前就用了预览版了，只要登陆就好了;1;1;2;23972;8.34306691139663e-05
25291;现在发达国家推行吧，毕竟人文素质还是相对有保障的;1;0;1;23972;4.171533455698315e-05
25294;學生會，批卷老師不會，怎麼打分;3;151;154;23972;0.006424161521775404
25300;能刷题就不错了，很多人连作业都不写;1;62;63;23972;0.0026280660770899382
25302;做为一个小学家长希望死记硬背，天天刷题这种教育方式真的能一去不复返;1;86;87;23972;0.0036292341064575336
25309;先把英语刷掉再说吧，英语全是死记硬背;5;22;27;23972;0.001126314033038545
25359;老少边穷地区的孩子不是更没上升通道了吗？;1;5;6;23972;0.0002502920073418989
25366;以后学习好的人才，就是要会提问。而不是回答;10;219;229;23972;0.00955281161354914
25377;你发明了联合播种机收割机我们偏不用，我们就用人工用牛耕作这是我们的文化自信;20;184;204;23972;0.008509928249624562
25399;用国学，文言文对付他们;6;50;56;23972;0.0023360587351910563
25406;目前还只是替代脑力劳动，应该用不了几年，整合机器人，就会大面积替代体力劳动。;12;46;58;23972;0.0024194894043050225
25420;我们都是天才只是被工业化的标准教育埋没了，AI时代到来就是最好的机遇;5;79;84;23972;0.003504088102786584
25426;那么会开逻辑课吗？;7;22;29;23972;0.0012097447021525113
25434;所以，以后需要学会怎么用工具，而不是死记硬背;2;60;62;23972;0.002586350742532955
25437;最后那句话很精彩;2;14;16;23972;0.0006674453529117303
25440;ai可以取代律师吗？;7;1;8;23972;0.0003337226764558652
25449;比作氢弹有点欠缺，智能给人带来的是方便，氢弹爆炸给人带来的是灾难;3;5;8;23972;0.0003337226764558652
25453;人家一关闭，突然不让用，你不学东西，就会突然干瞪眼;1;12;13;23972;0.0005422993492407809
25455;能不能把关键词说成中文;5;1;6;23972;0.0002502920073418989
25461;就是一个工具，和蒸汽机，电脑，电动工具，滴滴打车一样，提高了工作效率;8;0;8;23972;0.0003337226764558652
25493;深紫外光刻机能做出耒吗？比美国的航发还要强的能做出耒呜？能做出美元吗，人民币也行。;1;0;1;23972;4.171533455698315e-05
25501;他的危险还是在人。有人用它来发动战争。就危险了。;1;0;1;23972;4.171533455698315e-05
25506;能长出大米吗？能养出一只无害的肉猪吗？;1;0;1;23972;4.171533455698315e-05
25527;能结婚不要彩礼吗;2;1;3;23972;0.00012514600367094945
25530;独立思考，逻辑推理，创新能力也需要在知识的基础上，ai和人类只能是和谐生存，而不是ai代替人类;4;1;5;23972;0.00020857667278491573
25536;gtp只是整合大数据的能力真正的知识还是人类提供的;1;0;1;23972;4.171533455698315e-05
25539;独立思考的能力，逻辑推理的能力，打破认知边界的创新能力才真正有用，因为这些能力可以让人们提出好问题，提供好思路，只有这样才能引导AI帮助人类，更有效的组织和挖掘海量资源，更高效的做出更高水平的结果;2;2;4;23972;0.0001668613382279326
25553;以后逻辑课，数学，计算机才是重点;1;0;1;23972;4.171533455698315e-05
25573;但是这玩意想要不断提升完善不还得收集更新更完善更科学的创新思维嘛;1;0;1;23972;4.171533455698315e-05
25579;如何购买GTP;3;0;3;23972;0.00012514600367094945
25592;会不会同质化很严重？同样的命令AI智能写出来的东西会不会类似或者相同;2;1;3;23972;0.00012514600367094945
25608;哈哈。不必大惊小怪。你的思想Ai无法预料;1;0;1;23972;4.171533455698315e-05
25611;以后如果可以同声对话就更不得了了;1;0;1;23972;4.171533455698315e-05
25613;将来再把语音加上去，那就更恐怖了;1;0;1;23972;4.171533455698315e-05
25618;能否修汽车？;1;0;1;23972;4.171533455698315e-05
25623;马上机器人会成倍的出动作，中低端就会备取代，会识别视频就真麻烦了，主要是底层不过，人类就三五十年的好时间了，珍惜吧;1;4;5;23972;0.00020857667278491573
25626;如果2个人提供信息一样，出来结果会一样吗？;3;1;4;23972;0.0001668613382279326
25632;弱弱的问一句，我们也能用吗？;2;2;4;23972;0.0001668613382279326
25636;我们落伍了吗？;2;1;3;23972;0.00012514600367094945
25639;Chatgpt，也许是个智子，它让人们放弃学习，效果和物理学不存在了一样有效。长此以往，当某天超级太阳风暴催毁所有电子系统后，地球上就只剩一群土著人了。;1;3;4;23972;0.0001668613382279326
25651;艾伦耶格尔Irsooo是静静呀;1;1;2;23972;8.34306691139663e-05
25668;人工智能医生赶紧来吧，实在不愿意去医院看病了。;8;70;78;23972;0.0032537960954446853
25677;放心吧，改变不了我们任何东西。;3;4;7;23972;0.00029200734189888203
25681;非洲很多地方连工业革命都没参加不也接着过，这趟车我们大概率是赶不上了，以后踏踏实实做四流国家，别想超车什么的;1;10;11;23972;0.0004588686801268146
25683;人脑力才用开发了10。如果因为生物科技能突破把人类脑力提高到50人工智能就是笑话;2;0;2;23972;8.34306691139663e-05
25686;大部分人变得越来越愚蠢了。;1;11;12;23972;0.0005005840146837978
25688;国内用不了，被屏蔽;1;6;7;23972;0.00029200734189888203
25690;下载链接给个;1;0;1;23972;4.171533455698315e-05
25692;为什么人家能发明世界上没有的东西;1;0;1;23972;4.171533455698315e-05
25694;一大批大身价的人是要想尽穷计阻止的;1;0;1;23972;4.171533455698315e-05
25696;复古粉为了TZ可以和世界脱钩，抄东面那个国家的作业;1;5;6;23972;0.0002502920073418989
25698;每个部门只要留下那几个领导就够了;1;3;4;23972;0.0001668613382279326
25700;请问国内哪里可以看;2;1;3;23972;0.00012514600367094945
25704;废了什么？又不能用;1;2;3;23972;0.00012514600367094945
25849;吹的大了会爆的，人造东西超不过人的。真正拥有人的智慧还早着呢。;3;0;3;23972;0.00012514600367094945
25857;人全开除，老板在那自己那玩AI就好了;2;0;2;23972;8.34306691139663e-05
25862;那人类可以在家什么都不用干了吗？;1;1;2;23972;8.34306691139663e-05
