发布者;真实一级评论数;真实点赞数;边数;最大边数;集群密度
LuvstarvedShameless;1;1;2;287001;6.968616834087686e-06
赛博十块鉴定处;907;40000;40907;287001;0.14253260441601248
赛博十块鉴定处;718;49000;49718;287001;0.17323284587858578
林枭2023;88;3068;3156;287001;0.010996477364190368
赛博十块鉴定处;96;2285;2381;287001;0.00829613834098139
赛博十块鉴定处;55;2261;2316;287001;0.00806965829387354
赛博十块鉴定处;751;45000;45751;287001;0.15941059438817287
我是无能狂怒队长;4;12;16;287001;5.574893467270149e-05
东南亚选秀博士;65;240;305;287001;0.001062714067198372
不够吃我再点;1;3;4;287001;1.3937233668175372e-05
月神幻兔;2;122;124;287001;0.00043205424371343655
苏老邪_HenrySo;1;8;9;287001;3.135877575339459e-05
闲鱼带亨蛋小丁;1;2;3;287001;1.045292525113153e-05
凯蒂小姐的蔷薇花园;2;3;5;287001;1.7421542085219216e-05
技术不足超能力补;2;1;3;287001;1.045292525113153e-05
929星球-深深小白粥;1;6;7;287001;2.43901589193069e-05
mrboomer;1;1;2;287001;6.968616834087686e-06
东馆日常;5;133;138;287001;0.00048083456155205033
sunix;2;5;7;287001;2.43901589193069e-05
何尔萌很萌;5;1;6;287001;2.090585050226306e-05
看展sohu;3;2;5;287001;1.7421542085219216e-05
Tea-krisy;178;381;559;287001;0.0019477284051275083
小特研究所;37;381;418;287001;0.0014564409183243263
征哥哥哥哥哥哥;2;1;3;287001;1.045292525113153e-05
什么时候才能早睡早起鸭;3;7;10;287001;3.484308417043843e-05
萝依妮雅;1;5;6;287001;2.090585050226306e-05
安澜堂懒猫;3;13;16;287001;5.574893467270149e-05
自种天然;3;35000;35003;287001;0.12196124752178564
Sweet猫饼;85;318;403;287001;0.0014041762920686688
古拉古拉古拉皮卡;1;3958;3959;287001;0.013794377023076575
阿里云大咖说;9;2;11;287001;3.832739258748227e-05
简忠威水彩艺术;29;464;493;287001;0.0017177640496026146
稿定设计;1;1;2;287001;6.968616834087686e-06
小仲景的投资日记;2;10;12;287001;4.181170100452612e-05
于文平Turman;3;7;10;287001;3.484308417043843e-05
手可摘星星412;1;3;4;287001;1.3937233668175372e-05
洛之秋;146;9796;9942;287001;0.034640994282249885
虚鲸般的幻想;1;2;3;287001;1.045292525113153e-05
FH_moya;3;41;44;287001;0.0001533095703499291
搞笑奇葩精选;1;1;2;287001;6.968616834087686e-06
-你吱;1;1559;1560;287001;0.005435521130588396
凯蒂小姐的蔷薇花园;1;7;8;287001;2.7874467336350744e-05
童叟无欺鬼鬼山;2;4;6;287001;2.090585050226306e-05
极地羽翼;1;3;4;287001;1.3937233668175372e-05
盐水饼干;2;16;18;287001;6.271755150678917e-05
爱吃蛋糕的Felicia;1;3958;3959;287001;0.013794377023076575
盔性恋;1;7;8;287001;2.7874467336350744e-05
万年王十二;1;1;2;287001;6.968616834087686e-06
狂妄画集;1;7;8;287001;2.7874467336350744e-05
白白白花衬衫;2;5;7;287001;2.43901589193069e-05
斜谷云深;1;4;5;287001;1.7421542085219216e-05
AI-Doll;1;8;9;287001;3.135877575339459e-05
MANTIS红;1;7;8;287001;2.7874467336350744e-05
Shoppu-;1;3;4;287001;1.3937233668175372e-05
ionaraq_;2;58;60;287001;0.00020905850502263057
TK·唐;2;3;5;287001;1.7421542085219216e-05
我特爱吃汉堡;1;4;5;287001;1.7421542085219216e-05
蓝莓酱全肯定bot;2;2;4;287001;1.3937233668175372e-05
突然兴奋的患者;1;690;691;287001;0.0024076571161772958
你大延哥;1;1;2;287001;6.968616834087686e-06
小葱跑快快;3;214;217;287001;0.000756094926498514
俞晓晓晓;1;3;4;287001;1.3937233668175372e-05
俞晓晓晓;1;1;2;287001;6.968616834087686e-06
Utah相反方向;1;1;2;287001;6.968616834087686e-06
月神幻兔;2;124;126;287001;0.0004390228605475242
也亿盐;83;55;138;287001;0.00048083456155205033
呜哦喔_;2;1;3;287001;1.045292525113153e-05
搞某人;141;1593;1734;287001;0.006041790795154024
高通;2;15;17;287001;5.9233243089745335e-05
绝对伏特加;0;5;5;287001;1.7421542085219216e-05
Satan的女儿;1;1;2;287001;6.968616834087686e-06
大江户战士OedoSoldier;6;24;30;287001;0.00010452925251131529
老蜂蜜Gi;7;114;121;287001;0.000421601318462305
浩瀚海洋中的浅水之鱼;4;3;7;287001;2.43901589193069e-05
华北油田公司;1;4;5;287001;1.7421542085219216e-05
海盐抹茶山;6;6;12;287001;4.181170100452612e-05
崩壞小爪;3;13;16;287001;5.574893467270149e-05
半颗荔枝i;14;48;62;287001;0.00021602712185671828
md2_;171;5557;5728;287001;0.019958118612827133
浪与途鲸;1;1;2;287001;6.968616834087686e-06
小葱跑快快;1;50;51;287001;0.000177699729269236
Ai绘_Sicx本;2;5;7;287001;2.43901589193069e-05
腐潶;18;217;235;287001;0.0008188124780053031
机器之心Pro;1;9;10;287001;3.484308417043843e-05
凯蒂小姐的蔷薇花园;1;1;2;287001;6.968616834087686e-06
Starrrrrrry星;1;5;6;287001;2.090585050226306e-05
归羌;2;2;4;287001;1.3937233668175372e-05
Grandia元;14;276;290;287001;0.0010104494409427145
月神幻兔;-1;372;371;287001;0.0012926784227232657
涂鸦王国菌;1;19;20;287001;6.968616834087687e-05
鹤戾申;1;9;10;287001;3.484308417043843e-05
Cutky;1;15;16;287001;5.574893467270149e-05
阿尔萨鱼;3;10;13;287001;4.529600942156996e-05
虚拟多巴胺;-3;1;-2;287001;-6.968616834087686e-06
皮卡智能AI视觉平台;2;1;3;287001;1.045292525113153e-05
稿定设计;5;10;15;287001;5.226462625565764e-05
伍少霆;1;4;5;287001;1.7421542085219216e-05
清源妙道Jolin;3;9;12;287001;4.181170100452612e-05
AI-Doll;1;7;8;287001;2.7874467336350744e-05
刷电影的本老师;2;19;21;287001;7.31704767579207e-05
静静的猫超;1;3;4;287001;1.3937233668175372e-05
Melody欧美音乐台;9;72;81;287001;0.00028222898178055126
美是参差多态;1;162;163;287001;0.0005679422719781464
于文平Turman;1;10;11;287001;3.832739258748227e-05
阿呆谈币;2;7;9;287001;3.135877575339459e-05
高歌行说;1;1;2;287001;6.968616834087686e-06
愚者先生的甜冰茶的老婆;1;6;7;287001;2.43901589193069e-05
画画的SJMAN;68;679;747;287001;0.0026027783875317506
篮球实战指南;10;48;58;287001;0.0002020898881885429
数画-AI绘画App;1;1;2;287001;6.968616834087686e-06
绘画笔记;9;130;139;287001;0.0004843188699690942
风铃叮咚舞;35;442;477;287001;0.0016620151149299132
低可视度理工狼;18;349;367;287001;0.0012787411890550905
嗖嗖飞的蓝鱼;1;16;17;287001;5.9233243089745335e-05
北京大峰峰;1;5;6;287001;2.090585050226306e-05
小兔警探;4;5;9;287001;3.135877575339459e-05
泡-芙丶;3;48;51;287001;0.000177699729269236
张辛欣;7;19;26;287001;9.059201884313991e-05
横行的蟹形人类;1;5;6;287001;2.090585050226306e-05
因为我其实是一个赛博幽灵;2;1;3;287001;1.045292525113153e-05
狂妄画集;2;6;8;287001;2.7874467336350744e-05
gy·ObSEsSioN;2;24;26;287001;9.059201884313991e-05
露月之城;1;16;17;287001;5.9233243089745335e-05
UCG一刀;12;114;126;287001;0.0004390228605475242
纪屿十二;28;71;99;287001;0.00034494653328734045
闖紅燈的蝸犇;2;1;3;287001;1.045292525113153e-05
Art_艺术映画;9;223;232;287001;0.0008083595527541716
知心琥珀;2;7;9;287001;3.135877575339459e-05
嘲哳el;1;5;6;287001;2.090585050226306e-05
vase-八色;1;3;4;287001;1.3937233668175372e-05
CheungYiu-;1;1;2;287001;6.968616834087686e-06
水晶公主201305;1;3;4;287001;1.3937233668175372e-05
水晶公主201305;2;5;7;287001;2.43901589193069e-05
阿尔萨鱼;44;59;103;287001;0.00035888376695551586
北漠小豹子;2;2;4;287001;1.3937233668175372e-05
小马宋同学;3;13;16;287001;5.574893467270149e-05
设计目录;49;513;562;287001;0.0019581813303786396
乱步非鱼;4;16;20;287001;6.968616834087687e-05
栀温清;1;2;3;287001;1.045292525113153e-05
spark不夜城;200;376;576;287001;0.0020069616482172536
柳煦久;40;289;329;287001;0.0011463374692074243
AI-Doll;1;8;9;287001;3.135877575339459e-05
口袋巧克力;42;1954;1996;287001;0.006954679600419511
布偶米米糊;1;8;9;287001;3.135877575339459e-05
天上謡_;1;2;3;287001;1.045292525113153e-05
矜曦儿;19;53;72;287001;0.0002508702060271567
MFX·Airimania;3;55;58;287001;0.0002020898881885429
Melody欧美音乐台;2;33;35;287001;0.00012195079459653451
可奈何希;2;1;3;287001;1.045292525113153e-05
无界AI;1;2;3;287001;1.045292525113153e-05
阿尔萨鱼;55;66;121;287001;0.000421601318462305
美鸥阅读;5;13;18;287001;6.271755150678917e-05
散了玫瑰园;1;1;2;287001;6.968616834087686e-06
一帧秒创;1;2;3;287001;1.045292525113153e-05
京阁寺;2;56;58;287001;0.0002020898881885429
我心知许;1;1;2;287001;6.968616834087686e-06
亏贼修勾Zz;6;10;16;287001;5.574893467270149e-05
神奇小机零;25;168;193;287001;0.0006724715244894617
俺爱桑桑;2;2;4;287001;1.3937233668175372e-05
小树怜;2;6;8;287001;2.7874467336350744e-05
md2_;0;27;27;287001;9.407632726018377e-05
Ai绘_Sicx本;1;3;4;287001;1.3937233668175372e-05
量子位;5;16;21;287001;7.31704767579207e-05
不良艺;1;17;18;287001;6.271755150678917e-05
少狗椿__;7;94;101;287001;0.00035191515012142815
晋江羽萌萌萌;17;262;279;287001;0.0009721220483552322
Ai绘_Sicx本;1;2;3;287001;1.045292525113153e-05
进鸡的摇滚公主盆咪;6;42;48;287001;0.00016724680401810447
狂暴甜食组长;30;54;84;287001;0.0002926819070316828
Melody欧美音乐台;3;22;25;287001;8.710771042609608e-05
湖南科技大学;4;12;16;287001;5.574893467270149e-05
某熊233;3;2;5;287001;1.7421542085219216e-05
管郁生;2;29;31;287001;0.00010801356092835914
在实现不了的梦里羽化之蝶飞走了;1;1;2;287001;6.968616834087686e-06
那我关月亮了__;12;41;53;287001;0.00018466834610332368
sunix;10;54;64;287001;0.00022299573869080595
九河川-;2;68;70;287001;0.00024390158919306902
但斌;9;90;99;287001;0.00034494653328734045
画画的棍子今天做运动了吗;9;66;75;287001;0.00026132313127828825
花先舍;2;17;19;287001;6.620185992383301e-05
漓月鸭;2;21;23;287001;8.01390935920084e-05
小葱跑快快;5;174;179;287001;0.0006236912066508479
Raiedy;17;142;159;287001;0.0005540050383099711
AI-Doll;5;12;17;287001;5.9233243089745335e-05
苯甲酸C7H6O2;2;2;4;287001;1.3937233668175372e-05
黑白辉鸭;1;16;17;287001;5.9233243089745335e-05
Sidelight侧光工坊;2;1;3;287001;1.045292525113153e-05
Silence言声;2;11;13;287001;4.529600942156996e-05
HagawaKoori;1;1;2;287001;6.968616834087686e-06
新套橙联播;12;29;41;287001;0.00014285664509879756
阿尔萨鱼;24;47;71;287001;0.00024738589761011284
童叟无欺鬼鬼山;1;11;12;287001;4.181170100452612e-05
冬囚鲸岛;1;27;28;287001;9.75606356772276e-05
新套橙联播;3;4;7;287001;2.43901589193069e-05
Di_哒棣;1;2;3;287001;1.045292525113153e-05
炸虾奶油泡;1;4;5;287001;1.7421542085219216e-05
森林画册;5;90;95;287001;0.0003310092996191651
萝依妮雅;1;15;16;287001;5.574893467270149e-05
汪加诚-;1;1;2;287001;6.968616834087686e-06
夜神不说话;2;4;6;287001;2.090585050226306e-05
量子位;1;8;9;287001;3.135877575339459e-05
鹿菏HE;110;2563;2673;287001;0.009313556398758192
可以在围脖拉嗯嗯么;1;1;2;287001;6.968616834087686e-06
国服亡牌咒术师;30;66;96;287001;0.00033449360803620894
月神幻兔;1;155;156;287001;0.0005435521130588395
南灼艺术馆;1;6;7;287001;2.43901589193069e-05
什么都要说两句;1;2;3;287001;1.045292525113153e-05
阿尔萨鱼;13;506;519;287001;0.0018083560684457546
阿尔萨鱼;4;13;17;287001;5.9233243089745335e-05
阿远不开车;2;3;5;287001;1.7421542085219216e-05
苏吟风w;1;1;2;287001;6.968616834087686e-06
三刀八木双爻;1;1;2;287001;6.968616834087686e-06
小狗真芝棒;2;1;3;287001;1.045292525113153e-05
LilingF傅丽玲;1;1;2;287001;6.968616834087686e-06
闖紅燈的蝸犇;2;4;6;287001;2.090585050226306e-05
海风橘子吃不完呀;1;4;5;287001;1.7421542085219216e-05
而今已翻涌成海;1;1;2;287001;6.968616834087686e-06
千代醒;2;7;9;287001;3.135877575339459e-05
胖胖取名好困难;1;1;2;287001;6.968616834087686e-06
梨子兮饭;1;4;5;287001;1.7421542085219216e-05
玛蒂达尔效应;1;6;7;287001;2.43901589193069e-05
曲和型观雨机器;1;9;10;287001;3.484308417043843e-05
桔师傅掌勺;1;38000;38001;287001;0.1324072041560831
大江户战士OedoSoldier;4;45;49;287001;0.0001707311124351483
辞尘尘;2;8;10;287001;3.484308417043843e-05
泡-芙丶;3;130;133;287001;0.0004634130194668311
每日哀嚎bot;1;5;6;287001;2.090585050226306e-05
Elaine_Wmm;1;14;15;287001;5.226462625565764e-05
阿尔萨鱼;4;152;156;287001;0.0005435521130588395
河南手机报;1;6;7;287001;2.43901589193069e-05
程曦之星Lucifer;1;4;5;287001;1.7421542085219216e-05
河南手机报;2;5;7;287001;2.43901589193069e-05
民乐融媒体中心;36;40;76;287001;0.00026480743969533205
白夜菌Dream;1;17;18;287001;6.271755150678917e-05
一帧秒创;1;3;4;287001;1.3937233668175372e-05
Deliri22;2;1;3;287001;1.045292525113153e-05
手速赶不上脑速的Tyche;1;3;4;287001;1.3937233668175372e-05
看宜兴;2;3;5;287001;1.7421542085219216e-05
油画里的德拉科;11;163;174;287001;0.0006062696645656286
SWS任珂;33;217;250;287001;0.0008710771042609608
阿尔萨鱼;31;52;83;287001;0.00028919759861463897
我苏特稿;4;5;9;287001;3.135877575339459e-05
風巻立;2;67;69;287001;0.00024041728077602516
锦鲤是锦黎;1;1;2;287001;6.968616834087686e-06
江苏新闻;21;145;166;287001;0.0005783951972292779
不快乐的阿柿酱;2;2;4;287001;1.3937233668175372e-05
风清清呀;2;92;94;287001;0.00032752499120212124
南灼艺术馆;6;4;10;287001;3.484308417043843e-05
_北巷_;4;16;20;287001;6.968616834087687e-05
AI-Doll;3;4;7;287001;2.43901589193069e-05
fuqq;3;7;10;287001;3.484308417043843e-05
蜜蜂爸爸;1;5;6;287001;2.090585050226306e-05
优设AIGC;9;131;140;287001;0.00048780317838613803
十了个三zhan;3;24;27;287001;9.407632726018377e-05
品牌设计视觉;13;108;121;287001;0.000421601318462305
今日AI绘画;2;1;3;287001;1.045292525113153e-05
黑戈尼尔;1;7;8;287001;2.7874467336350744e-05
斜谷云深;1;1;2;287001;6.968616834087686e-06
贵州日报官微;1;1;2;287001;6.968616834087686e-06
ID莫古蘑菇;1;1;2;287001;6.968616834087686e-06
咒缚恒龙;5;117;122;287001;0.00042508562687934885
臻至dev;2;3;5;287001;1.7421542085219216e-05
行将已木;3;2;5;287001;1.7421542085219216e-05
每天不想做饭;1;4;5;287001;1.7421542085219216e-05
特务兔叽;13;27;40;287001;0.00013937233668175373
不稳异能;1;618;619;287001;0.002156786910150139
小树怜;2;8;10;287001;3.484308417043843e-05
小玛德莱娜和茶;1;7;8;287001;2.7874467336350744e-05
leeann_theDevilsViolinist;2;9;11;287001;3.832739258748227e-05
无西cheese;1;4;5;287001;1.7421542085219216e-05
优设AIGC;20;262;282;287001;0.0009825749736063637
Hinson-Lew;1;618;619;287001;0.002156786910150139
头像我老婆不服来战;23;229;252;287001;0.0008780457210950484
延同在等论衡师兄弟复合;6;44;50;287001;0.00017421542085219215
海胆uniiii;4;50;54;287001;0.00018815265452036753
维司塔;23;1003;1026;287001;0.003574900435886983
极光闪蝶_;2;20;22;287001;7.665478517496454e-05
iiiiiicey-;1;2;3;287001;1.045292525113153e-05
漫剧;439;14000;14439;287001;0.05030992923369605
渡口唱白骨;1;4;5;287001;1.7421542085219216e-05
卑弱;12;392;404;287001;0.0014076606004857126
唐二爸爸;9;92;101;287001;0.00035191515012142815
颠倒见梦;1;2;3;287001;1.045292525113153e-05
幻想读档器;2;4;6;287001;2.090585050226306e-05
梨子兮饭;1;2;3;287001;1.045292525113153e-05
十载一笔锦绣熬成词穷;1;15;16;287001;5.574893467270149e-05
眼镜军服鳖性恋厨;1;6;7;287001;2.43901589193069e-05
Wandering_Shouting_;1;9;10;287001;3.484308417043843e-05
十载一笔锦绣熬成词穷;4;34;38;287001;0.00013240371984766603
羊羊咩咩缪miu-;1;69;70;287001;0.00024390158919306902
明明是个月亮却叫Eloise;3;11;14;287001;4.87803178386138e-05
庚庚昀昀环游大梁;2;2;4;287001;1.3937233668175372e-05
栗子冰糕OwO;1;2;3;287001;1.045292525113153e-05
_酒祀;1;2;3;287001;1.045292525113153e-05
黄柯基KK;3;10;13;287001;4.529600942156996e-05
KUKO谷鸟;1;9;10;287001;3.484308417043843e-05
尤金理论;2;18;20;287001;6.968616834087687e-05
Bikka深陷蓝人池沼;1;9;10;287001;3.484308417043843e-05
Vista看天下;827;38000;38827;287001;0.13528524290856128
我苹果牛;14;94;108;287001;0.00037630530904073507
楚九江_帕底亚迷路专业户;2;8;10;287001;3.484308417043843e-05
这也是泽亚的预测吗;1;8;9;287001;3.135877575339459e-05
AI-Doll;1;4;5;287001;1.7421542085219216e-05
你狂傲的浪要到此止住;1;1;2;287001;6.968616834087686e-06
标志情报局;3;13;16;287001;5.574893467270149e-05
桃子不再摆烂;1;1;2;287001;6.968616834087686e-06
久久九酒-;1;5;6;287001;2.090585050226306e-05
Virgoz涵;3;9;12;287001;4.181170100452612e-05
匸匚匣;3;11;14;287001;4.87803178386138e-05
-Septina-;1;35;36;287001;0.00012543510301357835
壳那个椰;2;5;7;287001;2.43901589193069e-05
阿尔萨鱼;3;117;120;287001;0.00041811701004526114
l呆萌黄小鸭l;1;9;10;287001;3.484308417043843e-05
一转身有鬼;1;618;619;287001;0.002156786910150139
何时忘却瀛瀛;1;1;2;287001;6.968616834087686e-06
小猫咪觉得你很棒;3;10;13;287001;4.529600942156996e-05
三柒_twentyone;1;1;2;287001;6.968616834087686e-06
阿尔萨鱼;24;30;54;287001;0.00018815265452036753
易烊千玺微吧;22;44;66;287001;0.00022996435552489363
有竹为夭;1;1;2;287001;6.968616834087686e-06
大触来了专栏;4;77;81;287001;0.00028222898178055126
AI绘画精选;1;2;3;287001;1.045292525113153e-05
早睡鬣鬣也;14;79;93;287001;0.0003240406827850774
郁闷小烧酒;3;3;6;287001;2.090585050226306e-05
Simon的白日梦;11;354;365;287001;0.0012717725722210028
阿尔萨鱼;4;8;12;287001;4.181170100452612e-05
Mr数据杨;1;1;2;287001;6.968616834087686e-06
诗羽Sakura;3;36;39;287001;0.00013588802826470988
倒走钟;10;312;322;287001;0.0011219473102881176
八千八十;14;636;650;287001;0.002264800471078498
爱吃耶子和波萝;2;3;5;287001;1.7421542085219216e-05
八千八十;2;55;57;287001;0.00019860557977149907
艺术你我Cforabc;13;29;42;287001;0.0001463409535158414
MiNA-in-冷凍庫;2;6;8;287001;2.7874467336350744e-05
yuki夜倾;3;182;185;287001;0.0006445970571531109
三横没有一竖;1;2;3;287001;1.045292525113153e-05
SONIA邵;2;34;36;287001;0.00012543510301357835
goodbye_holiday;1;3;4;287001;1.3937233668175372e-05
今日AI绘画;2;2;4;287001;1.3937233668175372e-05
成都地铁;29;31;60;287001;0.00020905850502263057
无界AI;3;2;5;287001;1.7421542085219216e-05
写真store;2;87;89;287001;0.00031010344911690203
沈皖景;1;2;3;287001;1.045292525113153e-05
非正派鼠鼠;1;2;3;287001;1.045292525113153e-05
火锅沅子;2;5;7;287001;2.43901589193069e-05
illmiillmiillmi;0;5;5;287001;1.7421542085219216e-05
昨晚的星星很亮;1;4;5;287001;1.7421542085219216e-05
李荣浩的落俗-;1;5;6;287001;2.090585050226306e-05
林擒时猎深;4;8;12;287001;4.181170100452612e-05
年咸裕;1;5;6;287001;2.090585050226306e-05
我想吃蟹黄面;2;8;10;287001;3.484308417043843e-05
noubot;1;1;2;287001;6.968616834087686e-06
变形警车缤纷硝化细菌;1;4;5;287001;1.7421542085219216e-05
烟萝秋;1;6;7;287001;2.43901589193069e-05
7526389043_752;1;10;11;287001;3.832739258748227e-05
超满意吖;1;1;2;287001;6.968616834087686e-06
一只柚一只;2;1;3;287001;1.045292525113153e-05
倒走钟;41;765;806;287001;0.0028083525841373375
玉枕寒_逐风羽;1;1;2;287001;6.968616834087686e-06
远火依微秋草薄;1;1;2;287001;6.968616834087686e-06
1路项东;2;10;12;287001;4.181170100452612e-05
鹤啊鹤;2;4;6;287001;2.090585050226306e-05
冷圈选手吐槽;31;495;526;287001;0.0018327462273650614
axvkvcug;14;25;39;287001;0.00013588802826470988
Breswain;7;236;243;287001;0.0008466869453416538
Ashley和她的小窝;1;6;7;287001;2.43901589193069e-05
明日香你草死我算了;2;3;5;287001;1.7421542085219216e-05
涂鸦王国菌;1;2234;2235;287001;0.007787429312092989
这有一颗小太阳;2;9;11;287001;3.832739258748227e-05
蜂蜜烤烤烤;2;9;11;287001;3.832739258748227e-05
唐茶CLQC;1;8;9;287001;3.135877575339459e-05
想吃但是不能吃芒果;2;6;8;287001;2.7874467336350744e-05
狗子流星;1;8;9;287001;3.135877575339459e-05
洗洗睡吧再做个好梦;3;11;14;287001;4.87803178386138e-05
_Maevee_;2;1;3;287001;1.045292525113153e-05
赛博辛亚天选人外;2;40;42;287001;0.0001463409535158414
磨唧叽;1;2;3;287001;1.045292525113153e-05
梨子兮饭;1;6;7;287001;2.43901589193069e-05
f92改名好难;2;7;9;287001;3.135877575339459e-05
斯莱特林饿龙级长;2;251;253;287001;0.0008815300295120923
黑戈尼尔;1;6;7;287001;2.43901589193069e-05
shenin-_-;4;56;60;287001;0.00020905850502263057
努力之前不改名;1;3;4;287001;1.3937233668175372e-05
Y园糖;3;17;20;287001;6.968616834087687e-05
豆奶真君;6;5;11;287001;3.832739258748227e-05
半夏海角风;1;3;4;287001;1.3937233668175372e-05
Lu鹭川_;2;13;15;287001;5.226462625565764e-05
逐山光;2;9;11;287001;3.832739258748227e-05
玄清颂颂颂颂颂颂_____;2;9;11;287001;3.832739258748227e-05
爛Five;1;1;2;287001;6.968616834087686e-06
此账户已住校;1;1;2;287001;6.968616834087686e-06
车辆发动机废渣;4;193;197;287001;0.000686408758157637
清晨版薄荷牛奶狗狗厨;1;5;6;287001;2.090585050226306e-05
小笛甘比_上个号炸了;1;3;4;287001;1.3937233668175372e-05
彩·QM·棋魂·梦;1;2;3;287001;1.045292525113153e-05
白安墨QwQ;1;18;19;287001;6.620185992383301e-05
逼逼叭叭波波;2;8;10;287001;3.484308417043843e-05
萧萧鹤云间;11;7;18;287001;6.271755150678917e-05
猩工坊;2;3;5;287001;1.7421542085219216e-05
醉微沉;5;14;19;287001;6.620185992383301e-05
望月者WW;26;214;240;287001;0.0008362340200905223
Armstrong的空军之翼;2;17;19;287001;6.620185992383301e-05
戴帽子的熊小熊;1;1;2;287001;6.968616834087686e-06
窝头没猫饼;1;14;15;287001;5.226462625565764e-05
迷寂恶X;1;24;25;287001;8.710771042609608e-05
我的e人面具呢;1;48;49;287001;0.0001707311124351483
阿新melo;1;1;2;287001;6.968616834087686e-06
暴走畫伯早見沙織;1;7;8;287001;2.7874467336350744e-05
hyunlanyudin;2;2;4;287001;1.3937233668175372e-05
Tona兔娜;6;99;105;287001;0.0003658523837896035
错季苦樱_R;1;5;6;287001;2.090585050226306e-05
浮光月ING;1;1;2;287001;6.968616834087686e-06
池鹄鹄鹄;2;1;3;287001;1.045292525113153e-05
某白一觉睡到吃夜宵;1;1;2;287001;6.968616834087686e-06
请把板子烧了;3;9;12;287001;4.181170100452612e-05
就爱吃皮蛋_;3;10;13;287001;4.529600942156996e-05
星稽鸽鸽;2;6;8;287001;2.7874467336350744e-05
月神幻兔;2;137;139;287001;0.0004843188699690942
猪儿睡前故事;2;3;5;287001;1.7421542085219216e-05
萨摩耶的眉毛;2;2;4;287001;1.3937233668175372e-05
雨森bawp;1;5;6;287001;2.090585050226306e-05
唐吉童话;1;2;3;287001;1.045292525113153e-05
笙造;3;2;5;287001;1.7421542085219216e-05
相逢行_;4;7;11;287001;3.832739258748227e-05
宁欢喜;5;106;111;287001;0.0003867582342918666
不可食用牙膏;7;42;49;287001;0.0001707311124351483
海辛Hyacinth;32;218;250;287001;0.0008710771042609608
辞云青_隳世魔城爱情故事记录员;2;3;5;287001;1.7421542085219216e-05
瑜术临疯;1;6;7;287001;2.43901589193069e-05
画者不语;8;460;468;287001;0.0016306563391765185
千影孤烛;4;8;12;287001;4.181170100452612e-05
春日矮男;55;1594;1649;287001;0.005745624579705297
-EndsTillReachYourArms-;1;3;4;287001;1.3937233668175372e-05
7526389043_752;2;13;15;287001;5.226462625565764e-05
芝士小陆;1;15;16;287001;5.574893467270149e-05
再多呆一会吧;1;7;8;287001;2.7874467336350744e-05
线条猫ovo;3;19;22;287001;7.665478517496454e-05
月神幻兔;2;146;148;287001;0.0005156776457224888
漫语洵然本人;2;4;6;287001;2.090585050226306e-05
无界AI;1;2;3;287001;1.045292525113153e-05
摸鱼的一墨;11;268;279;287001;0.0009721220483552322
夏萧Dawn;12;378;390;287001;0.001358880282647099
重度污染200;73;4731;4804;287001;0.016738617635478622
魏晨全球歌迷会;165;1442;1607;287001;0.005599283626189455
六块麻薯;4;7;11;287001;3.832739258748227e-05
嘻嘻66675;2;12;14;287001;4.87803178386138e-05
熙棠棠棠;2;15;17;287001;5.9233243089745335e-05
檀霂piupiu;1;1;2;287001;6.968616834087686e-06
吃一口藕片;3;34;37;287001;0.0001289194114306222
桃子不再摆烂;14;58;72;287001;0.0002508702060271567
梓其_守护自己改名版;1;2;3;287001;1.045292525113153e-05
丹麦国家旅游局;7;20;27;287001;9.407632726018377e-05
颜临歌;1;11;12;287001;4.181170100452612e-05
三三亦未寝;1;11;12;287001;4.181170100452612e-05
-COICIS-;8;63;71;287001;0.00024738589761011284
小良头头;2;5;7;287001;2.43901589193069e-05
被画画拳打脚踢bot;3;19;22;287001;7.665478517496454e-05
IKteArimasen;6;21;27;287001;9.407632726018377e-05
天祝县融媒体中心;60;62;122;287001;0.00042508562687934885
梨子兮饭;1;30;31;287001;0.00010801356092835914
大叔咖清了;1;12;13;287001;4.529600942156996e-05
雨历的排气管;1;4;5;287001;1.7421542085219216e-05
-烟卷P-;4;20;24;287001;8.362340200905224e-05
大象杆菌;1;1;2;287001;6.968616834087686e-06
樊百乐;78;58;136;287001;0.0004738659447179627
死安sAnn;11;84;95;287001;0.0003310092996191651
萤月夏;5;17;22;287001;7.665478517496454e-05
naro桑的镜子不发光;2;2;4;287001;1.3937233668175372e-05
只有现在也好可以拥抱吗;1;6;7;287001;2.43901589193069e-05
阿尔萨鱼;11;154;165;287001;0.0005749108888122341
经海路大情种;3;5;8;287001;2.7874467336350744e-05
攻梦女个人微博_;1;287000;287001;287001;1.0
Naswn1116;1;4;5;287001;1.7421542085219216e-05
雨中曲漫话;5;17;22;287001;7.665478517496454e-05
非鱼罐头芜湖;3;13;16;287001;5.574893467270149e-05
崩溃不想去学校;1;6;7;287001;2.43901589193069e-05
-一碗阳春面-;4;7;11;287001;3.832739258748227e-05
李大白活Swoosh;3;4;7;287001;2.43901589193069e-05
二分音君;3;13;16;287001;5.574893467270149e-05
居家的水临烟;3;46;49;287001;0.0001707311124351483
游在野;1;4;5;287001;1.7421542085219216e-05
hottcake;1;3;4;287001;1.3937233668175372e-05
AI-Doll;2;10;12;287001;4.181170100452612e-05
伊织酱;35;43;78;287001;0.00027177605652941976
埋川雪;1;3;4;287001;1.3937233668175372e-05
梨三花花;64;899;963;287001;0.0033553890056132207
一颗咸鱼籽耶;1;6;7;287001;2.43901589193069e-05
黑戈尼尔;4;4;8;287001;2.7874467336350744e-05
一滩猫饼o;3;7;10;287001;3.484308417043843e-05
铁羽羽子;2;13;15;287001;5.226462625565764e-05
江懿秋;1;2;3;287001;1.045292525113153e-05
春浓满楼情痴狂;4;41;45;287001;0.00015679387876697294
大米的记忆;1;8;9;287001;3.135877575339459e-05
红绿灯的白bo;22;83;105;287001;0.0003658523837896035
Sakana水族馆;1;32;33;287001;0.00011498217776244682
宝藏图文集;1;2;3;287001;1.045292525113153e-05
南灼艺术馆;1;6;7;287001;2.43901589193069e-05
兔导;1;2;3;287001;1.045292525113153e-05
无名无姓丨不梦不醒;3;57;60;287001;0.00020905850502263057
洛北在南方;2;16;18;287001;6.271755150678917e-05
杨泪腺-Emalfire-;2;18;20;287001;6.968616834087687e-05
零重力瓦力;2;4;6;287001;2.090585050226306e-05
写手吐槽bot_;112;1812;1924;287001;0.006703809394392354
生蚝侠HA;1;4;5;287001;1.7421542085219216e-05
狂妄画集;1;4;5;287001;1.7421542085219216e-05
luky猪猪lwl;1;2;3;287001;1.045292525113153e-05
cat_米诺;5;6;11;287001;3.832739258748227e-05
红绫猫;4;114;118;287001;0.0004111483932111735
斯莱特林饿龙级长;6;82;88;287001;0.0003066191406998582
二般均衡;1;5;6;287001;2.090585050226306e-05
红绫猫;8;25;33;287001;0.00011498217776244682
张虎博hubostudio;1;3;4;287001;1.3937233668175372e-05
WhileELF;3;12;15;287001;5.226462625565764e-05
菊小荷;1;1;2;287001;6.968616834087686e-06
INFJbot;9;10;19;287001;6.620185992383301e-05
美-愈;1;1;2;287001;6.968616834087686e-06
Tidefading_;5;1;6;287001;2.090585050226306e-05
抱抱Brownie_ooc版;2;3;5;287001;1.7421542085219216e-05
春日矮男;1;159;160;287001;0.0005574893467270149
Ai绘_Sicx本;1;6;7;287001;2.43901589193069e-05
那谁AKer;5;1;6;287001;2.090585050226306e-05
奶茶不加糖全世界最甜;10;342;352;287001;0.0012264765627994327
V姐闯商海;2;5;7;287001;2.43901589193069e-05
_奶香味青椰子;2;1;3;287001;1.045292525113153e-05
Sakana水族馆;1;2;3;287001;1.045292525113153e-05
ATEEZ甲板女工会议室;6;8;14;287001;4.87803178386138e-05
皇家贝希摩斯宝宝;3;21;24;287001;8.362340200905224e-05
骆寻tz;1;14;15;287001;5.226462625565764e-05
Amero404;1;2;3;287001;1.045292525113153e-05
利维坦bot二号机;31;2136;2167;287001;0.007550496339734008
蜜雪冰城加雷马一号店;1;15;16;287001;5.574893467270149e-05
哈李菠菜LLL;2;10;12;287001;4.181170100452612e-05
利维坦bot二号机;33;657;690;287001;0.002404172807760252
69岁火辣寡妇岫;3;3;6;287001;2.090585050226306e-05
无界AI;3;7;10;287001;3.484308417043843e-05
是凌凌子耶;1;5;6;287001;2.090585050226306e-05
好不了一点n;1;1;2;287001;6.968616834087686e-06
csjin;8;14;22;287001;7.665478517496454e-05
-一定要瘦到90斤;1;1;2;287001;6.968616834087686e-06
-一口一个嘤嘤怪-;1;2;3;287001;1.045292525113153e-05
月华----;1;1;2;287001;6.968616834087686e-06
wrp不想喝奶茶;2;1;3;287001;1.045292525113153e-05
is双循环;3;7;10;287001;3.484308417043843e-05
风寈云淡;1;5;6;287001;2.090585050226306e-05
伊吹茶依;1;11;12;287001;4.181170100452612e-05
雨中曲漫话;1;7;8;287001;2.7874467336350744e-05
鸣泣哔哔;13;364;377;287001;0.0013135842732255288
孙冒泡;4;5;9;287001;3.135877575339459e-05
插话太师;1;6;7;287001;2.43901589193069e-05
Browncoffee_May;3;15;18;287001;6.271755150678917e-05
小狗香芋派;3;5;8;287001;2.7874467336350744e-05
悄悄不然;2;3;5;287001;1.7421542085219216e-05
冷圈选手吐槽;33;426;459;287001;0.0015992975634231239
晋江鸽子半夜雨;7;16;23;287001;8.01390935920084e-05
永远爱看毒唯大妈网上发疯_;-20;3524;3504;287001;0.012209016693321625
Satan的女儿;1;2;3;287001;1.045292525113153e-05
折春去;3;8;11;287001;3.832739258748227e-05
互联网的一些事;5;5;10;287001;3.484308417043843e-05
东阳工艺美术;1;1;2;287001;6.968616834087686e-06
天龙八部2官方;5;7;12;287001;4.181170100452612e-05
霖与尘;17;714;731;287001;0.0025470294528590494
冷圈选手吐槽;17;131;148;287001;0.0005156776457224888
林菀_lin;8;7;15;287001;5.226462625565764e-05
安蕾尔;9;44;53;287001;0.00018466834610332368
夜司山风;1;2;3;287001;1.045292525113153e-05
寒墨韶彤;3;2;5;287001;1.7421542085219216e-05
samushine;1;10;11;287001;3.832739258748227e-05
共由彡每寿;23;74;97;287001;0.0003379779164532528
-淡墨裢澂zZ;1;20;21;287001;7.31704767579207e-05
姜来咕咕;2;2;4;287001;1.3937233668175372e-05
Zz钛钛子-备考版;9;31;40;287001;0.00013937233668175373
韶芍今天吃饭了吗;1;29;30;287001;0.00010452925251131529
_异次圆猫;1;3524;3525;287001;0.012282187170079546
肉坨肉坨肉坨肉;2;4;6;287001;2.090585050226306e-05
Sidelight侧光工坊;3;8;11;287001;3.832739258748227e-05
柘十五先生;2;2;4;287001;1.3937233668175372e-05
小福鑫骑士;5;5;10;287001;3.484308417043843e-05
无界AI;1;6;7;287001;2.43901589193069e-05
枫林晚名阁;2;58;60;287001;0.00020905850502263057
莓天发癫西瓜太郎;1;5;6;287001;2.090585050226306e-05
sunix;4;13;17;287001;5.9233243089745335e-05
Sakana水族馆;1;2;3;287001;1.045292525113153e-05
杪商十九;1;3;4;287001;1.3937233668175372e-05
-风砚厨-;11;361;372;287001;0.0012961627311403095
小特研究所;4;47;51;287001;0.000177699729269236
油画里的德拉科;2;59;61;287001;0.00021254281343967442
小葱跑快快;2;101;103;287001;0.00035888376695551586
小葱跑快快;2;100;102;287001;0.000355399458538472
菠萝依舟;1;5;6;287001;2.090585050226306e-05
Ai绘_Sicx本;2;4;6;287001;2.090585050226306e-05
星越AI;3;1;4;287001;1.3937233668175372e-05
木木木木之本;1;2;3;287001;1.045292525113153e-05
Sakana水族馆;1;1;2;287001;6.968616834087686e-06
大米的记忆;1;3;4;287001;1.3937233668175372e-05
Y园糖;6;22;28;287001;9.75606356772276e-05
溺水的大象_;4;15;19;287001;6.620185992383301e-05
菊小荷;2;1;3;287001;1.045292525113153e-05
崔紫剑;9;67;76;287001;0.00026480743969533205
是瑜不是鱼_Glasya;4;15;19;287001;6.620185992383301e-05
公子乔200;1;3;4;287001;1.3937233668175372e-05
写手吐槽bot_;25;790;815;287001;0.002839711359890732
写手吐槽bot_;43;1493;1536;287001;0.005351897728579343
AI-Doll;1;11;12;287001;4.181170100452612e-05
一只找路佯;4;12;16;287001;5.574893467270149e-05
多糖枕頭;4;66;70;287001;0.00024390158919306902
Dearest甜;1;4;5;287001;1.7421542085219216e-05
狗狐狸洗衣机;1;1;2;287001;6.968616834087686e-06
大笨蛋你在里面吗;11;242;253;287001;0.0008815300295120923
Armstrong的空军之翼;12;39;51;287001;0.000177699729269236
宝树;2;633;635;287001;0.0022125358448228404
宝藏图文集;1;1;2;287001;6.968616834087686e-06
_玉米人_;2;1;3;287001;1.045292525113153e-05
Ai绘_Sicx本;1;6;7;287001;2.43901589193069e-05
钮祜禄椒今就;1;2;3;287001;1.045292525113153e-05
AI-Doll;2;12;14;287001;4.87803178386138e-05
ID莫古蘑菇;1;1;2;287001;6.968616834087686e-06
斜谷云深;1;1;2;287001;6.968616834087686e-06
若暮lmQwQ;1;2;3;287001;1.045292525113153e-05
只谈风月猫;1;633;634;287001;0.0022090515364057966
康波在召唤;1;287000;287001;287001;1.0
小葱跑快快;7;204;211;287001;0.0007351890759962509
小葱跑快快;1;18;19;287001;6.620185992383301e-05
蓝色巨大喷流;1;6;7;287001;2.43901589193069e-05
青柠qing-ning;1;2;3;287001;1.045292525113153e-05
星越AI;2;1;3;287001;1.045292525113153e-05
夏殇是只温柔的鮟鱇鹅;29;39;68;287001;0.00023693297235898134
Allencarl;3;4;7;287001;2.43901589193069e-05
宝藏图文集;1;4;5;287001;1.7421542085219216e-05
番茄鱼Poet;3;6;9;287001;3.135877575339459e-05
無音零_;1;2;3;287001;1.045292525113153e-05
野山雀-aurora;1;1;2;287001;6.968616834087686e-06
冲子老教授;5;128;133;287001;0.0004634130194668311
杨杨和夏季;2;6;8;287001;2.7874467336350744e-05
小宋酱;1;1;2;287001;6.968616834087686e-06
雨中曲漫话;4;15;19;287001;6.620185992383301e-05
7沐森_;1;1;2;287001;6.968616834087686e-06
呆毛小媛;25;27;52;287001;0.00018118403768627983
杜雨AIGC;1;1;2;287001;6.968616834087686e-06
晚山颜-;1;5;6;287001;2.090585050226306e-05
古风知乎;56;1291;1347;287001;0.004693363437758056
HagawaKoori;1;1;2;287001;6.968616834087686e-06
短尾DW;3;6;9;287001;3.135877575339459e-05
亚特斯6174;7;12;19;287001;6.620185992383301e-05
电气木鱼_official;14;93;107;287001;0.0003728210006236912
Behance精选分享;1;12;13;287001;4.529600942156996e-05
一坛斟;1;2;3;287001;1.045292525113153e-05
Camellia--椿;1;1;2;287001;6.968616834087686e-06
古风画册;118;2155;2273;287001;0.007919833031940656
-2407-;3;18000;18003;287001;0.06272800443204031
电子便利贴;46;899;945;287001;0.0032926714541064318
猫咪拉锯战;2;17;19;287001;6.620185992383301e-05
冷圈选手吐槽;45;2640;2685;287001;0.009355368099762718
钮祜禄椒今就;4;1;5;287001;1.7421542085219216e-05
萝依妮雅;4;11;15;287001;5.226462625565764e-05
松子Matsuk0;3;31;34;287001;0.00011846648617949067
一辈子的诗情画意;1;1;2;287001;6.968616834087686e-06
猫咪拉锯战;1;22;23;287001;8.01390935920084e-05
RATPENCIL;27;450;477;287001;0.0016620151149299132
关于老板评测;239;1073;1312;287001;0.004571412643161522
小彤07_;0;4;4;287001;1.3937233668175372e-05
跳舞选手霜小英_;4;4;8;287001;2.7874467336350744e-05
碎碎雪;2;13;15;287001;5.226462625565764e-05
别熬夜了奥利奥;1;1;2;287001;6.968616834087686e-06
森晚52Hertz;2;1;3;287001;1.045292525113153e-05
勾股定理和你;1;14;15;287001;5.226462625565764e-05
绿蓝色二价普希铜;1;4;5;287001;1.7421542085219216e-05
清瓷故言;1;3;4;287001;1.3937233668175372e-05
夏末喵小团;6;19;25;287001;8.710771042609608e-05
宝瑞斯;1;2;3;287001;1.045292525113153e-05
燕知白;1;94;95;287001;0.0003310092996191651
我要够到我的月亮;1;4;5;287001;1.7421542085219216e-05
满天星人工智能生成视频工作室;1;1;2;287001;6.968616834087686e-06
香橙拌橘子;2;8;10;287001;3.484308417043843e-05
凯蒂小姐的蔷薇花园;1;1;2;287001;6.968616834087686e-06
风寈云淡;1;1;2;287001;6.968616834087686e-06
Senlody和喵都希亚贴贴;1;4;5;287001;1.7421542085219216e-05
Cc的艺术设计研究室;4;122;126;287001;0.0004390228605475242
HkingAuditore_四代目;3;9;12;287001;4.181170100452612e-05
梅林在上1899;2;1;3;287001;1.045292525113153e-05
小葱跑快快;2;160;162;287001;0.0005644579635611025
小葱跑快快;6;194;200;287001;0.0006968616834087686
豆包一只;12;61;73;287001;0.00025435451444420055
王牛鸡腿堡;1;2;3;287001;1.045292525113153e-05
猊卡;5;5;10;287001;3.484308417043843e-05
教设计的优优;1;25;26;287001;9.059201884313991e-05
电商品牌报;1;17;18;287001;6.271755150678917e-05
写手吐槽bot_;6;99;105;287001;0.0003658523837896035
南灼艺术馆;1;3;4;287001;1.3937233668175372e-05
wan子源;38;164;202;287001;0.0007038303002428563
优设AIGC;1;14;15;287001;5.226462625565764e-05
叶子猪梦幻西游专区;1;2;3;287001;1.045292525113153e-05
希希希大吴;5;15;20;287001;6.968616834087687e-05
炸虾奶油泡;1;2;3;287001;1.045292525113153e-05
ID莫古蘑菇;1;1;2;287001;6.968616834087686e-06
_Polaroid愛;1;1;2;287001;6.968616834087686e-06
知识匠;3;15;18;287001;6.271755150678917e-05
猩工坊;2;4;6;287001;2.090585050226306e-05
菜爷CY;77;1741;1818;287001;0.006334472702185707
爱吃胡萝ber_黑魔仙小月;11;17;28;287001;9.75606356772276e-05
菜鸟是我我就是菜鸟;1;1;2;287001;6.968616834087686e-06
Browncoffee_May;3;15;18;287001;6.271755150678917e-05
小树怜;1;10;11;287001;3.832739258748227e-05
希希希大吴;23;84;107;287001;0.0003728210006236912
7526389043_752;6;147;153;287001;0.000533099187807708
是憨憨雾了;1;1;2;287001;6.968616834087686e-06
無袋鼠;1;9;10;287001;3.484308417043843e-05
秋秋Debbie;1;1;2;287001;6.968616834087686e-06
弗兰克队长;1;2;3;287001;1.045292525113153e-05
咸鱼钉;3;2;5;287001;1.7421542085219216e-05
任城融媒;-1;3;2;287001;6.968616834087686e-06
岚山发布;10;23;33;287001;0.00011498217776244682
威海日报;10;20;30;287001;0.00010452925251131529
anchovy___;1;1;2;287001;6.968616834087686e-06
希希希大吴;4;23;27;287001;9.407632726018377e-05
眷海游鲸;1;4;5;287001;1.7421542085219216e-05
不被找到的用户;1;3;4;287001;1.3937233668175372e-05
兔贰佰;3;20;23;287001;8.01390935920084e-05
Paintmybanistersblue;3;1;4;287001;1.3937233668175372e-05
_Mus_;1;9336;9337;287001;0.03253298768993836
油画里的德拉科;13;173;186;287001;0.0006480813655701548
漆戈-;1;61;62;287001;0.00021602712185671828
你们豹鹿了bot;2;20;22;287001;7.665478517496454e-05
Candy南宫;6;12;18;287001;6.271755150678917e-05
PandaFans_Syao;3;23;26;287001;9.059201884313991e-05
微胖microfat;5;8;13;287001;4.529600942156996e-05
DantE-驹仔蛋挞;2;3;5;287001;1.7421542085219216e-05
隐月啾;1;9336;9337;287001;0.03253298768993836
红莲_猫快回来改;1;2;3;287001;1.045292525113153e-05
穗小黎;5;12;17;287001;5.9233243089745335e-05
屋顶冲浪板;1;4;5;287001;1.7421542085219216e-05
猩工坊;1;1;2;287001;6.968616834087686e-06
漱石枕流;3;66;69;287001;0.00024041728077602516
在森林里种只猫;1;1;2;287001;6.968616834087686e-06
祤栀yz;2;6;8;287001;2.7874467336350744e-05
小葱跑快快;12;597;609;287001;0.0021219438259797003
听风念序织_;2;19;21;287001;7.31704767579207e-05
大熊呀嘤嘤;1;1;2;287001;6.968616834087686e-06
被美帝解霸凌的一生;2;3;5;287001;1.7421542085219216e-05
平安南京;1;145;146;287001;0.0005087090288884011
铁血夏推绝不认输;1;21;22;287001;7.665478517496454e-05
满月陨石的背面;2;1;3;287001;1.045292525113153e-05
齐鲁电视台;3;9;12;287001;4.181170100452612e-05
一大杯冰冻丧茶茶;1;1;2;287001;6.968616834087686e-06
無機霧質;2;5;7;287001;2.43901589193069e-05
Samei_xuan;2;4;6;287001;2.090585050226306e-05
社畜茶水间;41;240;281;287001;0.0009790906651893198
海盐冰淇淋布丁球;2;11;13;287001;4.529600942156996e-05
小葱跑快快;20;736;756;287001;0.0026341371632851453
十一颗栗子liz;1;9336;9337;287001;0.03253298768993836
宝藏图文集;2;4;6;287001;2.090585050226306e-05
MrDXXXXERROR;1;9336;9337;287001;0.03253298768993836
揪猫软妹孙小杭;1;10;11;287001;3.832739258748227e-05
敲里脑瓜;2;1;3;287001;1.045292525113153e-05
小葱跑快快;3;324;327;287001;0.0011393688523733366
封建冻干;1;9;10;287001;3.484308417043843e-05
PainT八邻域;1;8;9;287001;3.135877575339459e-05
搞某人;9;19;28;287001;9.75606356772276e-05
优设;1;59;60;287001;0.00020905850502263057
超闪小路denden;2;4;6;287001;2.090585050226306e-05
不良艺;1;21;22;287001;7.665478517496454e-05
哗哗huahua哗哗;1;6;7;287001;2.43901589193069e-05
代号阿拉哈托;3;8;11;287001;3.832739258748227e-05
月半狼叫;3;9336;9339;287001;0.03253995630677245
MMZVP;1;3;4;287001;1.3937233668175372e-05
舒国华的微博;1;5;6;287001;2.090585050226306e-05
猹斯拉;21;134;155;287001;0.0005400678046417957
木子想要money;6;1;7;287001;2.43901589193069e-05
格里芬匿名版;10;81;91;287001;0.00031707206595098974
建华速写赵建华;2;104;106;287001;0.00036933669220664736
张虎博hubostudio;3;13;16;287001;5.574893467270149e-05
暗哑行与秋_;0;4;4;287001;1.3937233668175372e-05
某不知名网友震;1;6;7;287001;2.43901589193069e-05
于文平Turman;1;5;6;287001;2.090585050226306e-05
速溶苹果好评发售中;1;5;6;287001;2.090585050226306e-05
苏莉安aton;2;7;9;287001;3.135877575339459e-05
行云过江夏22;4;23;27;287001;9.407632726018377e-05
品牌设计视觉;14;79;93;287001;0.0003240406827850774
复活的鲸鱼_;1;2;3;287001;1.045292525113153e-05
whiteflowers153052412;-1;1;0;287001;0.0
连彧Y;5;18;23;287001;8.01390935920084e-05
DantE-驹仔蛋挞;1;2;3;287001;1.045292525113153e-05
whiteflowers153052412;1;1;2;287001;6.968616834087686e-06
whiteflowers153052412;1;1;2;287001;6.968616834087686e-06
whiteflowers153052412;1;1;2;287001;6.968616834087686e-06
爱辣爱美人;5;58;63;287001;0.0002195114302737621
布偶米米糊;1;3;4;287001;1.3937233668175372e-05
AI-Doll;1;11;12;287001;4.181170100452612e-05
在伦敦读艺术;1;130;131;287001;0.00045644440263274347
皮卡智能AI视觉平台;2;3;5;287001;1.7421542085219216e-05
Sakana水族馆;1;9;10;287001;3.484308417043843e-05
冬月拾八-;3;4;7;287001;2.43901589193069e-05
陳莫斯;2;3;5;287001;1.7421542085219216e-05
古塔古观古古咕;1;3;4;287001;1.3937233668175372e-05
二叉又又又木;1;1;2;287001;6.968616834087686e-06
午言禾子;2;3;5;287001;1.7421542085219216e-05
金融八卦女;3;109;112;287001;0.0003902425427089104
地瓜熊老六;2;28;30;287001;0.00010452925251131529
科技小贝;766;7530;8296;287001;0.028905822627795723
互联网八哥;45;199;244;287001;0.0008501712537586977
素质堪比散兵;52;40;92;287001;0.0003205563743680336
ECHOFOOTBALL;7;143;150;287001;0.0005226462625565765
爆炸列车424;3;3;6;287001;2.090585050226306e-05
王芝士和王蛋糕;1;10;11;287001;3.832739258748227e-05
極惡逃兵;1;37;38;287001;0.00013240371984766603
李大白活Swoosh;2;4;6;287001;2.090585050226306e-05
yoly莜莉;1;18;19;287001;6.620185992383301e-05
泡-芙丶;3;73;76;287001;0.00026480743969533205
Jozhi----;1;1551;1552;287001;0.005407646663252045
Ai绘_Sicx本;1;3;4;287001;1.3937233668175372e-05
星球财经;201;203;404;287001;0.0014076606004857126
YZSKII;2;1;3;287001;1.045292525113153e-05
西安榜姐;1;307;308;287001;0.0010731669924495036
元宇宙-比特杀手;2;4;6;287001;2.090585050226306e-05
憨憨行为图鉴;17;81;98;287001;0.0003414622248702966
恋爱投递员;21;97;118;287001;0.0004111483932111735
内涵台长;20;106;126;287001;0.0004390228605475242
彩透小熊手;1;1;2;287001;6.968616834087686e-06
南图先生-文子;1;3;4;287001;1.3937233668175372e-05
KSC的4S;1;40;41;287001;0.00014285664509879756
囧TL-沉默的小羊咩咩吓得疯癫了;1;5;6;287001;2.090585050226306e-05
什么都吃食物中毒;2;2;4;287001;1.3937233668175372e-05
Sakana水族馆;1;5;6;287001;2.090585050226306e-05
SCIA_MACHY;2;15;17;287001;5.9233243089745335e-05
sunix;45;176;221;287001;0.0007700321601666893
乌拉拉_-v-;1;1;2;287001;6.968616834087686e-06
黄金炸鸡半只加大薯谢谢;1;5;6;287001;2.090585050226306e-05
我也想要ssr鸭;6;40;46;287001;0.0001602781871840168
今夜格尔曼加入狩猎;3;257;260;287001;0.0009059201884313992
萨达哈鲁的哈喇子;2;2;4;287001;1.3937233668175372e-05
七的质数和;1;3;4;287001;1.3937233668175372e-05
日照日报官博;22;17;39;287001;0.00013588802826470988
崂山融媒;6;9;15;287001;5.226462625565764e-05
Dokey_ee;2;9;11;287001;3.832739258748227e-05
济南历城融媒;10;13;23;287001;8.01390935920084e-05
平原县融媒体中心;1;2;3;287001;1.045292525113153e-05
你才屁咕瓣;10;55;65;287001;0.0002264800471078498
张二狗笑口常开;2;1;3;287001;1.045292525113153e-05
小雅的天下苏醒了;3;11;14;287001;4.87803178386138e-05
东营网官方微博;5;5;10;287001;3.484308417043843e-05
恶童在养猫;14;573;587;287001;0.002045289040804736
70s画师;2;3;5;287001;1.7421542085219216e-05
原来是城堡啊;1;3;4;287001;1.3937233668175372e-05
三月青烟四月雨;5;18;23;287001;8.01390935920084e-05
楊永芯02;2;3;5;287001;1.7421542085219216e-05
草履虫想拖稿;2;2;4;287001;1.3937233668175372e-05
休宝可爱捏;1;5;6;287001;2.090585050226306e-05
Simon的白日梦;20;527;547;287001;0.001905916704122982
亡鸟-;1;13;14;287001;4.87803178386138e-05
muss_1;1;6;7;287001;2.43901589193069e-05
什么都吃食物中毒;1;3;4;287001;1.3937233668175372e-05
晋江鸽子半夜雨;5;16;21;287001;7.31704767579207e-05
Jokielicious;25;10000;10025;287001;0.034930191880864526
_World_exe;1;4;5;287001;1.7421542085219216e-05
PuppyPigeonsss;2;1;3;287001;1.045292525113153e-05
福圆美里厨;1;7;8;287001;2.7874467336350744e-05
AI绘画精选;1;1;2;287001;6.968616834087686e-06
无糖小狗薄荷糖;2;11;13;287001;4.529600942156996e-05
LUVEleven;1;2;3;287001;1.045292525113153e-05
TIANYU2FM;1;4;5;287001;1.7421542085219216e-05
某不知名网友震;1;6;7;287001;2.43901589193069e-05
巧克力蛋糕厨;3;24;27;287001;9.407632726018377e-05
潮玩客;2;8;10;287001;3.484308417043843e-05
张虎博hubostudio;1;4;5;287001;1.7421542085219216e-05
md2_;3;38;41;287001;0.00014285664509879756
鱼琴o_o;1;1;2;287001;6.968616834087686e-06
娃圈洞娘;51;1721;1772;287001;0.00617419451500169
元宇宙-比特杀手;10;33;43;287001;0.00014982526193288526
我妻鱼傻;1;3;4;287001;1.3937233668175372e-05
迷失在地球的婧;1;3;4;287001;1.3937233668175372e-05
DantE-驹仔蛋挞;1;3;4;287001;1.3937233668175372e-05
yoly莜莉;102;3612;3714;287001;0.012940721460900834
ShowMeAI研究中心;2;2;4;287001;1.3937233668175372e-05
帆波;3;1;4;287001;1.3937233668175372e-05
还是一碗泡面;3;52;55;287001;0.00019163696293741136
我和小红猫不结婚很难收场;2;5;7;287001;2.43901589193069e-05
空中_飞马;1;2;3;287001;1.045292525113153e-05
洋在坦途;3;8;11;287001;3.832739258748227e-05
笑点叔叔;1;1;2;287001;6.968616834087686e-06
知秋工作室官博;4;1;5;287001;1.7421542085219216e-05
热评学姐;1;2;3;287001;1.045292525113153e-05
大脸猫3202青春版;1;2;3;287001;1.045292525113153e-05
除了你的声音之外毫无救赎啊;1;1;2;287001;6.968616834087686e-06
SocialBook海外网红号;1;2;3;287001;1.045292525113153e-05
小壶妖的壶;12;117;129;287001;0.00044947578579865576
·黑金兔兔厨·;2;9;11;287001;3.832739258748227e-05
imluffy路辉;6;54;60;287001;0.00020905850502263057
CHRONICLE爱丽C;1;3;4;287001;1.3937233668175372e-05
张荆_婚姻继承律师;3;16;19;287001;6.620185992383301e-05
麻我道;-3;2;-1;287001;-3.484308417043843e-06
侃见财经;421;373;794;287001;0.0027665408831328113
闲谈记;421;442;863;287001;0.0030069581639088367
AI-Doll;1;9;10;287001;3.484308417043843e-05
狂妄画集;1;12;13;287001;4.529600942156996e-05
海曙检察;1;3;4;287001;1.3937233668175372e-05
斜谷云深;1;1;2;287001;6.968616834087686e-06
好崩溃aaaaaaa;2;11000;11002;287001;0.03833436120431636
好丽友派的好朋友;2;4;6;287001;2.090585050226306e-05
南图先生-文子;1;1;2;287001;6.968616834087686e-06
无界AI;8;82;90;287001;0.0003135877575339459
我菟鸦;1;2;3;287001;1.045292525113153e-05
毛家小仙女;-1;6;5;287001;1.7421542085219216e-05
山木山木山;2;2;4;287001;1.3937233668175372e-05
写手吐槽bot_;14;246;260;287001;0.0009059201884313992
_祝菊艳_;3;45;48;287001;0.00016724680401810447
狸吉君;2;4;6;287001;2.090585050226306e-05
_北巷_;2;93;95;287001;0.0003310092996191651
PromptEngineer;1;1;2;287001;6.968616834087686e-06
Sakana水族馆;1;5;6;287001;2.090585050226306e-05
仿生鳐鱼;2;4;6;287001;2.090585050226306e-05
狸吉君;3;5;8;287001;2.7874467336350744e-05
小葱跑快快;3;107;110;287001;0.0003832739258748227
重庆熬夜冠军_f;2;1;3;287001;1.045292525113153e-05
泡-芙丶;1;29;30;287001;0.00010452925251131529
绀朱;2;2;4;287001;1.3937233668175372e-05
天使动漫谐星战术研究院;2;4;6;287001;2.090585050226306e-05
科技号角;4;23;27;287001;9.407632726018377e-05
每天炼点丹;4;7;11;287001;3.832739258748227e-05
7526389043_752;12;415;427;287001;0.001487799694077721
不Zexi你是天才;1;2;3;287001;1.045292525113153e-05
设计精选;6;41;47;287001;0.00016376249560106062
西柚希佑;1;3;4;287001;1.3937233668175372e-05
园园园园园子a;1;1;2;287001;6.968616834087686e-06
木南叽叽鸡;7;133;140;287001;0.00048780317838613803
月神幻兔;1;126;127;287001;0.00044250716896456806
牧羊阿卡;1;5;6;287001;2.090585050226306e-05
潮流音符之重来也不迟版;61;399;460;287001;0.0016027818718401677
疯山老妖;2;2;4;287001;1.3937233668175372e-05
亚拉戈独角兽;1;14;15;287001;5.226462625565764e-05
速溶苹果好评发售中;1;5;6;287001;2.090585050226306e-05
啊嘞不花心;2;3;5;287001;1.7421542085219216e-05
小葱跑快快;5;185;190;287001;0.0006620185992383302
Sidelight侧光工坊;7;4;11;287001;3.832739258748227e-05
TynkingStar;0;1;1;287001;3.484308417043843e-06
长谷川葵葵;2;2;4;287001;1.3937233668175372e-05
Moki·;2;10;12;287001;4.181170100452612e-05
炭烤棉花柴;2;13;15;287001;5.226462625565764e-05
黄石头狗;4;39;43;287001;0.00014982526193288526
王盐Charles;3;34;37;287001;0.0001289194114306222
纱玖夜_;4;19;23;287001;8.01390935920084e-05
艾欧泽亚老头健走bot;1;618;619;287001;0.002156786910150139
木生Lau;51;110;161;287001;0.0005609736551440588
你丫才美工;11;87;98;287001;0.0003414622248702966
同舟女性互助;3;21;24;287001;8.362340200905224e-05
尼姆遗迹的失忆学者;2;21;23;287001;8.01390935920084e-05
csjin;3;13;16;287001;5.574893467270149e-05
youknowhoooo;1;1;2;287001;6.968616834087686e-06
李大白活Swoosh;2;1;3;287001;1.045292525113153e-05
魔都靴牲交流中心;11;31;42;287001;0.0001463409535158414
线线是点儿;2;2;4;287001;1.3937233668175372e-05
ss沙师弟;2;306;308;287001;0.0010731669924495036
sunix;15;48;63;287001;0.0002195114302737621
AI-Doll;2;12;14;287001;4.87803178386138e-05
朋克大玩家;1;1;2;287001;6.968616834087686e-06
给我打钱去站街;1;2;3;287001;1.045292525113153e-05
郝智伟;22;51;73;287001;0.00025435451444420055
麻宁;3;33;36;287001;0.00012543510301357835
Sakana水族馆;1;1;2;287001;6.968616834087686e-06
加刘景长;3;39;42;287001;0.0001463409535158414
姚凌宇;16;57;73;287001;0.00025435451444420055
泡-芙丶;8;104;112;287001;0.0003902425427089104
中国传媒大学;8;26;34;287001;0.00011846648617949067
怪博士李雷;6;10;16;287001;5.574893467270149e-05
泡-芙丶;2;59;61;287001;0.00021254281343967442
不良艺;2;22;24;287001;8.362340200905224e-05
晋江-潇湘碧影;32;151;183;287001;0.0006376284403190233
安迪斯晨风;41;379;420;287001;0.001463409535158414
泡-芙丶;1;40;41;287001;0.00014285664509879756
林深时见尧-Ken;8;2;10;287001;3.484308417043843e-05
量子位;5;38;43;287001;0.00014982526193288526
暗哑行与秋_;1;4;5;287001;1.7421542085219216e-05
AI-Doll;1;11;12;287001;4.181170100452612e-05
泡-芙丶;1;13;14;287001;4.87803178386138e-05
灰野胡椒;1;4;5;287001;1.7421542085219216e-05
致幻海島;1;1;2;287001;6.968616834087686e-06
无意义人生指南;1;1;2;287001;6.968616834087686e-06
bright瞳;1;6;7;287001;2.43901589193069e-05
slxjxjdiwodoeijr001;1;1;2;287001;6.968616834087686e-06
Ca_Expresso;1;99000;99001;287001;0.3449500175957575
风如狮子鸣;1;47;48;287001;0.00016724680401810447
听叶念;1;3;4;287001;1.3937233668175372e-05
西猫ZeroYau;15;95;110;287001;0.0003832739258748227
UCG一刀;2;10;12;287001;4.181170100452612e-05
不Zexi你是天才;2;1;3;287001;1.045292525113153e-05
白棋一步走错;1;1;2;287001;6.968616834087686e-06
心上小猫;2;13;15;287001;5.226462625565764e-05
OosakiNanaaa-;3;7;10;287001;3.484308417043843e-05
冲子老教授;3;76;79;287001;0.0002752603649464636
大单间;2;7;9;287001;3.135877575339459e-05
脸很红的黄黄;1;2;3;287001;1.045292525113153e-05
yoly莜莉;6;124;130;287001;0.0004529600942156996
甄蓁_插画师;2;10;12;287001;4.181170100452612e-05
艺术插画手绘;2;3;5;287001;1.7421542085219216e-05
煌祺Onibi;14;66;80;287001;0.00027874467336350746
__九磅十五便士__;1;250000;250001;287001;0.8710805885693778
elros;1;6;7;287001;2.43901589193069e-05
极光色的小蘑菇;1;4;5;287001;1.7421542085219216e-05
路人壬--;3;6;9;287001;3.135877575339459e-05
新闻晨报;4;1984;1988;287001;0.00692680513308316
琉玄;70;3082;3152;287001;0.010982540130522193
龍玉一_大苦猹子;1;5;6;287001;2.090585050226306e-05
-天与否-;1;7921;7922;287001;0.027602691279821324
电商行业;13;50;63;287001;0.0002195114302737621
Art_艺术映画;12;241;253;287001;0.0008815300295120923
拆台本尊;9;41;50;287001;0.00017421542085219215
海辛Hyacinth;7;27;34;287001;0.00011846648617949067
UCG一刀;11;24;35;287001;0.00012195079459653451
uniko小姐;1;7;8;287001;2.7874467336350744e-05
特发性嗜睡症;1;4;5;287001;1.7421542085219216e-05
科技种草君;38;77;115;287001;0.00040069546796004193
西猫ZeroYau;28;140;168;287001;0.0005853638140633656
坎瞳;3;25;28;287001;9.75606356772276e-05
猫侍十三;4;8;12;287001;4.181170100452612e-05
Ehey扣子;109;489;598;287001;0.0020836164333922183
elgol;9;45;54;287001;0.00018815265452036753
清弥川;4;4;8;287001;2.7874467336350744e-05
魔法制造机;1;48;49;287001;0.0001707311124351483
怎么一天天的;2;4;6;287001;2.090585050226306e-05
Vista看天下;18;231;249;287001;0.000867592795843917
浙江科普;1;5;6;287001;2.090585050226306e-05
于文平Turman;1;6;7;287001;2.43901589193069e-05
·苒苒呐·;6;6;12;287001;4.181170100452612e-05
神勇小白兎;1;3;4;287001;1.3937233668175372e-05
六月可可熊;1;9;10;287001;3.484308417043843e-05
闺蜜头像无水印bo;3;5;8;287001;2.7874467336350744e-05
镜与谨;1;2;3;287001;1.045292525113153e-05
科技圣斗士;9;35;44;287001;0.0001533095703499291
坂本露子;2;6;8;287001;2.7874467336350744e-05
冯小夏同学;2;11;13;287001;4.529600942156996e-05
爱照相的大丸子;1;1;2;287001;6.968616834087686e-06
骑摩托的糖小希;17;56;73;287001;0.00025435451444420055
燕北翔;3;2;5;287001;1.7421542085219216e-05
魔法制造机;11;597;608;287001;0.0021184595175626564
UCG一刀;9;20;29;287001;0.00010104494409427145
暗哑行与秋_;1;6;7;287001;2.43901589193069e-05
食肉刀刀匠;10;20;30;287001;0.00010452925251131529
喝咖啡的饕餮;1;20;21;287001;7.31704767579207e-05
花田阿花;7;42;49;287001;0.0001707311124351483
殊玉瓷;1;1;2;287001;6.968616834087686e-06
钱芳;34;294;328;287001;0.0011428531607903805
imluffy路辉;1;67;68;287001;0.00023693297235898134
暗哑行与秋_;2;4;6;287001;2.090585050226306e-05
云深处那束光;1;2;3;287001;1.045292525113153e-05
洪大宽;2;3;5;287001;1.7421542085219216e-05
Sakana水族馆;1;5;6;287001;2.090585050226306e-05
最爱正装胖熊;2;12;14;287001;4.87803178386138e-05
栗子liz同学;2;49;51;287001;0.000177699729269236
复调;19;80;99;287001;0.00034494653328734045
大雨儿本儿;17;376;393;287001;0.0013693332078982302
準备啵叽一口;8;20;28;287001;9.75606356772276e-05
AI-Doll;3;19;22;287001;7.665478517496454e-05
苦丁山;6;38;44;287001;0.0001533095703499291
淮里有颗橘子糖;2;4;6;287001;2.090585050226306e-05
我和小红猫不结婚很难收场;11;8;19;287001;6.620185992383301e-05
凄墨涵;8;33;41;287001;0.00014285664509879756
空想住人;2;1;3;287001;1.045292525113153e-05
某不知名网友震;8;11;19;287001;6.620185992383301e-05
痞兴;1;1;2;287001;6.968616834087686e-06
limaric;6;11;17;287001;5.9233243089745335e-05
用户6285982974;1;3;4;287001;1.3937233668175372e-05
小葱跑快快;16;625;641;287001;0.0022334416953251036
UCG一刀;1;8;9;287001;3.135877575339459e-05
美首;12;165;177;287001;0.0006167225898167602
杭州PC交流联萌;16;10;26;287001;9.059201884313991e-05
小小小小小2h-赫尔郝;1;3;4;287001;1.3937233668175372e-05
AfterGLOW_1015;2;11;13;287001;4.529600942156996e-05
牧羊阿卡;1;3;4;287001;1.3937233668175372e-05
萝依妮雅;1;9;10;287001;3.484308417043843e-05
娱姐不打烊;3;3;6;287001;2.090585050226306e-05
雪落樱花v;66;112;178;287001;0.0006202068982338041
月半狼叫;28;719;747;287001;0.0026027783875317506
星纪时代官方微博;21;28;49;287001;0.0001707311124351483
火山弹_Art;1;1;2;287001;6.968616834087686e-06
魔法制造机;1;11;12;287001;4.181170100452612e-05
亲要一杯狗血吗;13;139;152;287001;0.0005296148793906641
祝佳音;8;116;124;287001;0.00043205424371343655
INTPbot;14;66;80;287001;0.00027874467336350746
加刘景长;1;24;25;287001;8.710771042609608e-05
月神幻兔;1;174;175;287001;0.0006097539729826725
寒塘秋鹤;1;2;3;287001;1.045292525113153e-05
许嘉琪-StOrY;1;1;2;287001;6.968616834087686e-06
阿怪的健;1;2;3;287001;1.045292525113153e-05
还没登月的Ray;1;4326;4327;287001;0.01507660252054871
Simon_阿文;26;526;552;287001;0.0019233382462082013
小乙PHOTO;1;2;3;287001;1.045292525113153e-05
-猴涂-;1;1;2;287001;6.968616834087686e-06
与慕色-龙龙;2;5;7;287001;2.43901589193069e-05
用户5404247403;1;3;4;287001;1.3937233668175372e-05
你丫才美工;19;212;231;287001;0.0008048752443371277
哩哩哩鱼捏;1;3;4;287001;1.3937233668175372e-05
月神幻兔;3;232;235;287001;0.0008188124780053031
_神埼爱丽丝;1;4;5;287001;1.7421542085219216e-05
A小Z17;4;4;8;287001;2.7874467336350744e-05
李淳呐;1;3;4;287001;1.3937233668175372e-05
芒果妈妈;103;150;253;287001;0.0008815300295120923
赵铮-同志;10;47;57;287001;0.00019860557977149907
宝藏图文集;1;11;12;287001;4.181170100452612e-05
-清白不-;1;5;6;287001;2.090585050226306e-05
即刻;3;32;35;287001;0.00012195079459653451
写手吐槽bot_;46;1273;1319;287001;0.004595802802080829
UCG一刀;6;23;29;287001;0.00010104494409427145
你狂傲的浪要到此止住;2;3;5;287001;1.7421542085219216e-05
UCG一刀;1;2;3;287001;1.045292525113153e-05
敏瑜公主;1;1;2;287001;6.968616834087686e-06
猫仙姑姑;12;27;39;287001;0.00013588802826470988
iGame玩家俱乐部;8;11;19;287001;6.620185992383301e-05
UCG一刀;8;7;15;287001;5.226462625565764e-05
UCG一刀;13;6;19;287001;6.620185992383301e-05
sunix;3;23;26;287001;9.059201884313991e-05
糖蒜辣鸡堡;7;30;37;287001;0.0001289194114306222
海陆空三用羊;4;68;72;287001;0.0002508702060271567
凌丁_常立;1;7;8;287001;2.7874467336350744e-05
凌丁_常立;2;7;9;287001;3.135877575339459e-05
武汉新闻;1;2;3;287001;1.045292525113153e-05
东城文旅;2;3;5;287001;1.7421542085219216e-05
UCG一刀;6;12;18;287001;6.271755150678917e-05
无界AI;1;1;2;287001;6.968616834087686e-06
Moondeadline;1;2;3;287001;1.045292525113153e-05
少女婉儿-;2;7;9;287001;3.135877575339459e-05
量子位;2;4;6;287001;2.090585050226306e-05
用户5404247403;1;1;2;287001;6.968616834087686e-06
UCG一刀;4;18;22;287001;7.665478517496454e-05
-休烛;1;134;135;287001;0.0004703816363009188
神嘛事儿;33;474;507;287001;0.0017665443674412284
光之萤火;1;4;5;287001;1.7421542085219216e-05
彗星试做型;1;3;4;287001;1.3937233668175372e-05
ss隐形贫困人口;2;2;4;287001;1.3937233668175372e-05
mhs隔空喊话bot备用版;1;22;23;287001;8.01390935920084e-05
宇宙猫猫环游星球写歌版bot;1;48;49;287001;0.0001707311124351483
古风知乎;1;8;9;287001;3.135877575339459e-05
落星风铃;1;4;5;287001;1.7421542085219216e-05
刘冬子;71;278;349;287001;0.0012160236375483011
小乙PHOTO;1;2;3;287001;1.045292525113153e-05
李大白活Swoosh;1;1;2;287001;6.968616834087686e-06
电子自旋退相干;2;239000;239002;287001;0.8327566802903126
绘圈隔空喊话bot;21;22;43;287001;0.00014982526193288526
UCG一刀;5;9;14;287001;4.87803178386138e-05
阆山苑人;1;538;539;287001;0.0018780422367866314
穆寒;0;1781;1781;287001;0.006205553290755085
泡-芙丶;1;60;61;287001;0.00021254281343967442
晋江-潇湘碧影;1;151;152;287001;0.0005296148793906641
用户5404247403;1;1;2;287001;6.968616834087686e-06
画小二ing;2;8;10;287001;3.484308417043843e-05
UCG一刀;8;6;14;287001;4.87803178386138e-05
UCG一刀;2;2;4;287001;1.3937233668175372e-05
用户5404247403;1;1;2;287001;6.968616834087686e-06
被画画拳打脚踢bot;18;76;94;287001;0.00032752499120212124
被画画拳打脚踢bot;4;38;42;287001;0.0001463409535158414
泡-芙丶;3;90;93;287001;0.0003240406827850774
小葱跑快快;2;32;34;287001;0.00011846648617949067
黎天月;2;15;17;287001;5.9233243089745335e-05
imluffy路辉;1;2;3;287001;1.045292525113153e-05
宅阿阳;1;1;2;287001;6.968616834087686e-06
今年不想做咸鱼了;1;2;3;287001;1.045292525113153e-05
北京塞冬;18;313;331;287001;0.001153306086041512
献予被忘却的神祇们的垂怜经;1;1;2;287001;6.968616834087686e-06
狗界诗人;4;1;5;287001;1.7421542085219216e-05
月神幻兔;5;338;343;287001;0.0011951177870460382
UCG一刀;1;1;2;287001;6.968616834087686e-06
UCG一刀;3;4;7;287001;2.43901589193069e-05
画学反应;5;49;54;287001;0.00018815265452036753
yoly莜莉;14;217;231;287001;0.0008048752443371277
小马小动物;1243;3795;5038;287001;0.017553945805066883
imluffy路辉;1;2;3;287001;1.045292525113153e-05
md2_;35;192;227;287001;0.0007909380106689524
大小姐可乐吖;1;2;3;287001;1.045292525113153e-05
云曦主页;6;223;229;287001;0.00079790662750304
StarfireArt;1;3;4;287001;1.3937233668175372e-05
艾是全部的心跳;1;16;17;287001;5.9233243089745335e-05
ss沙师弟;2;188;190;287001;0.0006620185992383302
Judgement隔空喊話bot;3;51;54;287001;0.00018815265452036753
小涛;2;5;7;287001;2.43901589193069e-05
西猫ZeroYau;30;192;222;287001;0.0007735164685837331
CeciCola;2;1;3;287001;1.045292525113153e-05
UCG一刀;7;5;12;287001;4.181170100452612e-05
唐卯在人间;1;2;3;287001;1.045292525113153e-05
UCG一刀;10;13;23;287001;8.01390935920084e-05
Cc镰仓;1;1;2;287001;6.968616834087686e-06
万花谷无痕天工出品人形跟宠;2;1;3;287001;1.045292525113153e-05
平行視覺_;8;29;37;287001;0.0001289194114306222
东写西读01;1;1;2;287001;6.968616834087686e-06
望月者WW;10;55;65;287001;0.0002264800471078498
神影依水仙女人鱼;2;2;4;287001;1.3937233668175372e-05
同人女bot;17;359;376;287001;0.001310099964808485
非生日快乐;3;21;24;287001;8.362340200905224e-05
电影铃芽之旅;2;112;114;287001;0.00039721115954299813
三水起晚了;19;30;49;287001;0.0001707311124351483
百草园说你想说bot;2;13;15;287001;5.226462625565764e-05
Ai绘_Sicx本;1;3;4;287001;1.3937233668175372e-05
江鹤泉Gallatin;3;17;20;287001;6.968616834087687e-05
_寒秋立阳_;1;2;3;287001;1.045292525113153e-05
AKI-JIANG酱;8;58;66;287001;0.00022996435552489363
亚拉戈独角兽;1;12;13;287001;4.529600942156996e-05
以普遍理性而论破绽稍纵即逝;2;4;6;287001;2.090585050226306e-05
龍公子宿;2;3;5;287001;1.7421542085219216e-05
春卷;3;31;34;287001;0.00011846648617949067
作家叶倾城;20;117;137;287001;0.0004773502531350065
李涛PS;10;67;77;287001;0.0002682917481123759
月神幻兔;8;933;941;287001;0.0032787342204382564
世界桃跑冠军_清嵐re;1;2;3;287001;1.045292525113153e-05
豆乳米麻薯啦_;1;1;2;287001;6.968616834087686e-06
月神幻兔;3;262;265;287001;0.0009233417305166184
熱妮rr;2;3;5;287001;1.7421542085219216e-05
月神幻兔;1;198;199;287001;0.0006933773749917248
小氏灰太狼;2;288;290;287001;0.0010104494409427145
阴阳师你这里欠我的拿什么还;1;7;8;287001;2.7874467336350744e-05
imluffy路辉;2;26;28;287001;9.75606356772276e-05
黑月乱;6;57;63;287001;0.0002195114302737621
yoly莜莉;4;125;129;287001;0.00044947578579865576
_-Sagittarius-_;2;2;4;287001;1.3937233668175372e-05
UCG一刀;8;20;28;287001;9.75606356772276e-05
老白鸽不爱画画;1;2;3;287001;1.045292525113153e-05
摄影曾曾;1;2;3;287001;1.045292525113153e-05
三次人别来搞我;1;11;12;287001;4.181170100452612e-05
·蜗牛先生;4;11;15;287001;5.226462625565764e-05
玉言右芷;25;114;139;287001;0.0004843188699690942
Bobbie_Lee;32;522;554;287001;0.001930306863042289
陆浔川;5;12;17;287001;5.9233243089745335e-05
鱼熬姜;14;123;137;287001;0.0004773502531350065
海辛Hyacinth;16;152;168;287001;0.0005853638140633656
UCG一刀;-6;5;-1;287001;-3.484308417043843e-06
金城漫画;1;17;18;287001;6.271755150678917e-05
AI-Doll;2;8;10;287001;3.484308417043843e-05
插画师芜小娴;2;12;14;287001;4.87803178386138e-05
狗头老板;42;724;766;287001;0.002668980247455584
七嗷_7AO;3;2;5;287001;1.7421542085219216e-05
章鱼烧寿司卷;1;2;3;287001;1.045292525113153e-05
阿符Afu;5;4;9;287001;3.135877575339459e-05
香芋伊梦;5;2;7;287001;2.43901589193069e-05
喆FILM;2;9;11;287001;3.832739258748227e-05
UCG一刀;3;17;20;287001;6.968616834087687e-05
mhs隔空喊话bot备用版;11;24;35;287001;0.00012195079459653451
湮舟Kari;11;5;16;287001;5.574893467270149e-05
沧笙苌歌;21;130;151;287001;0.0005261305709736203
蓝色海洋龙猫;166;1871;2037;287001;0.007097536245518309
爱吃考卷的糖;1;10;11;287001;3.832739258748227e-05
Art_艺术映画;7;89;96;287001;0.00033449360803620894
Derrick_Zhang_;7;22;29;287001;0.00010104494409427145
T藤芒m;2;9;11;287001;3.832739258748227e-05
梨子兮饭;1;3;4;287001;1.3937233668175372e-05
用户5404247403;1;1;2;287001;6.968616834087686e-06
别偷我衣服bot;5;24;29;287001;0.00010104494409427145
Samuraiwu;7;101;108;287001;0.00037630530904073507
狂妄画集;1;15;16;287001;5.574893467270149e-05
星吟Singing;3;4;7;287001;2.43901589193069e-05
小葱跑快快;2;86;88;287001;0.0003066191406998582
许韬de微博;15;192;207;287001;0.0007212518423280755
_雪葵_等到王国之泪ver;2;11;13;287001;4.529600942156996e-05
尤林yulin;11;10;21;287001;7.31704767579207e-05
数字尾巴;4;37;41;287001;0.00014285664509879756
口舍先生;5;68;73;287001;0.00025435451444420055
周二珂周三鸽;11;7;18;287001;6.271755150678917e-05
UCG一刀;5;8;13;287001;4.529600942156996e-05
爱记仇的小熊猫;9;93;102;287001;0.000355399458538472
如何极速毕业;1;2;3;287001;1.045292525113153e-05
眠某爱gb;0;6;6;287001;2.090585050226306e-05
我不是鸭鸭我也不认识鸭鸭;2;5;7;287001;2.43901589193069e-05
美腻喵姐;3;21;24;287001;8.362340200905224e-05
龙鸽-不咕;2;2;4;287001;1.3937233668175372e-05
_夏萧_;4;5;9;287001;3.135877575339459e-05
非耶ye;8;16;24;287001;8.362340200905224e-05
尘世瑄宵;1;62000;62001;287001;0.2160306061651353
焦糖蛋黃派_;5;23;28;287001;9.75606356772276e-05
互联网的一些事;2;6;8;287001;2.7874467336350744e-05
洛栖ww;1;9;10;287001;3.484308417043843e-05
宅阿阳;1;1;2;287001;6.968616834087686e-06
有苏绥绥;2;28;30;287001;0.00010452925251131529
甄蓁_插画师;2;5;7;287001;2.43901589193069e-05
安吉的小七;5;24;29;287001;0.00010104494409427145
未检疫多余的小狗;1;27;28;287001;9.75606356772276e-05
狮子头萌萌;1;7;8;287001;2.7874467336350744e-05
萝依妮雅;1;4;5;287001;1.7421542085219216e-05
黑猫牛奶兔饲养员;1;4;5;287001;1.7421542085219216e-05
摇摇车皇后;1;1;2;287001;6.968616834087686e-06
只须一笑再一笑;1;5;6;287001;2.090585050226306e-05
A-Jino文字暮;1;15;16;287001;5.574893467270149e-05
阿尔萨鱼;13;112;125;287001;0.0004355385521304804
喵酱823;1;1;2;287001;6.968616834087686e-06
网际飞侠;3;24;27;287001;9.407632726018377e-05
布鲁索姆;1;1;2;287001;6.968616834087686e-06
UCG一刀;1;2;3;287001;1.045292525113153e-05
伊水_Uryan;5;109;114;287001;0.00039721115954299813
麻省理工科技评论;1;5;6;287001;2.090585050226306e-05
UCG一刀;1;3;4;287001;1.3937233668175372e-05
抹茶小乔So;3;28;31;287001;0.00010801356092835914
绀朱;1;2;3;287001;1.045292525113153e-05
越来越好的月亮;10;81;91;287001;0.00031707206595098974
电竞召唤师;10;122;132;287001;0.00045992871104978727
吃一口藕片;17;55;72;287001;0.0002508702060271567
蝉鸣的旋律;2;3;5;287001;1.7421542085219216e-05
灯泡电视机;1;3;4;287001;1.3937233668175372e-05
红绿灯的白bo;1;15;16;287001;5.574893467270149e-05
鬼晓得是我吧;12;228;240;287001;0.0008362340200905223
秘密栖息;9;15;24;287001;8.362340200905224e-05
小树怜;1;8;9;287001;3.135877575339459e-05
赵文涛书画;1;2;3;287001;1.045292525113153e-05
钛媒体APP;3;11;14;287001;4.87803178386138e-05
月光下的番薯粥;2;12;14;287001;4.87803178386138e-05
摸鱼大列巴;1;1;2;287001;6.968616834087686e-06
雾灯Emerald;45;205;250;287001;0.0008710771042609608
抹茶all;2;24;26;287001;9.059201884313991e-05
洗洁精拌柠檬;1;11;12;287001;4.181170100452612e-05
寻找人生顶级玩家;1;3;4;287001;1.3937233668175372e-05
狗牙刷儿;1;4;5;287001;1.7421542085219216e-05
吃瓜岱宗岱;14;172;186;287001;0.0006480813655701548
UCG一刀;5;3;8;287001;2.7874467336350744e-05
妖舞_YOWU;14;43;57;287001;0.00019860557977149907
乐看永州;1;1;2;287001;6.968616834087686e-06
喜欢梦黎的书翁;2;7;9;287001;3.135877575339459e-05
UCG一刀;2;2;4;287001;1.3937233668175372e-05
虚数之树观测平台;3;3;6;287001;2.090585050226306e-05
丸仔码头·_·;1;28;29;287001;0.00010104494409427145
明日方舟绮良同人主页;3;11;14;287001;4.87803178386138e-05
如是生活;123;140;263;287001;0.0009163731136825307
泡-芙丶;1;31;32;287001;0.00011149786934540298
WSS不爱吃豆腐;2;2;4;287001;1.3937233668175372e-05
你可以非常信任小葵;1;6;7;287001;2.43901589193069e-05
夜长安淇;2;3;5;287001;1.7421542085219216e-05
封云朔雪;1;6;7;287001;2.43901589193069e-05
甜-牛-奶-盒-子;1;5;6;287001;2.090585050226306e-05
不爱次蛋挞的蛋疼ET;1;15;16;287001;5.574893467270149e-05
用户6635976165;1;1;2;287001;6.968616834087686e-06
-错雪-;8;20;28;287001;9.75606356772276e-05
互因科技;8;61;69;287001;0.00024041728077602516
星瞳小女友;1;1;2;287001;6.968616834087686e-06
Archisha_;2;16;18;287001;6.271755150678917e-05
手握科技;26;121;147;287001;0.000512193337305445
我一点都不困ww;3;15;18;287001;6.271755150678917e-05
zyting0815;1;5;6;287001;2.090585050226306e-05
喵斯拉大王二号机;4;30;34;287001;0.00011846648617949067
Archisha_;1;20;21;287001;7.31704767579207e-05
黑白旗帜Othello;3;7;10;287001;3.484308417043843e-05
不要炸号了啊;1;6;7;287001;2.43901589193069e-05
龙湖在东北;2;1;3;287001;1.045292525113153e-05
喵呜哩斯基;1;20;21;287001;7.31704767579207e-05
2023小李要加油哦;1;1;2;287001;6.968616834087686e-06
斯库里;24;470;494;287001;0.0017212483580196585
小衍学姐;53;340;393;287001;0.0013693332078982302
非李莫属;1;3;4;287001;1.3937233668175372e-05
歪果网红的日常;2;21;23;287001;8.01390935920084e-05
colouration;1;1;2;287001;6.968616834087686e-06
H8M4CH1N3;1;25;26;287001;9.059201884313991e-05
天使动漫谐星战术研究院;3;5;8;287001;2.7874467336350744e-05
陌黎喜欢艾辰;6;56;62;287001;0.00021602712185671828
UCG一刀;6;12;18;287001;6.271755150678917e-05
江小昀y;55;986;1041;287001;0.0036271650621426408
科技电玩;728;7047;7775;287001;0.02709049794251588
叨哥胡侃;31;341;372;287001;0.0012961627311403095
VV的元宇宙日记;303;947;1250;287001;0.004355385521304804
UCG一刀;8;12;20;287001;6.968616834087687e-05
零重力瓦力;38;241;279;287001;0.0009721220483552322
Daniel·PU;1;3;4;287001;1.3937233668175372e-05
哗哗huahua哗哗;3;18;21;287001;7.31704767579207e-05
来一杯海盐白桃冰冰茶;1;5;6;287001;2.090585050226306e-05
小葱跑快快;1;91;92;287001;0.0003205563743680336
蜀渝YOU;2;22;24;287001;8.362340200905224e-05
山奈zzz;1;7;8;287001;2.7874467336350744e-05
看见肥环的琵琶了吗;2;11;13;287001;4.529600942156996e-05
dsssjeiem;1;3;4;287001;1.3937233668175372e-05
你的大申突然出现;1;63;64;287001;0.00022299573869080595
小棉花咩团儿;2;882;884;287001;0.003080128640666757
宅阿阳;1;2;3;287001;1.045292525113153e-05
双标打脸机;1;6;7;287001;2.43901589193069e-05
热巴的小助理;1;39;40;287001;0.00013937233668175373
徐戈;3;25;28;287001;9.75606356772276e-05
林边清酒;3;22;25;287001;8.710771042609608e-05
cRush阶前雨;1;7;8;287001;2.7874467336350744e-05
-夜弦;4;40;44;287001;0.0001533095703499291
·蜗牛先生;4;4;8;287001;2.7874467336350744e-05
芝心牛乳糕切片;9;447;456;287001;0.0015888446381719925
破拆的拆;2;1;3;287001;1.045292525113153e-05
爱讲笑话的杰洛;2;23;25;287001;8.710771042609608e-05
Jim-hc;2;8;10;287001;3.484308417043843e-05
米叔啊;1;3;4;287001;1.3937233668175372e-05
烟萝秋;1;8;9;287001;3.135877575339459e-05
二条和飞飞;279;4020;4299;287001;0.014979041884871482
路辰的小卑鄙;12;43;55;287001;0.00019163696293741136
又见Zane;2;2;4;287001;1.3937233668175372e-05
小马叔叔不过河;1;2;3;287001;1.045292525113153e-05
噗噗噗_谁能理解;2;4;6;287001;2.090585050226306e-05
小葱跑快快;2;80;82;287001;0.0002857132901975951
阿嘎西AJIA;4;3;7;287001;2.43901589193069e-05
IT魅力;1;3;4;287001;1.3937233668175372e-05
原画大师君;22;78;100;287001;0.0003484308417043843
周思图;1;3;4;287001;1.3937233668175372e-05
零露泥泥;1;2;3;287001;1.045292525113153e-05
Art-DJ;32;448;480;287001;0.0016724680401810446
lI某人lI;1;2;3;287001;1.045292525113153e-05
春日樱满;2;2;4;287001;1.3937233668175372e-05
也许是藤原海;14;31;45;287001;0.00015679387876697294
韩锐_Arch;2;21;23;287001;8.01390935920084e-05
航空物语;10;96;106;287001;0.00036933669220664736
确定要我睁开眼吗;1;1;2;287001;6.968616834087686e-06
我是大侠Cc;2;8;10;287001;3.484308417043843e-05
枪版电影俱乐部;2;1;3;287001;1.045292525113153e-05
败子白歌;1;113;114;287001;0.00039721115954299813
黑城堡Epicastle;2;12;14;287001;4.87803178386138e-05
易企秀;1;2;3;287001;1.045292525113153e-05
AI绘画菌;2;5;7;287001;2.43901589193069e-05
绿蜥蜴X仔;9;80;89;287001;0.00031010344911690203
威斯特法伦洋葱报;2;16;18;287001;6.271755150678917e-05
徐铭远Meinn;1;14000;14001;287001;0.04878380214703085
森间飞鸟;5;397;402;287001;0.001400691983651625
泠年想要摸鱼;2;2;4;287001;1.3937233668175372e-05
识货少年;53;341;394;287001;0.001372817516315274
小马叔叔不过河;2;1;3;287001;1.045292525113153e-05
乌鸦校尉;25;235;260;287001;0.0009059201884313992
梅用的废卡;7;162;169;287001;0.0005888481224804095
努力奋斗的琳吖吖;5;5;10;287001;3.484308417043843e-05
鲈鱼爱芦苇;1;4;5;287001;1.7421542085219216e-05
Aoi_ioA的小屋;1;1;2;287001;6.968616834087686e-06
Cc的艺术设计研究室;1;10;11;287001;3.832739258748227e-05
每天学点心理学;20;43;63;287001;0.0002195114302737621
Cc的艺术设计研究室;3;75;78;287001;0.00027177605652941976
UCG一刀;8;4;12;287001;4.181170100452612e-05
胜利主义章北海;91;514;605;287001;0.002108006592311525
慵懒光影;1;2;3;287001;1.045292525113153e-05
小葱跑快快;1;43;44;287001;0.0001533095703499291
双椒清柠;1;9;10;287001;3.484308417043843e-05
华尔街见闻APP;1;7;8;287001;2.7874467336350744e-05
福布斯中文网;3;13;16;287001;5.574893467270149e-05
伪奋斗者-MK;1;1;2;287001;6.968616834087686e-06
潮新闻;1;2;3;287001;1.045292525113153e-05
清秋微抹;1;2;3;287001;1.045292525113153e-05
热可乐Even;2;1;3;287001;1.045292525113153e-05
青州广电;1;3;4;287001;1.3937233668175372e-05
我的昵称不记得了;9;34;43;287001;0.00014982526193288526
互因科技;4;28;32;287001;0.00011149786934540298
小豪_art;4;6;10;287001;3.484308417043843e-05
匡威不是匡威;1;1;2;287001;6.968616834087686e-06
低调的许亚鑫;3;11;14;287001;4.87803178386138e-05
月半狼叫;2;32;34;287001;0.00011846648617949067
不想氪了;1;1;2;287001;6.968616834087686e-06
网际飞侠;2;29;31;287001;0.00010801356092835914
爱国青年刘战神;13;90;103;287001;0.00035888376695551586
Jackie臣;3;6;9;287001;3.135877575339459e-05
悠悠哉哉种地梨;1;2;3;287001;1.045292525113153e-05
ai绘画素材菌;3;41;44;287001;0.0001533095703499291
三公里海与月;3;6;9;287001;3.135877575339459e-05
星辰HE大海;1;6;7;287001;2.43901589193069e-05
海辛Hyacinth;6;26;32;287001;0.00011149786934540298
骂骂咧咧的猫魅族;1;5;6;287001;2.090585050226306e-05
雾失楼台梦不见故里;1;1;2;287001;6.968616834087686e-06
小葱跑快快;1;93;94;287001;0.00032752499120212124
狮子座的鸿雁;1;1235;1236;287001;0.00430660520346619
KK就是康康;5;7;12;287001;4.181170100452612e-05
九九凉皮;2;6;8;287001;2.7874467336350744e-05
星话大白;19;92;111;287001;0.0003867582342918666
赵铮-同志;4;23;27;287001;9.407632726018377e-05
听王毛毛唱情歌;1;1;2;287001;6.968616834087686e-06
燕子sxsxsx;1;4;5;287001;1.7421542085219216e-05
优设;6;116;122;287001;0.00042508562687934885
互联网三爷;12;189;201;287001;0.0007003459918258125
大声牛防弹咖啡;9;3;12;287001;4.181170100452612e-05
卡奇Home;1;2;3;287001;1.045292525113153e-05
深圳科技园三毛;10;52;62;287001;0.00021602712185671828
文拉法辛弃疾Kiki;1;1;2;287001;6.968616834087686e-06
无界AI;1;2;3;287001;1.045292525113153e-05
大联大;8;5;13;287001;4.529600942156996e-05
张小平;8;16;24;287001;8.362340200905224e-05
雷子训画;1;1;2;287001;6.968616834087686e-06
皮卡皮卡森;3;5;8;287001;2.7874467336350744e-05
小葱跑快快;1;82;83;287001;0.00028919759861463897
小葱跑快快;11;311;322;287001;0.0011219473102881176
Sakana水族馆;1;1;2;287001;6.968616834087686e-06
台铃电动车;28;63;91;287001;0.00031707206595098974
只须一笑再一笑;1;4;5;287001;1.7421542085219216e-05
撒旦君_Satan;7;14;21;287001;7.31704767579207e-05
零重力瓦力;2;17;19;287001;6.620185992383301e-05
黄豆豆Oceana;-1;1;0;287001;0.0
爱困媛仔-Aubrey;1;6;7;287001;2.43901589193069e-05
遇涟漪;1;2;3;287001;1.045292525113153e-05
叶子猪梦幻西游专区;1;1;2;287001;6.968616834087686e-06
击中要海;2;73;75;287001;0.00026132313127828825
三千爻_;2;69;71;287001;0.00024738589761011284
未来科技范影儿;1;4;5;287001;1.7421542085219216e-05
用户不想被吞评论;1;5;6;287001;2.090585050226306e-05
外贸娘子薇;4;28;32;287001;0.00011149786934540298
一帧秒创;1;2;3;287001;1.045292525113153e-05
开机不加电D630;1;2;3;287001;1.045292525113153e-05
Bobbie_Lee;8;22;30;287001;0.00010452925251131529
无界AI;1;1;2;287001;6.968616834087686e-06
坐忘道小一一;2;37;39;287001;0.00013588802826470988
果壳中的田丰;1;5;6;287001;2.090585050226306e-05
小谷聊科技;2;1;3;287001;1.045292525113153e-05
艾同学阿;68;338;406;287001;0.0014146292173198003
栗子liz同学;302;7344;7646;287001;0.026641022156717223
UCG一刀;3;9;12;287001;4.181170100452612e-05
深海歌唱_深海人鱼恶魔陀;3;43;46;287001;0.0001602781871840168
UCG一刀;8;60;68;287001;0.00023693297235898134
老刀99;2;13;15;287001;5.226462625565764e-05
枫壁纸;3;53;56;287001;0.0001951212713544552
米饭君Umi;4;1;5;287001;1.7421542085219216e-05
羽最爱蒋子了;1;2;3;287001;1.045292525113153e-05
心赴虞;7;4;11;287001;3.832739258748227e-05
大思想家李继生;1;4;5;287001;1.7421542085219216e-05
聆_悠;1;2;3;287001;1.045292525113153e-05
风云学会陈经;310;2996;3306;287001;0.011519123626746945
自由2023影视;1;2;3;287001;1.045292525113153e-05
宇宙最后的答案是42;2;24;26;287001;9.059201884313991e-05
某不知名网友震;1;3;4;287001;1.3937233668175372e-05
Candy南宫;2;11;13;287001;4.529600942156996e-05
猫猫研究所优秀员工;0;25000;25000;287001;0.08710771042609608
小葱跑快快;2;294;296;287001;0.0010313552914449776
-旧曲重听-;2;7;9;287001;3.135877575339459e-05
三花鸡腿子_MOLLY;1;4;5;287001;1.7421542085219216e-05
洛圣督好青年;879;4529;5408;287001;0.018843139919373104
自由2023影视;1;3;4;287001;1.3937233668175372e-05
熬夜波比poppy吖;12;58;70;287001;0.00024390158919306902
小树怜;1;8;9;287001;3.135877575339459e-05
格拉斯的夜;1;1;2;287001;6.968616834087686e-06
画画的鲨鱼丹;3;7;10;287001;3.484308417043843e-05
每日悦色赏花;1;50;51;287001;0.000177699729269236
每日悦色赏花;4;124;128;287001;0.0004459914773816119
燕市哭歌;12;3;15;287001;5.226462625565764e-05
精神不稳定版修女;2;13;15;287001;5.226462625565764e-05
春在山野;1;476;477;287001;0.0016620151149299132
木南楠nan-;2;1;3;287001;1.045292525113153e-05
小葱跑快快;1;71;72;287001;0.0002508702060271567
小葱跑快快;1;49;50;287001;0.00017421542085219215
我爱邪魔;2;4;6;287001;2.090585050226306e-05
宇宙最后的答案是42;1;16;17;287001;5.9233243089745335e-05
张裕葡萄酒;2;5;7;287001;2.43901589193069e-05
推软妹君;11;513;524;287001;0.0018257776105309739
aBeiJLou_;2;8;10;287001;3.484308417043843e-05
米尔老C;1;2;3;287001;1.045292525113153e-05
陈擦皮;12;67;79;287001;0.0002752603649464636
营养师张婕;1;1;2;287001;6.968616834087686e-06
Maker17346;1;1;2;287001;6.968616834087686e-06
你的妮妮Ninii;2;1;3;287001;1.045292525113153e-05
私募排排网;4;19;23;287001;8.01390935920084e-05
范志红_原创营养信息;41;778;819;287001;0.0028536485935589076
自动的织织;1;1;2;287001;6.968616834087686e-06
南蛮秘鲁;1;10;11;287001;3.832739258748227e-05
MissMichellexxxx;3;3;6;287001;2.090585050226306e-05
悉喜翠流;2;3;5;287001;1.7421542085219216e-05
科技果儿;1;3;4;287001;1.3937233668175372e-05
沼跃古鱼鱼鱼;1;1;2;287001;6.968616834087686e-06
半条芩;3;22;25;287001;8.710771042609608e-05
珠宝设计联盟;1;12;13;287001;4.529600942156996e-05
福圆美里厨;1;9;10;287001;3.484308417043843e-05
星藏小兔;2;1;3;287001;1.045292525113153e-05
张宸闳;4;9;13;287001;4.529600942156996e-05
挤车族;2;2;4;287001;1.3937233668175372e-05
兔撕鸡大老爷;12;183;195;287001;0.0006794401413235494
重生之管人观众线上互殴bot;3;43;46;287001;0.0001602781871840168
老宴头bot;2;21000;21002;287001;0.07317744537475479
LAPow_er;1;4;5;287001;1.7421542085219216e-05
林曦晨c;2;17;19;287001;6.620185992383301e-05
疯批小桃沢;2;9;11;287001;3.832739258748227e-05
树君MQC;3;40;43;287001;0.00014982526193288526
就耀志心;2;21;23;287001;8.01390935920084e-05
宝玉xp;10;320;330;287001;0.0011498217776244682
三暝三日_san;14;239;253;287001;0.0008815300295120923
量子位;1;30;31;287001;0.00010801356092835914
_未通过图灵测试;8;8;16;287001;5.574893467270149e-05
被画画拳打脚踢bot;3;15;18;287001;6.271755150678917e-05
栗子liz同学;9;172;181;287001;0.0006306598234849356
猫疏_Matteo;1;3;4;287001;1.3937233668175372e-05
小仲景的投资日记;1;11;12;287001;4.181170100452612e-05
诛砂;1;4;5;287001;1.7421542085219216e-05
鲤DevinsLee;1;11;12;287001;4.181170100452612e-05
糊糊与猫不出门;3;1;4;287001;1.3937233668175372e-05
零重力瓦力;10;31;41;287001;0.00014285664509879756
菅原小吱厨;2;6;8;287001;2.7874467336350744e-05
黑人龙龙;1;1;2;287001;6.968616834087686e-06
李糯滟的南瓜;1;4;5;287001;1.7421542085219216e-05
变身成为胖蒜吧;1;1;2;287001;6.968616834087686e-06
钟视于你;2;207;209;287001;0.0007282204591621632
蓝花楹木香花与蔷薇;1;1;2;287001;6.968616834087686e-06
玄杰wax;2;3;5;287001;1.7421542085219216e-05
正正有点方;1;3;4;287001;1.3937233668175372e-05
小葱跑快快;2;111;113;287001;0.0003937268511259543
小葱跑快快;6;350;356;287001;0.0012404137964676081
月神幻兔;4;337;341;287001;0.0011881491702119505
书途汇;3;34;37;287001;0.0001289194114306222
无界AI;2;1;3;287001;1.045292525113153e-05
Flamebringer;2;3;5;287001;1.7421542085219216e-05
採一梦而压星河;2;25000;25002;287001;0.08711467904293016
MMM布;10;15;25;287001;8.710771042609608e-05
优设AIGC;2;17;19;287001;6.620185992383301e-05
any快跑any;1;4025;4026;287001;0.014027825687018512
Veracheng;2;1;3;287001;1.045292525113153e-05
孙继文一起向未来;2;112;114;287001;0.00039721115954299813
我就是汤圆妹;31;242;273;287001;0.0009512161978529692
壁纸颜究室;22;438;460;287001;0.0016027818718401677
ClaraRin;2;1;3;287001;1.045292525113153e-05
UCG一刀;6;5;11;287001;3.832739258748227e-05
白娟_Jolie;16;17;33;287001;0.00011498217776244682
不愿透露姓名的阿薯;9;17;26;287001;9.059201884313991e-05
紫荻锦茵;3;8;11;287001;3.832739258748227e-05
一脚一个大乱;1;2;3;287001;1.045292525113153e-05
马东不吃饭;4;13;17;287001;5.9233243089745335e-05
树君MQC;1;24;25;287001;8.710771042609608e-05
珠宝设计联盟;6;39;45;287001;0.00015679387876697294
krelly7;3;9;12;287001;4.181170100452612e-05
越默有点甜;2;6;8;287001;2.7874467336350744e-05
阿尔萨鱼;69;64;133;287001;0.0004634130194668311
网际飞侠;25;109;134;287001;0.00046689732788387497
周思图;1;2;3;287001;1.045292525113153e-05
-黑夜无梦魇-;2;29;31;287001;0.00010801356092835914
阿迟菌_Ulrica;2;10;12;287001;4.181170100452612e-05
MMM阿蒙;1;1;2;287001;6.968616834087686e-06
咖啡阿芙佳朵已售罄;7;1;8;287001;2.7874467336350744e-05
呜哇格格巫;6;25;31;287001;0.00010801356092835914
可我们都不是外星人;4;1;5;287001;1.7421542085219216e-05
万萤三酒;2;1;3;287001;1.045292525113153e-05
春在山野;4;475;479;287001;0.001668983731764001
在交界地与尸体约会;2;3;5;287001;1.7421542085219216e-05
欢乐马牛;8;25;33;287001;0.00011498217776244682
慵懒光影;1;1;2;287001;6.968616834087686e-06
SaintJoeYoung;3;50;53;287001;0.00018466834610332368
FluorescentYugiri;1;1;2;287001;6.968616834087686e-06
Bobbie_Lee;36;283;319;287001;0.001111494385036986
绒绒豆子;3;3;6;287001;2.090585050226306e-05
森间飞鸟;4;390;394;287001;0.001372817516315274
龙咻每天被貂貂帅哭一百遍;0;1;1;287001;3.484308417043843e-06
小树怜;5;17;22;287001;7.665478517496454e-05
伊吹茶依;2;2;4;287001;1.3937233668175372e-05
春日青与黑;1;1761;1762;287001;0.006139351430831251
logo设计匠;1;1761;1762;287001;0.006139351430831251
阿尔萨鱼;6;16;22;287001;7.665478517496454e-05
临水沉沙;2;3;5;287001;1.7421542085219216e-05
轩辕十四Rex;2;3;5;287001;1.7421542085219216e-05
冬至见春礼;18;8;26;287001;9.059201884313991e-05
_祝菊艳_;5;118;123;287001;0.0004285699352963927
显软;1;11;12;287001;4.181170100452612e-05
春在山野;6;334;340;287001;0.0011846648617949067
GitHubDaily;10;507;517;287001;0.001801387451611667
Jim-hc;2;5;7;287001;2.43901589193069e-05
跨境背包客;5;111;116;287001;0.0004041797763770858
张艺谋贴吧官博;2;6;8;287001;2.7874467336350744e-05
零重力瓦力;1;7;8;287001;2.7874467336350744e-05
山川洋子;1;28;29;287001;0.00010104494409427145
局长老油条;10;79;89;287001;0.00031010344911690203
GitHubDaily;5;74;79;287001;0.0002752603649464636
岛主WD;1;2;3;287001;1.045292525113153e-05
珠宝设计联盟;7;82;89;287001;0.00031010344911690203
乐希-流麻翻车版;2;8;10;287001;3.484308417043843e-05
北夏无旸;1;1;2;287001;6.968616834087686e-06
一夜知秋;1;7;8;287001;2.7874467336350744e-05
九点了饮茶;1;7;8;287001;2.7874467336350744e-05
志子同学;1;2;3;287001;1.045292525113153e-05
重庆见023;1;3;4;287001;1.3937233668175372e-05
一碗卷卷;2;1;3;287001;1.045292525113153e-05
北绫缪缪;1;2;3;287001;1.045292525113153e-05
极玥版法丹尼尔;1;1;2;287001;6.968616834087686e-06
星星小野109;1;1;2;287001;6.968616834087686e-06
谷茶荼荼;1;4;5;287001;1.7421542085219216e-05
万能的老师;4;67;71;287001;0.00024738589761011284
大鼻子仙女;4;1;5;287001;1.7421542085219216e-05
张洲;49;562;611;287001;0.002128912442813788
绿白橙灰;1;17000;17001;287001;0.059236727398162374
银河系消极客;1;1;2;287001;6.968616834087686e-06
光启野玫瑰;8;75;83;287001;0.00028919759861463897
勺布斯;48;1421;1469;287001;0.005118449064637405
小葱跑快快;1;42;43;287001;0.00014982526193288526
熬夜的猫v;1;1;2;287001;6.968616834087686e-06
Art-DJ;23;532;555;287001;0.0019337911714593329
乾达婆与紧那罗;10;110;120;287001;0.00041811701004526114
共由彡每寿;12;77;89;287001;0.00031010344911690203
晓春花事;1;1;2;287001;6.968616834087686e-06
小葱跑快快;4;228;232;287001;0.0008083595527541716
-明峻-;1;4;5;287001;1.7421542085219216e-05
你理解不了那算了;1;11;12;287001;4.181170100452612e-05
阿黎我姓黎;1;2;3;287001;1.045292525113153e-05
磁器CIQI;26;102;128;287001;0.0004459914773816119
雾日沉;16;69;85;287001;0.00029616621544872667
小蛮牛LT;4;22;26;287001;9.059201884313991e-05
逍遥凡公子;1;222;223;287001;0.000777000777000777
墨粉Ai数字人;1;2;3;287001;1.045292525113153e-05
以曦依夕亿曦;3;5;8;287001;2.7874467336350744e-05
咖bu啡;1;2;3;287001;1.045292525113153e-05
禾堂知暖渡春风;9;162;171;287001;0.0005958167393144972
杰森白;5;19;24;287001;8.362340200905224e-05
夹在菠萝里的猫;1;3;4;287001;1.3937233668175372e-05
零重力瓦力;3;9;12;287001;4.181170100452612e-05
赛博十块鉴定处;22;246;268;287001;0.0009337946557677499
让意好尝尝;1;3;4;287001;1.3937233668175372e-05
财入门;15;47;62;287001;0.00021602712185671828
花与星共眠;5;22;27;287001;9.407632726018377e-05
写手吐槽bot_;30;611;641;287001;0.0022334416953251036
bxalice;1;2;3;287001;1.045292525113153e-05
聚镁智能;6;5;11;287001;3.832739258748227e-05
春渡丶;1;3;4;287001;1.3937233668175372e-05
WELLWEELLL;4;40;44;287001;0.0001533095703499291
星闻快递;2;2;4;287001;1.3937233668175372e-05
泡-芙丶;2;110;112;287001;0.0003902425427089104
优设AIGC;5;193;198;287001;0.0006898930665746809
珠宝设计联盟;5;218;223;287001;0.000777000777000777
呼求圣洁;1;3;4;287001;1.3937233668175372e-05
jianzhongx;2;4;6;287001;2.090585050226306e-05
许有希光;1;7;8;287001;2.7874467336350744e-05
楚天音乐广播;1;2;3;287001;1.045292525113153e-05
ss沙师弟;6;231;237;287001;0.0008257810948393908
月神幻兔;5;261;266;287001;0.0009268260389336622
梦中旋转的猫;1;1;2;287001;6.968616834087686e-06
我用光作画;1;4;5;287001;1.7421542085219216e-05
红绿灯的白bo;7;52;59;287001;0.00020557419660558674
盈步婀娜Grace;1;3;4;287001;1.3937233668175372e-05
小葱跑快快;3;182;185;287001;0.0006445970571531109
小葱跑快快;1;48;49;287001;0.0001707311124351483
迷子的飞;2;1;3;287001;1.045292525113153e-05
枞莘;2;8;10;287001;3.484308417043843e-05
搞某人;40;69;109;287001;0.00037978961745777887
Janice_poles;1;3;4;287001;1.3937233668175372e-05
红薯哪里去哇_;1;4;5;287001;1.7421542085219216e-05
索拉大锦鲤;2;9;11;287001;3.832739258748227e-05
Schicksal_布洛芬绝赞依存中;1;2;3;287001;1.045292525113153e-05
migagao_咪嘎;7;63;70;287001;0.00024390158919306902
小万万是恶猫;3;1;4;287001;1.3937233668175372e-05
大p好运来啦;1;3;4;287001;1.3937233668175372e-05
uidhlee;2;2;4;287001;1.3937233668175372e-05
migagao_咪嘎;1;10;11;287001;3.832739258748227e-05
archah;1;1;2;287001;6.968616834087686e-06
Elk无痕穿戴甲刘斌老师;3;4;7;287001;2.43901589193069e-05
Jim-hc;1;6;7;287001;2.43901589193069e-05
ClaireLee茜;2;5;7;287001;2.43901589193069e-05
森间飞鸟;8;261;269;287001;0.0009372789641847938
阿尔萨鱼;3;81;84;287001;0.0002926819070316828
守望电影;39;26;65;287001;0.0002264800471078498
摧毁泡芙;6;3;9;287001;3.135877575339459e-05
咖啡-因过量;1;2;3;287001;1.045292525113153e-05
小手大艺术;1;12;13;287001;4.529600942156996e-05
打别人;1;23;24;287001;8.362340200905224e-05
腾讯程序员;33;154;187;287001;0.0006515656739871986
搞某人;7;9;16;287001;5.574893467270149e-05
荷糖月酱;2;7;9;287001;3.135877575339459e-05
可乐雪碧CD;43;184;227;287001;0.0007909380106689524
雷杯;4;36;40;287001;0.00013937233668175373
Art_艺术映画;1;82;83;287001;0.00028919759861463897
泡-芙丶;9;263;272;287001;0.0009477318894359254
张虎博hubostudio;1;2;3;287001;1.045292525113153e-05
推软妹君;9;246;255;287001;0.00088849864634618
8848究极手机项目发起人之一泰坦;2;4;6;287001;2.090585050226306e-05
科技电玩;555;5106;5661;287001;0.019724669948885196
莫-大湿;2;26;28;287001;9.75606356772276e-05
hekaptah;2;2;4;287001;1.3937233668175372e-05
EvanLeeCG;55;846;901;287001;0.0031393618837565027
我可太能宅了;2;13;15;287001;5.226462625565764e-05
卡里古拉深知自己被众人所爱;1;1;2;287001;6.968616834087686e-06
小章鱼噼里啪啦隔空喊话bot;1;49;50;287001;0.00017421542085219215
sunix;4;14;18;287001;6.271755150678917e-05
绘圈隔空喊话bot;6;25;31;287001;0.00010801356092835914
林泰前;4;14;18;287001;6.271755150678917e-05
无柳;8;15;23;287001;8.01390935920084e-05
科技企业法务前沿;1;3;4;287001;1.3937233668175372e-05
LANGE刘远;48;658;706;287001;0.002459921742432953
文心一格;7;8;15;287001;5.226462625565764e-05
钛媒体APP;1;1;2;287001;6.968616834087686e-06
无界AI;1;1;2;287001;6.968616834087686e-06
狸吉君;1;7;8;287001;2.7874467336350744e-05
国酒地理;1;2;3;287001;1.045292525113153e-05
激情嗑茸徐的咕姑苏叶;34;48;82;287001;0.0002857132901975951
冈瓦纳;15;107;122;287001;0.00042508562687934885
炎热的瘦虎;3;21;24;287001;8.362340200905224e-05
迪拜中阿卫视;2;7;9;287001;3.135877575339459e-05
卤蛋闯世界;1;4;5;287001;1.7421542085219216e-05
阿林Art;4;9;13;287001;4.529600942156996e-05
小楼公子吹笛;1;7;8;287001;2.7874467336350744e-05
容易象数理;4;17;21;287001;7.31704767579207e-05
日理万姬-;1;6;7;287001;2.43901589193069e-05
青光楚辞;5;15;20;287001;6.968616834087687e-05
岳东晓博士;40;195;235;287001;0.0008188124780053031
你维阿管不到我bot;14;67;81;287001;0.00028222898178055126
绘画姬_;3;8;11;287001;3.832739258748227e-05
汪有;66;847;913;287001;0.003181173584761029
艺术你我Cforabc;11;36;47;287001;0.00016376249560106062
藝術犬;2;24;26;287001;9.059201884313991e-05
Penthesileia;11;67;78;287001;0.00027177605652941976
苍南言;12;18;30;287001;0.00010452925251131529
茉莉莱莱;1;32;33;287001;0.00011498217776244682
糖金桔sama;15;197;212;287001;0.0007386733844132947
青岛大学;2;16;18;287001;6.271755150678917e-05
YAA亚洲青年艺术家提名展;2;6;8;287001;2.7874467336350744e-05
怀海提着裤子说天庭之上休要胡闹;1;5;6;287001;2.090585050226306e-05
吴吉明;1;1;2;287001;6.968616834087686e-06
小葱跑快快;1;29;30;287001;0.00010452925251131529
赛博十块鉴定处;7;109;116;287001;0.0004041797763770858
三花鸡腿子_MOLLY;1;3;4;287001;1.3937233668175372e-05
ELLE;25;49;74;287001;0.0002578388228612444
小葱跑快快;2;107;109;287001;0.00037978961745777887
零重力瓦力;6;19;25;287001;8.710771042609608e-05
春与卿卿谈;1;15;16;287001;5.574893467270149e-05
腐-狸;2;170;172;287001;0.000599301047731541
_何時_;13;655;668;287001;0.002327518022585287
子棋谈;21;76;97;287001;0.0003379779164532528
狂妄画集;1;10;11;287001;3.832739258748227e-05
狗生逆袭的斯芬克斯;25;298;323;287001;0.0011254316187051614
乾谷goo;10;107;117;287001;0.00040766408479412964
别理我先生;1;1;2;287001;6.968616834087686e-06
小葱跑快快;1;61;62;287001;0.00021602712185671828
探索科技匠;103;200;303;287001;0.0010557454503642844
小葱跑快快;5;225;230;287001;0.0008013909359200839
麻省理工科技评论;1;7;8;287001;2.7874467336350744e-05
Amazon小锦鲤;1;5;6;287001;2.090585050226306e-05
一个专员;9;22;31;287001;0.00010801356092835914
Feelingwithoutbrains;2;3;5;287001;1.7421542085219216e-05
白色聆听之歌;1;5;6;287001;2.090585050226306e-05
冰心雪儿888;2;42;44;287001;0.0001533095703499291
籽木与_ZIM;3;170;173;287001;0.0006027853561485848
Simon_阿文;50;386;436;287001;0.0015191584698311155
阿尔萨鱼;8;156;164;287001;0.0005714265803951902
UI设计君;2;6;8;287001;2.7874467336350744e-05
指尖蝴蝶舞翩跹;1;2;3;287001;1.045292525113153e-05
零重力瓦力;3;28;31;287001;0.00010801356092835914
保护我方小蘑菇丷;1;5;6;287001;2.090585050226306e-05
Art_艺术映画;7;341;348;287001;0.0012125393291312573
BIE别的;11;170;181;287001;0.0006306598234849356
dp-1;2;7;9;287001;3.135877575339459e-05
Simon_阿文;46;555;601;287001;0.00209406935864335
月神幻兔;3;324;327;287001;0.0011393688523733366
林亦LYi;11;74;85;287001;0.00029616621544872667
莞Ana;2;12;14;287001;4.87803178386138e-05
墨言盒子;1;2;3;287001;1.045292525113153e-05
小葱跑快快;1;83;84;287001;0.0002926819070316828
Thomas看看世界;187;1350;1537;287001;0.0053553820369963865
PG包装设计;3;17;20;287001;6.968616834087687e-05
夙愿project;1;2;3;287001;1.045292525113153e-05
速溶犬科;2;17000;17002;287001;0.05924021170657942
某不知名网友震;2;9;11;287001;3.832739258748227e-05
冷哇哇的呀;3;90;93;287001;0.0003240406827850774
大江户战士OedoSoldier;6;162;168;287001;0.0005853638140633656
那一抹浅浅;1;1;2;287001;6.968616834087686e-06
液态中二病废料;1;3;4;287001;1.3937233668175372e-05
JIMMYs动画剧场;1;7;8;287001;2.7874467336350744e-05
阿林Art;3;3;6;287001;2.090585050226306e-05
Yanagi_6分間休憩;1;3;4;287001;1.3937233668175372e-05
i粑粑静雅;2;5;7;287001;2.43901589193069e-05
NOWNESS现在;1;17;18;287001;6.271755150678917e-05
WEI_卫卫;1;1;2;287001;6.968616834087686e-06
图宠壁纸现;1;3;4;287001;1.3937233668175372e-05
马良;6;183;189;287001;0.0006585342908212863
亦性恋;6;126;132;287001;0.00045992871104978727
写手吐槽bot_;5;99;104;287001;0.00036236807537255966
蒋其宇-;1;1;2;287001;6.968616834087686e-06
蓝铅笔;5;6;11;287001;3.832739258748227e-05
扶星枕月;1;4;5;287001;1.7421542085219216e-05
安塔西亚的河;4;1720;1724;287001;0.006006947710983586
你看白象似的群山;1;1720;1721;287001;0.005996494785732454
叫我乔韵就好了;1;1;2;287001;6.968616834087686e-06
林步里;12;458;470;287001;0.0016376249560106062
涉水折春;1;6419;6420;287001;0.022369260037421474
小葱跑快快;1;20;21;287001;7.31704767579207e-05
孙无力;71;1603;1674;287001;0.005832732290131393
Art_艺术映画;2;257;259;287001;0.0009024358800143554
鹤顶红阿;1;1;2;287001;6.968616834087686e-06
张帆FFAN;13;111;124;287001;0.00043205424371343655
插画师小光sir;3;15;18;287001;6.271755150678917e-05
财入门;6;9;15;287001;5.226462625565764e-05
黄老邪23;1;3;4;287001;1.3937233668175372e-05
可爱表情包;217;400;617;287001;0.002149818293316051
希望幸运一点的roro酱;2;1;3;287001;1.045292525113153e-05
包大有趣;8;13;21;287001;7.31704767579207e-05
不吃饭会饿的慌;3;3;6;287001;2.090585050226306e-05
心宓瑶;1;2;3;287001;1.045292525113153e-05
你的绘画素材库;78;42;120;287001;0.00041811701004526114
钟视于你;1;29;30;287001;0.00010452925251131529
网恋;213;423;636;287001;0.0022160201532398843
现男友;214;402;616;287001;0.0021463339848990072
南方周末;7;624;631;287001;0.002198598611154665
阴暗重女;1;1;2;287001;6.968616834087686e-06
一道亮彩虹;1;3;4;287001;1.3937233668175372e-05
若惟馨;1;1;2;287001;6.968616834087686e-06
娱闻蜀黍;31;39;70;287001;0.00024390158919306902
零重力瓦力;1;5;6;287001;2.090585050226306e-05
今日-Today2100;1;2;3;287001;1.045292525113153e-05
我苹果牛;8;121;129;287001;0.00044947578579865576
让你开心;4;18;22;287001;7.665478517496454e-05
小葱跑快快;1;52;53;287001;0.00018466834610332368
淘气野橘;2;1;3;287001;1.045292525113153e-05
煌豹小队长;15;4623;4638;287001;0.016160222438249345
低烧眼镜;1;1;2;287001;6.968616834087686e-06
南方周末;4;16;20;287001;6.968616834087687e-05
欣然自乐1222;4;20;24;287001;8.362340200905224e-05
Elk无痕穿戴甲刘斌老师;1;3;4;287001;1.3937233668175372e-05
vip_momoo;1;2;3;287001;1.045292525113153e-05
西番莲与花椒;3;3;6;287001;2.090585050226306e-05
可乐交易日记;1;2;3;287001;1.045292525113153e-05
wuil小橙子;2;1;3;287001;1.045292525113153e-05
莹石-;2;4;6;287001;2.090585050226306e-05
UNCLE疯叔;1;21;22;287001;7.665478517496454e-05
青木菌哪;2;1;3;287001;1.045292525113153e-05
还有三十年退休;1;3;4;287001;1.3937233668175372e-05
阿什么南什么刻;1;2;3;287001;1.045292525113153e-05
sunix;16;26;42;287001;0.0001463409535158414
黎平县的;3;8;11;287001;3.832739258748227e-05
Sidelight侧光工坊;3;50;53;287001;0.00018466834610332368
Jeep中国站;55;1225;1280;287001;0.004459914773816119
町咚隆咚锵;2;3;5;287001;1.7421542085219216e-05
优设AIGC;4;92;96;287001;0.00033449360803620894
小葱跑快快;2;93;95;287001;0.0003310092996191651
道_農;1;2981;2982;287001;0.01039020769962474
Ai绘_Sicx本;1;5;6;287001;2.090585050226306e-05
浪西安浪;1;5;6;287001;2.090585050226306e-05
装甲北极白熊;1;16000;16001;287001;0.05575241898111853
娄底车务段;8;8;16;287001;5.574893467270149e-05
宝玉xp;36;1004;1040;287001;0.003623680753725597
敬英激推bot;2;3;5;287001;1.7421542085219216e-05
冰心雪儿888;1;5;6;287001;2.090585050226306e-05
万物与边界;1;1;2;287001;6.968616834087686e-06
JuniorSweet;1;25000;25001;287001;0.08711119473451312
泡-芙丶;1;71;72;287001;0.0002508702060271567
梨子兮饭;1;3;4;287001;1.3937233668175372e-05
穗有喵;4;47;51;287001;0.000177699729269236
陈有点皮Pro;1;1;2;287001;6.968616834087686e-06
推软妹君;4;195;199;287001;0.0006933773749917248
少女肖走江湖;1;4;5;287001;1.7421542085219216e-05
月神幻兔;6;188;194;287001;0.0006759558329065056
泡-芙丶;24;302;326;287001;0.0011358845439562928
Elivagar_Eljudnir;1;1;2;287001;6.968616834087686e-06
deviljack-99;3;7;10;287001;3.484308417043843e-05
今天的东南枝也甚是拥挤呢;2;9;11;287001;3.832739258748227e-05
不见云心不思归;1;14;15;287001;5.226462625565764e-05
树君MQC;5;64;69;287001;0.00024041728077602516
梦茜_mx;6;54;60;287001;0.00020905850502263057
忆棠2022;1;2;3;287001;1.045292525113153e-05
城主鬼谷藏龙;5;5;10;287001;3.484308417043843e-05
每日悦色赏花;1;4;5;287001;1.7421542085219216e-05
布偶米米糊;1;2;3;287001;1.045292525113153e-05
淫乱芝士;2;3;5;287001;1.7421542085219216e-05
搞某人;19;21;40;287001;0.00013937233668175373
_莫卡_;1;3;4;287001;1.3937233668175372e-05
红星新闻;4;11;15;287001;5.226462625565764e-05
一梦糊了;1;4;5;287001;1.7421542085219216e-05
狂炫薯条三百斤;1;4;5;287001;1.7421542085219216e-05
sunix;4;9;13;287001;4.529600942156996e-05
萝依妮雅;1;4;5;287001;1.7421542085219216e-05
红绿灯的白bo;3;24;27;287001;9.407632726018377e-05
量子位;1;7;8;287001;2.7874467336350744e-05
美-丽-想-象;1;1;2;287001;6.968616834087686e-06
长江日报;1;5;6;287001;2.090585050226306e-05
才尽之江郎;2;173;175;287001;0.0006097539729826725
吃勺糖吧;8;9;17;287001;5.9233243089745335e-05
祝凯ZK;1;5;6;287001;2.090585050226306e-05
推软妹君;4;78;82;287001;0.0002857132901975951
杨文彬Wenbin;1;28;29;287001;0.00010104494409427145
千里暮云平_12;2;1;3;287001;1.045292525113153e-05
夜雨零灰zerogrey;1;3;4;287001;1.3937233668175372e-05
大乐Daleee;32;590;622;287001;0.0021672398354012704
狸吉君;2;9;11;287001;3.832739258748227e-05
ss沙师弟;3;374;377;287001;0.0013135842732255288
森间飞鸟;10;427;437;287001;0.0015226427782481593
长江日报;1;5;6;287001;2.090585050226306e-05
羊脂玉铭;1;1;2;287001;6.968616834087686e-06
油画里的德拉科;2;62;64;287001;0.00022299573869080595
-邱山-;2;1;3;287001;1.045292525113153e-05
动漫达人JACO;14;156;170;287001;0.0005923324308974533
谷大白话;92;2548;2640;287001;0.009198574220995745
战斧Cosplay创造;11;101;112;287001;0.0003902425427089104
于文平Turman;1;5;6;287001;2.090585050226306e-05
包容万物恒河水;39;819;858;287001;0.0029895366218236174
蜡笔嘤嘤怪;1;1;2;287001;6.968616834087686e-06
达明安赫斯特DamienHirst;1;9;10;287001;3.484308417043843e-05
澹澹花影没;1;19;20;287001;6.968616834087687e-05
冰心雪儿888;11;197;208;287001;0.0007247361507451193
奇葩菌;3;7;10;287001;3.484308417043843e-05
ChemLRQ123;14;33;47;287001;0.00016376249560106062
桃井喵;1;3;4;287001;1.3937233668175372e-05
汪彬-Esun;1;2;3;287001;1.045292525113153e-05
GitHubDaily;23;176;199;287001;0.0006933773749917248
流离鲸鱼岛;1;4;5;287001;1.7421542085219216e-05
瘦成冬瓜;3;10;13;287001;4.529600942156996e-05
朝如雪ZRX;1;1;2;287001;6.968616834087686e-06
maybe的后厨;4;5;9;287001;3.135877575339459e-05
电竞永不停歇;1;1;2;287001;6.968616834087686e-06
小葱跑快快;11;386;397;287001;0.0013832704415664056
于文平Turman;1;2;3;287001;1.045292525113153e-05
数可视-黄志敏;1;2;3;287001;1.045292525113153e-05
36氪;3;21;24;287001;8.362340200905224e-05
毛豆chshg;13;18;31;287001;0.00010801356092835914
方便面没有葱;11;32;43;287001;0.00014982526193288526
自由2023影视;2;7;9;287001;3.135877575339459e-05
广州米洛英文幼儿园;1;1;2;287001;6.968616834087686e-06
Libra王小痣;17;11;28;287001;9.75606356772276e-05
小明选手踩到狗屎摔倒在起跑线上;1;1;2;287001;6.968616834087686e-06
mhs隔空喊话bot备用版;15;224;239;287001;0.0008327497116734785
胖头鱼小妹儿;1;25;26;287001;9.059201884313991e-05
色土狗;2;22;24;287001;8.362340200905224e-05
诗匪rs7;1;5;6;287001;2.090585050226306e-05
董董Mercurio;1;41;42;287001;0.0001463409535158414
乔令同学;1;11;12;287001;4.181170100452612e-05
弎水朰展;1;5;6;287001;2.090585050226306e-05
陈震Marco;1629;5107;6736;287001;0.023470301497207326
美术王子艾老师;1;4;5;287001;1.7421542085219216e-05
九口走召;4;15;19;287001;6.620185992383301e-05
躺倒鸭;6;22;28;287001;9.75606356772276e-05
Cosplay炒炒bot之萌萌别破防了版;82;452;534;287001;0.0018606206947014122
红绿灯的白bo;6;26;32;287001;0.00011149786934540298
fanghouguo;1;4;5;287001;1.7421542085219216e-05
爱上柠檬茶的老实人;1;2;3;287001;1.045292525113153e-05
油画里的德拉科;10;234;244;287001;0.0008501712537586977
c伊伊人;4;15;19;287001;6.620185992383301e-05
Elii;32;291;323;287001;0.0011254316187051614
写手吐槽bot_;6;82;88;287001;0.0003066191406998582
小葱跑快快;31;429;460;287001;0.0016027818718401677
赛博十块鉴定处;12;104;116;287001;0.0004041797763770858
今日AI绘画;1;1;2;287001;6.968616834087686e-06
光明日报;5;18;23;287001;8.01390935920084e-05
山海98683;1;1;2;287001;6.968616834087686e-06
波路萌;3;2;5;287001;1.7421542085219216e-05
壁纸包;199;197;396;287001;0.0013797861331493618
Hakumyo;1;2;3;287001;1.045292525113153e-05
布偶米米糊;1;3;4;287001;1.3937233668175372e-05
落入一滴水;6;37;43;287001;0.00014982526193288526
Thomas看看世界;127;1357;1484;287001;0.005170713690893063
直男体育生室友;1;13;14;287001;4.87803178386138e-05
MICU设计;4;76;80;287001;0.00027874467336350746
零重力瓦力;1;2;3;287001;1.045292525113153e-05
爱的奇迹口袋;1;2;3;287001;1.045292525113153e-05
北北北awa;3;9;12;287001;4.181170100452612e-05
渊渊-yuan;10;47;57;287001;0.00019860557977149907
SaRiElHo;30;219;249;287001;0.000867592795843917
优设AIGC;4;52;56;287001;0.0001951212713544552
动漫达人JACO;7;118;125;287001;0.0004355385521304804
高_Sheng;3;4;7;287001;2.43901589193069e-05
春在山野;2;417;419;287001;0.0014599252267413702
白玉石77191;4;12;16;287001;5.574893467270149e-05
梅耶姑娘;2;21;23;287001;8.01390935920084e-05
萤火虫如我;16;63;79;287001;0.0002752603649464636
研究者July;2;6;8;287001;2.7874467336350744e-05
一道亮彩虹;1;3;4;287001;1.3937233668175372e-05
水木木Cici;3;7;10;287001;3.484308417043843e-05
可以帮我点份板烧吗谢谢;1;4;5;287001;1.7421542085219216e-05
XPandA-K;1;1;2;287001;6.968616834087686e-06
金成森;18;521;539;287001;0.0018780422367866314
搞某人;3;6;9;287001;3.135877575339459e-05
简繁zZz;24;94;118;287001;0.0004111483932111735
mhs隔空喊话bot备用版;4;25;29;287001;0.00010104494409427145
被选召的大人;24;515;539;287001;0.0018780422367866314
一道亮彩虹;2;5;7;287001;2.43901589193069e-05
盈步婀娜Grace;1;3;4;287001;1.3937233668175372e-05
冯小夏同学;3;16;19;287001;6.620185992383301e-05
湖湘财经;2;2;4;287001;1.3937233668175372e-05
姓朝名暮;2;547;549;287001;0.0019128853209570698
说给可爱的你;17;34;51;287001;0.000177699729269236
垂木难春;5;6;11;287001;3.832739258748227e-05
肉汁奶酪薯条也不行吗;1;13;14;287001;4.87803178386138e-05
暗哑行与秋_;13;377;390;287001;0.001358880282647099
谷园讲通鉴;1;6;7;287001;2.43901589193069e-05
枫壁纸;5;65;70;287001;0.00024390158919306902
小树怜;1;8;9;287001;3.135877575339459e-05
imluffy路辉;4;38;42;287001;0.0001463409535158414
兔兔头像壁纸馆;1;1;2;287001;6.968616834087686e-06
圣域食堂一号厅;-13;5;-8;287001;-2.7874467336350744e-05
知未科技;30;65;95;287001;0.0003310092996191651
日理万姬-;2;7;9;287001;3.135877575339459e-05
福布斯中文网;3;31;34;287001;0.00011846648617949067
奇葩菌;1;10;11;287001;3.832739258748227e-05
互因科技;1;2;3;287001;1.045292525113153e-05
树君MQC;2;25;27;287001;9.407632726018377e-05
时代财经;88;320;408;287001;0.001421597834153888
小葱跑快快;4;263;267;287001;0.0009303103473507061
零重力瓦力;1;1;2;287001;6.968616834087686e-06
韩吉老师我作业做完了;1;1;2;287001;6.968616834087686e-06
艾伦呐艾伦;1;9;10;287001;3.484308417043843e-05
泡-芙丶;3;18;21;287001;7.31704767579207e-05
白黎电台限定频道;3;53;56;287001;0.0001951212713544552
无界AI;2;1;3;287001;1.045292525113153e-05
打火机里会住着小鸟吗;1;4;5;287001;1.7421542085219216e-05
国际视觉艺术大师丹尼斯;1;1;2;287001;6.968616834087686e-06
无界AI;2;2;4;287001;1.3937233668175372e-05
森林画册;6;131;137;287001;0.0004773502531350065
捌颂予鲸;19;17;36;287001;0.00012543510301357835
AI猿画师;1;2;3;287001;1.045292525113153e-05
闪耀帷幕之春;1;1;2;287001;6.968616834087686e-06
阿拉牛小帅;1;1;2;287001;6.968616834087686e-06
泡-芙丶;3;70;73;287001;0.00025435451444420055
Rex漫剪;2;1;3;287001;1.045292525113153e-05
祝凯ZK;1;3;4;287001;1.3937233668175372e-05
yunmi晓菁;1;6;7;287001;2.43901589193069e-05
李坤雨-;2;5;7;287001;2.43901589193069e-05
程阿尧;4;2;6;287001;2.090585050226306e-05
这里有帅哥X;20;1017;1037;287001;0.0036132278284744654
墨言盒子;1;4;5;287001;1.7421542085219216e-05
翡翠铁头娃;1;2;3;287001;1.045292525113153e-05
Jim-hc;6;10;16;287001;5.574893467270149e-05
北瑠菜;1;8;9;287001;3.135877575339459e-05
Felix葡萄园;1;4;5;287001;1.7421542085219216e-05
流云飞舞8888;12;53;65;287001;0.0002264800471078498
复方耶加雪菲冰美式;1;4;5;287001;1.7421542085219216e-05
零重力瓦力;1;2;3;287001;1.045292525113153e-05
小叶子88叶子88;1;2;3;287001;1.045292525113153e-05
于文平Turman;2;7;9;287001;3.135877575339459e-05
锤锤壁纸君;2;3;5;287001;1.7421542085219216e-05
泡-芙丶;1;18;19;287001;6.620185992383301e-05
柒日醉酒;2;4;6;287001;2.090585050226306e-05
西西爱吃泡芙;2;1;3;287001;1.045292525113153e-05
泡-芙丶;2;52;54;287001;0.00018815265452036753
乱鸣犬;1;4;5;287001;1.7421542085219216e-05
巴卫那个狐狸;13;18;31;287001;0.00010801356092835914
青衫隐归鹤;2;1;3;287001;1.045292525113153e-05
某不知名网友震;3;23;26;287001;9.059201884313991e-05
推软妹君;2;110;112;287001;0.0003902425427089104
帅炸-苍穹-;1;10;11;287001;3.832739258748227e-05
h攀攀阿;2;2;4;287001;1.3937233668175372e-05
朱老ber;59;811;870;287001;0.0030313483228281432
那我哪芝道a;2;5;7;287001;2.43901589193069e-05
熬夜的猫v;-1;3;2;287001;6.968616834087686e-06
南宫门外朱雀桥边;9;80;89;287001;0.00031010344911690203
Thomas看看世界;3;1357;1360;287001;0.004738659447179627
QQQQt-;1;6;7;287001;2.43901589193069e-05
荒井健一ak;1;2;3;287001;1.045292525113153e-05
Yu雨oo0;1;2;3;287001;1.045292525113153e-05
网络资源学家v;1;3;4;287001;1.3937233668175372e-05
油画里的德拉科;4;87;91;287001;0.00031707206595098974
不会再烦恼叻_;1;4;5;287001;1.7421542085219216e-05
郎佳子彧;25;178;203;287001;0.0007073146086599002
捏小猪;3;14;17;287001;5.9233243089745335e-05
JF猫猫狗狗;5;51;56;287001;0.0001951212713544552
译心-乐园;1;2;3;287001;1.045292525113153e-05
包容万物恒河水;9;84;93;287001;0.0003240406827850774
Jim-hc;2;4;6;287001;2.090585050226306e-05
仙粑;16;50;66;287001;0.00022996435552489363
财经黄小姐;1;2;3;287001;1.045292525113153e-05
抓马扣叔;61;575;636;287001;0.0022160201532398843
石头头石乾志;2;4;6;287001;2.090585050226306e-05
爱可可-爱生活;5;34;39;287001;0.00013588802826470988
卢诗翰;130;1583;1713;287001;0.005968620318396103
我是阿卜哒;2;2;4;287001;1.3937233668175372e-05
Sakana水族馆;1;14;15;287001;5.226462625565764e-05
UCG一刀;5;4;9;287001;3.135877575339459e-05
小透明N次方_;1;3;4;287001;1.3937233668175372e-05
ss沙师弟;5;864;869;287001;0.0030278640144111
小葱跑快快;2;84;86;287001;0.0002996505238657705
ai萝莉酱;1;1;2;287001;6.968616834087686e-06
泡-芙丶;1;102;103;287001;0.00035888376695551586
那谁AKer;1;2;3;287001;1.045292525113153e-05
每日经济新闻;12;48;60;287001;0.00020905850502263057
HandsDio;5;85;90;287001;0.0003135877575339459
鸡红柿炒西蛋_;1;6;7;287001;2.43901589193069e-05
新仔走天涯;2;2;4;287001;1.3937233668175372e-05
福布斯中文网;1;5;6;287001;2.090585050226306e-05
ss沙师弟;4;302;306;287001;0.001066198375615416
米斯特古德卡特;11;127;138;287001;0.00048083456155205033
无界AI;1;1;2;287001;6.968616834087686e-06
巴普洛夫pavlov;3;35;38;287001;0.00013240371984766603
andy妙想;1;1;2;287001;6.968616834087686e-06
锐图RAYFOTO;1;3;4;287001;1.3937233668175372e-05
中国经营报;1;5;6;287001;2.090585050226306e-05
量子位;3;34;37;287001;0.0001289194114306222
AI-Doll;1;13;14;287001;4.87803178386138e-05
钦一点儿;4;20;24;287001;8.362340200905224e-05
珠宝设计联盟;1;2;3;287001;1.045292525113153e-05
谢安妮野生设计师;1;15;16;287001;5.574893467270149e-05
Ashley__Li;1;1;2;287001;6.968616834087686e-06
赵宏民;61;961;1022;287001;0.0035609632022188076
无界AI;1;1;2;287001;6.968616834087686e-06
虎嗅APP;4;24;28;287001;9.75606356772276e-05
零重力瓦力;-39;5;-34;287001;-0.00011846648617949067
画久久99;12;296;308;287001;0.0010731669924495036
怪博士李雷;10;16;26;287001;9.059201884313991e-05
南方一只雀;6;24;30;287001;0.00010452925251131529
大象新闻;2;3;5;287001;1.7421542085219216e-05
科学探索;4;12;16;287001;5.574893467270149e-05
AI次世代;1;1;2;287001;6.968616834087686e-06
娱闻蜀黍;32;92;124;287001;0.00043205424371343655
元宇宙-比特杀手;9;27;36;287001;0.00012543510301357835
日理万姬-;3;12;15;287001;5.226462625565764e-05
无界AI;1;1;2;287001;6.968616834087686e-06
GBT玩车速改;1;1;2;287001;6.968616834087686e-06
无界AI;1;3;4;287001;1.3937233668175372e-05
酒百合winelily;2;4;6;287001;2.090585050226306e-05
森林画册;9;200;209;287001;0.0007282204591621632
于文平Turman;2;7;9;287001;3.135877575339459e-05
包容万物恒河水;16;228;244;287001;0.0008501712537586977
36氪;12;61;73;287001;0.00025435451444420055
米兔不裸考;4;6;10;287001;3.484308417043843e-05
小谷聊科技;1;4;5;287001;1.7421542085219216e-05
115_128;2;814;816;287001;0.002843195668307776
月神幻兔;5;411;416;287001;0.0014494723014902386
一家之主rcat;2;814;816;287001;0.002843195668307776
全是猫崽;1;3;4;287001;1.3937233668175372e-05
张小翼weddingvision;3;11;14;287001;4.87803178386138e-05
大一的吃货生活;5;17;22;287001;7.665478517496454e-05
火红森林;3;814;817;287001;0.00284667997672482
霸道猫男爱上我;1;2;3;287001;1.045292525113153e-05
Harvipolard;1;1;2;287001;6.968616834087686e-06
包容万物恒河水;12;162;174;287001;0.0006062696645656286
江南征唱征服;1;7;8;287001;2.7874467336350744e-05
虎阿夏;4;21;25;287001;8.710771042609608e-05
_祝菊艳_;4;814;818;287001;0.0028501642851418638
萌影时光;7;84;91;287001;0.00031707206595098974
原来是大太阳啊233;1;1;2;287001;6.968616834087686e-06
苏梦蝶是只垂耳兔兔;1;2;3;287001;1.045292525113153e-05
麻酱头;1;2;3;287001;1.045292525113153e-05
男友一号;1;1;2;287001;6.968616834087686e-06
朱老ber;1;814;815;287001;0.002839711359890732
茶杯不泡tea;1;814;815;287001;0.002839711359890732
冰心雪儿888;1;11;12;287001;4.181170100452612e-05
绿图哥;23;814;837;287001;0.0029163661450656965
克苏鲁薯条;11;15;26;287001;9.059201884313991e-05
羽军是一只狼;1;3;4;287001;1.3937233668175372e-05
油画里的德拉科;2;61;63;287001;0.0002195114302737621
三木幸也-于雷霆轰鸣之夜-;5;20;25;287001;8.710771042609608e-05
光之萤火;1;1;2;287001;6.968616834087686e-06
布偶米米糊;1;5;6;287001;2.090585050226306e-05
陈钰琪粉丝后援会;44;314;358;287001;0.0012473824133016958
电竞召唤师;14;223;237;287001;0.0008257810948393908
尘千岁;1;3;4;287001;1.3937233668175372e-05
月神幻兔;1;465;466;287001;0.0016236877223424308
德国马牌轮胎;2;2;4;287001;1.3937233668175372e-05
包容万物恒河水;42;446;488;287001;0.0017003425075173954
aloststar走失的星星;1;1;2;287001;6.968616834087686e-06
炼奶达人;11;21;32;287001;0.00011149786934540298
ea6th;1;1541;1542;287001;0.005372803579081606
赧颜-Lixeden;1;2;3;287001;1.045292525113153e-05
于赓哲;47;388;435;287001;0.0015156741614140716
扬子晚报;4;87;91;287001;0.00031707206595098974
百石设计;1;2;3;287001;1.045292525113153e-05
GitHubDaily;13;136;149;287001;0.0005191619541395327
你的妮妮Ninii;4;1;5;287001;1.7421542085219216e-05
躲进暖气里;1;2;3;287001;1.045292525113153e-05
临月安下;14;12;26;287001;9.059201884313991e-05
_祝菊艳_;1;17000;17001;287001;0.059236727398162374
赵老哥游资备用号;1;18;19;287001;6.620185992383301e-05
HandsDio;1;18;19;287001;6.620185992383301e-05
老acid;1;5;6;287001;2.090585050226306e-05
推软妹君;9;49;58;287001;0.0002020898881885429
画画的张旺;1;17000;17001;287001;0.059236727398162374
Ai绘_Sicx本;2;15;17;287001;5.9233243089745335e-05
红绿灯的白bo;3;32;35;287001;0.00012195079459653451
liyokii;1;17000;17001;287001;0.059236727398162374
森林画册;2;60;62;287001;0.00021602712185671828
瑶伊依;14;42;56;287001;0.0001951212713544552
嘉炜1994;51;712;763;287001;0.0026585273222044523
七落35186;52;82;134;287001;0.00046689732788387497
心动柚稚;5;1;6;287001;2.090585050226306e-05
deoR;13;17000;17013;287001;0.0592785390991669
万鱼鱼;1;3;4;287001;1.3937233668175372e-05
中国传媒大学;2;60;62;287001;0.00021602712185671828
快科技官方;1;1;2;287001;6.968616834087686e-06
七落35186;75;369;444;287001;0.0015470329371674663
投行泰山;3;41;44;287001;0.0001533095703499291
小葱跑快快;15;152;167;287001;0.0005818795056463218
IT之家;1;3;4;287001;1.3937233668175372e-05
优设AIGC;9;89;98;287001;0.0003414622248702966
PMM_LORD;2;17000;17002;287001;0.05924021170657942
爱范儿;7;67;74;287001;0.0002578388228612444
日理万姬-;2;38;40;287001;0.00013937233668175373
0221一直很安静;1;20;21;287001;7.31704767579207e-05
二十七歲搖滾詩人;1;1;2;287001;6.968616834087686e-06
小马叔叔不过河;1;2;3;287001;1.045292525113153e-05
于文平Turman;1;3;4;287001;1.3937233668175372e-05
刀了你玩;1;1;2;287001;6.968616834087686e-06
Moo864;1;2;3;287001;1.045292525113153e-05
ai萝莉酱;1;6;7;287001;2.43901589193069e-05
wjqstszd5114728;2;3;5;287001;1.7421542085219216e-05
Ai绘_Sicx本;2;9;11;287001;3.832739258748227e-05
馋醒狗酱;7;4;11;287001;3.832739258748227e-05
章鱼花园;2;1;3;287001;1.045292525113153e-05
Limited糖老鸭_嘎;3;7;10;287001;3.484308417043843e-05
神奇黑鸭子;1;27;28;287001;9.75606356772276e-05
十六夜秋澄;4;14;18;287001;6.271755150678917e-05
日理万姬-;1;24;25;287001;8.710771042609608e-05
长春生活;14;12;26;287001;9.059201884313991e-05
赛博十块鉴定处;10;79;89;287001;0.00031010344911690203
WritingPrompts;18;2361;2379;287001;0.008289169724147302
互联网的一些事;8;11;19;287001;6.620185992383301e-05
你丫才美工;3;10;13;287001;4.529600942156996e-05
三花鸡腿子_MOLLY;1;2;3;287001;1.045292525113153e-05
浮明影;1;4;5;287001;1.7421542085219216e-05
今天的东南枝也甚是拥挤呢;2;11;13;287001;4.529600942156996e-05
小葱跑快快;43;733;776;287001;0.0027038233316260224
于文平Turman;1;4;5;287001;1.7421542085219216e-05
月神幻兔;3;407;410;287001;0.0014285664509879757
张米伽Mika;2;18;20;287001;6.968616834087687e-05
鼻梁一点红_红二二;1;17000;17001;287001;0.059236727398162374
零重力瓦力;1;14;15;287001;5.226462625565764e-05
赛博十块鉴定处;7;97;104;287001;0.00036236807537255966
可爱头像pro;8;254;262;287001;0.0009128888052654869
盼凯karry;2;5;7;287001;2.43901589193069e-05
少数派sspai;3;20;23;287001;8.01390935920084e-05
一诺·斑马乐园后援会;174;438;612;287001;0.002132396751230832
快科技官方;1;7;8;287001;2.7874467336350744e-05
树君MQC;1;43;44;287001;0.0001533095703499291
湖南千思装饰集团;2;42;44;287001;0.0001533095703499291
乔纳森何;3;17;20;287001;6.968616834087687e-05
云荼不见夏;2;3;5;287001;1.7421542085219216e-05
无界AI;1;1;2;287001;6.968616834087686e-06
jianoliu;4;36;40;287001;0.00013937233668175373
桃良初五;1;3;4;287001;1.3937233668175372e-05
UI设计;1;7;8;287001;2.7874467336350744e-05
GitHubDaily;4;74;78;287001;0.00027177605652941976
清清白桃;2;1;3;287001;1.045292525113153e-05
糖葫芦可太好吃了-;1;17000;17001;287001;0.059236727398162374
你的好邻居李小气;4;36;40;287001;0.00013937233668175373
光明日报;1;2;3;287001;1.045292525113153e-05
你的好邻居李小气;1;7;8;287001;2.7874467336350744e-05
饭饭不恰饭2023;3;3;6;287001;2.090585050226306e-05
祝凯ZK;1;18;19;287001;6.620185992383301e-05
鱼总-A4TYPHOON;54;1174;1228;287001;0.004278730736129839
Simon_阿文;28;412;440;287001;0.0015330957034992909
作家徐小斌;2;3;5;287001;1.7421542085219216e-05
零重力瓦力;2;9;11;287001;3.832739258748227e-05
Art_艺术映画;2;48;50;287001;0.00017421542085219215
布偶米米糊;0;1;1;287001;3.484308417043843e-06
Njorun;2;1;3;287001;1.045292525113153e-05
ABOUTCG;2;5;7;287001;2.43901589193069e-05
闇翼零式;1;5676;5677;287001;0.019780418883557898
夹心-山楂;5;11;16;287001;5.574893467270149e-05
优癖;3;5676;5679;287001;0.019787387500391985
栗子liz同学;1;156;157;287001;0.0005470364214758834
暗哑行与秋_;3;10;13;287001;4.529600942156996e-05
航言左杰;1;1;2;287001;6.968616834087686e-06
AKB48TeamSH毛唯嘉应援会;3;10;13;287001;4.529600942156996e-05
UI设计;3;26;29;287001;0.00010104494409427145
春在山野;6;867;873;287001;0.003041801248079275
无聊的雪子;3;24;27;287001;9.407632726018377e-05
邰邰_MyMolequeNey;1;814;815;287001;0.002839711359890732
表弟慢热手丶;1;1;2;287001;6.968616834087686e-06
CSDN;1;1;2;287001;6.968616834087686e-06
乌拉拉_-v-;1;2;3;287001;1.045292525113153e-05
4A广告网;11;28;39;287001;0.00013588802826470988
去鳞;4;13;17;287001;5.9233243089745335e-05
小葱跑快快;10;173;183;287001;0.0006376284403190233
互联网纵横;6;11;17;287001;5.9233243089745335e-05
湘楠的小猫儿;1;1;2;287001;6.968616834087686e-06
诗匪rs7;5;3;8;287001;2.7874467336350744e-05
腾讯程序员;27;62;89;287001;0.00031010344911690203
摆烂;2;2;4;287001;1.3937233668175372e-05
鲁国平先生;1;6;7;287001;2.43901589193069e-05
ss沙师弟;4;244;248;287001;0.0008641084874268731
王自荣;1;11;12;287001;4.181170100452612e-05
冰心雪儿888;1;19;20;287001;6.968616834087687e-05
于文平Turman;1;3;4;287001;1.3937233668175372e-05
篱笆念泥巴;1;3;4;287001;1.3937233668175372e-05
网民a矮土豆大王;1;5;6;287001;2.090585050226306e-05
山根老朱;1;1;2;287001;6.968616834087686e-06
宁宁想要欧欧欧;2;3;5;287001;1.7421542085219216e-05
zhangrunjia12345;1;1;2;287001;6.968616834087686e-06
诺亚lllll-jzyyds永远盛开;2;8;10;287001;3.484308417043843e-05
与君一顾;4;2;6;287001;2.090585050226306e-05
包容万物恒河水;7;112;119;287001;0.00041463270162821734
赭山柳;8;163;171;287001;0.0005958167393144972
非马影像;1;2;3;287001;1.045292525113153e-05
Luis苏牙9;7;13;20;287001;6.968616834087687e-05
小斗篷八子;1;3;4;287001;1.3937233668175372e-05
动漫达人JACO;7;99;106;287001;0.00036933669220664736
赛博十块鉴定处;11;100;111;287001;0.0003867582342918666
月神幻兔;4;239;243;287001;0.0008466869453416538
61cm五连装酸素鱼雷;1;1;2;287001;6.968616834087686e-06
蜡笔小新蹦蹦蹦蹦;15;64;79;287001;0.0002752603649464636
即时设计JsDesign;3;5;8;287001;2.7874467336350744e-05
Art-DJ;12;118;130;287001;0.0004529600942156996
古风知乎;2;31;33;287001;0.00011498217776244682
兔兔头像壁纸馆;1;5;6;287001;2.090585050226306e-05
月亮市民;6;56;62;287001;0.00021602712185671828
GnoT童;21;41;62;287001;0.00021602712185671828
电竞召唤师;11;120;131;287001;0.00045644440263274347
用户7758465136;3;2;5;287001;1.7421542085219216e-05
电竞召唤师;11;240;251;287001;0.0008745614126780046
冯小夏同学;4;10;14;287001;4.87803178386138e-05
小马叔叔不过河;1;3;4;287001;1.3937233668175372e-05
月神幻兔;3;247;250;287001;0.0008710771042609608
一只向阳而生的蛱碟;5;48;53;287001;0.00018466834610332368
我爱拉粪;1;11;12;287001;4.181170100452612e-05
克里斯多利;13;60;73;287001;0.00025435451444420055
小影日记本;15;15;30;287001;0.00010452925251131529
春在山野;18;653;671;287001;0.0023379709478364187
三倍速科技;1;23;24;287001;8.362340200905224e-05
司马中原同学;2;1;3;287001;1.045292525113153e-05
云台山;2;3;5;287001;1.7421542085219216e-05
慵懒光影;2;31;33;287001;0.00011498217776244682
可乐永远都是第一口好喝;6;7;13;287001;4.529600942156996e-05
零重力瓦力;1;4;5;287001;1.7421542085219216e-05
假药贩帝;1;5;6;287001;2.090585050226306e-05
赛博十块鉴定处;1;38;39;287001;0.00013588802826470988
电竞召唤师;10;222;232;287001;0.0008083595527541716
假药贩帝;7;14;21;287001;7.31704767579207e-05
Amoeba原虫;22;143;165;287001;0.0005749108888122341
电竞召唤师;14;192;206;287001;0.0007177675339110317
百事256;1;6;7;287001;2.43901589193069e-05
GitHubDaily;12;149;161;287001;0.0005609736551440588
小葱跑快快;8;182;190;287001;0.0006620185992383302
股的knight;4;27;31;287001;0.00010801356092835914
小王子的玫瑰Niehsta;1;11;12;287001;4.181170100452612e-05
探索者7236;1;2;3;287001;1.045292525113153e-05
王自荣;1;3;4;287001;1.3937233668175372e-05
yoly莜莉;14;208;222;287001;0.0007735164685837331
平方C整漫画;1;10;11;287001;3.832739258748227e-05
CandyRain_u;6;1;7;287001;2.43901589193069e-05
曹操大叔;1;1110;1111;287001;0.0038710666513357096
控控aka游戏播报君;1;9;10;287001;3.484308417043843e-05
