发布者;真实一级评论数;真实点赞数;边数;最大边数;集群密度
_雯雯_酱;2;1;3;2576;0.0011645962732919255
影视侃侃圈;1;1;2;2576;0.0007763975155279503
水螅_蹲等玛丽重制;4;44;48;2576;0.018633540372670808
麦芽脆心R;2;2;4;2576;0.0015527950310559005
我就是喜欢看小说;7;81;88;2576;0.034161490683229816
平衣笠守;3;2;5;2576;0.0019409937888198758
时月文化;8;22;30;2576;0.011645962732919254
蜀黍冲浪指南;488;605;1093;2576;0.42430124223602483
前线娱乐;347;518;865;2576;0.3357919254658385
娱蜀黍;470;595;1065;2576;0.41343167701863354
欧气小买手;3;5;8;2576;0.003105590062111801
网易严选;1;9;10;2576;0.0038819875776397515
星综科技;10;13;23;2576;0.008928571428571428
影综科技;10;14;24;2576;0.009316770186335404
历史故事;10;13;23;2576;0.008928571428571428
数码看剧;11;17;28;2576;0.010869565217391304
旧楚传播;10;11;21;2576;0.008152173913043478
数码装备处;10;9;19;2576;0.007375776397515528
数码电竞;10;13;23;2576;0.008928571428571428
科技数码粉;10;11;21;2576;0.008152173913043478
我的眼里夹心最好;1;3;4;2576;0.0015527950310559005
锦鲤菩萨;11;15;26;2576;0.010093167701863354
好运许愿;10;17;27;2576;0.01048136645962733
数码卡卡君;10;14;24;2576;0.009316770186335404
扬帆起航前行;7;2;9;2576;0.0034937888198757765
是烫手山芋吖;1;15;16;2576;0.006211180124223602
科技好梦;10;18;28;2576;0.010869565217391304
科技好运;10;11;21;2576;0.008152173913043478
历史电影;10;17;27;2576;0.01048136645962733
数码视镜;10;18;28;2576;0.010869565217391304
科技沫小北;2;3;5;2576;0.0019409937888198758
财神地盘;10;17;27;2576;0.01048136645962733
数码小机友;10;16;26;2576;0.010093167701863354
一阵蒙圈;8;12;20;2576;0.007763975155279503
科技小天;2;7;9;2576;0.0034937888198757765
娱乐News;371;529;900;2576;0.34937888198757766
木头鱼;984;931;1915;2576;0.7434006211180124
科技社长;15;14;29;2576;0.01125776397515528
李小祥龙;3;13;16;2576;0.006211180124223602
小蓓说数码;1;1;2;2576;0.0007763975155279503
大猪蹄子奇迹;1;3;4;2576;0.0015527950310559005
科技班主;23;278;301;2576;0.11684782608695653
貌美如花似邹霞;11;21;32;2576;0.012422360248447204
佟忆;15;36;51;2576;0.019798136645962732
浪子言科技;15;17;32;2576;0.012422360248447204
正向娱乐;383;2193;2576;2576;1.0
桃娱乐;543;669;1212;2576;0.4704968944099379
娱大蜀黍;449;1657;2106;2576;0.8175465838509317
齐齐哈哈市萍萍;185;764;949;2576;0.3684006211180124
IT互联网那点事;45;344;389;2576;0.15100931677018634
西部决策;94;212;306;2576;0.1187888198757764
网易严选;95;135;230;2576;0.08928571428571429
ahhhhfs;1;2;3;2576;0.0011645962732919255
QQ音乐官方歌单;26;128;154;2576;0.059782608695652176
huanghw66;1;1;2;2576;0.0007763975155279503
陌川_MC;12;258;270;2576;0.1048136645962733
第五人格隔空喊话之曲工而枕之版;3;5;8;2576;0.003105590062111801
死花绽放;1;3;4;2576;0.0015527950310559005
打别人;1;22;23;2576;0.008928571428571428
又快被封了;5;79;84;2576;0.03260869565217391
壹壹4wo;4;2;6;2576;0.002329192546583851
凌宙但是赛博蛋工;2;10;12;2576;0.004658385093167702
雪疾Fragaria;1;5;6;2576;0.002329192546583851
Lumi刘敏;30;214;244;2576;0.09472049689440994
O6l8;2;3;5;2576;0.0019409937888198758
二逼瓦西里;25;97;122;2576;0.04736024844720497
Art0X聚镁艺术;5;6;11;2576;0.004270186335403727
财经老陈论市;1;2;3;2576;0.0011645962732919255
佟睿睿;14;68;82;2576;0.03183229813664596
杭州图书馆;2;7;9;2576;0.0034937888198757765
有趣de歪果仁;5;6;11;2576;0.004270186335403727
壹有伍-毛线甜心激吹;1;10;11;2576;0.004270186335403727
电商之家;14;48;62;2576;0.02406832298136646
熠熠生琰;1;16;17;2576;0.006599378881987578
麻督并非衡量现实;3;11;14;2576;0.005434782608695652
浕羽;1;1;2;2576;0.0007763975155279503
因幡白兔200501;1;2;3;2576;0.0011645962732919255
姬永锋;2;13;15;2576;0.005822981366459627
猫仙姑姑;12;27;39;2576;0.015139751552795032
加拿大大使馆官方微博;4;15;19;2576;0.007375776397515528
夕檽;3;21;24;2576;0.009316770186335404
Moki·;2;8;10;2576;0.0038819875776397515
郝智伟;20;52;72;2576;0.027950310559006212
樊百乐;20;158;178;2576;0.06909937888198758
中国传媒大学;8;26;34;2576;0.013198757763975156
哎呀我果;77;148;225;2576;0.08734472049689442
亡鸟-;1;13;14;2576;0.005434782608695652
鍋盖頭司令;180;803;983;2576;0.3815993788819876
GabR_夕雨;4;1;5;2576;0.0019409937888198758
麦子智能生活;24;167;191;2576;0.07414596273291925
铁血科学家;1;18;19;2576;0.007375776397515528
星空今天还继续写文吗;12;124;136;2576;0.052795031055900624
打雷打人;8;73;81;2576;0.031444099378881984
星lxt;1;9;10;2576;0.0038819875776397515
少数派sspai;6;23;29;2576;0.01125776397515528
AI观查橘;5;48;53;2576;0.020574534161490684
汐海flowerless;10;212;222;2576;0.08618012422360248
只发老婆疯;1;26;27;2576;0.01048136645962733
我和科技那些事;50;171;221;2576;0.08579192546583851
夯她D1矿工专属酷拉皮卡;4;3;7;2576;0.002717391304347826
Nefelibata_2022;2;2;4;2576;0.0015527950310559005
LING叔;6;80;86;2576;0.033385093167701864
神奇小机零;25;168;193;2576;0.0749223602484472
作者欣玥;27;86;113;2576;0.04386645962732919
专业证券分析;1;6;7;2576;0.002717391304347826
这里是日本;108;803;911;2576;0.3536490683229814
视角_日本;29;1335;1364;2576;0.5295031055900621
电商报;16;28;44;2576;0.017080745341614908
姚凌宇;10;206;216;2576;0.08385093167701864
日本沙雕日常;30;2007;2037;2576;0.7907608695652174
Lilhx仙女的名单;2;12;14;2576;0.005434782608695652
陌上读书;311;203;514;2576;0.19953416149068323
南昌火车站;5;9;14;2576;0.005434782608695652
东营广播电视台;17;24;41;2576;0.01591614906832298
新华网;5;49;54;2576;0.02096273291925466
哦一吸养肝茶_;1;1;2;2576;0.0007763975155279503
DM48_高小悦丶;3;7;10;2576;0.0038819875776397515
懿领土_1113;7;19;26;2576;0.010093167701863354
躺平居委会;10;20;30;2576;0.011645962732919254
Daisy左佐;4;52;56;2576;0.021739130434782608
afzondering;1;2;3;2576;0.0011645962732919255
缘宝同心圆;2;1;3;2576;0.0011645962732919255
海利亚白毛鸭;4;19;23;2576;0.008928571428571428
桂哥猎手VIP777;7;66;73;2576;0.028338509316770188
Musical_Fans;2;16;18;2576;0.006987577639751553
海绵饱饱9号机;3;26;29;2576;0.01125776397515528
捣鼓音符的小胖;5;39;44;2576;0.017080745341614908
杨帆教授;137;1278;1415;2576;0.5493012422360248
JIMMYs动画剧场;1;16;17;2576;0.006599378881987578
東方千月;7;35;42;2576;0.016304347826086956
刘小欣富小乐;3;1;4;2576;0.0015527950310559005
一米阳光照我玺;2;2;4;2576;0.0015527950310559005
tfunk;1;1;2;2576;0.0007763975155279503
墨說財經;5;14;19;2576;0.007375776397515528
贵州大数据微博;1;1;2;2576;0.0007763975155279503
槽值;60;126;186;2576;0.07220496894409938
潘学才;8;100;108;2576;0.04192546583850932
种土豆的菌菇;1;1;2;2576;0.0007763975155279503
加特林小土豆;50;217;267;2576;0.10364906832298136
天使大哥;2;14;16;2576;0.006211180124223602
我在四楼耍大刀;1;1;2;2576;0.0007763975155279503
中科大胡不归;12;83;95;2576;0.03687888198757764
白羊白-;1;6;7;2576;0.002717391304347826
专业证券分析;2;6;8;2576;0.003105590062111801
唐律疏议V;7;15;22;2576;0.008540372670807454
金十数据;1;11;12;2576;0.004658385093167702
中科大胡不归;6;27;33;2576;0.01281055900621118
风中流转Ruby;3;14;17;2576;0.006599378881987578
啾星想吃没羶味的坎蒂丝羊咩咩吗;49;280;329;2576;0.12771739130434784
电子世界没有海;1;3;4;2576;0.0015527950310559005
鍋米寶肉_;1;8;9;2576;0.0034937888198757765
猫嘴小超人苏菲;4;33;37;2576;0.01436335403726708
GelekChoe;1;2;3;2576;0.0011645962732919255
祝佳音;15;113;128;2576;0.049689440993788817
啊是xxn;1;3;4;2576;0.0015527950310559005
