发布者;真实一级评论数;真实点赞数;边数;最大边数;集群密度
哇咔咔已存在;16;58;74;31370;0.002358941664010201
゜阿良良木历;167;1001;1168;31370;0.037233025183296145
斑箭;33;272;305;31370;0.00972266496652853
岩究君;7;16;23;31370;0.0007331845712464138
林蚺;34;657;691;31370;0.022027414727446605
ZYonghai;14;62;76;31370;0.0024226968441185847
流动的宇宙;5;12;17;31370;0.0005419190309212624
开着无畏的小吱吱;28;70;98;31370;0.0031240038253108064
一颗虚拟土豆;5;32;37;31370;0.0011794708320051004
厂里的阿木哥;10;38;48;31370;0.0015301243226012113
一眼丁真懒的鉴定;10;33;43;31370;0.001370736372330252
熊游戏说;100;1310;1410;31370;0.04494740197641058
BDFFZI;1253;17000;18253;31370;0.5818616512591648
花式脑洞大玩家Vsir;50;365;415;31370;0.01322919987248964
责无旁代;30;113;143;31370;0.004558495377749442
星辰入怀眠;42;83;125;31370;0.003984698756773988
UTF-8-Single;2;3;5;31370;0.0001593879502709595
北京音视跳动官方账号;139;684;823;31370;0.026235256614599935
肩为诗瘦的骨头;109;2850;2959;31370;0.09432578897035385
玄繄_;84;1958;2042;31370;0.06509403889065987
SUI雪儿;6;31;37;31370;0.0011794708320051004
K大说AI;122;5574;5696;31370;0.1815747529486771
奇迹冰血;1844;3691;5535;31370;0.1764424609499522
Dev通道;217;4372;4589;31370;0.14628626075868664
熊游戏说;11;73;84;31370;0.00267771756455212
汤姆家的Jerry;120;507;627;31370;0.019987248963978323
李小脸和张大白打痘痘;4;51;55;31370;0.0017532674529805547
DrDot;19;493;512;31370;0.016321326107746253
七宫鸭;5;13;18;31370;0.0005737966209754542
MichaelZh;1;4;5;31370;0.0001593879502709595
那谁thatone;7;9;16;31370;0.0005100414408670704
IT那些小事儿;29;117;146;31370;0.004654128147912018
二进制哈士奇;2;14;16;31370;0.0005100414408670704
学不会太难了;21;75;96;31370;0.0030602486452024225
349KUMA;4;22;26;31370;0.0008288173414089894
无知少女的卡密撒嘛;4;5;9;31370;0.0002868983104877271
飞卢网编爱豆;17;52;69;31370;0.0021995537137392412
于乐Beh;7;35;42;31370;0.00133885878227606
再寂核心;24;226;250;31370;0.007969397513547976
洗衣约基因;69;753;822;31370;0.026203379024545743
NewBing新必应趣探;332;2152;2484;31370;0.07918393369461268
积絮;13;22;35;31370;0.0011157156518967167
竹叶梦_亦初;22;283;305;31370;0.00972266496652853
积絮;82;1937;2019;31370;0.06436085431941345
枫叶_Ayanami;19;102;121;31370;0.0038571883965572203
jzbili秋;1;4;5;31370;0.0001593879502709595
骁执;4;276;280;31370;0.008925725215173734
離中虚;5;6;11;31370;0.0003506534905961109
LiveTiles;3;23;26;31370;0.0008288173414089894
苏霍伊vs图波列夫;3;17;20;31370;0.000637551801083838
风花學业;2;6;8;31370;0.0002550207204335352
云时计;8;40;48;31370;0.0015301243226012113
浩渺天冰;2;3;5;31370;0.0001593879502709595
找乐子的河神;4;23;27;31370;0.0008606949314631814
给岁月以生命;41;421;462;31370;0.01472744660503666
SKYzhaoyy;4;6;10;31370;0.000318775900541919
赛博瘸子;191;203;394;31370;0.01255977048135161
胖橘不是胖大橘;8;51;59;31370;0.0018807778131973223
曲光-绎风;1;2;3;31370;9.56327701625757e-05
萧翊凌;1;10;11;31370;0.0003506534905961109
一个兴趣使然的maker;1;4;5;31370;0.0001593879502709595
奇迹冰血;29;348;377;31370;0.012017851450430347
胖橘不是胖大橘;5;14;19;31370;0.0006056742110296462
御坂10839号;1;2;3;31370;9.56327701625757e-05
flexdd和他的月光女神;1;16;17;31370;0.0005419190309212624
上次那位;1;8;9;31370;0.0002868983104877271
小C点课;15;34;49;31370;0.0015620019126554032
奇迹冰血;326;485;811;31370;0.025852725533949635
爱py的流苏;517;1218;1735;31370;0.05530761874402295
夏普西;2;7;9;31370;0.0002868983104877271
鬼畜的达瓦里希;12;25;37;31370;0.0011794708320051004
蛋蛋たまご;2;8;10;31370;0.000318775900541919
夜雨橙;8;37;45;31370;0.0014344915524386356
冷星蝶愿;7;22;29;31370;0.0009244501115715652
AI卡卡布多伊奇;4;22;26;31370;0.0008288173414089894
晴天娃娃哎;11;54;65;31370;0.002072043353522474
IT那些小事儿;12;15;27;31370;0.0008606949314631814
RPA之家;19;11;30;31370;0.000956327701625757
碗裡沒有魚;90;501;591;31370;0.018839655722027414
木槿初荣丶;1;5;6;31370;0.0001912655403251514
離中虚;15;76;91;31370;0.002900860694931463
悠悠二十一;24;68;92;31370;0.002932738284985655
心之视界;1;0;1;31370;3.18775900541919e-05
和AI一起进化;29;800;829;31370;0.026426522154925088
向睌大魇王;162;1659;1821;31370;0.05804909148868346
kemomii;1;2;3;31370;9.56327701625757e-05
Toad蟾绝;7;64;71;31370;0.002263308893847625
梦の三重奏;3;25;28;31370;0.0008925725215173732
呵呵斯坦;1;17;18;31370;0.0005737966209754542
熊游戏说;82;743;825;31370;0.02629901179470832
摇摇机1082;58;201;259;31370;0.008256295824035703
奇迹冰血;86;260;346;31370;0.011029646158750399
川老师兽课了;1;0;1;31370;3.18775900541919e-05
feelsdogman;5;7;12;31370;0.0003825310806503028
倒萨防辐射;2;1;3;31370;9.56327701625757e-05
o熊猫一只o;18;135;153;31370;0.004877271278291361
惠特利;14;23;37;31370;0.0011794708320051004
我是柠檬味酸奶;1;10;11;31370;0.0003506534905961109
奶黄蛋壳;1;8;9;31370;0.0002868983104877271
梦の三重奏;6;26;32;31370;0.0010200828817341408
流星i;35;146;181;31370;0.005769843799808734
椰酒不贪杯;4;41;45;31370;0.0014344915524386356
拂晓前夜;2;1;3;31370;9.56327701625757e-05
豆糕奶酪;5;101;106;31370;0.0033790245457443416
技术流老阿姨Oym;42;45;87;31370;0.0027733503347146956
设计软件库;14;609;623;31370;0.019859738603761556
想想十一会怎么做;7;89;96;31370;0.0030602486452024225
我一按错就;63;666;729;31370;0.023238763149505896
AI学长小林;26;286;312;31370;0.009945808096907875
香锅太凉;4;2;6;31370;0.0001912655403251514
幻想FY;13;155;168;31370;0.00535543512910424
速光网络;21;124;145;31370;0.0046222505578578255
多多来自月亮;13;145;158;31370;0.005036659228562321
和AI一起进步吧;10;112;122;31370;0.003889065986611412
诡谷声;8;4;12;31370;0.0003825310806503028
再寂核心;19;264;283;31370;0.009021357985336308
AI掌门;101;809;910;31370;0.029008606949314633
XH_小黄;2;6;8;31370;0.0002550207204335352
找乐子的河神;12;123;135;31370;0.004303474657315907
Missヾaurora;16;131;147;31370;0.00468600573796621
真寻和美波里;3;15;18;31370;0.0005737966209754542
寸缕a;3;12;15;31370;0.0004781638508128785
希洛a;4;9;13;31370;0.0004144086707044947
木羽zy;1;1;2;31370;6.37551801083838e-05
助力tuo梦fa想;20;55;75;31370;0.0023908192540643925
Missヾaurora;39;237;276;31370;0.008798214854956965
禾青烟;14;126;140;31370;0.004462862607586867
斑箭;49;399;448;31370;0.014281160344277972
动漫二次猿;4;11;15;31370;0.0004781638508128785
夜城电台Aruvito;6;6;12;31370;0.0003825310806503028
DRJ在变瘦了;1;4;5;31370;0.0001593879502709595
改名六个币-;1;3;4;31370;0.0001275103602167676
拔香粑粑;8;22;30;31370;0.000956327701625757
能饮小火炉;1;4;5;31370;0.0001593879502709595
木子文成洛;6;32;38;31370;0.0012113484220592924
熊游戏说;25;437;462;31370;0.01472744660503666
梁爽的风;25;161;186;31370;0.005929231750079694
奇迹冰血;318;475;793;31370;0.025278928912974178
星空末来;2;3;5;31370;0.0001593879502709595
斑箭;4;46;50;31370;0.0015938795027095952
土方的;5;14;19;31370;0.0006056742110296462
我生侠骨非英雄;36;313;349;31370;0.011125278928912975
Web3研习社;3;4;7;31370;0.0002231431303793433
蛋包Fun;9;36;45;31370;0.0014344915524386356
子雾在此;1;5;6;31370;0.0001912655403251514
不会跳票;21;114;135;31370;0.004303474657315907
史蒂芬-祸精;3;5;8;31370;0.0002550207204335352
皮卡八丘;13;28;41;31370;0.001306981192221868
托比杨卡;134;1568;1702;31370;0.05425565827223462
一天不看乃琳就发病;2;11;13;31370;0.0004144086707044947
张三犯法日记;9;61;70;31370;0.0022314313037934334
辉月子Star;1;5;6;31370;0.0001912655403251514
洗衣约基因;83;1074;1157;31370;0.03688237169270003
MC_cookies;1;3;4;31370;0.0001275103602167676
ThingsMatter;110;930;1040;31370;0.03315269365635958
丶Hen淡定;4;7;11;31370;0.0003506534905961109
Eliauk-akurah;3;8;11;31370;0.0003506534905961109
良米良米;43;183;226;31370;0.00720433535224737
你的战龙吖;5;12;17;31370;0.0005419190309212624
和AI一起进化;14;96;110;31370;0.0035065349059611095
殇驹;2;5;7;31370;0.0002231431303793433
WL天尊;2;11;13;31370;0.0004144086707044947
昨日重现001;2;2;4;31370;0.0001275103602167676
二范数智能;4;35;39;31370;0.0012432260121134843
当个哔站小混子;49;271;320;31370;0.010200828817341408
離中虚;65;250;315;31370;0.010041440867070449
Phoelle_;3;9;12;31370;0.0003825310806503028
ddzk;1;1;2;31370;6.37551801083838e-05
沐白川飞;2;8;10;31370;0.000318775900541919
離中虚;25;70;95;31370;0.003028371055148231
任务计划程序taskschd;2;1;3;31370;9.56327701625757e-05
没有鱼刺的于;2;2;4;31370;0.0001275103602167676
张了个赫;6;10;16;31370;0.0005100414408670704
SUI雪儿;1;2;3;31370;9.56327701625757e-05
小豆沙包丶;2;6;8;31370;0.0002550207204335352
壁纸娘official;12;167;179;31370;0.005706088619700351
Sjobss;2;2;4;31370;0.0001275103602167676
镜中虚言;6;60;66;31370;0.0021039209435766656
915代马兆;1;12;13;31370;0.0004144086707044947
太宇可斯;6;7;13;31370;0.0004144086707044947
GolangLearning;8;39;47;31370;0.0014982467325470195
喝着红酒-敲代码;1;2;3;31370;9.56327701625757e-05
K大说AI;80;3632;3712;31370;0.11832961428116034
TN2101;3;3;6;31370;0.0001912655403251514
于惊惊的口袋笔记;96;1509;1605;31370;0.051163532036978
柿子侠丶;2;14;16;31370;0.0005100414408670704
就这称呼吧咋滴;15;97;112;31370;0.003570290086069493
小臧老师_;2;6;8;31370;0.0002550207204335352
一书生尔;1;2;3;31370;9.56327701625757e-05
科技发现;23;240;263;31370;0.00838380618425247
離中虚;13;189;202;31370;0.006439273190946764
游览游览客游览客;1;2;3;31370;9.56327701625757e-05
院长Exiles;1;2;3;31370;9.56327701625757e-05
君莫笑傻了;23;47;70;31370;0.0022314313037934334
_夏_-;2;3;5;31370;0.0001593879502709595
夏蒂奥伊Chatioyr;2;8;10;31370;0.000318775900541919
12356az;20;291;311;31370;0.009913930506853682
知日智丿;138;1428;1566;31370;0.04992030602486452
胖橘不是胖大橘;6;28;34;31370;0.0010838380618425248
麻由里的ENIAC;1;11;12;31370;0.0003825310806503028
一朵鲜花插人间;95;669;764;31370;0.024354478801402613
離中虚;37;153;190;31370;0.006056742110296462
动漫二次猿;1;2;3;31370;9.56327701625757e-05
迪哥起床爱世界;22;103;125;31370;0.003984698756773988
曲光-绎风;1;3;4;31370;0.0001275103602167676
转身ベ便是一世;10;35;45;31370;0.0014344915524386356
奇迹冰血;30;49;79;31370;0.0025183296142811604
皮实andLove;3;25;28;31370;0.0008925725215173732
和AI一起进步吧;3;14;17;31370;0.0005419190309212624
辉月子Star;1;10;11;31370;0.0003506534905961109
霂染zX;1;17;18;31370;0.0005737966209754542
科技猎奇;13;72;85;31370;0.0027095951546063117
啊哈小原;9;31;40;31370;0.001275103602167676
青梅煮酒话语长;35;396;431;31370;0.01373924131335671
严竏子cccp;1;5;6;31370;0.0001912655403251514
不值得关注的程序员UP;10;69;79;31370;0.0025183296142811604
找乐子的河神;5;10;15;31370;0.0004781638508128785
金色葡萄球君;2;35;37;31370;0.0011794708320051004
肉丁同学Rocky;2;46;48;31370;0.0015301243226012113
黍离ing;6;27;33;31370;0.0010519604717883328
kh空白;1;2;3;31370;9.56327701625757e-05
竹叶梦_亦初;2;16;18;31370;0.0005737966209754542
罗小黑der黑;22;289;311;31370;0.009913930506853682
林蚺;10;98;108;31370;0.0034427797258527256
WeSif;71;575;646;31370;0.02059292317500797
MetaMcosM;16;137;153;31370;0.004877271278291361
小胡胡66;3;11;14;31370;0.0004462862607586866
zs_NANTI;2;6;8;31370;0.0002550207204335352
奇迹冰血;7;24;31;31370;0.000988205291679949
Siwccc;4;9;13;31370;0.0004144086707044947
the-observer;149;955;1104;31370;0.03519285941982786
JupiterJPT;2;72;74;31370;0.002358941664010201
办公室的奋斗小白abc;3;0;3;31370;9.56327701625757e-05
向睌大魇王;317;1685;2002;31370;0.0638189352884922
贫民阿右;1;3;4;31370;0.0001275103602167676
-无言宇宙-;42;34;76;31370;0.0024226968441185847
澪L1ng;8;63;71;31370;0.002263308893847625
DKkjjs;2;3;5;31370;0.0001593879502709595
歌者official;5;20;25;31370;0.0007969397513547976
_Hinazuki_Kayo;32;326;358;31370;0.011412177239400701
BestFlowey;5;102;107;31370;0.003410902135798534
杰哥教你登登登;14;35;49;31370;0.0015620019126554032
Eharca;1;8;9;31370;0.0002868983104877271
幻想FY;7;38;45;31370;0.0014344915524386356
灰狼无冥;2;5;7;31370;0.0002231431303793433
投资的维度;2;2;4;31370;0.0001275103602167676
羽一大魔王;5;5;10;31370;0.000318775900541919
存硬币改名儿;6;5;11;31370;0.0003506534905961109
南棠听风;5;8;13;31370;0.0004144086707044947
镜中虚言;1;16;17;31370;0.0005419190309212624
依你指尖;1;15;16;31370;0.0005100414408670704
ChatGPTAi俱乐部;2;5;7;31370;0.0002231431303793433
它喵了个咪咪的;3;5;8;31370;0.0002550207204335352
GEM小周大人;1;5;6;31370;0.0001912655403251514
Girlluckyme;5;21;26;31370;0.0008288173414089894
沐安宸;5;21;26;31370;0.0008288173414089894
萌古丄單;3;4;7;31370;0.0002231431303793433
维瓦娜鬼熊;7;40;47;31370;0.0014982467325470195
是兆兆哇;1;2;3;31370;9.56327701625757e-05
health_first;1;2;3;31370;9.56327701625757e-05
禾青烟;2;3;5;31370;0.0001593879502709595
Falling_Sakura;4;10;14;31370;0.0004462862607586866
daemonliz;2;2;4;31370;0.0001275103602167676
知道E点;114;839;953;31370;0.030379343321644884
爱搞机的郭同学;476;3416;3892;31370;0.12406758049091489
神楽七七四十九奈;2;5;7;31370;0.0002231431303793433
全一逆A;2;2;4;31370;0.0001275103602167676
散步的彭导;66;113;179;31370;0.005706088619700351
奇迹冰血;41;86;127;31370;0.004048453936882372
白粥子_z;1;8;9;31370;0.0002868983104877271
MetaMcosM;2;7;9;31370;0.0002868983104877271
红薯_potato;120;2412;2532;31370;0.0807140580172139
右代宫八城十八;3;4;7;31370;0.0002231431303793433
以求然可;5;13;18;31370;0.0005737966209754542
右代宫八城十八;185;3589;3774;31370;0.12030602486452024
Filsci_WK;2;5;7;31370;0.0002231431303793433
陽仔嘿;1;7;8;31370;0.0002550207204335352
现代魔法研究员;6;4;10;31370;0.000318775900541919
MistyRain;3;1;4;31370;0.0001275103602167676
孽海冰原狼;2;3;5;31370;0.0001593879502709595
_姜枫_;2;6;8;31370;0.0002550207204335352
SiwiC;15;12;27;31370;0.0008606949314631814
星空与百年孤独;4;4;8;31370;0.0002550207204335352
咸鱼少年每日进化中;3;2;5;31370;0.0001593879502709595
投资的维度;1;6;7;31370;0.0002231431303793433
Hyper_R;10;32;42;31370;0.00133885878227606
右代宫八城十八;193;1408;1601;31370;0.05103602167676124
手持摄影研究学会;2;2;4;31370;0.0001275103602167676
黄金坷垃西班牙;5;2;7;31370;0.0002231431303793433
jkghu65;7;15;22;31370;0.0007013069811922218
放羊人1986;29;434;463;31370;0.01475932419509085
沈影默;1;4;5;31370;0.0001593879502709595
秋刀鱼的猫-_-;1;5;6;31370;0.0001912655403251514
里森堡住花太史馆;1;2;3;31370;9.56327701625757e-05
中国GEEK;22;146;168;31370;0.00535543512910424
偶然想起曾经的过往;29;7;36;31370;0.0011475932419509084
莫堂;4;14;18;31370;0.0005737966209754542
WeSif;4;55;59;31370;0.0018807778131973223
AI小学生pingX;1;4;5;31370;0.0001593879502709595
代升级gpt4;1;0;1;31370;3.18775900541919e-05
直播中;1;1;2;31370;6.37551801083838e-05
西园公子冲冲冲;18;123;141;31370;0.004494740197641059
蓝短卷の沙耶香;1;1;2;31370;6.37551801083838e-05
分分钟MIKU掉你;1;3;4;31370;0.0001275103602167676
上岸人冲呀;2;3;5;31370;0.0001593879502709595
赛博云图;2;3;5;31370;0.0001593879502709595
科技视点;1;2;3;31370;9.56327701625757e-05
直播中;5;36;41;31370;0.001306981192221868
GolangLearning;24;51;75;31370;0.0023908192540643925
阿拉德非酋长;4;22;26;31370;0.0008288173414089894
菜叶cc;32;276;308;31370;0.009818297736691106
愈来记挂;20;27;47;31370;0.0014982467325470195
风一样的坑爹哥688;2;4;6;31370;0.0001912655403251514
阿潜潜潜潜潜;2;17;19;31370;0.0006056742110296462
老衲超仁;3;12;15;31370;0.0004781638508128785
L1_Xu4n;74;2335;2409;31370;0.07679311444054829
方方上土;1;8;9;31370;0.0002868983104877271
疯丶桂宝;9;248;257;31370;0.00819254064392732
50%的梦想;2;2;4;31370;0.0001275103602167676
可乐味的冰糖;2;4;6;31370;0.0001912655403251514
沉寂的山丘;1;2;3;31370;9.56327701625757e-05
凌微愁;14;9;23;31370;0.0007331845712464138
跟我练手语;1;2;3;31370;9.56327701625757e-05
blamlight;73;170;243;31370;0.007746254383168632
梦想家嘟嘟嘟嘟;18;17;35;31370;0.0011157156518967167
漫语-倾心;3;23;26;31370;0.0008288173414089894
资深潜水人员;2;2;4;31370;0.0001275103602167676
立刻有又如何;2;10;12;31370;0.0003825310806503028
bili_85396880987;1;3;4;31370;0.0001275103602167676
我就是柠檬味酸奶;10;75;85;31370;0.0027095951546063117
执笔轻诉;1;2;3;31370;9.56327701625757e-05
一切自动;4;18;22;31370;0.0007013069811922218
ojj011;3;5;8;31370;0.0002550207204335352
元来氏佐田;1;1;2;31370;6.37551801083838e-05
-风箱-;1;11;12;31370;0.0003825310806503028
706麒麟;40;37;77;31370;0.0024545744341727765
黄天鬼道;6;4;10;31370;0.000318775900541919
中野三酒;6;4;10;31370;0.000318775900541919
星辰入怀眠;3;9;12;31370;0.0003825310806503028
TinyEdison;7;122;129;31370;0.004112209116990755
高频交易dragon;-5;3;-2;31370;-6.37551801083838e-05
岛民四季宝;18;182;200;31370;0.006375518010838381
迪哥起床爱世界;1;1;2;31370;6.37551801083838e-05
benisben;1;2;3;31370;9.56327701625757e-05
用工具的人;2;24;26;31370;0.0008288173414089894
白箱丶;30;146;176;31370;0.005610455849537775
托比杨卡;21;188;209;31370;0.006662416321326108
白木三石;1;2;3;31370;9.56327701625757e-05
離中虚;4;18;22;31370;0.0007013069811922218
雨落庭澜;1;0;1;31370;3.18775900541919e-05
立刻有又如何;33;101;134;31370;0.004271597067261715
幸运酋长;38;87;125;31370;0.003984698756773988
门罗币公主;1;10;11;31370;0.0003506534905961109
奶黄蛋壳;52;287;339;31370;0.010806503028371056
和AI一起进步吧;3;33;36;31370;0.0011475932419509084
我就是柠檬味酸奶;2;22;24;31370;0.0007650621613006056
一剑倾城;3;5;8;31370;0.0002550207204335352
三火老师;2;1;3;31370;9.56327701625757e-05
老湾python量化交易;1;14;15;31370;0.0004781638508128785
助力tuo梦fa想;12;12;24;31370;0.0007650621613006056
刘卫萌;1;1;2;31370;6.37551801083838e-05
706麒麟;213;2067;2280;31370;0.07268090532355755
给你一楚子_;4;6;10;31370;0.000318775900541919
朋友我是隔壁王学徒;3;7;10;31370;0.000318775900541919
Young丶半仙;5;5;10;31370;0.000318775900541919
你又熬夜了吧;11;28;39;31370;0.0012432260121134843
星辰入怀眠;17;42;59;31370;0.0018807778131973223
不二小段;3;16;19;31370;0.0006056742110296462
世木零;2;1;3;31370;9.56327701625757e-05
幻想Z-;14;15;29;31370;0.0009244501115715652
王点儿--;7;32;39;31370;0.0012432260121134843
zk15d23;1;3;4;31370;0.0001275103602167676
雯是云彩;1;0;1;31370;3.18775900541919e-05
西部打工仔;30;69;99;31370;0.0031558814153649986
测测君;24;333;357;31370;0.011380299649346509
冲浪达人123456;53;283;336;31370;0.01071087025820848
无聊小码农;347;6173;6520;31370;0.2078418871533312
咖啡ovo猫头鹰;2;4;6;31370;0.0001912655403251514
Okey-donkey;12;1;13;31370;0.0004144086707044947
橘大喵_;1;0;1;31370;3.18775900541919e-05
IT那些小事儿;2;2;4;31370;0.0001275103602167676
分分钟MIKU掉你;1;1;2;31370;6.37551801083838e-05
爱搞机的靓仔杰;1;1;2;31370;6.37551801083838e-05
放羊人1986;51;252;303;31370;0.009658909786420146
灵境时代;16;103;119;31370;0.0037934332164488364
-Oran橘;1;14;15;31370;0.0004781638508128785
与糖未来N;3;10;13;31370;0.0004144086707044947
奇迹冰血;16;25;41;31370;0.001306981192221868
奇迹冰血;56;71;127;31370;0.004048453936882372
露米莉娅-斯卡雷特;13;116;129;31370;0.004112209116990755
正经人王同学;6;31;37;31370;0.0011794708320051004
卧龙丹心;1;2;3;31370;9.56327701625757e-05
一个windows爱好者;2;8;10;31370;0.000318775900541919
Tddesu;2;12;14;31370;0.0004462862607586866
Coaixy;8;18;26;31370;0.0008288173414089894
16cafe;4;1;5;31370;0.0001593879502709595
铃风の;1;1;2;31370;6.37551801083838e-05
技不如人deEk;1;0;1;31370;3.18775900541919e-05
飞卢网编爱豆;92;403;495;31370;0.015779407076824993
开心每一天O耶;2;8;10;31370;0.000318775900541919
小龙曦宝;2;5;7;31370;0.0002231431303793433
Andy的百宝箱;16;49;65;31370;0.002072043353522474
头号玩家猹西里;164;5214;5378;31370;0.17143767931144405
半床花影伴书眠__;4;2;6;31370;0.0001912655403251514
银色DE丝线;55;185;240;31370;0.007650621613006056
不二小段;14;58;72;31370;0.002295186483901817
小新星星啦啦啦;2;1;3;31370;9.56327701625757e-05
南嘉野;2;3;5;31370;0.0001593879502709595
abaelard;16;135;151;31370;0.004813516098182978
花花喵主子;3;2;5;31370;0.0001593879502709595
二进制哈士奇;2;7;9;31370;0.0002868983104877271
_逻各斯;10;51;61;31370;0.001944532993305706
viopsa233;77;363;440;31370;0.014026139623844438
动漫二次猿;5;6;11;31370;0.0003506534905961109
奇迹冰血;2;24;26;31370;0.0008288173414089894
赞夼咩-秋裤;3;3;6;31370;0.0001912655403251514
任务计划程序taskschd;2;6;8;31370;0.0002550207204335352
Monogatari-15;1;0;1;31370;3.18775900541919e-05
Bdth_bt;16;33;49;31370;0.0015620019126554032
地下城与摄影士;5;4;9;31370;0.0002868983104877271
三仟世界;1;3;4;31370;0.0001275103602167676
尕芙-德尒塔-缪;1;7;8;31370;0.0002550207204335352
华蕾哎;42;284;326;31370;0.01039209435766656
inu_碳水化合犬;2;3;5;31370;0.0001593879502709595
Toad蟾绝;3;9;12;31370;0.0003825310806503028
天然呆的猪猪侠;23;327;350;31370;0.011157156518967166
一天不看乃琳就发病;4;9;13;31370;0.0004144086707044947
牙膏挤萌王;2;2;4;31370;0.0001275103602167676
竹叶梦_亦初;2;1;3;31370;9.56327701625757e-05
操作相当炸裂;1;12;13;31370;0.0004144086707044947
空小夕;2;6;8;31370;0.0002550207204335352
Axhell;1;2;3;31370;9.56327701625757e-05
梦前光-_-;3;20;23;31370;0.0007331845712464138
可夫小子;4;2;6;31370;0.0001912655403251514
剃须刀刮胸毛;1;2;3;31370;9.56327701625757e-05
奇迹冰血;8;24;32;31370;0.0010200828817341408
庙月乎巨;31;236;267;31370;0.008511316544469238
机智一逼鹏饱饱;2;8;10;31370;0.000318775900541919
风筝风筝飞上天aa;2;1;3;31370;9.56327701625757e-05
UFA军团官方号;3;31;34;31370;0.0010838380618425248
蛋炒鸡丁小饭团;5;2;7;31370;0.0002231431303793433
奇迹冰血;89;127;216;31370;0.006885559451705451
专逗文心;1;0;1;31370;3.18775900541919e-05
光辉的青春-;2;7;9;31370;0.0002868983104877271
无处安放的小黑菌;1;6;7;31370;0.0002231431303793433
四圣释禅心;1;6;7;31370;0.0002231431303793433
龙皮手套;25;94;119;31370;0.0037934332164488364
摆烂公孙;1;5;6;31370;0.0001912655403251514
赞夼咩-秋裤;4;14;18;31370;0.0005737966209754542
乐瑶做生活的高手;2;1;3;31370;9.56327701625757e-05
博文哥-;8;40;48;31370;0.0015301243226012113
请催我去学做live2d;1;0;1;31370;3.18775900541919e-05
小王来爪哇;2;5;7;31370;0.0002231431303793433
文化与艺术家;1;4;5;31370;0.0001593879502709595
JupiterJPT;1;24;25;31370;0.0007969397513547976
电子垃圾大全;2;4;6;31370;0.0001912655403251514
皮卡八丘;1;6;7;31370;0.0002231431303793433
围巾哥V;3;12;15;31370;0.0004781638508128785
麦隔伤心鸭;2;3;5;31370;0.0001593879502709595
图书馆星老师;8;13;21;31370;0.00066942939113803
西瓜肉酱;1;1;2;31370;6.37551801083838e-05
有乐哆哆;6;7;13;31370;0.0004144086707044947
祖安小花;1;11;12;31370;0.0003825310806503028
老吃猪侠;20;12;32;31370;0.0010200828817341408
御宅制造中心;4;1;5;31370;0.0001593879502709595
御坂10839号;2;6;8;31370;0.0002550207204335352
小龙曦宝;1;4;5;31370;0.0001593879502709595
only逆蝶oo;3;12;15;31370;0.0004781638508128785
千野风狂;1;0;1;31370;3.18775900541919e-05
我就是柠檬味酸奶;1;26;27;31370;0.0008606949314631814
划水不是在摸鱼;1;2;3;31370;9.56327701625757e-05
水清沙白ovo;2;1;3;31370;9.56327701625757e-05
狂奔的di蜗牛;1;1;2;31370;6.37551801083838e-05
我就是柠檬味酸奶;2;24;26;31370;0.0008288173414089894
困崽没事过载了;2;3;5;31370;0.0001593879502709595
張Bi閗;1;0;1;31370;3.18775900541919e-05
黑面沸龟;1;0;1;31370;3.18775900541919e-05
Jazz0Trumpet;3;8;11;31370;0.0003506534905961109
最无敌可爱的小吴;2;0;2;31370;6.37551801083838e-05
游戏攻资君;2;1;3;31370;9.56327701625757e-05
AI新世界的船;1;3;4;31370;0.0001275103602167676
贱贱姐;2;3;5;31370;0.0001593879502709595
hhh-wtf;3;13;16;31370;0.0005100414408670704
贫民阿右;1;3;4;31370;0.0001275103602167676
xh89agbuikj;3;2;5;31370;0.0001593879502709595
直播中;2;5;7;31370;0.0002231431303793433
安晓蘭;2;2;4;31370;0.0001275103602167676
枫秀帝君;2;2;4;31370;0.0001275103602167676
流家星少爷;1;12;13;31370;0.0004144086707044947
8896w;1;8;9;31370;0.0002868983104877271
中国GEEK;1;2;3;31370;9.56327701625757e-05
冰城化雨;2;2;4;31370;0.0001275103602167676
狂风凶勇;2;5;7;31370;0.0002231431303793433
伍贰1379;3;6;9;31370;0.0002868983104877271
小猪憨憨憨;1;4;5;31370;0.0001593879502709595
WarmneoN;1;6;7;31370;0.0002231431303793433
幻_城;3;5;8;31370;0.0002550207204335352
DrDot;370;31000;31370;31370;1.0
峰不二子の謎弟;5;10;15;31370;0.0004781638508128785
有一天喵喵喵喵;1;3;4;31370;0.0001275103602167676
废石;3;13;16;31370;0.0005100414408670704
丿Ray丶丶;1;2;3;31370;9.56327701625757e-05
看亿点未来;26;246;272;31370;0.008670704494740198
全民编程是有意义;1;3;4;31370;0.0001275103602167676
竹叶梦_亦初;2;2;4;31370;0.0001275103602167676
哈士奇本狗;10;61;71;31370;0.002263308893847625
自律打卡邢同学;1;3;4;31370;0.0001275103602167676
知秋知寒;1;5;6;31370;0.0001912655403251514
StevenW65;5;94;99;31370;0.0031558814153649986
主机空间;1;2;3;31370;9.56327701625757e-05
KiRiKiRiKiREi;1;6;7;31370;0.0002231431303793433
Brokeboishawty;1;1;2;31370;6.37551801083838e-05
PockyPudding;1;5;6;31370;0.0001912655403251514
爱搞机的郭同学;20;77;97;31370;0.0030921262352566147
现实与理想的尽头;1;0;1;31370;3.18775900541919e-05
zbxzbx98;1;5;6;31370;0.0001912655403251514
冷月无声惜马蹄;76;1223;1299;31370;0.04140898948039528
zhepeng_;1;7;8;31370;0.0002550207204335352
薛定谔的大小眼;2;6;8;31370;0.0002550207204335352
帘予Y;4;11;15;31370;0.0004781638508128785
唐半弦;40;222;262;31370;0.008351928594198279
乾龙盘钱;19;110;129;31370;0.004112209116990755
jihualz008;1;3;4;31370;0.0001275103602167676
丁仪硕士;25;18;43;31370;0.001370736372330252
叔叔hao牛啤;6;14;20;31370;0.000637551801083838
不甘平凡的安梦;10;50;60;31370;0.001912655403251514
杰哥教你登登登;4;40;44;31370;0.0014026139623844437
沐安宸;1;17;18;31370;0.0005737966209754542
斑箭;3;5;8;31370;0.0002550207204335352
DorabacktoCV;1;9;10;31370;0.000318775900541919
GPT撸英语;1;6;7;31370;0.0002231431303793433
隔壁程总;2;3;5;31370;0.0001593879502709595
望月几侗村;2;3;5;31370;0.0001593879502709595
理性派小杨;3;9;12;31370;0.0003825310806503028
DreamsSetFree;1;3;4;31370;0.0001275103602167676
Timelessisle;1;1;2;31370;6.37551801083838e-05
刚通网的Cuter;1;2;3;31370;9.56327701625757e-05
马拉卡啃大瓜;2;2;4;31370;0.0001275103602167676
蓝天解说吖1;3;8;11;31370;0.0003506534905961109
褚鏡;16;77;93;31370;0.002964615875039847
RPA之家;3;8;11;31370;0.0003506534905961109
搞仿真的晴博;10;110;120;31370;0.003825310806503028
LV6点赞人;2;2;4;31370;0.0001275103602167676
暗夜暗魂;2;44;46;31370;0.0014663691424928276
小谭清清;1;6;7;31370;0.0002231431303793433
怒也偷一点;2;1;3;31370;9.56327701625757e-05
waitXmin;1;3;4;31370;0.0001275103602167676
冰的顏色;1;7;8;31370;0.0002550207204335352
雍华壮;1;3;4;31370;0.0001275103602167676
MichaelZh;1;1;2;31370;6.37551801083838e-05
红薯_potato;1;2;3;31370;9.56327701625757e-05
风花學业;3;17;20;31370;0.000637551801083838
手持摄影研究学会;1;6;7;31370;0.0002231431303793433
離中虚;2;7;9;31370;0.0002868983104877271
NVGUKYM;1;3;4;31370;0.0001275103602167676
别叫我取名字啊;1;2;3;31370;9.56327701625757e-05
沧峦;6;8;14;31370;0.0004462862607586866
萨尼铁塔黑扶米亚;1;4;5;31370;0.0001593879502709595
硅基生物-;1;8;9;31370;0.0002868983104877271
Terrell特雷尔呀;2;8;10;31370;0.000318775900541919
也许这样也挺好;1;10;11;31370;0.0003506534905961109
也许这样也挺好;1;5;6;31370;0.0001912655403251514
评论秒回的know634;7;24;31;31370;0.000988205291679949
西瓜肉酱;1;3;4;31370;0.0001275103602167676
西瓜肉酱;1;7;8;31370;0.0002550207204335352
木又力L;2;2;4;31370;0.0001275103602167676
咿呀咿呀哟x_x;2;6;8;31370;0.0002550207204335352
德胜刘;2;7;9;31370;0.0002868983104877271
陽仔嘿;3;26;29;31370;0.0009244501115715652
八聲;1;2;3;31370;9.56327701625757e-05
UILEO;404;5742;6146;31370;0.19591966847306344
天口木仓;1;1;2;31370;6.37551801083838e-05
麦田十三岁;1;5;6;31370;0.0001912655403251514
叽叭王子;1;8;9;31370;0.0002868983104877271
星归间江;30;350;380;31370;0.012113484220592923
我今天就要把你烧成炭;7;35;42;31370;0.00133885878227606
老李与GPT;3;8;11;31370;0.0003506534905961109
我是柠檬味酸奶;1;11;12;31370;0.0003825310806503028
超爱刘星的东东;1;2;3;31370;9.56327701625757e-05
御坂10839号;2;5;7;31370;0.0002231431303793433
蓝二三四五六七;1;0;1;31370;3.18775900541919e-05
杰克kkk;5;5;10;31370;0.000318775900541919
融化的哈士奇;1;0;1;31370;3.18775900541919e-05
荒潮Arashiooo;3;12;15;31370;0.0004781638508128785
王溯洄;3;9;12;31370;0.0003825310806503028
我就是柠檬味酸奶;4;29;33;31370;0.0010519604717883328
陽仔嘿;2;11;13;31370;0.0004144086707044947
土豆泥沙拉酱;1;4;5;31370;0.0001593879502709595
科幻朱朱侠;1;2;3;31370;9.56327701625757e-05
锁定东方;4;18;22;31370;0.0007013069811922218
我没搁那旮瘩;2;29;31;31370;0.000988205291679949
349KUMA;1;2;3;31370;9.56327701625757e-05
Coaixy;6;14;20;31370;0.000637551801083838
侵权申诉处;1;5;6;31370;0.0001912655403251514
newbing大小姐;1;4;5;31370;0.0001593879502709595
不过迈步从头越;2;12;14;31370;0.0004462862607586866
雪糕挺甜;1;5;6;31370;0.0001912655403251514
jansona;1;7;8;31370;0.0002550207204335352
布吉咔叽补集韩;31;42;73;31370;0.002327064073956009
5656501;1;3;4;31370;0.0001275103602167676
Siwccc;1;0;1;31370;3.18775900541919e-05
怼家魁首--怼子;2;7;9;31370;0.0002868983104877271
老师让我改个名;1;2;3;31370;9.56327701625757e-05
爱搞机的郭同学;205;1698;1903;31370;0.06066305387312719
Switch在哪里;1;5;6;31370;0.0001912655403251514
CZ-LI;1;4;5;31370;0.0001593879502709595
要送外卖的驴小羊;3;3;6;31370;0.0001912655403251514
季风风风;8;12;20;31370;0.000637551801083838
陽仔嘿;1;8;9;31370;0.0002868983104877271
武汉小鹏vlog;10;69;79;31370;0.0025183296142811604
期末必过i;2;5;7;31370;0.0002231431303793433
空闲测评chatGPT;1;0;1;31370;3.18775900541919e-05
NewBing新必应趣探;7;25;32;31370;0.0010200828817341408
IShowSpeed甲亢哥官方;2;3;5;31370;0.0001593879502709595
cc爱辅助;2;2;4;31370;0.0001275103602167676
Edwin_lee;2;1;3;31370;9.56327701625757e-05
昨天的雨今天下;2;2;4;31370;0.0001275103602167676
文之易音;1;1;2;31370;6.37551801083838e-05
lucifermzhang;1;2;3;31370;9.56327701625757e-05
赛博克拉克特;1;5;6;31370;0.0001912655403251514
阿石粒扬教授;1;6;7;31370;0.0002231431303793433
罗德岛办事处;17;65;82;31370;0.002613962384443736
RC丸钢;11;108;119;31370;0.0037934332164488364
剑克锋;3;2;5;31370;0.0001593879502709595
-熊哩-;2;1;3;31370;9.56327701625757e-05
林w檎;6;17;23;31370;0.0007331845712464138
神兵小将P;1;1;2;31370;6.37551801083838e-05
整碗米线;1;4;5;31370;0.0001593879502709595
Co-酱;1;0;1;31370;3.18775900541919e-05
这可不兴看呀;8;30;38;31370;0.0012113484220592924
叨叨侠AI;1;3;4;31370;0.0001275103602167676
22层痴;2;4;6;31370;0.0001912655403251514
油鸡喙;2;4;6;31370;0.0001912655403251514
洋拉图;317;2688;3005;31370;0.09579215811284666
禾青烟;24;104;128;31370;0.004080331526936563
长枫夜白;1;10;11;31370;0.0003506534905961109
木淡吹又生;1;1;2;31370;6.37551801083838e-05
这可不兴看呀;1;12;13;31370;0.0004144086707044947
陽仔嘿;3;15;18;31370;0.0005737966209754542
憨憨天翎;3;4;7;31370;0.0002231431303793433
電动人;10;15;25;31370;0.0007969397513547976
阡之尘埃;2;2;4;31370;0.0001275103602167676
云行无常元妙归淳;21;16;37;31370;0.0011794708320051004
lithium__flower;8;17;25;31370;0.0007969397513547976
Constantinus11;3;5;8;31370;0.0002550207204335352
ベレッタ;1;10;11;31370;0.0003506534905961109
九幽炎歌;19;41;60;31370;0.001912655403251514
22535441760_bili;1;4;5;31370;0.0001593879502709595
varACundefined;4;20;24;31370;0.0007650621613006056
黑框白眼镜;1;2;3;31370;9.56327701625757e-05
九曜星君DGY;4;14;18;31370;0.0005737966209754542
DayDayUp每天向上;1;14;15;31370;0.0004781638508128785
Lciu_7;19;66;85;31370;0.0027095951546063117
冷酱冷酱冷;4;4;8;31370;0.0002550207204335352
健康入口;1;4;5;31370;0.0001593879502709595
北宸Polariss;50;349;399;31370;0.012719158431622569
知道E点;29;377;406;31370;0.012942301562001912
钱小雨雨;22;76;98;31370;0.0031240038253108064
于乐Beh;739;626;1365;31370;0.04351291042397195
昨天的雨今天下;18;47;65;31370;0.002072043353522474
乌鸦反杀龙卷风;4;5;9;31370;0.0002868983104877271
GolangLearning;21;23;44;31370;0.0014026139623844437
troilusoct;326;5106;5432;31370;0.1731590691743704
Mark孔子;1;2;3;31370;9.56327701625757e-05
咩咩咩Lx;2;0;2;31370;6.37551801083838e-05
飞蛾扑火时;5;8;13;31370;0.0004144086707044947
Tricia77;1;3;4;31370;0.0001275103602167676
网络工程师七七;6;62;68;31370;0.0021676761236850495
爱搞机的郭同学;51;477;528;31370;0.016831367548613325
月与柏;1;4;5;31370;0.0001593879502709595
糟糕的婚礼;38;466;504;31370;0.01606630538731272
来自火距星的少年;5;34;39;31370;0.0012432260121134843
科技音乐爱分享;5;7;12;31370;0.0003825310806503028
街头迷你四驱-Kyu;9;41;50;31370;0.0015938795027095952
门罗币公主;1;11;12;31370;0.0003825310806503028
蔚蓝的珊瑚海o;106;372;478;31370;0.01523748804590373
凯凯吃西瓜;2;0;2;31370;6.37551801083838e-05
安德菠萝包夫;2;2;4;31370;0.0001275103602167676
離中虚;7;3;10;31370;0.000318775900541919
Q弹的硬币;1;2;3;31370;9.56327701625757e-05
小朋电脑网络科技;31;20;51;31370;0.0016257570927637871
圣夜改;1;10;11;31370;0.0003506534905961109
温榆akuma;1;2;3;31370;9.56327701625757e-05
浅离忘忧;4;7;11;31370;0.0003506534905961109
AI应用领航者;6;2;8;31370;0.0002550207204335352
技术流老阿姨Oym;1;6;7;31370;0.0002231431303793433
猫爪的小跟班;5;4;9;31370;0.0002868983104877271
肖育文视界;12;58;70;31370;0.0022314313037934334
晨隐_;3;18;21;31370;0.00066942939113803
Celesrandwat;1;3;4;31370;0.0001275103602167676
进攻进攻再进攻;5;0;5;31370;0.0001593879502709595
城规理论团;1;4;5;31370;0.0001593879502709595
狗小带;22;155;177;31370;0.005642333439591967
小亮1983;2;5;7;31370;0.0002231431303793433
量子位;283;17000;17283;31370;0.5509403889065987
忠于子Loyal;6;20;26;31370;0.0008288173414089894
钊我满怀冰雪;6;15;21;31370;0.00066942939113803
GlaD-OS;2;1;3;31370;9.56327701625757e-05
一口会修仙的锅子;3;11;14;31370;0.0004462862607586866
生于夏末初秋;2;8;10;31370;0.000318775900541919
懒懒冲鸭;1;1;2;31370;6.37551801083838e-05
IT那些小事儿;24;63;87;31370;0.0027733503347146956
啷儿个哩个浪;1;6;7;31370;0.0002231431303793433
南京在逃盐水鴨;2;2;4;31370;0.0001275103602167676
AnninSpace;1;2;3;31370;9.56327701625757e-05
傻大个科技;24;255;279;31370;0.008893847625119541
你好我叫袁园圆;1;2;3;31370;9.56327701625757e-05
每天安安心心更新视频;1;10;11;31370;0.0003506534905961109
九幽炎歌;1;1;2;31370;6.37551801083838e-05
暴毙小王子;1;4;5;31370;0.0001593879502709595
AI掌门;90;135;225;31370;0.0071724577621931785
兔阿归er;3;4;7;31370;0.0002231431303793433
20岁还没用过chatGPT;21;37;58;31370;0.0018489002231431304
3572707928;2;21;23;31370;0.0007331845712464138
香香卿娜娜奇;1;4;5;31370;0.0001593879502709595
巴纳姆的马戏世界;2;23;25;31370;0.0007969397513547976
996的R科技;2;11;13;31370;0.0004144086707044947
桐野雪絵;3;35;38;31370;0.0012113484220592924
俅俅是我;5;4;9;31370;0.0002868983104877271
随鹰;2;0;2;31370;6.37551801083838e-05
超越1223;1;23;24;31370;0.0007650621613006056
AI工具推荐;4;51;55;31370;0.0017532674529805547
_Hinazuki_Kayo;8;32;40;31370;0.001275103602167676
aRknights_0024;1;1;2;31370;6.37551801083838e-05
雾切橘子;3;17;20;31370;0.000637551801083838
Chinzicam;37;79;116;31370;0.0036978004462862608
洛琪希的苹果;2;1;3;31370;9.56327701625757e-05
Colorless_Cat;2;10;12;31370;0.0003825310806503028
俗人_LM;11;35;46;31370;0.0014663691424928276
喵喵喵传奇影业;1;3;4;31370;0.0001275103602167676
一只拆家狗;4;7;11;31370;0.0003506534905961109
么么哒小陈o;10;49;59;31370;0.0018807778131973223
chaoscodes;38;450;488;31370;0.015556263946445648
有乐哆哆;2;5;7;31370;0.0002231431303793433
荒夢橘;11;62;73;31370;0.002327064073956009
乱搞的升哥;2;3;5;31370;0.0001593879502709595
zhepeng_;51;983;1034;31370;0.032961428116034426
皮实andLove;2;4;6;31370;0.0001912655403251514
金馆长VS金馆长;2;2;4;31370;0.0001275103602167676
卡秃噜皮君;79;1254;1333;31370;0.04249282754223781
想做大佬的萌新晓黎;2;8;10;31370;0.000318775900541919
不良人候卿;6;14;20;31370;0.000637551801083838
手持摄影研究学会;2;10;12;31370;0.0003825310806503028
月亮掉入芬达;2;0;2;31370;6.37551801083838e-05
长枫夜白;10;22;32;31370;0.0010200828817341408
ThingsMatter;62;642;704;31370;0.0224418233981511
恰坨子咯;114;4025;4139;31370;0.1319413452343003
甘蔗有点肥;4;6;10;31370;0.000318775900541919
御坂1412号;1;1;2;31370;6.37551801083838e-05
GPT撸英语;1;3;4;31370;0.0001275103602167676
土豆泥沙拉酱;9;114;123;31370;0.003920943576665604
