label;一级评论;真实二级评论数;真实点赞数;边数;最大边数;集群密度
0;为什么没有Get智能写作;6;83;89;20497;0.004342098843733229
7;请问都是免费的吗？;7;55;62;20497;0.0030248329023759572
15;还是gtp好一些;7;2;9;20497;0.0004390886471190906
23;还是会计吃香，毕竟ai只会做真的;7;22;29;20497;0.0014148411962726253
31;试用了一下，不就是openai的价格翻了10倍，功能阉割了不少。但是总体上来说付费来提高工作效率确实不错，总体性价比挺高;2;15;17;20497;0.0008293896667805044
35;再也不用操心我儿子的小学征文了;2;6;8;20497;0.00039030101966141384
38;海马轻帆没找到呀;3;2;5;20497;0.00024393813728838367
43;以后博士毕业论文也可以让AI来写吗？;1;5;6;20497;0.0002927257647460604
46;都有openai的技术对吧;1;4;5;20497;0.00024393813728838367
48;海马轻帆现在不能用了吧;2;1;3;20497;0.0001463628823730302
60;为什么没有黑豆智能工具箱;1;0;1;20497;4.878762745767673e-05
62;要钱么这个;1;0;1;20497;4.878762745767673e-05
68;和变相的浏览器有什么区别;1;0;1;20497;4.878762745767673e-05
72;论文呢;1;0;1;20497;4.878762745767673e-05
76;不如写作猫，写作猫是目前最好用的;5;4;9;20497;0.0004390886471190906
89;火龙果写作真的是最难用的;1;0;1;20497;4.878762745767673e-05
91;多谢介绍;1;0;1;20497;4.878762745767673e-05
94;Hi，你好;1;0;1;20497;4.878762745767673e-05
97;你这谁写的;1;0;1;20497;4.878762745767673e-05
100;非常好;1;1;2;20497;9.757525491535346e-05
106;Suzzkk;1;0;1;20497;4.878762745767673e-05
109;彧謩;1;0;1;20497;4.878762745767673e-05
112;明明明明爱吃醋;1;0;1;20497;4.878762745767673e-05
128;一盏明灯儿;1;0;1;20497;4.878762745767673e-05
131;FridayAI场景。火龙果写作，改写润色校对翻译续写。海马轻帆适合小说新手创作者;2;9;11;20497;0.000536663902034444
134;本人特意试了第一个，千万别上当;2;2;4;20497;0.00019515050983070692
137;这些都是垃圾，没有chatgpt好;1;4;5;20497;0.00024393813728838367
144;我主页的AI都绘画本，写故事了，还使用了蒙太奇手法;1;1;2;20497;9.757525491535346e-05
158;能写小说吗，想唐三少那样子年入百万;1;0;1;20497;4.878762745767673e-05
184;写作猫试了假大空比较合适;7;72;79;20497;0.003854222569156462
192;我完全没有看到科技所谓的进步，只是因为放大了人类的懒惰;42;101;143;20497;0.006976630726447773
235;gpt无敌;5;11;16;20497;0.0007806020393228277
241;写作猫体验太差，和国外的GPT相比较，不能相提并论;12;19;31;20497;0.0015124164511879786
254;免费还是收费？;8;17;25;20497;0.0012196906864419183
263;试试鬼手剪辑;1;10;11;20497;0.000536663902034444
265;第一个应该不是AI写作，感觉好像是在网上找了个跟你标题一样的文章复制过来;3;10;13;20497;0.0006342391569497975
269;收费吗？;3;5;8;20497;0.00039030101966141384
273;花钱吗;3;3;6;20497;0.0002927257647460604
277;这到底算谁的;1;9;10;20497;0.00048787627457676734
279;这就是Giiso刚刚注册试了下。就帮我写了这么个玩意。;1;3;4;20497;0.00019515050983070692
281;收费不;1;3;4;20497;0.00019515050983070692
285;有没有做设计的啊，麻烦推荐一下呗;1;0;1;20497;4.878762745767673e-05
291;羊羊羊的小尾巴看这个;1;0;1;20497;4.878762745767673e-05
299;鄧这里这里;1;1;2;20497;9.757525491535346e-05
302;要钱吗;1;0;1;20497;4.878762745767673e-05
328;0;1;0;1;20497;4.878762745767673e-05
348;0;1;2;3;20497;0.0001463628823730302
350;我用了查重爆炸最后还是找的代写一稿就帮我过了专业的事情交给专业的人这句话还是有道理的;3;6;9;20497;0.0004390886471190906
354;chatGPT通通解决。;1;4;5;20497;0.00024393813728838367
357;别听他瞎说，别上当，全是垃圾东西，骗你会员;1;1;2;20497;9.757525491535346e-05
359;只有chatgpt;2;0;2;20497;9.757525491535346e-05
374;当你看到这条评论的时候你已经晚了两个月了;1;0;1;20497;4.878762745767673e-05
387;买个chatgpt也可以用;1;0;1;20497;4.878762745767673e-05
403;现在写文案和论文，全都AI搞定了;6;5;11;20497;0.000536663902034444
410;前两个网站，第三个软件;6;6;12;20497;0.0005854515294921208
417;全是收费的;1;1;2;20497;9.757525491535346e-05
420;不会啊太难用了;1;0;1;20497;4.878762745767673e-05
422;每个点赞的人都收藏了，;1;0;1;20497;4.878762745767673e-05
443;大家知不知道又一个狗屁不通文章生成器的网站。;1;1;2;20497;9.757525491535346e-05
447;他们不会真喝过吧;2;25;27;20497;0.0013172659413572718
450;我已经用上了很强大;2;0;2;20497;9.757525491535346e-05
453;不用科学上网能用吗？;9;9;18;20497;0.0008781772942381812
463;怎么下载;7;0;7;20497;0.00034151339220373715
471;3个结合起来，就不需要基层搬砖的啦;2;8;10;20497;0.00048787627457676734
474;这些去哪里下载搜索基本搜索不到。;6;0;6;20497;0.0002927257647460604
481;简直太好用啦，;3;0;3;20497;0.0001463628823730302
485;之前的写营销文案的呢;2;1;3;20497;0.0001463628823730302
488;懒得鼓捣不如花几块钱买一个;1;3;4;20497;0.00019515050983070692
490;公文可以吗;2;0;2;20497;9.757525491535346e-05
493;用哪个软件？;2;0;2;20497;9.757525491535346e-05
498;为啥我用查特写作投稿十几篇都被退稿了;1;0;1;20497;4.878762745767673e-05
500;没有一个不收费;2;0;2;20497;9.757525491535346e-05
512;用户917334534597报告文案有着落了;1;1;2;20497;9.757525491535346e-05
515;开题报告过过过等我试试广告;1;0;1;20497;4.878762745767673e-05
519;HL灰色的秋刀鱼啦啦啦啦耶耶耶耶KK一口大蒜一口面;1;2;3;20497;0.0001463628823730302
522;如果只做考勤表函数也可以吗？;1;0;1;20497;4.878762745767673e-05
527;为啥我每次提问都会跳转到应用程序错误，发生了客户端异常;1;0;1;20497;4.878762745767673e-05
532;小雷不犯困;1;0;1;20497;4.878762745767673e-05
549;这家伙很懒;1;0;1;20497;4.878762745767673e-05
553;西瓜很甜一个小王子;2;0;2;20497;9.757525491535346e-05
564;楷瑟琳Katherine;1;0;1;20497;4.878762745767673e-05
569;能写擦边小说吗？;7;4;11;20497;0.000536663902034444
577;怎么用chatgpt;6;1;7;20497;0.00034151339220373715
586;手机怎么下;1;0;1;20497;4.878762745767673e-05
588;在哪儿获取chatGPT这个网址？;1;0;1;20497;4.878762745767673e-05
590;前提是不塞车plus排到了，就是卡买不到;1;0;1;20497;4.878762745767673e-05
610;最后一个是什么？;2;4;6;20497;0.0002927257647460604
643;昧良心推荐，不怕遭报应吗;1;35;36;20497;0.0017563545884763624
645;第3款在哪里下呀？;2;3;5;20497;0.00024393813728838367
648;我一堆免费;4;0;4;20497;0.00019515050983070692
669;锅内的基本收费;1;12;13;20497;0.0006342391569497975
672;免费吗？;2;1;3;20497;0.0001463628823730302
679;视频最后不是给了网址吗，是网址网址不是小程序，不是App。免费的不收费。;1;11;12;20497;0.0005854515294921208
682;问题在于你是想要一份自己的周报，还是想要一份自己都不理解的周报？;2;1;3;20497;0.0001463628823730302
685;付费吗？;1;0;1;20497;4.878762745767673e-05
687;不知道你们信不信，我职场中第一次升职就是因为和领导硬钢不写周报。;1;1;2;20497;9.757525491535346e-05
690;这个没有找到;1;0;1;20497;4.878762745767673e-05
692;华为手机没找到呢;1;0;1;20497;4.878762745767673e-05
708;欧豆豆差不多小姐你胖你先吃;1;0;1;20497;4.878762745767673e-05
715;奶糖;1;0;1;20497;4.878762745767673e-05
720;哪下载，咋使用;1;3;4;20497;0.00019515050983070692
724;如果周报有用，编造的周报有什么意义？如果周报无用，编造的周报又有什么意义？;1;0;1;20497;4.878762745767673e-05
731;你后面的钟表变形了;2;6;8;20497;0.00039030101966141384
735;敢敢老师站在好漂亮;1;0;1;20497;4.878762745767673e-05
745;吴忧无虑;1;2;3;20497;0.0001463628823730302
755;AI文案写作神器，我只认可97文案;2;2;4;20497;0.00019515050983070692
765;明明要钱;5;3;8;20497;0.00039030101966141384
771;秘塔已经开始收费了;24;90;114;20497;0.005561789530175148
796;极致写作社;3;12;15;20497;0.000731814411865151
808;小蜗这个;2;1;3;20497;0.0001463628823730302
822;0;2;1;3;20497;0.0001463628823730302
825;天蛋Lnhb;2;0;2;20497;9.757525491535346e-05
831;rrrrrrlighting是AU鸭月月baby啊嗝嗝嗝嗝啊Mandarin211ppppppp;1;2;3;20497;0.0001463628823730302
834;芸;1;0;1;20497;4.878762745767673e-05
836;cc，;1;0;1;20497;4.878762745767673e-05
844;照一世在等星星吗;1;2;3;20497;0.0001463628823730302
848;椿，偷一抹月光纯属虚构;1;2;3;20497;0.0001463628823730302
852;陈十余是小澄同学阿小千你好敷衍Dnfdlkand1河夕;1;0;1;20497;4.878762745767673e-05
854;全假的;6;2;8;20497;0.00039030101966141384
861;听说最近抖音更新了，发不了动图了;2;1;3;20497;0.0001463628823730302
864;都是收费的，还白P呢;1;1;2;20497;9.757525491535346e-05
869;那如果碰上写h的咋办？;1;0;1;20497;4.878762745767673e-05
881;就问要不要钱吧;1;18;19;20497;0.0009269649216958579
885;教坏小孩子;2;0;2;20497;9.757525491535346e-05
890;能不能写论文;1;0;1;20497;4.878762745767673e-05
910;围棋5段试试去;3;0;3;20497;0.0001463628823730302
916;为什么第一个没有网网址呢;1;0;1;20497;4.878762745767673e-05
928;貌似收费有点夸张哦;2;20;22;20497;0.001073327804068888
931;这不是可以大肆拍造谣视频了;1;11;12;20497;0.0005854515294921208
935;能去马赛克吗;1;1;2;20497;9.757525491535346e-05
939;免费不？;2;0;2;20497;9.757525491535346e-05
942;收费吗;2;0;2;20497;9.757525491535346e-05
947;在哪用;1;0;1;20497;4.878762745767673e-05
955;z大奔这个吗;1;0;1;20497;4.878762745767673e-05
963;tbtfrfr润色论文应该也可以吧;1;0;1;20497;4.878762745767673e-05
987;0;1;0;1;20497;4.878762745767673e-05
1003;这不是giiso写作机器人吗？;6;17;23;20497;0.0011221154315265648
1010;这个一个月得多少钱啊;3;3;6;20497;0.0002927257647460604
1069;在哪里下载？我是免费的吗;1;0;1;20497;4.878762745767673e-05
1071;不是软件厉害，是包月太贵;1;0;1;20497;4.878762745767673e-05
1090;喜欢的可以试试，每天都有免费使用时长;28;60;88;20497;0.004293311216275552
1119;电影解说怎么做的。你给大家说说。详细教程;12;43;55;20497;0.0026833195101722204
1132;要交费的，vip，下载了又删了;7;22;29;20497;0.0014148411962726253
1140;懂的很容易是真的;1;0;1;20497;4.878762745767673e-05
1142;需要二次改文案的时候，如果文字不够需要用钱买对吧？;6;16;22;20497;0.001073327804068888
1149;好用，我的抖音因为有你变得格外精彩;1;25;26;20497;0.001268478313899595
1152;老师好请问说得相机是要下载的吗？;6;9;15;20497;0.000731814411865151
1159;影视在哪剪辑;2;12;14;20497;0.0006830267844074743
1162;老师太棒了全是能赚大米的老师太优秀;2;10;12;20497;0.0005854515294921208
1165;教的都是干货在这里学到了好多;2;6;8;20497;0.00039030101966141384
1168;别信，现在什么都是要下载后收费的。;3;3;6;20497;0.0002927257647460604
1175;主播讲的很详细，就是学不会;1;4;5;20497;0.00024393813728838367
1178;A丨软件要买多少钱的呀;1;0;1;20497;4.878762745767673e-05
1206;还没见涨过粉;3;0;3;20497;0.0001463628823730302
1219;这个软件能过原创吗？;1;0;1;20497;4.878762745767673e-05
1221;最讨厌这种洗稿的了;2;0;2;20497;9.757525491535346e-05
1230;涨了1400多;1;1;2;20497;9.757525491535346e-05
1237;文案提取要是会员寸可以进，又要交钱啊;1;2;3;20497;0.0001463628823730302
1302;挺好的呀;1;0;1;20497;4.878762745767673e-05
1304;认真学习;1;0;1;20497;4.878762745767673e-05
1306;太棒了;1;0;1;20497;4.878762745767673e-05
1308;感谢老师先关注收藏慢慢学习;1;0;1;20497;4.878762745767673e-05
1310;好好学习;1;0;1;20497;4.878762745767673e-05
1312;说的很对;1;0;1;20497;4.878762745767673e-05
1315;你真棒;1;0;1;20497;4.878762745767673e-05
1319;讲的真详细，谢谢分享，为你点赞;2;0;2;20497;9.757525491535346e-05
1323;0;1;0;1;20497;4.878762745767673e-05
1326;主播好棒，满满的干货，感谢分享;1;0;1;20497;4.878762745767673e-05
1329;谢谢很好，我会试一下能不能做;1;0;1;20497;4.878762745767673e-05
1331;学习了，谢谢;1;0;1;20497;4.878762745767673e-05
1334;太复杂了，学不会，谢谢分享;1;0;1;20497;4.878762745767673e-05
1336;好用，我的抖音因为有你变得格外精彩;1;0;1;20497;4.878762745767673e-05
1338;可以试一下;1;0;1;20497;4.878762745767673e-05
1340;先学习，试试看吧，收藏了;1;0;1;20497;4.878762745767673e-05
1342;没学会;1;1;2;20497;9.757525491535346e-05
1344;喜欢听你讲课，虽然不会，还是认真在学;1;0;1;20497;4.878762745767673e-05
1346;我也来慢慢学习天天向一下看看;1;0;1;20497;4.878762745767673e-05
1348;谢谢你的分享;1;0;1;20497;4.878762745767673e-05
1350;学习到了谢谢老师分享抖音知识;1;0;1;20497;4.878762745767673e-05
1352;听得不错;1;0;1;20497;4.878762745767673e-05
1354;0;1;0;1;20497;4.878762745767673e-05
1356;喜欢你的视频，感觉都是干货;1;0;1;20497;4.878762745767673e-05
1358;这个好可以学学，每天能出一个热门也好啊。;1;1;2;20497;9.757525491535346e-05
1360;讲的非常详细;1;0;1;20497;4.878762745767673e-05
1362;帅哥讲的不错;1;0;1;20497;4.878762745767673e-05
1364;这个方法不错，还能活跃账号;1;1;2;20497;9.757525491535346e-05
1366;抖音逆天功能多;1;1;2;20497;9.757525491535346e-05
1368;谢谢老师分享;1;0;1;20497;4.878762745767673e-05
1371;老师的这一招特别实用;1;0;1;20497;4.878762745767673e-05
1393;很好，非常好用，谢谢分享。;1;1;2;20497;9.757525491535346e-05
1398;一学就会，一操作就废。有没有一样的？;1;1;2;20497;9.757525491535346e-05
1408;0;1;1;2;20497;9.757525491535346e-05
1427;0;1;0;1;20497;4.878762745767673e-05
1430;挺好的;1;1;2;20497;9.757525491535346e-05
1470;0;1;0;1;20497;4.878762745767673e-05
1472;越来越方便;1;0;1;20497;4.878762745767673e-05
1478;我支持謝謝你說的太好看了你的士品听了你的讲的太好了;1;0;1;20497;4.878762745767673e-05
1480;非常棒，说得很好;1;1;2;20497;9.757525491535346e-05
1483;我支持謝謝你說的太好看了你的士品听了你的讲的太好了;1;1;2;20497;9.757525491535346e-05
1485;老师讲的详细，简单，我们自己去做就不会了;1;1;2;20497;9.757525491535346e-05
1510;好用，我的抖音因为有你变得格外精彩;1;2;3;20497;0.0001463628823730302
1527;点赞;1;0;1;20497;4.878762745767673e-05
1546;谢谢主播讲的详细讲解，值得一试;1;3;4;20497;0.00019515050983070692
1582;学会了，感谢主播;1;2;3;20497;0.0001463628823730302
1608;最后说得相机的那里的提词器怎么跟你的口播同步的可以讲解一下吗;1;0;1;20497;4.878762745767673e-05
1636;0;1;0;1;20497;4.878762745767673e-05
1638;0;1;0;1;20497;4.878762745767673e-05
1641;0;1;0;1;20497;4.878762745767673e-05
1643;0;1;0;1;20497;4.878762745767673e-05
1646;0;1;0;1;20497;4.878762745767673e-05
1648;0;1;0;1;20497;4.878762745767673e-05
1654;0;1;0;1;20497;4.878762745767673e-05
1656;0;1;1;2;20497;9.757525491535346e-05
1658;0;1;1;2;20497;9.757525491535346e-05
1664;0;1;1;2;20497;9.757525491535346e-05
1876;0;1;0;1;20497;4.878762745767673e-05
1884;0;1;0;1;20497;4.878762745767673e-05
1886;点赞;1;0;1;20497;4.878762745767673e-05
1888;0;1;0;1;20497;4.878762745767673e-05
1890;0;1;0;1;20497;4.878762745767673e-05
1893;0;1;0;1;20497;4.878762745767673e-05
1895;主播讲的非常的好，谢谢你的讲解和分享;1;0;1;20497;4.878762745767673e-05
1897;谢谢老师的分享;1;0;1;20497;4.878762745767673e-05
1901;在哪里下载你说的软件;3;0;3;20497;0.0001463628823730302
1905;想请老师教我一个做视频的方法不知道可不可以;1;0;1;20497;4.878762745767673e-05
1907;视频是要自己新拍摄一个吗？;1;0;1;20497;4.878762745767673e-05
1909;下载不了;1;0;1;20497;4.878762745767673e-05
1911;抖音很多技巧;1;0;1;20497;4.878762745767673e-05
1913;这个肯定是个技术活啊;1;0;1;20497;4.878762745767673e-05
1915;这个工具很好噢;1;0;1;20497;4.878762745767673e-05
1917;得慢慢学呀;1;0;1;20497;4.878762745767673e-05
1919;好用，我的抖音因为有你变得格外精彩;1;0;1;20497;4.878762745767673e-05
1924;这个工具很棒啊;1;0;1;20497;4.878762745767673e-05
1927;主播中午好讲的太好了;1;0;1;20497;4.878762745767673e-05
1929;听起来很方便的;1;0;1;20497;4.878762745767673e-05
1936;0;1;0;1;20497;4.878762745767673e-05
1939;0;1;0;1;20497;4.878762745767673e-05
1945;你中午好;1;0;1;20497;4.878762745767673e-05
1947;真好;1;0;1;20497;4.878762745767673e-05
1950;怎么我下载的和你的不一样;1;0;1;20497;4.878762745767673e-05
1952;听起来挺方便;1;0;1;20497;4.878762745767673e-05
1954;太开心了，但愿我能学会;1;0;1;20497;4.878762745767673e-05
1956;0;1;0;1;20497;4.878762745767673e-05
1961;主播早上好：讲的好：慢慢学;1;0;1;20497;4.878762745767673e-05
1963;小宇哥真优秀;1;0;1;20497;4.878762745767673e-05
1965;0;1;0;1;20497;4.878762745767673e-05
1967;老师。这个软件走哪里下载？我走应用市场都没有;1;0;1;20497;4.878762745767673e-05
1969;0;1;0;1;20497;4.878762745767673e-05
1971;这个挺好。;1;0;1;20497;4.878762745767673e-05
1974;极速版行吗;1;0;1;20497;4.878762745767673e-05
1976;0;1;0;1;20497;4.878762745767673e-05
1978;0;1;0;1;20497;4.878762745767673e-05
1982;0;1;0;1;20497;4.878762745767673e-05
1984;哇学会了方便自己行走江湖谢小宇哥分享;1;0;1;20497;4.878762745767673e-05
1987;0;1;0;1;20497;4.878762745767673e-05
1989;棒棒哒;1;0;1;20497;4.878762745767673e-05
1993;小宇老师真厉害;2;0;2;20497;9.757525491535346e-05
1997;这么好吗;2;0;2;20497;9.757525491535346e-05
2001;0;1;0;1;20497;4.878762745767673e-05
2006;0;1;0;1;20497;4.878762745767673e-05
2008;哥哥找不到你呀，群里不能和你请教;1;0;1;20497;4.878762745767673e-05
2010;0;1;0;1;20497;4.878762745767673e-05
2012;0;1;0;1;20497;4.878762745767673e-05
2014;谢谢主播讲解，一定认真学习。;1;0;1;20497;4.878762745767673e-05
2016;0;1;0;1;20497;4.878762745767673e-05
2018;关注主播;1;0;1;20497;4.878762745767673e-05
2020;0;1;0;1;20497;4.878762745767673e-05
2022;0;1;0;1;20497;4.878762745767673e-05
2024;小宇哥每个作品内容都带来新知识，先点赞再看;1;0;1;20497;4.878762745767673e-05
2026;年纪大了记不住;1;0;1;20497;4.878762745767673e-05
2028;0;1;0;1;20497;4.878762745767673e-05
2030;说的不错;1;0;1;20497;4.878762745767673e-05
2034;老师真好，抖音教程什么内容都传授，谢谢老师。;1;0;1;20497;4.878762745767673e-05
2036;感觉好复杂;2;0;2;20497;9.757525491535346e-05
2039;0;1;0;1;20497;4.878762745767673e-05
2041;常来常往，我来看你了，记得来看我哦;1;0;1;20497;4.878762745767673e-05
2043;谢谢你小宇老师又给我们带来新知识;1;0;1;20497;4.878762745767673e-05
2045;太多了，不知道该干嘛了，最终也就娱乐了;1;0;1;20497;4.878762745767673e-05
2047;帅哥;1;0;1;20497;4.878762745767673e-05
2049;0;1;0;1;20497;4.878762745767673e-05
2051;唉，也看完了又忘完了;1;0;1;20497;4.878762745767673e-05
2053;0;1;0;1;20497;4.878762745767673e-05
2055;0;1;0;1;20497;4.878762745767673e-05
2057;软件使用需要费用吗？;2;0;2;20497;9.757525491535346e-05
2060;0;1;0;1;20497;4.878762745767673e-05
2062;0;1;0;1;20497;4.878762745767673e-05
2066;0;1;0;1;20497;4.878762745767673e-05
2069;好帅哥，太麻烦了帅哥为你点赞;1;0;1;20497;4.878762745767673e-05
2071;0;1;0;1;20497;4.878762745767673e-05
2073;0;1;0;1;20497;4.878762745767673e-05
2075;0;1;0;1;20497;4.878762745767673e-05
2077;0;1;0;1;20497;4.878762745767673e-05
2079;谢谢你小宇老师又给我们带来新知识;1;0;1;20497;4.878762745767673e-05
2081;感谢分享;1;0;1;20497;4.878762745767673e-05
2083;讲的很好;1;0;1;20497;4.878762745767673e-05
2085;0;1;0;1;20497;4.878762745767673e-05
2087;天天卖会员;1;0;1;20497;4.878762745767673e-05
2089;谢谢你小宇老师又给我们带来新知识;1;0;1;20497;4.878762745767673e-05
2091;0;1;0;1;20497;4.878762745767673e-05
2093;0;1;0;1;20497;4.878762745767673e-05
2095;0;1;0;1;20497;4.878762745767673e-05
2097;0;1;0;1;20497;4.878762745767673e-05
2099;不要一毛要会员;1;0;1;20497;4.878762745767673e-05
2101;小帅哥，你好啊，我这岁数可能不行了，弄不了啊;1;0;1;20497;4.878762745767673e-05
2103;讲的很好;1;0;1;20497;4.878762745767673e-05
2105;厉害了;1;0;1;20497;4.878762745767673e-05
2107;非常好;1;0;1;20497;4.878762745767673e-05
2109;还是最喜欢你分享的，不知道为啥;1;0;1;20497;4.878762745767673e-05
2112;谢谢主播分享;1;0;1;20497;4.878762745767673e-05
2114;0;1;0;1;20497;4.878762745767673e-05
2116;说的不错;1;0;1;20497;4.878762745767673e-05
2120;能教我影视剪辑制作吗？;1;0;1;20497;4.878762745767673e-05
2122;实用;2;0;2;20497;9.757525491535346e-05
2127;赞赞赞赞;1;0;1;20497;4.878762745767673e-05
2129;0;1;0;1;20497;4.878762745767673e-05
2131;点赞点赞点赞点赞点赞;1;0;1;20497;4.878762745767673e-05
2133;的是终身会员呀，老师你怎么不说;1;0;1;20497;4.878762745767673e-05
2136;不错哦;1;0;1;20497;4.878762745767673e-05
2138;网页卡到爆炸你是不是充20美金会员啦;24;60;84;20497;0.004098160706444845
2163;魔法上网这是关键;23;35;58;20497;0.0028296823925452507
2187;付费版可以联网？;2;1;3;20497;0.0001463628823730302
2190;现在已经不行了，他会说，我作为一个语言模型不能是作家和企业家;8;12;20;20497;0.0009757525491535347
2199;为什么你可以用;8;4;12;20497;0.0005854515294921208
2208;如何可以合法的使用;2;3;5;20497;0.00024393813728838367
2211;把双色球前期中奖号码全部输进去，让他预测下;4;4;8;20497;0.00039030101966141384
2216;怎么注册？;5;1;6;20497;0.0002927257647460604
2222;有没有大佬说一下，为什么我的手机能用，电脑用不了？;7;0;7;20497;0.00034151339220373715
2230;Chagpt能读取网页？;9;1;10;20497;0.00048787627457676734
2240;怎么越狱;6;1;7;20497;0.00034151339220373715
2247;我试了，参数性的内容还是不行，它还停留在打太极的阶段;4;10;14;20497;0.0006830267844074743
2252;Mac笔记本怎么魔法上网的;3;2;5;20497;0.00024393813728838367
2256;这是35还是40;7;1;8;20497;0.00039030101966141384
2264;关键要给钱;3;3;6;20497;0.0002927257647460604
2268;如何让chatGPT访问互联网上的特定网站？;1;6;7;20497;0.00034151339220373715
2270;我会魔法上网;2;0;2;20497;9.757525491535346e-05
2274;为啥你的gpt能学习链接，是金钱的力量吗？;1;0;1;20497;4.878762745767673e-05
2290;付费版现在到处炫;1;0;1;20497;4.878762745767673e-05
2293;怎么打开这个;1;1;2;20497;9.757525491535346e-05
2299;我冲了被封了;1;0;1;20497;4.878762745767673e-05
2304;来一些朋友一起学习交流;1;0;1;20497;4.878762745767673e-05
2309;太贵了这个要钱另一个要钱到处都需要钱;1;0;1;20497;4.878762745767673e-05
2313;链接不上;1;2;3;20497;0.0001463628823730302
2321;office365多久能在国内使用啊;1;0;1;20497;4.878762745767673e-05
2324;怎么用啊;2;1;3;20497;0.0001463628823730302
2327;这是爬虫的AI应用？;1;0;1;20497;4.878762745767673e-05
2335;卧槽，双色球;2;3;5;20497;0.00024393813728838367
2340;完了，全部下岗;1;3;4;20497;0.00019515050983070692
2346;这种文章对SEO有用吗;2;0;2;20497;9.757525491535346e-05
2350;所以ai咋用？;2;2;4;20497;0.00019515050983070692
2354;你们在用这个的同时，也把机器人教会了，同时机器人会把你的一辈子的思维理论和技能汇总到研发者那里，然后再把你们所有人的思想和工作技能，我觉得是这样的;1;0;1;20497;4.878762745767673e-05
2359;20刀一个月;1;0;1;20497;4.878762745767673e-05
2367;要钱的;1;1;2;20497;9.757525491535346e-05
2371;你这是付费版的吧，好流畅啊;1;0;1;20497;4.878762745767673e-05
2379;k;1;0;1;20497;4.878762745767673e-05
2381;0;2;0;2;20497;9.757525491535346e-05
2393;L;1;0;1;20497;4.878762745767673e-05
2400;derder;1;0;1;20497;4.878762745767673e-05
2402;秋高气爽;3;0;3;20497;0.0001463628823730302
2412;又一个拿链接乱糊弄人的，你到底自己搞懂了吗chat暂时没有读网站功能，它读的是你的网址里单词的信息不是真的看到了链接内容好多自己没玩明白就跑来教人的;12;9;21;20497;0.0010245401766112113
2425;gpt咋安装呀？;4;4;8;20497;0.00039030101966141384
2430;怎么上这个网站;3;6;9;20497;0.0004390886471190906
2434;gpt可以读取连接？乱来;4;1;5;20497;0.00024393813728838367
2439;什么网页呀老师;3;6;9;20497;0.0004390886471190906
2443;这个软件多少钱一个月;1;1;2;20497;9.757525491535346e-05
2446;咋登录;1;1;2;20497;9.757525491535346e-05
2449;什么网站;1;1;2;20497;9.757525491535346e-05
2451;网页打不开，怎么下载;1;1;2;20497;9.757525491535346e-05
2453;哪里下载;1;1;2;20497;9.757525491535346e-05
2455;那里找到GPT4的官方网站;1;1;2;20497;9.757525491535346e-05
2458;骗钱的，还没用就要你充值，谁知道是不是骗人的，搞不好这视频就是托。;2;0;2;20497;9.757525491535346e-05
2463;Ai能确保是公正平等吗？如果不能很容易被人为操控，甚至是垄断经营;1;0;1;20497;4.878762745767673e-05
2465;为什么我需要一直重新打开页面;1;0;1;20497;4.878762745767673e-05
2497;我也搞了账号，在叫他帮我写小说;1;0;1;20497;4.878762745767673e-05
2499;挺深奥的我一直用chatgpt推荐的号码买双色球;1;0;1;20497;4.878762745767673e-05
2501;这不对劲，国家要重视了。怎么一天内到处是智能的视频。新型的1450来了。美国自爆关键的时候，来这一出。美国自爆，这些都是科幻而已。没钱印，哪来的研究费用;1;0;1;20497;4.878762745767673e-05
2505;就喜欢这种长视频，一口气讲完，从不分集;3;6;9;20497;0.0004390886471190906
2509;收费的，而且很多也是大空话作用不是很大，不过确实有提醒作用，大家别指望代替自己;1;5;6;20497;0.0002927257647460604
2512;你好：怎么下载。是在电脑上下载吗？;2;0;2;20497;9.757525491535346e-05
2515;你该试试gpt，不是一个维度的产物。;1;0;1;20497;4.878762745767673e-05
2521;20岁美艳小妈今天用了一下，一会儿就写了一篇交上去了;2;2;4;20497;0.00019515050983070692
2525;goodpoint;1;1;2;20497;9.757525491535346e-05
2527;还有个媒帮派也挺牛的;1;6;7;20497;0.00034151339220373715
2529;百度直接搜索写作猫帮你们节约命。;1;4;5;20497;0.00024393813728838367
2531;所以到底是哪个网站;2;1;3;20497;0.0001463628823730302
2534;什么软件？;3;0;3;20497;0.0001463628823730302
2540;写的一点都不好，没意思白花我二百;7;16;23;20497;0.0011221154315265648
2548;收费软件？;2;5;7;20497;0.00034151339220373715
2551;账号分享20元，我要把我花的200赚过来;2;0;2;20497;9.757525491535346e-05
2555;你推荐过好多软件;3;0;3;20497;0.0001463628823730302
2559;就问平台不审核吗？人人都会写小说。还要作家干嘛？;1;0;1;20497;4.878762745767673e-05
2565;不好用，写得不好。。浪费200;1;0;1;20497;4.878762745767673e-05
2567;现在好多不收费的;1;0;1;20497;4.878762745767673e-05
2578;要不要开会员？;1;0;1;20497;4.878762745767673e-05
2586;确实很好;1;0;1;20497;4.878762745767673e-05
2595;电商今年太难做了，昨天就被抓了七条链接;5;3;8;20497;0.00039030101966141384
2601;不好用，不要下来自一个大头的忠告;3;2;5;20497;0.00024393813728838367
2605;chatgpt用起来就够了;1;1;2;20497;9.757525491535346e-05
2611;直接chatgpt就行了;1;0;1;20497;4.878762745767673e-05
2613;共享账号付费;1;0;1;20497;4.878762745767673e-05
2639;一帧秒创的ai作画，预计等待一分钟，然后我等了一宿人都麻了;5;61;66;20497;0.0032199834122066642
2645;这个各位剪辑师不用焦虑哈这东西真的搞出来了那以后也大概率会成为咱们剪辑的素材库毕竟剪辑的情感不是机器可以学会的;6;172;178;20497;0.008684197687466458
2652;我现在就更想要一台550W了;2;252;254;20497;0.01239205737424989
2655;以后的老板：以后都不招编剧，导演，摄影，剪辑了，招个会操作的人就可以了;1;116;117;20497;0.005708152412548178
2657;一帧秒创哪里可以下载？;4;15;19;20497;0.0009269649216958579
2662;我回家拾粪，他还能抢？;3;56;59;20497;0.0028784700200029274
2666;以后给AI一个剧本，是不是都能自己拍电影了？;2;56;58;20497;0.0028296823925452507
2669;目前很多一键生成都很生硬，完全不能用;1;31;32;20497;0.0015612040786456554
2671;说重点，收不收费;3;10;13;20497;0.0006342391569497975
2702;杨洋得亿辅导员上课的时候讲的那个;1;1;2;20497;9.757525491535346e-05
2730;十一十一十一昨天，刚;1;0;1;20497;4.878762745767673e-05
2769;以后的互联网就会充满了各种AI出来的内容，大概率会是80的垃圾内容，20的有些微用处的内容，我们的大部时间需要用来过滤无效内容了;2;69;71;20497;0.003463921549495048
2807;可以我差的就是废话;2;105;107;20497;0.005220276137971411
2810;拿去应付考察课的报考反正老师也不看哈哈哈哈;1;63;64;20497;0.0031224081572913107
2812;非常难用;10;11;21;20497;0.0010245401766112113
2823;我还以为又是啥好用的软件;1;45;46;20497;0.0022442308630531297
2825;正好今年毕业，拿来制造学术垃圾还是可以的;1;19;20;20497;0.0009757525491535347
2827;只关心付费不;3;10;13;20497;0.0006342391569497975
2832;我专科用这个没事吧;3;0;3;20497;0.0001463628823730302
2837;我想问一下，如果两个人输入的标题一样，出来的内容一样嘛;1;2;3;20497;0.0001463628823730302
2839;那个查重;1;1;2;20497;9.757525491535346e-05
2852;乔沂哈哈哈哈哈哈哈;1;0;1;20497;4.878762745767673e-05
2854;月亮快写;2;0;2;20497;9.757525491535346e-05
2858;小花：;1;0;1;20497;4.878762745767673e-05
2862;可以逝世;1;0;1;20497;4.878762745767673e-05
2865;Togo一下就感觉到了你给我发个那个小程序的强大了;1;0;1;20497;4.878762745767673e-05
2867;AAA乐乡跳水兔批发商杨哥我用好久了;1;3;4;20497;0.00019515050983070692
2870;笑死我了;1;0;1;20497;4.878762745767673e-05
2872;这位紫霞是;2;1;3;20497;0.0001463628823730302
2876;煤焦油小马HC论文好手;2;0;2;20497;9.757525491535346e-05
2880;咱没早发现;2;0;2;20497;9.757525491535346e-05
2884;关你什么柿我就用的是这个;1;1;2;20497;9.757525491535346e-05
2889;慕山月这是个好东西啊;1;0;1;20497;4.878762745767673e-05
2897;小秋肚子圆滚滚朝圣相宜海对面风也温柔Elf初秋好物牛逼;2;0;2;20497;9.757525491535346e-05
2902;Trouvaille这个更牛逼;1;0;1;20497;4.878762745767673e-05
2913;小这等我一会起床试试写思政;1;0;1;20497;4.878762745767673e-05
2916;一颗甜橙树;1;0;1;20497;4.878762745767673e-05
2933;玊尔与树立5000字论文试试;1;0;1;20497;4.878762745767673e-05
2939;失格拉斯;1;0;1;20497;4.878762745767673e-05
2944;jetsonmade天津朴彩英共勉懂？;1;1;2;20497;9.757525491535346e-05
2947;yrrrrrrrrSaturdayYoii铃铃铃Deaosy今晚打麻将Duzihao2兰州莎莎斤欠蓝桉鹿冉prospect41九漏鱼11刚用这个写了一篇论文;3;0;3;20497;0.0001463628823730302
2952;A大队长可以写论文;2;0;2;20497;9.757525491535346e-05
2956;由你论文不就来了吗;1;0;1;20497;4.878762745767673e-05
2960;Mer1in你觉得可搞不;1;0;1;20497;4.878762745767673e-05
2962;我擦，我拿这个糊弄思政课题论文的;1;5;6;20497;0.0002927257647460604
2965;我看过一个作家说，能不能替代。后来他说很难替代，因为你说一句话写一句话，下一句自动生成的根本不是本人想说的，还有提纲之类的我就不懂了，总之，AI并非无所不能;2;5;7;20497;0.00034151339220373715
2976;奶茶不加料张耳朵南山;1;0;1;20497;4.878762745767673e-05
2978;阿弥;1;0;1;20497;4.878762745767673e-05
2984;退休富婆替孙子玩抖音;1;0;1;20497;4.878762745767673e-05
2989;cherishandlove;1;0;1;20497;4.878762745767673e-05
2991;不念尘;1;0;1;20497;4.878762745767673e-05
2998;Simms;1;0;1;20497;4.878762745767673e-05
3000;82;1;0;1;20497;4.878762745767673e-05
3004;曲江;1;0;1;20497;4.878762745767673e-05
3017;派大星;1;0;1;20497;4.878762745767673e-05
3025;7811;1;0;1;20497;4.878762745767673e-05
3028;19选手;1;0;1;20497;4.878762745767673e-05
3038;米花氢原子si;1;0;1;20497;4.878762745767673e-05
3042;落日归山海;1;0;1;20497;4.878762745767673e-05
3050;戳麦火HomeJ温振kun;1;0;1;20497;4.878762745767673e-05
3060;奥利奥酷盖;1;0;1;20497;4.878762745767673e-05
3064;粉色泡泡;1;1;2;20497;9.757525491535346e-05
3066;ALittleMochi;1;0;1;20497;4.878762745767673e-05
3081;DuoduoT;1;0;1;20497;4.878762745767673e-05
3083;陆HT;1;0;1;20497;4.878762745767673e-05
3088;kevinye缺觉谁偷俺蜂蜜不戳;1;0;1;20497;4.878762745767673e-05
3090;养乐多绿十;1;0;1;20497;4.878762745767673e-05
3094;52Hertz;1;0;1;20497;4.878762745767673e-05
3103;1017山有木兮看见了下雨阿姨来份烤冷面;1;1;2;20497;9.757525491535346e-05
3105;江1;1;1;2;20497;9.757525491535346e-05
3108;星之所在;1;1;2;20497;9.757525491535346e-05
3110;修远;2;0;2;20497;9.757525491535346e-05
3115;能写小说不我有个大胆的想法;10;351;361;20497;0.0176123335122213
3126;数据就那么点，那么怎么完成一篇论文，那当然是废话来凑，总结：适合数据不多的某些文科专业做废话参考;7;205;212;20497;0.010342977021027468
3134;信了你的，进入写的啥也不是;2;2;4;20497;0.00019515050983070692
3137;这个软件叫什么，我想玩玩;2;1;3;20497;0.0001463628823730302
3140;将将酱酱摩西摩西;1;1;2;20497;9.757525491535346e-05
3142;专业导论论文就用这个，嘎嘎香;1;0;1;20497;4.878762745767673e-05
3144;头的头疼都写不出，还是花点钱找朋友还好过关了;1;0;1;20497;4.878762745767673e-05
3150;早睡早起dovWinwinwinCBY少7一点大眼邓小眼;1;0;1;20497;4.878762745767673e-05
3152;BiyLong喝醉的猫llAmorfati;1;0;1;20497;4.878762745767673e-05
3183;notionai不是调的gpt借口吗，我记错了吗;5;4;9;20497;0.0004390886471190906
3189;这玩意儿有次数限制，账号不够用;5;2;7;20497;0.00034151339220373715
3195;可以写论文吗;1;0;1;20497;4.878762745767673e-05
3197;免费嘛？;2;0;2;20497;9.757525491535346e-05
3201;李永乐用考大学试题考了chatgpt超过不少人了;1;0;1;20497;4.878762745767673e-05
3235;英语不好，还不能用？;2;0;2;20497;9.757525491535346e-05
3238;该说不说，你这个音频质量不行啊，你换的是猛犸M1吗？;1;0;1;20497;4.878762745767673e-05
3248;费用承受不起，我几个站，这价格5毛一篇，一百篇一天就是50了。;1;2;3;20497;0.0001463628823730302
3251;写的旧文;4;0;4;20497;0.00019515050983070692
3256;0;1;1;2;20497;9.757525491535346e-05
3258;网站是什么呀？;1;0;1;20497;4.878762745767673e-05
3261;无意间刷到您的视频，不知不觉的看了2个小时;1;0;1;20497;4.878762745767673e-05
3267;0;1;0;1;20497;4.878762745767673e-05
3269;0;1;2;3;20497;0.0001463628823730302
3271;0;1;0;1;20497;4.878762745767673e-05
3273;666;1;0;1;20497;4.878762745767673e-05
3275;谢谢主播分享知识你讲的真好很喜欢听为你点赞了;1;0;1;20497;4.878762745767673e-05
3277;AI文案写作神器，我只认可97文案;1;0;1;20497;4.878762745767673e-05
3281;你用的是chatgpt的平替产品也许人工智能取代不了余华这样的级别的作家，但是取代你们这样的中游作家，是完全可能的，你们要面临失业了;16;7;23;20497;0.0011221154315265648
3298;来源数据量不够，往数据库里放10万本小说，你会发现它真的可以;72;160;232;20497;0.011318729570181003
3371;你用的假的吧;7;2;9;20497;0.0004390886471190906
3379;我刚试了一下彩云小梦见鬼了居然写的蛮好的;8;17;25;20497;0.0012196906864419183
3388;当这个软件刚出来以后，我真的有点慌了，但是后来确定，它是不能代替作家的。;22;268;290;20497;0.014148411962726253
3411;chatGPT能不能写出好的小说，跟你问的问题有直接关系，如果你问的简单宽泛智障，她的回答就会简单智障。你要先设定更多的条件她才能回答的更精彩;1;2;3;20497;0.0001463628823730302
3413;彩云小梦试过吗;7;1;8;20497;0.00039030101966141384
3421;交流电刚刚被发明的时候，也遭受过质疑，特斯拉回答说，你能指望一个刚出生的孩子做什么呢？AI现在处于起步阶段。随着以后越来越完善肯定会更好。;9;33;42;20497;0.0020490803532224227
3431;你成功地把人工智能搞成了人工智障。;2;90;92;20497;0.004488461726106259
3434;写是能写，说起来也通顺，但就是看起来很像是小学生写的小故事、小作文，甚至不如那些网络作者，更比不上那些出版作家，一点思考跟深度都没有;2;79;81;20497;0.003951797824071815
3437;也许十年以后，A作者写一个大纲，让AI扩写，然后A作者再润个色;2;25;27;20497;0.0013172659413572718
3440;我是网文作者，然后懂点编程原理，这么说吧，这玩意儿要替代作者，20年内不可能。;6;5;11;20497;0.000536663902034444
3447;我也是被骗了，去研究了一天，花钱买软件买账号，然后除了损失了时间与金钱，什么都没有获得;2;17;19;20497;0.0009269649216958579
3450;写长篇小说那么复杂，AI要是能的话，还有什么不能干;2;12;14;20497;0.0006830267844074743
3453;你这个方法不对，你可以尝试下一个具体一点的指令，类似细纲，我今天试了一下，的确强大，代替低端写手没问题，但是代替大佬那是肯定不行的;2;8;10;20497;0.00048787627457676734
3456;如果AI写作真的可以写出如人类思想的小说，那就意味着AI有了自我思考能力，这么牛逼的科研能力，拿来写小说，是不是有点大材小用了。;2;8;10;20497;0.00048787627457676734
3459;这就和刘慈欣的《诗云》（好像叫这个名字）一样的，人的思想是无可替代的。;1;5;6;20497;0.0002927257647460604
3468;我用的ai不是直接给我故事，而是指出我所却少的部分，我一点点的加，最后一个想法写出几万字，咋不好呢;1;0;1;20497;4.878762745767673e-05
3480;0;3;1;4;20497;0.00019515050983070692
3493;挺坑的，亲测，要会员。充值后写不出来小说。只能是单一的描述一个静态画面的感觉;1;0;1;20497;4.878762745767673e-05
3505;这个软件不行;1;0;1;20497;4.878762745767673e-05
3516;绝对可以，绝对可以，绝对可以，我作为美术从业者这么说，我刚开始的想法跟你是一致的，但Ai的进化速度超乎寻常。;3;2;5;20497;0.00024393813728838367
3526;那个，我现在就是拿这玩意儿当做一个润色来看的，我编写这边给我显着他改出来的东西，然后我看着他写的比我好的话，我就用他写的不比我好的话，我就笑笑，我就继续写，没有灵感的话，就让他胡揍一顿，然后看看能不能出来什么？让我感觉耳目一新的东西;3;1;4;20497;0.00019515050983070692
3540;你的问法不对确实是可以写的;1;2;3;20497;0.0001463628823730302
3542;0;4;0;4;20497;0.00019515050983070692
3570;路西阳一如既往地背着书包，低着头，一个人走在犬牙街的街道上。他知道，这个地方并不安全，有很多的黑帮和混混在这里横行霸道，但是他还是必须要经过这里，因为这是他回家的必经之路。“嘿，小子，你干什么呢？”突然，他听到了一个声音，抬起头，发现一个混混正在冲他吐口水，周围的人也跟着起哄。他感到十分无助和恐惧，不知道该怎么办才好。“路西阳，你怎么了？”突然，一个女生的声音响起，他抬起头，发现是沈雪，他们是同班同学，但是并没有什么交集。沈雪伸手把他拉了起来，对那些混混说道：“这是我们学校的同学，你们为什么要这样对他？”“哦，沈雪，我们只是和他开个玩笑，你别管闲事。”那些混混见有美女出来搭理，纷纷散开了，留下了一地的垃圾和口水。路西阳感到十分感激和欣慰，他对沈雪说道：“谢谢你，沈雪，你真的是我的救命恩人。”“没事，这是应该的。不过，你怎么总是一个人呢？”“我我不喜欢和别人交往，觉得自己很笨，所以总是被人欺负。”沈雪看着他，似乎有些明白了他的心思，她说道：“其实，你并不笨，只是缺乏自信。你要相信自己，不要被别人的话影响，好吗？”;4;0;4;20497;0.00019515050983070692
3580;好像是要引导他才能写复杂;1;0;1;20497;4.878762745767673e-05
3582;agoni这AI也傻了;1;0;1;20497;4.878762745767673e-05
3586;也仅仅是现在不能替代;4;0;4;20497;0.00019515050983070692
3592;是你不会调教。并不是他不行;1;4;5;20497;0.00024393813728838367
3599;不过是数据量不够。当数据量足够的时候，你得相信它;2;1;3;20497;0.0001463628823730302
3603;今天及格，明天呢？它本身是个学习模型，如果它链接所有的网文，以后是不是就会写了;1;1;2;20497;9.757525491535346e-05
3640;其实我挺希望AI能有文学家的水平，如果它有这种水平，那证明人类距离解放双手和大脑也不远了，完全躺平，什么都AI去做，生产力飙升，去月球旅游可能只花几百块钱。;2;1;3;20497;0.0001463628823730302
3643;你这个可以画画吗不可以的话就呵呵了;2;0;2;20497;9.757525491535346e-05
3649;替代网文没问题，替代文学不可能。;3;0;3;20497;0.0001463628823730302
3688;其实我很担心，因为ai一开始被叫做人工智障，可是现在已经充满人类的生活中了，比如美颜滤镜中就有ai的身影，还有下面这张ai绘画，即使不懂绘画也会发现它画得好看，懂绘画的人能看出来它甚至会藏色人学绘画要几年，画出来要多少个小时，ai只需要几分钟。;2;1;3;20497;0.0001463628823730302
3697;我知道一个网址是可以写出很流畅的文章，不是老张视频里展示的这种，真的是很流畅的那种，但是没啥文学素养，需要再润色润色;2;0;2;20497;9.757525491535346e-05
3700;老张，会不会是因为你没充钱;1;0;1;20497;4.878762745767673e-05
3702;老张啊，你没用对啊。这东西可以当一个助手，但必须要输入适合的指令，并且还要根据需求在OpenAI的基础上去微调模型，让他变的更适合写小说。总的来说，这东西当个工具可以，让你一天能轻松写两万字以上是有可能的，但完全代替作者，现阶段来说基本不可能。;1;0;1;20497;4.878762745767673e-05
3715;没有伏笔，没有跌宕起伏的剧情，没有扎实的人物设计，不会用对话推进剧情，就连主线都不清楚，管这样的叫小说？;4;0;4;20497;0.00019515050983070692
3720;牵;1;0;1;20497;4.878762745767673e-05
3733;0;1;1;2;20497;9.757525491535346e-05
3740;人的情感，二进制代码的机器咋写的出来;1;0;1;20497;4.878762745767673e-05
3802;看起来，清爽;1;0;1;20497;4.878762745767673e-05
3804;要收费吗;1;0;1;20497;4.878762745767673e-05
3809;怎么下载;1;0;1;20497;4.878762745767673e-05
3816;你这邮件能不能点掉;6;42;48;20497;0.002341806117968483
3823;试了一下，文案出来有点蠢，感觉胡乱拼凑的，试了5000字后收费。;4;28;32;20497;0.0015612040786456554
3828;以后还要人吗？;4;3;7;20497;0.00034151339220373715
3835;贵吗;2;0;2;20497;9.757525491535346e-05
3838;能写论文吗;2;0;2;20497;9.757525491535346e-05
3842;这个让点进去不是你视频里这个呀;1;0;1;20497;4.878762745767673e-05
3844;打不开了;1;0;1;20497;4.878762745767673e-05
3846;手机怎么操作？;1;0;1;20497;4.878762745767673e-05
3857;米奇妙妙屋857857;1;0;1;20497;4.878762745767673e-05
3860;丑丑还想吃这个看起来好方便;1;0;1;20497;4.878762745767673e-05
3862;韭菜宝宝适合你;1;0;1;20497;4.878762745767673e-05
3865;小佳这个收藏吧;1;0;1;20497;4.878762745767673e-05
3869;绵绵怡可怕;1;0;1;20497;4.878762745767673e-05
3874;一针秒创;1;2;3;20497;0.0001463628823730302
3906;北洋园仙女;1;0;1;20497;4.878762745767673e-05
3910;小猪LilZelliy;1;1;2;20497;9.757525491535346e-05
3912;happy每一天TUZIWEIBA;1;0;1;20497;4.878762745767673e-05
3916;乌龙茶;1;0;1;20497;4.878762745767673e-05
3921;谝欸;1;1;2;20497;9.757525491535346e-05
3929;看到了，copydone点cn;2;3;5;20497;0.00024393813728838367
3934;看下chatGPT吧;1;0;1;20497;4.878762745767673e-05
3936;今天咋风格不太一样了;1;0;1;20497;4.878762745767673e-05
3938;贵;1;0;1;20497;4.878762745767673e-05
3940;免费的都可以用嘛，还是收费太香了;1;0;1;20497;4.878762745767673e-05
3959;一个月198的费用;4;13;17;20497;0.0008293896667805044
3964;这种软件真的没用，我用它修改热点文章，重写后用来做视频文案，做了7个视频3个被检测出来不过关，扣了我30分;1;4;5;20497;0.00024393813728838367
3966;很贵的;1;1;2;20497;9.757525491535346e-05
3968;骨传导耳机;1;0;1;20497;4.878762745767673e-05
3970;需要充值;1;0;1;20497;4.878762745767673e-05
3981;转发;1;0;1;20497;4.878762745767673e-05
3992;软件？;12;1;13;20497;0.0006342391569497975
4005;我也要;2;0;2;20497;9.757525491535346e-05
4008;我又来了老师;2;0;2;20497;9.757525491535346e-05
4014;这么流弊？;1;0;1;20497;4.878762745767673e-05
4016;可以给孩子一个吗？;1;0;1;20497;4.878762745767673e-05
4018;我也想要;1;0;1;20497;4.878762745767673e-05
4128;想要;1;0;1;20497;4.878762745767673e-05
4130;我想要;1;0;1;20497;4.878762745767673e-05
4132;488;1;0;1;20497;4.878762745767673e-05
4134;488;1;0;1;20497;4.878762745767673e-05
4136;我想要;1;0;1;20497;4.878762745767673e-05
4139;求求了，链接;1;0;1;20497;4.878762745767673e-05
4165;懒人神器;1;1;2;20497;9.757525491535346e-05
4193;你到是说啊，什么软件;3;10;13;20497;0.0006342391569497975
4197;论文呢？;2;6;8;20497;0.00039030101966141384
4213;顾奈;3;0;3;20497;0.0001463628823730302
4225;热心帮助大家解答论文写作过程中遇到的问题蓝天;4;36;40;20497;0.0019515050983070694
4230;还好我们不用写论文，我们写毕设（咬牙切齿）;54;131;185;20497;0.009025711079670196
4285;太空洞了;45;45;90;20497;0.004390886471190906
4331;要付费了;41;48;89;20497;0.004342098843733229
4373;写了一个月都没写出来最后还是被打败了，找别人写的;48;14;62;20497;0.0030248329023759572
4422;我就是自己写的头疼，最后还是找人写的，很负责，一直陪我到盲审通过;23;18;41;20497;0.002000292725764746
4446;和室友一起找人帮忙写过的;43;2;45;20497;0.002195443235595453
4490;自动写小说论文各种稿子;17;18;35;20497;0.0017075669610186856
4508;不会写啊;22;12;34;20497;0.0016587793335610089
4531;被骂怕了，直接找人写，还好顺利过了;25;7;32;20497;0.0015612040786456554
4557;本科，毕业设计有人接吗;20;9;29;20497;0.0014148411962726253
4578;我还没开始慌死了;13;22;35;20497;0.0017075669610186856
4592;不会弄找人写的省心省力;13;7;20;20497;0.0009757525491535347
4606;英语专业找一个写论文;11;10;21;20497;0.0010245401766112113
4618;有没有帮忙写城市轨道交通运输与管理专业的;13;6;19;20497;0.0009269649216958579
4632;土工工程的6000字找写手，挺急的，在线等;11;5;16;20497;0.0007806020393228277
4644;不会写啊;9;0;9;20497;0.0004390886471190906
4654;有接电气专业毕设的吗;4;1;5;20497;0.00024393813728838367
4659;有人接毕业设计论文吗;4;0;4;20497;0.00019515050983070692
4664;云南少数民族服饰研究论文有人接么，;3;1;4;20497;0.00019515050983070692
4668;有人接电气自动化论文吗;3;1;4;20497;0.00019515050983070692
4672;有人接写油画专业的吗？;5;0;5;20497;0.00024393813728838367
4678;帮写毕业论文;1;1;2;20497;9.757525491535346e-05
4680;机电的有代写吗;1;1;2;20497;9.757525491535346e-05
4688;国富论或者金融的逻辑读后感三千字有人接吗;17;0;17;20497;0.0008293896667805044
4706;太麻烦了，直接找代写过的;3;0;3;20497;0.0001463628823730302
4710;有人能接药学论文吗？2000字到4000字。;6;1;7;20497;0.00034151339220373715
4718;插画的有人接吗;4;1;5;20497;0.00024393813728838367
4723;有没有人帮写;7;0;7;20497;0.00034151339220373715
4731;冬早呀我开始用了，能降重;1;0;1;20497;4.878762745767673e-05
4734;财务管理有没有人帮忙啊;5;2;7;20497;0.00034151339220373715
4740;本科，基于智能电表的自动负载识别有人接吗;3;1;4;20497;0.00019515050983070692
4745;气体泄露检测器帮忙;1;1;2;20497;9.757525491535346e-05
4749;艺术类的有人接吗;12;1;13;20497;0.0006342391569497975
4762;5000字期末论文有查重要求有接的吗？;20;5;25;20497;0.0012196906864419183
4784;我当时也是写的头疼，被打回重新写了，最后还是找了别人写的，给我过了;1;1;2;20497;9.757525491535346e-05
4786;有人接毕业论文吗？;7;3;10;20497;0.00048787627457676734
4794;你让我兽医怎么写论文啥病都写完了查重超级高;3;2;5;20497;0.00024393813728838367
4801;我想知道降重有人接吗，大概多少钱，改不了一点;3;2;5;20497;0.00024393813728838367
4805;有没有人接毕业论文;9;2;11;20497;0.000536663902034444
4816;通信毕设有会的吗;1;1;2;20497;9.757525491535346e-05
4818;英语专业找一个代写的;5;2;7;20497;0.00034151339220373715
4824;可以帮忙写论文;3;1;4;20497;0.00019515050983070692
4828;碎梦;1;0;1;20497;4.878762745767673e-05
4831;我们宿舍之前是找的一个学长写的，写的超级棒，后面分数都挺高的;1;1;2;20497;9.757525491535346e-05
4835;以前觉得论文太难了;1;0;1;20497;4.878762745767673e-05
4839;基于单片机的八路抢答器毕业论文有人接吗;3;5;8;20497;0.00039030101966141384
4843;没空写，我都是找人写的;8;0;8;20497;0.00039030101966141384
4855;英语师范求拯救;2;1;3;20497;0.0001463628823730302
4858;有没有能接改论文和加内容的审计专业的;11;4;15;20497;0.000731814411865151
4871;低价写;5;0;5;20497;0.00024393813728838367
4877;交通;3;1;4;20497;0.00019515050983070692
4881;环艺;5;4;9;20497;0.0004390886471190906
4887;我行政管理一开始自己写的最后写不下去了，找老师写的，包修改通过，可以推荐;4;2;6;20497;0.0002927257647460604
4892;有会写微电网的论文的吗;3;1;4;20497;0.00019515050983070692
4896;这个写出来的论文能过吗？;1;0;1;20497;4.878762745767673e-05
4900;大家好找代写一定要找正规公司。我最开始图便宜找的一家工作室。写的全是垃圾而且还把我拉黑了。最后找的一家大公司，质量很好，现在我明天就答辩了。希望同学们不要被骗了。;2;1;3;20497;0.0001463628823730302
4903;Rebirth别管;2;0;2;20497;9.757525491535346e-05
4907;有应用心理学论文dx吗？;6;1;7;20497;0.00034151339220373715
4914;有没有需要帮忙的我可以当天完成;11;0;11;20497;0.000536663902034444
4926;光电工程的论文有没有人帮帮忙写了6000字了还差点写不出来了;6;0;6;20497;0.0002927257647460604
4934;有人需要帮写论文吗;3;4;7;20497;0.00034151339220373715
4938;来个dx，马上就要答辩了;3;2;5;20497;0.00024393813728838367
4942;电气工程及其自动化专业，论文题目：车载充电机pfc变换器设计有人接吗？;1;1;2;20497;9.757525491535346e-05
4944;实在头疼找人写了;1;0;1;20497;4.878762745767673e-05
4946;毕设广联达bim建模模型建完了只需要写建模步骤就行求求求求;1;0;1;20497;4.878762745767673e-05
4949;找的两百多就过了;22;0;22;20497;0.001073327804068888
4973;我论文从知网70降重到8;2;2;4;20497;0.00019515050983070692
4976;要会员啊？;5;0;5;20497;0.00024393813728838367
4982;不是我不想写，是写了几次都没过，写到哭，我感觉就是故意为难人的，最后找了学姐推荐来的，一次过。;4;0;4;20497;0.00019515050983070692
4987;有没有人帮帮我写啊写了一半了我真的头大求求了;1;0;1;20497;4.878762745767673e-05
4993;有人接毕设嘛，最好能快一点的;1;1;2;20497;9.757525491535346e-05
5004;化工专业论文谁来帮我;4;1;5;20497;0.00024393813728838367
5009;有木有人会做实证分析;2;3;5;20497;0.00024393813728838367
5013;太难了我就找人代了;1;0;1;20497;4.878762745767673e-05
5015;有带写实证分析部分的吗;2;1;3;20497;0.0001463628823730302
5018;有代写吗;9;2;11;20497;0.000536663902034444
5028;机械本科毕设，谁来;11;2;13;20497;0.0006342391569497975
5042;财务管理专业，想找写毕设的;4;3;7;20497;0.00034151339220373715
5047;带着标题找我;1;0;1;20497;4.878762745767673e-05
5049;有人收论文吗;1;0;1;20497;4.878762745767673e-05
5052;不会写论文，想找人代写;6;2;8;20497;0.00039030101966141384
5059;有人助攻论文嘛;4;1;5;20497;0.00024393813728838367
5064;专科300通通300;4;1;5;20497;0.00024393813728838367
5073;浅谈幼儿识字原则和方法求今天有人能帮我写完吗;4;2;6;20497;0.0002927257647460604
5080;论文还只是刚刚动笔，周四就要交了;6;4;10;20497;0.00048787627457676734
5087;3000字写应用性光伏小产品的论文有人接吗？;2;3;5;20497;0.00024393813728838367
5090;可以生成数据图表吗;1;1;2;20497;9.757525491535346e-05
5092;不会写，烦死;5;4;9;20497;0.0004390886471190906
5098;WYH我真的很需要;1;1;2;20497;9.757525491535346e-05
5100;有代写吗，有代写吗;8;4;12;20497;0.0005854515294921208
5110;为什么我的ai写作点不开;5;0;5;20497;0.00024393813728838367
5116;视觉传达设计有吗;4;3;7;20497;0.00034151339220373715
5122;没空写直接找人写的;1;0;1;20497;4.878762745767673e-05
5124;专科，电气专业，毕业设计1w字，30查重，要求设计程序，有无会的;5;7;12;20497;0.0005854515294921208
5132;有dx法学方面的吗;4;5;9;20497;0.0004390886471190906
5138;但是这个论文里面如果需要数据的话，怎么办，代写的论文里面会有数据吗，;2;2;4;20497;0.00019515050983070692
5142;有没有地信啊;4;4;8;20497;0.00039030101966141384
5147;机械系，本科，需要完成论文内容部分，有接的吗。;2;4;6;20497;0.0002927257647460604
5151;找个人帮忙更香呀;1;0;1;20497;4.878762745767673e-05
5154;汉语言文学的8000字古代文学方向有没有人接;8;9;17;20497;0.0008293896667805044
5163;找人写的，一遍过，哪里需要自己费心哈哈哈;4;0;4;20497;0.00019515050983070692
5171;有没有做深度学习三维重建的预算1000;6;2;8;20497;0.00039030101966141384
5180;计科专业查重率15以下可以吗？;4;4;8;20497;0.00039030101966141384
5187;笨蛋爱说反话你说这种对不对;1;2;3;20497;0.0001463628823730302
5191;求告知怎么写添加剂在饲料中的应用啊，孩子脑子想破了也想不出来;2;1;3;20497;0.0001463628823730302
5194;专科200有没有接的;4;3;7;20497;0.00034151339220373715
5200;大专毕业设计有人接吗;3;8;11;20497;0.000536663902034444
5205;要写的私聊我;11;2;13;20497;0.0006342391569497975
5217;专科论文200有没有人写？;2;2;4;20497;0.00019515050983070692
5220;那这种论文能通过查重吗;2;2;4;20497;0.00019515050983070692
5224;公共事业管理有没有;1;5;6;20497;0.0002927257647460604
5226;建筑工程技术专业的，2000字有人接吗？;2;4;6;20497;0.0002927257647460604
5230;找人写论文我推人，;11;1;12;20497;0.0005854515294921208
5243;摄影的有人能写吗;5;2;7;20497;0.00034151339220373715
5249;也不难;2;1;3;20497;0.0001463628823730302
5253;有可以公共事业管理专业的论文嘛推我;4;6;10;20497;0.00048787627457676734
5258;财大毕业生求代写毕业论文，老师给题。;3;4;7;20497;0.00034151339220373715
5262;找个帮忙写机械设计专业的;3;4;7;20497;0.00034151339220373715
5267;职称论文能写吗;4;5;9;20497;0.0004390886471190906
5272;dai;1;1;2;20497;9.757525491535346e-05
5274;好难啊;2;2;4;20497;0.00019515050983070692
5277;我们宿舍之前是找的一个研究生学姐写的，写的超级棒，后面分数都挺高的;1;0;1;20497;4.878762745767673e-05
5279;时不晴速成了;3;2;5;20497;0.00024393813728838367
5285;口乞屯页女子白勺这个可以;3;0;3;20497;0.0001463628823730302
5295;有财会类管理类还未搞定的吗？需要数据处理也可以;1;1;2;20497;9.757525491535346e-05
5297;有没有会用节约里程法写物流配送路径优化过程的;5;2;7;20497;0.00034151339220373715
5303;类AI辅助高风险;3;2;5;20497;0.00024393813728838367
5307;谁能救救我，小学教育的;10;3;13;20497;0.0006342391569497975
5321;翻译实践报告怎么写;8;7;15;20497;0.000731814411865151
5336;Aaaa宁不知道可以可以忧愁死我了;1;0;1;20497;4.878762745767673e-05
5340;说实话，我就是憋不出来，直接找人解决了，省心省力;1;0;1;20497;4.878762745767673e-05
5343;找学姐帮我写的，过了;1;0;1;20497;4.878762745767673e-05
5347;来试试我这个啊;2;1;3;20497;0.0001463628823730302
5350;我找的人工给我搞定的哈哈哈36到了10哈哈哈哈;8;1;9;20497;0.0004390886471190906
5360;我也是找的dx最好找企业，同学找的个人被写的乱七八糟;8;3;11;20497;0.000536663902034444
5369;找别人写的，已经过了，躺平;11;0;11;20497;0.000536663902034444
5381;写不出来，和室友商量的找人写的，省心了;6;1;7;20497;0.00034151339220373715
5396;我的找别人写的，自己改几遍都不行，最后花钱弄了，导师那通过了;7;1;8;20497;0.00039030101966141384
5405;前辈，参考文献怎么引用？用这个;1;0;1;20497;4.878762745767673e-05
5408;有人帮我写过了;23;0;23;20497;0.0011221154315265648
5432;查过了查重14;3;0;3;20497;0.0001463628823730302
5436;一头雾水，马上要截止啦;2;1;3;20497;0.0001463628823730302
5445;我都快写完了才看到这个;7;7;14;20497;0.0006830267844074743
5453;为什么我刚让人写完，就看见这个;9;2;11;20497;0.000536663902034444
5467;大家好;2;1;3;20497;0.0001463628823730302
5470;怎么那么多钓鱼啊;1;24;25;20497;0.0012196906864419183
5473;用不到了我找的全包的已经都给我搞定了还弄个优秀;7;3;10;20497;0.00048787627457676734
5481;一开始就喊我交钱了;1;1;2;20497;9.757525491535346e-05
5483;你看我写不写吧，我双手插兜，一个字不写，直接钞能力，，刚通过嘿嘿，;1;1;2;20497;9.757525491535346e-05
5487;一星期之前找dx昨天给我的稿子我交了直接过了就很懵逼;1;3;4;20497;0.00019515050983070692
5489;写不出来啊被逼的找人写的一遍过了;1;1;2;20497;9.757525491535346e-05
5493;系统还是找人靠谱一点自己又要学又要写关键是还是错误还多;10;0;10;20497;0.00048787627457676734
5505;黑胡椒不得行嘞菠萝不是萝卜ye耶耶辣辣;1;0;1;20497;4.878762745767673e-05
5508;工作室写手在这;1;0;1;20497;4.878762745767673e-05
5512;已经过了，找学长写的;8;1;9;20497;0.0004390886471190906
5522;十二爱吃西瓜学会了吗;1;0;1;20497;4.878762745767673e-05
5524;太牛了;1;1;2;20497;9.757525491535346e-05
5527;感觉这些都没用到最后发现还是找人写比较香，过来人经验之谈;3;4;7;20497;0.00034151339220373715
5531;数据怎么办;1;1;2;20497;9.757525491535346e-05
5533;要钱了吗;1;0;1;20497;4.878762745767673e-05
5536;求求教教我;9;3;12;20497;0.0005854515294921208
5546;交直流互联模块化多电平换流器建模与仿真;2;6;8;20497;0.00039030101966141384
5549;点击头像进入粉丝群，热心帮助大家解答论文写作过程中遇到的问题;2;8;10;20497;0.00048787627457676734
5552;娟儿;1;0;1;20497;4.878762745767673e-05
5554;凌源;1;0;1;20497;4.878762745767673e-05
5559;北京第一懒蛋不郁男青年Nemophilist没有手机好玩小浴霸出来看月亮ture一百六十斤的小胖子;2;0;2;20497;9.757525491535346e-05
5570;栀子;1;0;1;20497;4.878762745767673e-05
5580;小姚ps魅影;3;0;3;20497;0.0001463628823730302
5585;DangerousPeople;1;0;1;20497;4.878762745767673e-05
5600;时光相思;2;0;2;20497;9.757525491535346e-05
5604;紫曦褚宸爱你万万年输了不许跑（御姐版）早点睡觉好吗;1;1;2;20497;9.757525491535346e-05
5613;MonetGrey;1;0;1;20497;4.878762745767673e-05
5621;扬迷人的烨哥;1;0;1;20497;4.878762745767673e-05
5625;啾啾在树上吃西瓜亿开开;1;0;1;20497;4.878762745767673e-05
5627;啾啾在树上吃西瓜;1;0;1;20497;4.878762745767673e-05
5630;敢敢;1;0;1;20497;4.878762745767673e-05
5635;圄;1;0;1;20497;4.878762745767673e-05
5640;顾gugu;1;0;1;20497;4.878762745767673e-05
5647;睡不着的泡泡糖：雾（肝论文版）;1;0;1;20497;4.878762745767673e-05
5652;0;1;0;1;20497;4.878762745767673e-05
5662;橙子;1;1;2;20497;9.757525491535346e-05
5669;我不吃佩奇;1;0;1;20497;4.878762745767673e-05
5671;自己写不出来最后找的dx给我全包的;141;57;198;20497;0.009659950236619993
5813;别为难自己了，尤其基础不太好的，我之前自己挣扎折腾没弄出来，最后还得是钞能力;24;12;36;20497;0.0017563545884763624
5838;不会写就直接找人写了过程不重要，只要结果;23;12;35;20497;0.0017075669610186856
5862;找代一定要擦亮眼;21;3;24;20497;0.0011709030589842416
5884;本科论文，dx要多少钱啊;23;2;25;20497;0.0012196906864419183
5908;在知网上查重会不会很高啊;6;32;38;20497;0.0018539298433917159
5915;我找别人写的，查重才百分之几，老师说我写的非常不错，我都不好意思了;23;0;23;20497;0.0011221154315265648
5939;gpt写的正文，自己抄了百度的摘要多了4查重概率，但是也过了;5;25;30;20497;0.001463628823730302
5945;大家多个心眼不要找个人代写的，那种同时接很多单子，最后都是凑的，别问我怎么知道，我经历过我第二次找的是机构里老师写的，特别靠谱，过了;10;3;13;20497;0.0006342391569497975
5956;找人已经写完啦，终于通过啦;13;0;13;20497;0.0006342391569497975
5970;Ai感觉gpt牛掰一些，一天就写完一篇论文，查重还10左右;5;4;9;20497;0.0004390886471190906
5976;这个还是找人写安心，去年找的代写，全程基本没管，顺利毕业;9;0;9;20497;0.0004390886471190906
5986;感觉这些都没用到最后发现还是找人写比较香，过来人经验之谈;4;1;5;20497;0.00024393813728838367
5991;不要挣扎了到最后发现还是找人写比较香，过来人经验之谈写和降重都可以;4;1;5;20497;0.00024393813728838367
5996;我找的代写答辩优秀真的很感谢而且对方性格太好找个靠谱的太难了;3;4;7;20497;0.00034151339220373715
6000;找人写的150;5;0;5;20497;0.00024393813728838367
6006;我能写中国人不骗中国人写不好的我不接;4;0;4;20497;0.00019515050983070692
6011;我自己写的，反反复复改了好几遍，都没过，然后找了一个论文工作室写的，质量非常好，一次就过了，我们寝室后来都找他写的;4;0;4;20497;0.00019515050983070692
6016;求一个代毕设的路子我现在已经麻木了;2;1;3;20497;0.0001463628823730302
6019;150找人写的;3;0;3;20497;0.0001463628823730302
6023;有没有靠谱的代写;1;2;3;20497;0.0001463628823730302
6025;我也是不会写，好不容易提交初稿，还被退回重写，实在受不了，最后找人写的，竟然一遍过;1;1;2;20497;9.757525491535346e-05
6027;有没有代写的帮我写一篇;1;1;2;20497;9.757525491535346e-05
6029;太难了，每次都只写个初搞都要十天半个月还被打下来，只好找学长论文的老师帮忙写了;1;1;2;20497;9.757525491535346e-05
6031;天无道;1;1;2;20497;9.757525491535346e-05
6049;不会写找人写的现在才看的;1;0;1;20497;4.878762745767673e-05
6051;形势与政策有人接吗，第一次不会写;1;0;1;20497;4.878762745767673e-05
6053;和室友一块找的学长重合很低很负责最后还送了答辩ppt;1;0;1;20497;4.878762745767673e-05
6055;我帮帮忙写论文，100200，三天内写完;1;0;1;20497;4.878762745767673e-05
6145;论文实在写不出来，加上又催着交，被打回来了两次，最后实在写不出来了找的机构代写;1;0;1;20497;4.878762745767673e-05
6154;牛头;1;0;1;20497;4.878762745767673e-05
6162;木鱼;1;0;1;20497;4.878762745767673e-05
6166;有谁是和我一样找人代写一遍过的吗;2;0;2;20497;9.757525491535346e-05
6169;专业写作八年;1;0;1;20497;4.878762745767673e-05
6176;可接;1;0;1;20497;4.878762745767673e-05
6179;写到哭，最后找了学姐推荐来的，一次过。有需要可推荐;1;0;1;20497;4.878762745767673e-05
6182;我帮你们写，质量杠杠的;3;0;3;20497;0.0001463628823730302
6186;嘻咔咙咚ber呲打Bungalow;1;0;1;20497;4.878762745767673e-05
6192;unique921;1;0;1;20497;4.878762745767673e-05
6196;阿喵呀;1;0;1;20497;4.878762745767673e-05
6200;時肆你值得拥有;2;0;2;20497;9.757525491535346e-05
6205;星河这样可以嘛;1;0;1;20497;4.878762745767673e-05
6211;哈哈derLareina;3;0;3;20497;0.0001463628823730302
6217;有没有代写;3;0;3;20497;0.0001463628823730302
6223;去年我哥快交了还没写，最后找人写，还评了优;1;0;1;20497;4.878762745767673e-05
6228;蜡笔小欣大宝喜欢拍照;4;0;4;20497;0.00019515050983070692
6235;那只白熊;3;0;3;20497;0.0001463628823730302
6240;Funnier;2;0;2;20497;9.757525491535346e-05
6248;潴猪女孩;1;0;1;20497;4.878762745767673e-05
6251;我就是自己写的头疼，后来找别人写的，又不贵，特别负责，最后通过了;2;0;2;20497;9.757525491535346e-05
6254;芋泥酪酪丸;2;0;2;20497;9.757525491535346e-05
6257;论文找人写的，踩坑了别找便宜的被骗了两次，贪小便宜亏了好几百，最后找个贵一点的走闲鱼过了，直接转账的不行;1;0;1;20497;4.878762745767673e-05
6260;Na;2;0;2;20497;9.757525491535346e-05
6263;Bxy;1;0;1;20497;4.878762745767673e-05
6267;怎样才能让你们发现我;2;0;2;20497;9.757525491535346e-05
6275;爱吃鱼的老猫;1;0;1;20497;4.878762745767673e-05
6278;快删我论文有望了，（不是）;22;600;622;20497;0.030345904278674927
6301;自信点，把牛通改成nb你完全可以配得上;2;217;219;20497;0.010684490413231204
6304;但凡当时写论文知道这个软件;11;168;179;20497;0.008732985314924136
6316;这还是民用级别的。你可能不知道网晴有多牛;8;95;103;20497;0.005025125628140704
6325;洗稿神器啊;1;134;135;20497;0.006586329706786359
6327;怎么感觉你是给他打广告的;8;66;74;20497;0.0036102844318680783
6336;我马上去下，结果下载不了;8;24;32;20497;0.0015612040786456554
6346;怎么知道这个视频是苏星河牛通发的还是苏星河牛逼发的;1;25;26;20497;0.001268478313899595
6349;苏星河牛批;1;13;14;20497;0.0006830267844074743
6351;写小说水字数;2;6;8;20497;0.00039030101966141384
6355;牛逼牛逼;1;7;8;20497;0.00039030101966141384
6358;库库南;1;0;1;20497;4.878762745767673e-05
6369;nineholland;3;0;3;20497;0.0001463628823730302
6377;一颗小草莓谂莘陌然浅笑离雨容嬷嬷的春天;1;0;1;20497;4.878762745767673e-05
6380;Augenstern看我发现了什么好东西;1;0;1;20497;4.878762745767673e-05
6384;宝宝真的好用;2;0;2;20497;9.757525491535346e-05
6390;挺好玩的诗鹿不是鹿小惹晒;2;0;2;20497;9.757525491535346e-05
6394;Jiaq这可是神器呀;1;0;1;20497;4.878762745767673e-05
6397;L解放双手;5;0;5;20497;0.00024393813728838367
6406;可怪不得起点上很多小说都很一样;1;0;1;20497;4.878762745767673e-05
6408;Arrebol啧;1;0;1;20497;4.878762745767673e-05
6410;水下的绷带君好家伙;1;0;1;20497;4.878762745767673e-05
6413;来点维C太无敌了;1;2;3;20497;0.0001463628823730302
6424;小羽这不妥妥检讨书编辑器嘛;1;0;1;20497;4.878762745767673e-05
6430;Luella写作猫;1;0;1;20497;4.878762745767673e-05
6434;月念彩云小梦？;1;0;1;20497;4.878762745767673e-05
6438;脸红艺术家这个牛逼;1;0;1;20497;4.878762745767673e-05
6441;半口雪饼论文有望;1;0;1;20497;4.878762745767673e-05
6444;牛蛙牛蛙保济丸救我狗命还好哈哈哈周周不喝粥mugen黑汁蒸乌鱼但凡知道早点;2;0;2;20497;9.757525491535346e-05
6447;北辰;2;0;2;20497;9.757525491535346e-05
6450;火速蛋糕这个改论文好;1;0;1;20497;4.878762745767673e-05
6453;一颗葡萄葡萄哦这个好;4;0;4;20497;0.00019515050983070692
6461;微微大宝贝喜禾谁是猪咪听到论文我直接坐起来了论文有救了;2;2;4;20497;0.00019515050983070692
6465;沅清蜜酒酿桃月亮总会西沉不慌张拔尖儿论文有救了;4;2;6;20497;0.0002927257647460604
6472;酱酱酱我去;4;1;5;20497;0.00024393813728838367
6477;是宋宋呀看看这个;2;0;2;20497;9.757525491535346e-05
6481;我们人类还有一个能力不会被学习;1;1;2;20497;9.757525491535346e-05
6486;沈经并真的考上大学了论文这样子写;1;1;2;20497;9.757525491535346e-05
6488;YORIROUU这个功能好用不;3;0;3;20497;0.0001463628823730302
6492;W论文有救了;1;0;1;20497;4.878762745767673e-05
6497;风晚关你西红柿S晓晓晓柠橘子酸酸Gogogo你们有用的到的么;3;0;3;20497;0.0001463628823730302
6507;张笑涵快记好;1;0;1;20497;4.878762745767673e-05
6509;夏汤圆XIA年年要遂遂小树莓雨尘diviner美羊羊云落呀清歌未止;1;0;1;20497;4.878762745767673e-05
6513;B612梨涡烊下学期有底了;1;1;2;20497;9.757525491535346e-05
6515;嘻嘻哈哈哈哈哈哈嗝;1;0;1;20497;4.878762745767673e-05
6522;敏敏子阿西写论文的时候怎么没看到这个;3;0;3;20497;0.0001463628823730302
6527;鈞LTayMandyC中文版的grammarly跟quiibot;2;2;4;20497;0.00019515050983070692
6534;清酒巧克力该不会以后就没作家了吧？我还没饭碗就丢饭碗了？;2;0;2;20497;9.757525491535346e-05
6540;许写作神器啊;1;1;2;20497;9.757525491535346e-05
6542;汪汪狗;1;0;1;20497;4.878762745767673e-05
6546;TveLibo快来;2;0;2;20497;9.757525491535346e-05
6552;亖木写作困难症有救了;1;0;1;20497;4.878762745767673e-05
6557;你是果冻吗卧槽;1;0;1;20497;4.878762745767673e-05
6559;LilX这个好东西;1;0;1;20497;4.878762745767673e-05
6565;extra;1;1;2;20497;9.757525491535346e-05
6572;芭蕉山哈哈哈;1;0;1;20497;4.878762745767673e-05
6581;遥梓以后看一下有没有用;1;0;1;20497;4.878762745767673e-05
6583;宇宙超级无敌噼里啪啦暗黑闪电无敌暴龙战士毕业有望;1;1;2;20497;9.757525491535346e-05
6585;橘子海好东西推荐;1;0;1;20497;4.878762745767673e-05
6589;忧郁白色米线;1;0;1;20497;4.878762745767673e-05
6594;葶葶子爱吃香菜小杜同志论文有望了;2;0;2;20497;9.757525491535346e-05
6597;我不知道我不知道这个真的不错;2;1;3;20497;0.0001463628823730302
6604;Ler好东西;2;0;2;20497;9.757525491535346e-05
6607;冰冰棒我怀疑小说都是这样被写出来的;1;0;1;20497;4.878762745767673e-05
6626;就叫美女论文有救了;1;0;1;20497;4.878762745767673e-05
6631;想听晴天毕业论文有望了;1;0;1;20497;4.878762745767673e-05
6636;最爱蓉儿崽了;1;0;1;20497;4.878762745767673e-05
6655;喵喵喵牛啊;1;0;1;20497;4.878762745767673e-05
6657;我开了会员;1;0;1;20497;4.878762745767673e-05
6663;黑芝麻芋圆哈哈哈哈好牛啊;1;0;1;20497;4.878762745767673e-05
6667;怦怦爆炸啦让他写规则;1;0;1;20497;4.878762745767673e-05
6673;、写作文神器;2;0;2;20497;9.757525491535346e-05
6677;Angelbeats这个软件牛;1;0;1;20497;4.878762745767673e-05
6691;Mrs差不多哇哦;1;0;1;20497;4.878762745767673e-05
6693;别北极熊雯神来来来，好东西，直接看第三点;1;0;1;20497;4.878762745767673e-05
6696;林麻麻林凡林白白哈哈哈，小白包年吧;1;0;1;20497;4.878762745767673e-05
6699;茉小橘鲲汤有毒四喜是只喵温温尔雅好东西啊;1;4;5;20497;0.00024393813728838367
6702;梁无双（把书读烂版）我该昨天看到这个的;1;0;1;20497;4.878762745767673e-05
6708;小孙膑仪馆;4;1;5;20497;0.00024393813728838367
6724;蹲坑唱情歌MG大乐Daseinmann鑫愿成蓁;1;0;1;20497;4.878762745767673e-05
6727;本间郁子;1;0;1;20497;4.878762745767673e-05
6730;依玲Yi蔣小玉不是小鱼;1;1;2;20497;9.757525491535346e-05
6733;YERLIHenorejun;1;1;2;20497;9.757525491535346e-05
6739;n7;1;0;1;20497;4.878762745767673e-05
6747;热爱;1;0;1;20497;4.878762745767673e-05
6751;西西Bbb;1;0;1;20497;4.878762745767673e-05
6754;derder来皖啦;1;0;1;20497;4.878762745767673e-05
6765;图图你不洗澡;1;0;1;20497;4.878762745767673e-05
6767;五包小辣条。CING;1;0;1;20497;4.878762745767673e-05
6769;Hepcat;2;0;2;20497;9.757525491535346e-05
6772;shx;2;1;3;20497;0.0001463628823730302
6783;goddess;1;0;1;20497;4.878762745767673e-05
6788;墨镜方13;1;0;1;20497;4.878762745767673e-05
6792;皮蛋瘦肉邹;1;0;1;20497;4.878762745767673e-05
6797;小羊打嗝谁爱上彩虹gos47;3;0;3;20497;0.0001463628823730302
6801;渴了瞌睡喝可乐;1;0;1;20497;4.878762745767673e-05
6804;萱萱爱吃爆米花;1;1;2;20497;9.757525491535346e-05
6808;zhou;4;0;4;20497;0.00019515050983070692
6817;桃色;1;0;1;20497;4.878762745767673e-05
6824;才不吃苦瓜;2;0;2;20497;9.757525491535346e-05
6827;太上忘情;1;0;1;20497;4.878762745767673e-05
6831;一蓑烟雨、;1;0;1;20497;4.878762745767673e-05
6833;想穿裙子了;1;0;1;20497;4.878762745767673e-05
6835;小鱼仙倌;1;0;1;20497;4.878762745767673e-05
6838;JWwytttt：）;1;0;1;20497;4.878762745767673e-05
6840;樗暇;1;0;1;20497;4.878762745767673e-05
6845;小胡宝宝;2;0;2;20497;9.757525491535346e-05
6854;JiN;3;0;3;20497;0.0001463628823730302
6866;鸭梨不大;3;1;4;20497;0.00019515050983070692
6871;禾火;1;0;1;20497;4.878762745767673e-05
6879;西红柿鸡蛋汤;1;1;2;20497;9.757525491535346e-05
6887;酸崽;3;0;3;20497;0.0001463628823730302
6892;？;1;0;1;20497;4.878762745767673e-05
6894;gduu临冬nauyizhuzkun疏桐念茳;2;0;2;20497;9.757525491535346e-05
6902;故里有意留长安;1;0;1;20497;4.878762745767673e-05
6909;ikxing;2;0;2;20497;9.757525491535346e-05
6913;小谢“”;1;0;1;20497;4.878762745767673e-05
6915;zwzwz;1;0;1;20497;4.878762745767673e-05
6917;琪;1;0;1;20497;4.878762745767673e-05
6921;啵妞;1;0;1;20497;4.878762745767673e-05
6926;春日小憨;1;1;2;20497;9.757525491535346e-05
6935;八怪;1;0;1;20497;4.878762745767673e-05
6947;把红楼梦前80回放进去，试试续写功能;11;778;789;20497;0.03849343806410694
6959;贩卖日落直接三分三十七，看看怎么用;1;1;2;20497;9.757525491535346e-05
6961;这个厉害;1;0;1;20497;4.878762745767673e-05
7027;奥奥你看这些收藏hhh;1;0;1;20497;4.878762745767673e-05
7029;让嘉里来派送;1;0;1;20497;4.878762745767673e-05
7033;Margaret;1;0;1;20497;4.878762745767673e-05
7038;枝枝好机会王姐的偷懒秘诀;1;0;1;20497;4.878762745767673e-05
7042;SY;2;0;2;20497;9.757525491535346e-05
7048;吐泡泡的王小鱼鱼感觉你很需要;1;0;1;20497;4.878762745767673e-05
7055;查重能过吗;1;0;1;20497;4.878762745767673e-05
7061;马上就下载了;1;0;1;20497;4.878762745767673e-05
7065;Whisper;1;0;1;20497;4.878762745767673e-05
7074;小晓梦想;1;0;1;20497;4.878762745767673e-05
7094;Cassie;1;0;1;20497;4.878762745767673e-05
7099;omumua;1;0;1;20497;4.878762745767673e-05
7110;beatmstp排尔可以多看看他的视频，B站上更多;4;0;4;20497;0.00019515050983070692
7115;remember蓝小孩和吴大傻哦了瓦晓雪碧丫;1;0;1;20497;4.878762745767673e-05
7130;不想背书;1;0;1;20497;4.878762745767673e-05
7134;小了白了兔;1;0;1;20497;4.878762745767673e-05
7139;Muistletoenb，感觉你以后可以用一用;1;0;1;20497;4.878762745767673e-05
7142;满分甜度收下这个软件;1;0;1;20497;4.878762745767673e-05
7145;晚风;1;0;1;20497;4.878762745767673e-05
7147;孤独面包;1;0;1;20497;4.878762745767673e-05
7149;柳塘新绿却温柔老师你的论文查重有救了;2;0;2;20497;9.757525491535346e-05
7154;阿嘎吃肉肉毕业论文搞一搞;3;0;3;20497;0.0001463628823730302
7161;心软的升;2;0;2;20497;9.757525491535346e-05
7170;七年;1;0;1;20497;4.878762745767673e-05
7175;东坡德华飔雨郑博文;1;0;1;20497;4.878762745767673e-05
7177;洛寒汐神器;1;0;1;20497;4.878762745767673e-05
7179;Duck不必;1;0;1;20497;4.878762745767673e-05
7181;心动神明这个牛;1;0;1;20497;4.878762745767673e-05
7183;脆皮儿哦我敲;1;0;1;20497;4.878762745767673e-05
7187;冰美式就好昊天;2;0;2;20497;9.757525491535346e-05
7190;小欧不是小O笑笑不笑Lanki呌呌;3;0;3;20497;0.0001463628823730302
7201;此号已废;1;0;1;20497;4.878762745767673e-05
7211;久遠九敏，早点告诉我啊论文都写完了;1;0;1;20497;4.878762745767673e-05
7214;卟立昂;3;0;3;20497;0.0001463628823730302
7222;小王小王;4;0;4;20497;0.00019515050983070692
7230;十七之夏;1;0;1;20497;4.878762745767673e-05
7234;江天烟景不苍傷安吉尼儿惊枝;1;0;1;20497;4.878762745767673e-05
7240;我想问，可以写公文吗;1;0;1;20497;4.878762745767673e-05
7244;Neyon;1;0;1;20497;4.878762745767673e-05
7252;咪哒;1;0;1;20497;4.878762745767673e-05
7255;不是苏星河牛逼？;3;0;3;20497;0.0001463628823730302
7260;讨厌怀天气干掉小草莓友友们我被狠狠种草;2;0;2;20497;9.757525491535346e-05
7279;甜崽小young;1;0;1;20497;4.878762745767673e-05
7283;小志解说;1;0;1;20497;4.878762745767673e-05
7289;、7One今天也是可爱的崽崽好物推荐;1;0;1;20497;4.878762745767673e-05
7320;已下单，26877703qqcom;1;1;2;20497;9.757525491535346e-05
7322;怎么总？;1;1;2;20497;9.757525491535346e-05
7324;这个要怎么用;1;0;1;20497;4.878762745767673e-05
7326;怎么买;1;0;1;20497;4.878762745767673e-05
7331;？;1;0;1;20497;4.878762745767673e-05
7336;查重率100;87;3902;3989;20497;0.19461384592867248
7424;虽然写的奇奇怪怪，模棱两可。应付一些选修课还行。;17;1849;1866;20497;0.09103771283602478
7442;求网址;82;126;208;20497;0.01014782651119676
7525;用了两天收费了，;26;103;129;20497;0.006293603942040298
7552;超级好用，反正是选修课老师应该不得细看;6;191;197;20497;0.009611162609162317
7559;麻烦咨询下，一般写英文论文（SCI时，是把写好的中文论文通过专业翻译软件进行翻译，还是直接写英文论文呢？？麻烦了。;17;45;62;20497;0.0030248329023759572
7577;真假？我正愁毕业论文没头绪;13;28;41;20497;0.002000292725764746
7591;论文也可以？;7;12;19;20497;0.0009269649216958579
7599;专业导论可以吗;4;12;16;20497;0.0007806020393228277
7604;秘塔科技;2;14;16;20497;0.0007806020393228277
7607;毕设用这个的真不怕啊我自己写的花几百查重都有快十了，这玩意确定不会重吗;2;13;15;20497;0.000731814411865151
7610;要手写怎么办;5;2;7;20497;0.00034151339220373715
7616;只发不给地址;1;14;15;20497;0.000731814411865151
7618;就是从网上爬取的一些同命文章吧，不如叫懒人文章爬取器;2;4;6;20497;0.0002927257647460604
7621;可以拿来写论文嘛;2;1;3;20497;0.0001463628823730302
7624;沙漠玫瑰（185版）爱吃香菜花椒葱芹菜的胃病患者universe今天遣返了吗收藏;7;0;7;20497;0.00034151339220373715
7632;帅气的非主流小男小男难上加难十九殇佰我就不多说了两秒写完政治总结;2;1;3;20497;0.0001463628823730302
7636;蓝色话筒芋头酱bking棣棣快来，好东西;1;0;1;20497;4.878762745767673e-05
7642;Leleii怎么毕业了才知道;1;0;1;20497;4.878762745767673e-05
7649;许七安;1;0;1;20497;4.878762745767673e-05
7651;好好吃饭饭;1;0;1;20497;4.878762745767673e-05
7653;兰亭晚钟写课程作业;1;1;2;20497;9.757525491535346e-05
7655;Ydwct这个也好;1;0;1;20497;4.878762745767673e-05
7657;吖为什么我现在才刷到;1;0;1;20497;4.878762745767673e-05
7659;查重极低;2;0;2;20497;9.757525491535346e-05
7663;Two7糖醋柚子;3;0;3;20497;0.0001463628823730302
7669;哈喽在吗搞一篇;1;1;2;20497;9.757525491535346e-05
7672;求网址;2;0;2;20497;9.757525491535346e-05
7675;game牛逼啊;1;0;1;20497;4.878762745767673e-05
7677;求网址;1;0;1;20497;4.878762745767673e-05
7679;玛多得充会员;2;0;2;20497;9.757525491535346e-05
7683;无言看;2;0;2;20497;9.757525491535346e-05
7687;别传播了，我水课论文都是这么写的，它要是收费了可咋办;1;0;1;20497;4.878762745767673e-05
7695;求网址;1;0;1;20497;4.878762745767673e-05
7697;好了我知道了删了吧;1;0;1;20497;4.878762745767673e-05
7699;锁上月亮的窗牛逼;2;0;2;20497;9.757525491535346e-05
7709;纤尘;1;0;1;20497;4.878762745767673e-05
7713;小刘在睡觉4000字算什么;1;0;1;20497;4.878762745767673e-05
7716;白兰地这就是大数据？;2;0;2;20497;9.757525491535346e-05
7719;陶然不遇看起来不错;1;0;1;20497;4.878762745767673e-05
7723;q应付选修课;2;0;2;20497;9.757525491535346e-05
7728;在想赫赫好玩;1;2;3;20497;0.0001463628823730302
7733;困成憨包儿我用这个写;1;0;1;20497;4.878762745767673e-05
7735;D你用的不会就是这种吧;1;0;1;20497;4.878762745767673e-05
7738;等风至好了这下全知道了;1;1;2;20497;9.757525491535346e-05
7741;hi大家好我回来啦你的作业这样不就好了;2;0;2;20497;9.757525491535346e-05
7744;0;1;0;1;20497;4.878762745767673e-05
7746;AAA专业下水道疏通（最畅通版）;1;0;1;20497;4.878762745767673e-05
7751;斯利婆狗屁不通文章生成器;4;1;5;20497;0.00024393813728838367
7756;哦豁帮我找资源;2;0;2;20497;9.757525491535346e-05
7759;用户5160134267478好东西;1;0;1;20497;4.878762745767673e-05
7762;蔡蔡在这里www够用;5;1;6;20497;0.0002927257647460604
7769;黄河东流;7;0;7;20497;0.00034151339220373715
7781;八七木查一下;1;0;1;20497;4.878762745767673e-05
7784;长安某朱宇伦小白096lullaby;1;2;3;20497;0.0001463628823730302
7786;祐我要吃鸡腿可用;1;0;1;20497;4.878762745767673e-05
7788;息息这个好;1;0;1;20497;4.878762745767673e-05
7790;一枝花花花RRRRRR取什么名字;5;0;5;20497;0.00024393813728838367
7796;啵啵爱吃香菜推给你学弟;2;0;2;20497;9.757525491535346e-05
7800;康康康柒;1;0;1;20497;4.878762745767673e-05
7804;Nil不瘦30斤不改名丝绒拿铁（减肥版）吕口口（六级必过版）小盒子装什么无秋帮我找;1;0;1;20497;4.878762745767673e-05
7807;此时眼前人已非彼时人两两相望唯余失王女士牛逼;2;0;2;20497;9.757525491535346e-05
7812;雷崩崩你需要吗;1;0;1;20497;4.878762745767673e-05
7817;汤圆你的福音来了;1;0;1;20497;4.878762745767673e-05
7820;下次试试;1;0;1;20497;4.878762745767673e-05
7822;何枝惊鹊我超;3;0;3;20497;0.0001463628823730302
7830;朴彩英的小迷弟结合我微信发的，你就懂了;1;0;1;20497;4.878762745767673e-05
7834;鱼香肉丝儿这个可以吗;1;0;1;20497;4.878762745767673e-05
7839;快船总冠军陈酒50小杨同学摇屁股的小柯基无沐帅乐乐乐乐乐乐乐流年几度忆清欢给我旺仔许意久。好东西;1;0;1;20497;4.878762745767673e-05
7842;莲;1;0;1;20497;4.878762745767673e-05
7849;辰逸凡Alex野肆、辣条吃不胖樱桃小嘉biubiu一个达布刘sweet杀死那个编剧;3;1;4;20497;0.00019515050983070692
7853;Paraaaaaa用得上宝;1;0;1;20497;4.878762745767673e-05
7855;大妍同学查一下，以后混一下的论文都直接抄了;2;0;2;20497;9.757525491535346e-05
7860;取悦;1;0;1;20497;4.878762745767673e-05
7862;Goddess1绚都核酸检讨这不就来了;1;0;1;20497;4.878762745767673e-05
7864;DCXLPCYZ你试试这个好了;1;0;1;20497;4.878762745767673e-05
7867;hha见字如面Avu御鱼左岸939597照相机娟子G这个好;1;0;1;20497;4.878762745767673e-05
7870;陇少东陈秘书，给我把这个网址搞到手;2;1;3;20497;0.0001463628823730302
7874;小苍澪你以后会用上;1;1;2;20497;9.757525491535346e-05
7876;开朗的网友这个咋弄，有了这个选修课论文就有救了;2;2;4;20497;0.00019515050983070692
7879;用过，还行;3;0;3;20497;0.0001463628823730302
7888;憨小鬼哇哦;1;0;1;20497;4.878762745767673e-05
7890;怎么能降重呢;1;0;1;20497;4.878762745767673e-05
7895;绫大学生很需要这个;1;0;1;20497;4.878762745767673e-05
7897;凉白开迟来的鱼梓洛川一起淋雨THeHeart我只能帮到这了;3;1;4;20497;0.00019515050983070692
7901;祤6;1;0;1;20497;4.878762745767673e-05
7906;沉星整点有用的;1;0;1;20497;4.878762745767673e-05
7915;爱吃簸箕板老艺术家了一块冰美式三天饿九顿nnnnnnnnRose九里库库库日天专说废话博主暴打猪小林爱吃香芋派reacher杰你的福音;1;0;1;20497;4.878762745767673e-05
7921;我的检讨和形势政策全是靠这个写的;4;0;4;20497;0.00019515050983070692
7926;看见我请叫我去睡觉。zzz;1;0;1;20497;4.878762745767673e-05
7928;钮钴禄莞莞这个适合你，水文章;2;0;2;20497;9.757525491535346e-05
7936;啦啦啦啦lala闻舟渡我黑湖大章鱼绿豆冰舟（减肥版）Ven从前有座山还有这种好东西;2;1;3;20497;0.0001463628823730302
7939;敬之利己主义整篇sci;1;0;1;20497;4.878762745767673e-05
7941;好像说了很多，好像什么都没说。应付选修挺好的;1;0;1;20497;4.878762745767673e-05
7943;求网址;1;0;1;20497;4.878762745767673e-05
7945;穹焱;1;1;2;20497;9.757525491535346e-05
7947;求网址;1;0;1;20497;4.878762745767673e-05
7949;求网址;1;0;1;20497;4.878762745767673e-05
7951;求操作求教程;1;0;1;20497;4.878762745767673e-05
7954;求网址;1;0;1;20497;4.878762745767673e-05
7956;求;1;0;1;20497;4.878762745767673e-05
7958;写材料也可以用这个吗？;1;0;1;20497;4.878762745767673e-05
7960;求网址;1;0;1;20497;4.878762745767673e-05
7962;求网址;1;0;1;20497;4.878762745767673e-05
7964;怎么下载;1;0;1;20497;4.878762745767673e-05
7966;网址;3;0;3;20497;0.0001463628823730302
7970;查重率100;1;0;1;20497;4.878762745767673e-05
7972;能不能搜一下国足怎样才能踢进世界杯;1;0;1;20497;4.878762745767673e-05
7974;求网址;1;0;1;20497;4.878762745767673e-05
7976;钻石心肠鱼头星星早知道作业这样搞了;2;0;2;20497;9.757525491535346e-05
7979;求网址;1;0;1;20497;4.878762745767673e-05
7981;求网址;1;0;1;20497;4.878762745767673e-05
7985;一博博士（科研分享）;1;0;1;20497;4.878762745767673e-05
7987;老杀;1;0;1;20497;4.878762745767673e-05
7989;少年孤身提剑赴长安;1;0;1;20497;4.878762745767673e-05
8006;FreeGiveManRIO微醺真系好好饮動画PaffiX;1;0;1;20497;4.878762745767673e-05
8008;Destiny歪歪歪;2;1;3;20497;0.0001463628823730302
8011;西光;1;0;1;20497;4.878762745767673e-05
8013;晚上吃什么FLIPPED半只星星夜澜freedomL小琪剪醇;4;2;6;20497;0.0002927257647460604
8019;c5号居民;1;0;1;20497;4.878762745767673e-05
8021;未来兴小镇镇长;2;0;2;20497;9.757525491535346e-05
8024;旭;1;0;1;20497;4.878762745767673e-05
8026;阿抱;3;0;3;20497;0.0001463628823730302
8030;夏野了桐不桐意小池抚月一只委屈脆脆鲨鱼;7;1;8;20497;0.00039030101966141384
8038;爷的;1;0;1;20497;4.878762745767673e-05
8041;D企鹅;1;0;1;20497;4.878762745767673e-05
8045;清凉幼稚园一姐;2;0;2;20497;9.757525491535346e-05
8050;asdfghj;1;0;1;20497;4.878762745767673e-05
8058;卡卡卡卡嘻嘻;1;0;1;20497;4.878762745767673e-05
8068;栓什么名字小小小谷小邢不在线;2;0;2;20497;9.757525491535346e-05
8074;Gary小邢睡不饱洋洋不ILclown小五一（积德版;2;1;3;20497;0.0001463628823730302
8077;怀念月色;1;0;1;20497;4.878762745767673e-05
8079;西边有只羊汪汪汪汪y;1;1;2;20497;9.757525491535346e-05
8083;庚庚庚庚庚庚;1;0;1;20497;4.878762745767673e-05
8086;有媛;1;0;1;20497;4.878762745767673e-05
8091;A花开富贵专业水果批发xuanVNASA丨忆丨狗砸;1;0;1;20497;4.878762745767673e-05
8097;不問菩提符瑾命中悬灯。比熊困了;1;2;3;20497;0.0001463628823730302
8103;Y;1;1;2;20497;9.757525491535346e-05
8106;hhzzzzzzzzzzxy;1;0;1;20497;4.878762745767673e-05
8109;Tequiero;1;0;1;20497;4.878762745767673e-05
8113;我只属于你AAAAA九江第一产瓜有限公司小吴总轻翾;1;2;3;20497;0.0001463628823730302
8115;徐英明;1;0;1;20497;4.878762745767673e-05
8118;我喜欢炸鸡;1;0;1;20497;4.878762745767673e-05
8121;独爱;2;0;2;20497;9.757525491535346e-05
8130;大呲花;1;0;1;20497;4.878762745767673e-05
8133;止戒并;1;1;2;20497;9.757525491535346e-05
8138;可乐叮当猫rua;1;1;2;20497;9.757525491535346e-05
8144;Artemis;1;0;1;20497;4.878762745767673e-05
8146;匹诺曹要长鼻子;1;0;1;20497;4.878762745767673e-05
8148;辞;1;0;1;20497;4.878762745767673e-05
8150;喧嚣月牙;1;0;1;20497;4.878762745767673e-05
8152;华南不倒翁;1;0;1;20497;4.878762745767673e-05
8154;0;1;0;1;20497;4.878762745767673e-05
8159;乖乖beyslf;1;0;1;20497;4.878762745767673e-05
8162;啊帆爱吃篮下火锅;1;0;1;20497;4.878762745767673e-05
8166;钟小脑斧;1;1;2;20497;9.757525491535346e-05
8168;Wait鱼才不说话TZ2lockXIAOSU宇宙无敌超级暴龙兽锤爆火星陨石拿铁;2;0;2;20497;9.757525491535346e-05
8186;山城冰汤圆;1;0;1;20497;4.878762745767673e-05
8191;霍格沃茨在逃魔法师;4;0;4;20497;0.00019515050983070692
8198;浮生做梦;1;1;2;20497;9.757525491535346e-05
8200;可乐不加冰吖;1;0;1;20497;4.878762745767673e-05
8203;aaaaa桃花木心我快发霉了;1;1;2;20497;9.757525491535346e-05
8206;心头一座山;1;0;1;20497;4.878762745767673e-05
8209;来财;2;0;2;20497;9.757525491535346e-05
8213;银河;1;0;1;20497;4.878762745767673e-05
8216;纳米;2;0;2;20497;9.757525491535346e-05
8222;爷投降好吗木渡;1;0;1;20497;4.878762745767673e-05
8227;你好我叫陈大力没有名字呔太阳西下啦怎么肥四;1;0;1;20497;4.878762745767673e-05
8233;三天饿九顿见信安吃饱睡不饱咖啡和面包的公主;1;1;2;20497;9.757525491535346e-05
8240;又又又HR;1;0;1;20497;4.878762745767673e-05
8242;木耳炒肉丝汤;1;1;2;20497;9.757525491535346e-05
8245;sooooon;1;1;2;20497;9.757525491535346e-05
8247;上沢川z;1;1;2;20497;9.757525491535346e-05
8255;小得得得;1;0;1;20497;4.878762745767673e-05
8260;DOU小助手抖音小助手抖音正能量抖音;3;72;75;20497;0.003659072059325755
8264;我昨晚刚用，好用，应付一些水课论文;2;0;2;20497;9.757525491535346e-05
8267;ZLY;2;0;2;20497;9.757525491535346e-05
8270;那你捶死我好了;2;0;2;20497;9.757525491535346e-05
8273;有没有网址啊;2;0;2;20497;9.757525491535346e-05
8276;不怎么好;2;0;2;20497;9.757525491535346e-05
8279;Feint羽然怀里的垂耳兔和你晩汐不知道自己该叫啥;2;0;2;20497;9.757525491535346e-05
8282;直接百度秘塔写作猫;1;2;3;20497;0.0001463628823730302
8284;求;1;1;2;20497;9.757525491535346e-05
8286;我警告你，最好删了这个，别让我老师发现，我以为只有我知道;1;1;2;20497;9.757525491535346e-05
8288;如果大学生写文章都用这个，那这个文凭不给也罢。;1;1;2;20497;9.757525491535346e-05
8290;Bensann这个好;1;1;2;20497;9.757525491535346e-05
8293;是不是被封了，用了梯子我找不到，只找到一个写作猫的广告;1;0;1;20497;4.878762745767673e-05
8295;江上月卿我的思政作业就是靠这个写的，再改一下就交上去了;1;0;1;20497;4.878762745767673e-05
8297;616;1;0;1;20497;4.878762745767673e-05
8299;有无网站;1;0;1;20497;4.878762745767673e-05
8301;给个地址;1;0;1;20497;4.878762745767673e-05
8303;求网址;1;0;1;20497;4.878762745767673e-05
8305;要收费，10000字19元;1;0;1;20497;4.878762745767673e-05
8307;求链接;1;0;1;20497;4.878762745767673e-05
8309;求网址;1;0;1;20497;4.878762745767673e-05
8311;求;1;0;1;20497;4.878762745767673e-05
8313;说白了就是废话连篇不过写文科类的还挺合适;1;0;1;20497;4.878762745767673e-05
8315;反复女的;1;0;1;20497;4.878762745767673e-05
8317;亲测，很难用;1;0;1;20497;4.878762745767673e-05
8319;用这个写论文简直作死;1;0;1;20497;4.878762745767673e-05
8321;这种文章有毛用，查重率百分百;1;0;1;20497;4.878762745767673e-05
8323;这能及格？别害人了;1;0;1;20497;4.878762745767673e-05
8325;废话连篇器;1;0;1;20497;4.878762745767673e-05
8388;一笙总是睡的不太晚诗织爱上层楼;1;0;1;20497;4.878762745767673e-05
8390;炒酸奶它老婆;1;0;1;20497;4.878762745767673e-05
8392;废话生成器;1;0;1;20497;4.878762745767673e-05
8394;真的假的;1;0;1;20497;4.878762745767673e-05
8396;x;1;0;1;20497;4.878762745767673e-05
8398;名字是？;1;0;1;20497;4.878762745767673e-05
8400;6;1;0;1;20497;4.878762745767673e-05
8402;卧槽牛逼;1;0;1;20497;4.878762745767673e-05
8404;什么软件;1;0;1;20497;4.878762745767673e-05
8406;求地址;1;0;1;20497;4.878762745767673e-05
8408;跪求;1;0;1;20497;4.878762745767673e-05
8410;这个是啥网站啊;3;0;3;20497;0.0001463628823730302
8414;用过Ai的宝子请举手;2;8;10;20497;0.00048787627457676734
8417;它就是接入了openai的KPI;1;3;4;20497;0.00019515050983070692
8419;为什么充不了AI得会员。;1;5;6;20497;0.0002927257647460604
8422;免费的吗？;1;1;2;20497;9.757525491535346e-05
8434;需要会员吗;2;2;4;20497;0.00019515050983070692
8444;又想骗我充会员;1;3;4;20497;0.00019515050983070692
8453;你是懂足球的;2;5;7;20497;0.00034151339220373715
8456;这个收费的;2;4;6;20497;0.0002927257647460604
8459;ai也有国产的嘛？文言文编程吗？;2;3;5;20497;0.00024393813728838367
8462;国足那个不是论文是科幻小说;1;2;3;20497;0.0001463628823730302
8470;小F同学;1;0;1;20497;4.878762745767673e-05
8473;城北徐公;1;1;2;20497;9.757525491535346e-05
8475;美国为什么游戏珍珠港;3;3;6;20497;0.0002927257647460604
8479;能写领导讲话吗;1;2;3;20497;0.0001463628823730302
8481;骂国足是唯一绝对正确的;1;2;3;20497;0.0001463628823730302
8484;自动文案剪辑;2;5;7;20497;0.00034151339220373715
8490;一帧秒创;1;1;2;20497;9.757525491535346e-05
8494;厉害了AI;3;2;5;20497;0.00024393813728838367
8498;免费的吗？;1;4;5;20497;0.00024393813728838367
8502;能剪辑影视吗;1;1;2;20497;9.757525491535346e-05
8536;不交钱不给你用;1;1;2;20497;9.757525491535346e-05
8599;自动文案剪辑;3;0;3;20497;0.0001463628823730302
8640;真的这么好的工具？太想要了;1;0;1;20497;4.878762745767673e-05
8663;自动文案剪辑;1;4;5;20497;0.00024393813728838367
8679;自动文案剪辑;1;2;3;20497;0.0001463628823730302
8691;这个真棒;1;3;4;20497;0.00019515050983070692
8764;写到后面就串了，甚至和前面搭不上;48;607;655;20497;0.03195589598477826
8813;再进化十年也写不了小说，小说不仅仅是懂逻辑这么简单，写好看需要调动情绪，至少怎么调动读者情绪，这是智慧生命才能掌握;21;64;85;20497;0.004146948333902522
8835;写的倒是规整，就是没意思;1;0;1;20497;4.878762745767673e-05
8837;唐家三少有救了;6;128;134;20497;0.006537542079328682
8844;我觉得现在b乎的很多小说就是ai写的抖音上推送的基本都是这种;9;160;169;20497;0.008245109040347368
8854;牛逼，只要有脑洞，人人作家时代已来临;1;0;1;20497;4.878762745767673e-05
8856;首先，你这个剧情简单，第三章读者还能剩30都挺难;13;7;20;20497;0.0009757525491535347
8870;写成人小说呢？带动作描写，会不会都是省略号;18;12;30;20497;0.001463628823730302
8889;这样写能放到起点挣到钱吗？;14;9;23;20497;0.0011221154315265648
8904;不晓得，但是写论文有市场;10;60;70;20497;0.0034151339220373713
8915;GPT更适合写段落，然后自己修改很适合脑海中有画面，却写不出来的新手作者;2;29;31;20497;0.0015124164511879786
8918;写爽文可以，最近有一大批100w字的网文出现，全部都被差评，感觉就是这个东西写的;3;42;45;20497;0.002195443235595453
8922;写小说可能一般，但是写都市家庭剧，抗日神剧，这类剧本很容易;1;50;51;20497;0.0024881690003415134
8924;plus怎么支付啊;11;0;11;20497;0.000536663902034444
8936;续写校花的贴身高手;2;19;21;20497;0.0010245401766112113
8939;我女儿问我，现在AI技术那么厉害，我努力学习画画，AI会画得更好，我学了还有用吗？;8;0;8;20497;0.00039030101966141384
8948;这东西是要下寨还是付费;7;1;8;20497;0.00039030101966141384
8957;你喂他几十万本小说的数据你看他能不能写出来他虽然不会创造，但他会拼接;1;6;7;20497;0.00034151339220373715
8974;这个是4还是3;1;0;1;20497;4.878762745767673e-05
8978;很早就有机器人写小说了内容有点侮辱智商而且很水起点现在很多名字很长的小说都是这种;1;4;5;20497;0.00024393813728838367
8995;这个软件在网上找好久都没有;5;1;6;20497;0.0002927257647460604
9002;单走一个六快看看内容;1;0;1;20497;4.878762745767673e-05
9011;可以写作文吗？;1;0;1;20497;4.878762745767673e-05
9016;网络作家们快要全部失业了;1;0;1;20497;4.878762745767673e-05
9032;不行的我用过，写出来简直不忍直视;1;4;5;20497;0.00024393813728838367
9041;我仿佛发现了新商机;1;0;1;20497;4.878762745767673e-05
9044;能写特殊种类的小说吗，我替朋友问的;1;3;4;20497;0.00019515050983070692
9046;我有个小说灵感;1;0;1;20497;4.878762745767673e-05
9048;小说家失业了;1;0;1;20497;4.878762745767673e-05
9055;不用熬夜写论文了，如果可以做PPT就好了;6;0;6;20497;0.0002927257647460604
9068;直接写不行，但是可以让它设计情节，搞设定，起名字，我觉得拓展脑洞还是有帮助的。;2;5;7;20497;0.00034151339220373715
9073;会不会出现版权问题？;1;0;1;20497;4.878762745767673e-05
9080;剧情太快，妙写简单，没有代入感，作为一个入行一年的网文作者，我可以明确的告诉各位，ai写作段时间无法代替真正的作者，网文发展多年，早已自成一套叙述体系，这是ai学不来的，至少段时间内学不来，拿来当短篇都很勉强，长篇更不可能;6;12;18;20497;0.0008781772942381812
9088;以后作家也不赚钱了;1;7;8;20497;0.00039030101966141384
9093;完了，我是作家咯;1;1;2;20497;9.757525491535346e-05
9095;那是不是直接可以上书网了，直接搞钱了;1;1;2;20497;9.757525491535346e-05
9101;大佬我用的手机登录为啥跟他对话得用英文呀谷歌自动翻译但是输入中文他就不搭理人;2;1;3;20497;0.0001463628823730302
9110;以后小学老师布置作文，交上来的都一样;1;1;2;20497;9.757525491535346e-05
9114;AI写不出自己的风格，说白了没有灵魂，你看那些成名的大神，哪一个没有自己的写作特点，即便是两个大神写同一题材，也很容易判断两个作品的不同。;1;1;2;20497;9.757525491535346e-05
9116;cpt4吗？3的话就会重复，强行结尾，乱早就试了，不行，4的话没试，没钱充;1;4;5;20497;0.00024393813728838367
9119;这个可以写大纲然后在大纲上面自行发挥就好了番茄和飞卢一堆这种小说;1;14;15;20497;0.000731814411865151
9126;直接说写一本类似xxx的小说;2;0;2;20497;9.757525491535346e-05
9133;灵异小说也能写吗？;2;0;2;20497;9.757525491535346e-05
9137;这是只能在电脑上操作吧;1;0;1;20497;4.878762745767673e-05
9141;卧槽以后论文有着落了;1;2;3;20497;0.0001463628823730302
9144;国外的小说网站已经有单独一个类目是GPT参与的小说;2;1;3;20497;0.0001463628823730302
9148;短篇比较容易;1;0;1;20497;4.878762745767673e-05
9151;什么名字，;2;0;2;20497;9.757525491535346e-05
9154;番茄不全是这种吗？;1;0;1;20497;4.878762745767673e-05
9158;得前后剧情逻辑能自洽才行;1;2;3;20497;0.0001463628823730302
9160;内容写的不怎么样啊;1;3;4;20497;0.00019515050983070692
9162;肯定有;1;1;2;20497;9.757525491535346e-05
9168;A7l;1;0;1;20497;4.878762745767673e-05
9170;我作为读者，反正ai写的我不会去看。因为文字是一种情感传递与表达，不管是网文还是文学作品，我要看的是人的情感，思维，表达。冷漠的机器他不配我去费时间阅读;3;3;6;20497;0.0002927257647460604
9175;依了个比古;1;1;2;20497;9.757525491535346e-05
9180;这玩意儿都可以算卦了;3;0;3;20497;0.0001463628823730302
9189;0;2;0;2;20497;9.757525491535346e-05
9197;gpt4你直接喂一本小说你让它读完这一本差不多的就行了。你只要设定名字年代。;6;9;15;20497;0.000731814411865151
9204;如果让两个chatgpt相互对话会怎样;3;3;6;20497;0.0002927257647460604
9208;写小说肯定没市场，因为ai不会创新;7;0;7;20497;0.00034151339220373715
9216;很多不会玩的人说根本不能用来写小说，打脸;6;0;6;20497;0.0002927257647460604
9223;然后你会发觉，上面的东西，全都是复制粘贴别人的，网络一搜，立马出来;1;0;1;20497;4.878762745767673e-05
9225;全是叙述;1;0;1;20497;4.878762745767673e-05
9227;这玩意如果真的写的比人好就有鬼了;1;0;1;20497;4.878762745767673e-05
9229;问题是国内怎么下载啊;1;0;1;20497;4.878762745767673e-05
9297;怎么用;1;0;1;20497;4.878762745767673e-05
9302;我想知道这个软件它如何充会员内地的银行卡支持吗？;1;0;1;20497;4.878762745767673e-05
9305;网址是？？;3;4;7;20497;0.00034151339220373715
9310;大家好;2;0;2;20497;9.757525491535346e-05
9314;我不敢抄怕查重率太高，太折磨人了，后来找人写的，真的很担心不靠谱，还好最后给过了，一路太心酸;2;5;7;20497;0.00034151339220373715
9317;哈哈，你怎么净说大实话，我和我的学术垃圾，我找的代写，写论文太难了，已经定稿啦，坐等答辩;2;2;4;20497;0.00019515050983070692
9320;有谁跟我一样是找别人写的，并且我觉得我找对了;1;0;1;20497;4.878762745767673e-05
9323;抓住一个到特魏;2;15;17;20497;0.0008293896667805044
9326;高考作文本来就没啥思想吧;3;9;12;20497;0.0005854515294921208
9330;如果是个有思想的AI呢;3;3;6;20497;0.0002927257647460604
9334;亲爱的宝贝魏教授谢谢你给我们推荐的好书以后继续给我们推荐好书哈爱你呦;2;4;6;20497;0.0002927257647460604
9337;如果你不知道是AI写的呢;2;0;2;20497;9.757525491535346e-05
9351;好早;1;1;2;20497;9.757525491535346e-05
9353;沙发;1;2;3;20497;0.0001463628823730302
9355;沙发;1;0;1;20497;4.878762745767673e-05
9357;鲤鱼与鱼小鲤鱼历险记;1;0;1;20497;4.878762745767673e-05
9360;0;1;0;1;20497;4.878762745767673e-05
9370;让我想起来去年在github上火的“狗屁不通文章生成器”;2;276;278;20497;0.013562960433234132
9373;直接三篇sci;7;230;237;20497;0.011562667707469386
9381;校花的贴身高手用的是这个嘛;15;172;187;20497;0.00912328633458555
9398;我用免费模式测试了一下他的写作功能，结果各种语序不通和用词不当，稀烂，于是我决定不付费，这么稀烂，付费后会后悔的;2;45;47;20497;0.0022930184905108064
9401;十篇sci冲;1;24;25;20497;0.0012196906864419183
9403;目前我看到的真的ai写作的就是国内一个大佬的开源项目，可以生成800字的类似议论文的文章，代码再谷歌云上有。国内的，大多都是爬虫，非ai;4;6;10;20497;0.00048787627457676734
9408;我弱弱的问一下这些东西那里找？有人懂得能回答一下吗？谢谢;3;9;12;20497;0.0005854515294921208
9412;问题是一月多钱呢;3;1;4;20497;0.00019515050983070692
9416;可以写论文吗？;1;5;6;20497;0.0002927257647460604
9419;是是不是可以用这个来写工作总结;1;2;3;20497;0.0001463628823730302
9454;凯旋木可水手冲了冲了;1;0;1;20497;4.878762745767673e-05
9456;可以写标书么;1;0;1;20497;4.878762745767673e-05
9468;收费吗？;1;0;1;20497;4.878762745767673e-05
9472;app13有没有绩效总结;1;1;2;20497;9.757525491535346e-05
9481;我想问下有没有年终总结对照检查;1;0;1;20497;4.878762745767673e-05
9484;渝川蓝葵富士nnn别揣兜了huh飞飞这么牛逼的必须都知道;3;0;3;20497;0.0001463628823730302
9489;对于毕业论文我有个想法;1;0;1;20497;4.878762745767673e-05
9491;木头山人真的有;1;0;1;20497;4.878762745767673e-05
9499;早就有了;1;0;1;20497;4.878762745767673e-05
9503;写标书;1;1;2;20497;9.757525491535346e-05
9510;。。;1;0;1;20497;4.878762745767673e-05
9514;可以写论文吗;2;0;2;20497;9.757525491535346e-05
9525;AnaisAnnie;1;0;1;20497;4.878762745767673e-05
9535;zl思想汇报;1;1;2;20497;9.757525491535346e-05
9538;女菩萨我有个大胆的想法;1;0;1;20497;4.878762745767673e-05
9540;柒柒wzq留起;1;1;2;20497;9.757525491535346e-05
9552;酒过三巡？？;1;0;1;20497;4.878762745767673e-05
9573;周周顾顾;1;0;1;20497;4.878762745767673e-05
9576;Dear;1;0;1;20497;4.878762745767673e-05
9581;小啾（湫禾）;1;0;1;20497;4.878762745767673e-05
9584;Roxanne;1;0;1;20497;4.878762745767673e-05
9595;小都和老吴;1;0;1;20497;4.878762745767673e-05
9599;七叔;2;0;2;20497;9.757525491535346e-05
9609;刘羽祁;2;0;2;20497;9.757525491535346e-05
9618;米啊啊;1;0;1;20497;4.878762745767673e-05
9624;聒噪。简报;2;0;2;20497;9.757525491535346e-05
9682;努力减肥的小猴;1;0;1;20497;4.878762745767673e-05
9701;目前AI还写不出好文章，读起来还有很多问题;7;11;18;20497;0.0008781772942381812
9709;1Jasper2Surfer3小莫4CopyAI5悉语;2;8;10;20497;0.00048787627457676734
9712;查重率100;2;7;9;20497;0.0004390886471190906
9715;试过，填内容还行，不能细看全是空话。;1;5;6;20497;0.0002927257647460604
9717;以后作家还有吗;9;4;13;20497;0.0006342391569497975
9727;卵用没有，收费的免费的国内外的我都基本试用差不多了。和自己想要的想法差距甚远。更多的是提供一点点灵感思路以及路线，最后还得自己写;2;2;4;20497;0.00019515050983070692
9732;这个编曲生产本身无版权哦，因为使用的是他人制作的音频内容素材生成新内容，首先要获得原始著作权授权另外需要有自己独创性;1;1;2;20497;9.757525491535346e-05
9753;刚刚试了金钱豹大战奥特曼;1;1;2;20497;9.757525491535346e-05
9755;《击剑分胜负》;1;1;2;20497;9.757525491535346e-05
9757;看着挺有意思是什么软件;1;0;1;20497;4.878762745767673e-05
9759;请求机器人写文案;1;0;1;20497;4.878762745767673e-05
9764;风浅桃花源的那个很有意思啊;1;2;3;20497;0.0001463628823730302
9766;第一;1;2;3;20497;0.0001463628823730302
9768;我之前不知道写什么，给它输了个颜文字，它回我一堆不一样的颜文字;1;1;2;20497;9.757525491535346e-05
9770;什么软件;1;1;2;20497;9.757525491535346e-05
9776;别分享了，要收费，哥们;3;4;7;20497;0.00034151339220373715
9780;能识别图片中的错别字吗;1;3;4;20497;0.00019515050983070692
9782;怎么要;1;0;1;20497;4.878762745767673e-05
9794;什么东西分享;1;0;1;20497;4.878762745767673e-05
9803;可是我周文王生成的论文查重率187基本没有重复的，但是就是内容有点没实质;5;62;67;20497;0.003268771039664341
9809;我用周文王写的论文（汉语言专业），没有的人物被写了进去？怎么回事;6;7;13;20497;0.0006342391569497975
9825;教怎麼作弊中國的希望就是這種人？;4;0;4;20497;0.00019515050983070692
9830;差点说成我们人类只是工具而已;1;3;4;20497;0.00019515050983070692
9832;在逃艺术家企鹅男孩qaqjdjjrrnbqjwjndjn烤蜜袋地芙蓉王姐帅哥入驻抖音了萨萨AAA东屯渡卤味;2;0;2;20497;9.757525491535346e-05
9841;这一套下来充会员得多少钱？;5;24;29;20497;0.0014148411962726253
9847;文心一言这就用上啦？我的还没排上呢，试用感受如何啊？差距大吗;2;5;7;20497;0.00034151339220373715
9851;你们都说没流量，万一火了几个，这成本多低呀;1;4;5;20497;0.00024393813728838367
9859;会员我都买不起;1;0;1;20497;4.878762745767673e-05
9884;以后拍电影是不是只要剧本就可以了？;2;0;2;20497;9.757525491535346e-05
9889;did哪里下;1;0;1;20497;4.878762745767673e-05
9891;互联网垃圾生成器;1;0;1;20497;4.878762745767673e-05
9893;最后生成视频太垃圾;1;0;1;20497;4.878762745767673e-05
9907;工具只是工具哦，使用之余不要忘记自己码字的快乐哦;17;637;654;20497;0.031907108357320586
9925;每天一个遣返冷知识;202;2634;2836;20497;0.13836171146997123
10128;建议升级一下变成能自动写reference;38;982;1020;20497;0.04976338000683027
10167;每天一个开学术听证会小知识;27;654;681;20497;0.033224374298677854
10195;如果是上国外大学，别以为老师看不出来哦有查重软件过20要出问题的;29;207;236;20497;0.01151388008001171
10225;每天一个退学小知识;10;319;329;20497;0.016051129433575645
10236;最近常看;16;220;236;20497;0.01151388008001171
10253;加油，我已经抓到不少用这种方法写文章的学生了你教授不说，真心是想给你机会;4;164;168;20497;0.00819632141288969
10258;躲得过turnitin;8;61;69;20497;0.0033663462945796945
10267;reference可怎么办啊;7;47;54;20497;0.0026345318827145437
10275;我搜你这个网站啥都没有;5;36;41;20497;0.002000292725764746
10281;有没有写日语的呀;6;17;23;20497;0.0011221154315265648
10288;狼人大学;4;25;29;20497;0.0014148411962726253
10293;看完马上申请哈佛牛津耶鲁了，soeasy;2;26;28;20497;0.0013660535688149486
10296;大家冷静思考一下，这个只能给小孩写写作文什么的，写论文的话这个不会引用文献，而且也不会理解学术上的专用术语，更不会论证你的研究成果。;3;18;21;20497;0.0010245401766112113
10300;手机端GPT做ppt嘎嘎好用;3;0;3;20497;0.0001463628823730302
10304;找别人写的;1;1;2;20497;9.757525491535346e-05
10307;蓝过来看;1;0;1;20497;4.878762745767673e-05
10328;日出看这个;1;2;3;20497;0.0001463628823730302
10333;苏柒儿好像是这个但查重会很高哦;1;1;2;20497;9.757525491535346e-05
10339;自己实在写不出来不会写最后没办法找了别人写一次过;4;4;8;20497;0.00039030101966141384
10345;我都不会写，都是找代写，写完的;4;2;6;20497;0.0002927257647460604
10352;寸头救你;3;0;3;20497;0.0001463628823730302
10356;我认识一个研究生学姐写的很靠谱，我们宿舍都是她给写的，全过;4;1;5;20497;0.00024393813728838367
10366;白熊就是这个;1;1;2;20497;9.757525491535346e-05
10369;限期心動这个就是早上我跟妳讲的;2;1;3;20497;0.0001463628823730302
10372;LH7看常用网站;2;3;5;20497;0.00024393813728838367
10377;网址是啥呀;1;1;2;20497;9.757525491535346e-05
10379;注册邮箱QQ邮箱好像用不了一直显示错误;5;1;6;20497;0.0002927257647460604
10385;要钱哦;1;2;3;20497;0.0001463628823730302
10388;霜霜猪;2;0;2;20497;9.757525491535346e-05
10391;凝白茶urwelcome;2;1;3;20497;0.0001463628823730302
10397;小陈同学;1;1;2;20497;9.757525491535346e-05
10399;（隔离版三个大头钉ltTinn好东西;1;1;2;20497;9.757525491535346e-05
10401;笑靠北，谷歌可以这样玩？;1;1;2;20497;9.757525491535346e-05
10403;Y为什么没早点知道;1;2;3;20497;0.0001463628823730302
10407;捡到一只Lee我靠;2;0;2;20497;9.757525491535346e-05
10410;ym学到了;1;1;2;20497;9.757525491535346e-05
10413;妈宝女我要了;1;0;1;20497;4.878762745767673e-05
10417;皖秋小陈我有救了;1;1;2;20497;9.757525491535346e-05
10419;冈崎真一以后不用发愁了;1;1;2;20497;9.757525491535346e-05
10421;水晶女孩本人哦哟;1;2;3;20497;0.0001463628823730302
10423;0;1;1;2;20497;9.757525491535346e-05
10425;木土土贤;1;0;1;20497;4.878762745767673e-05
10427;我操开学季CCCCH普信猫（隐身版）全球魔法联合会会长;3;1;4;20497;0.00019515050983070692
10431;茵桃子珣珣小陆同学有想法？;1;1;2;20497;9.757525491535346e-05
10434;bb看看;4;0;4;20497;0.00019515050983070692
10439;铨看到细节吗;2;0;2;20497;9.757525491535346e-05
10442;全集团QS看到细节了吗;1;1;2;20497;9.757525491535346e-05
10444;ZHOUYINbelikeyou困困的豆奶;1;1;2;20497;9.757525491535346e-05
10446;原耽动漫就是动力羨哎呀妈呀宝藏软件阿;2;1;3;20497;0.0001463628823730302
10449;yt草莓;3;2;5;20497;0.00024393813728838367
10454;Alani;2;0;2;20497;9.757525491535346e-05
10458;xinnnnYIPnewsreflection有救了;1;1;2;20497;9.757525491535346e-05
10463;啵的女人伴宇登顶kt;1;1;2;20497;9.757525491535346e-05
10466;头上长犄角irving;3;0;3;20497;0.0001463628823730302
10473;哦哦哦哦是黄桃精吖;1;1;2;20497;9.757525491535346e-05
10475;Hoppy聋了的自习;2;1;3;20497;0.0001463628823730302
10478;Summerbeingtall;2;2;4;20497;0.00019515050983070692
10481;DCoolAid大AEverly;3;0;3;20497;0.0001463628823730302
10487;igggggggy日;1;0;1;20497;4.878762745767673e-05
10489;Cx330。yo;4;1;5;20497;0.00024393813728838367
10494;我想吃西瓜独自莫凭栏大鹅你需要;1;1;2;20497;9.757525491535346e-05
10498;kjsjYAn鹅琳Jewel珠宝Toto7每天一个回国小技巧;1;2;3;20497;0.0001463628823730302
10502;我想要个名字来了;1;0;1;20497;4.878762745767673e-05
10505;wooo七为什么睡不着觉看到都头痛哦;2;0;2;20497;9.757525491535346e-05
10513;kepler已经开始教我怎么留学了;1;1;2;20497;9.757525491535346e-05
10516;陈阿姨;1;0;1;20497;4.878762745767673e-05
10522;喵喵卧槽;1;0;1;20497;4.878762745767673e-05
10525;batsoupnumber1鸿鸿不是怪蜀黍弯腰;2;1;3;20497;0.0001463628823730302
10529;火锅用这个写然后有道转成韩语;1;1;2;20497;9.757525491535346e-05
10531;PeregrinTook;5;1;6;20497;0.0002927257647460604
10541;MrLimturnitinkena100;4;0;4;20497;0.00019515050983070692
10548;秃头美女别的可以不看这个你一定要看;1;1;2;20497;9.757525491535346e-05
10552;小村香菇我觉得你可能需要这个;1;2;3;20497;0.0001463628823730302
10555;星轨学;3;0;3;20497;0.0001463628823730302
10559;奚落Y鸭鸭茶先码住;2;4;6;20497;0.0002927257647460604
10567;乌托邦现实主义者试试;1;1;2;20497;9.757525491535346e-05
10569;贤xian看;1;1;2;20497;9.757525491535346e-05
10571;还能抹个零妈妈再也不用担心我被罚啦CGNexonUnknown凱;2;4;6;20497;0.0002927257647460604
10576;到时候记得用啊，一定得用啊普信男（爱我没结果）奶思;3;0;3;20497;0.0001463628823730302
10580;禧get;1;1;2;20497;9.757525491535346e-05
10587;喝酒八斤七两活了;1;0;1;20497;4.878762745767673e-05
10589;南下叙与晴与旋旋天地小九樱夏沐给爷学;1;0;1;20497;4.878762745767673e-05
10591;封疆。woc还有这个东西;1;1;2;20497;9.757525491535346e-05
10593;煎饼卷饺子妮Will这真的不兴推荐啊;1;2;3;20497;0.0001463628823730302
10595;迢遥;1;0;1;20497;4.878762745767673e-05
10598;破防哥的冷酷零下八度自卑男之无敌旋风回旋踢鱿鱼四海我艹;1;1;2;20497;9.757525491535346e-05
10604;雪元快来看;2;1;3;20497;0.0001463628823730302
10607;月夜星河落;1;0;1;20497;4.878762745767673e-05
10611;好东西;1;0;1;20497;4.878762745767673e-05
10613;GuoZH写论文了;1;1;2;20497;9.757525491535346e-05
10615;芝士焗排骨这开始给我推的啥;1;0;1;20497;4.878762745767673e-05
10617;tzy等233万人;1;0;1;20497;4.878762745767673e-05
10619;焚风牛逼啊哈哈哈哈;1;0;1;20497;4.878762745767673e-05
10622;高冷的山芋;1;0;1;20497;4.878762745767673e-05
10624;三岁勤恳上分馒头超人夏凉收藏;1;0;1;20497;4.878762745767673e-05
10628;来杯奶茶加啵啵啊这，也太厉害了吧;1;0;1;20497;4.878762745767673e-05
10636;栩栩栩栩栩xxxx;4;0;4;20497;0.00019515050983070692
10642;美女的事情你少管研究研究？;1;1;2;20497;9.757525491535346e-05
10644;lmz哈哈哈哈哈哈哈哈哈哈学费了;1;1;2;20497;9.757525491535346e-05
10646;kk;1;0;1;20497;4.878762745767673e-05
10649;11;1;0;1;20497;4.878762745767673e-05
10653;半泽树;1;1;2;20497;9.757525491535346e-05
10656;赵烧鸡腿堡王茗析Miaa;2;1;3;20497;0.0001463628823730302
10659;瑶真mori;1;0;1;20497;4.878762745767673e-05
10661;小甜姜黑山小妖;1;1;2;20497;9.757525491535346e-05
10664;陸个东也;2;1;3;20497;0.0001463628823730302
10667;几分;1;1;2;20497;9.757525491535346e-05
10672;19L02Z;1;0;1;20497;4.878762745767673e-05
10676;Sy好牛的感觉;1;0;1;20497;4.878762745767673e-05
10679;要钱？？;1;0;1;20497;4.878762745767673e-05
10682;你们不说我也不说;14;208;222;20497;0.010830853295604235
10698;夜空中的;1;0;1;20497;4.878762745767673e-05
10708;qima有爱情;1;0;1;20497;4.878762745767673e-05
10725;不要香菜不要葱过路旅客;1;1;2;20497;9.757525491535346e-05
10731;嘎鸿;1;1;2;20497;9.757525491535346e-05
10733;诺诺王一;1;1;2;20497;9.757525491535346e-05
10742;咖啡香长安;2;1;3;20497;0.0001463628823730302
10747;妈妈不爱你;1;0;1;20497;4.878762745767673e-05
10749;NofriendYongjianjudehan杰正阳Kw;2;7;9;20497;0.0004390886471190906
10752;碰不到月亮最低价墨凉;2;0;2;20497;9.757525491535346e-05
10755;烧烧酒酒酒酒;1;1;2;20497;9.757525491535346e-05
10758;墨澄念凤梨解忧馆licnly;1;0;1;20497;4.878762745767673e-05
10760;ckkkkrystal;1;1;2;20497;9.757525491535346e-05
10762;水無月斋藤一XYZK;3;1;4;20497;0.00019515050983070692
10767;芋泥;1;0;1;20497;4.878762745767673e-05
10769;MerryStegosaurus;1;3;4;20497;0.00019515050983070692
10771;伊总说老约不行;1;0;1;20497;4.878762745767673e-05
10774;zy金俊勉爱我无法自拔;1;1;2;20497;9.757525491535346e-05
10777;二级废物;1;0;1;20497;4.878762745767673e-05
10779;x;1;1;2;20497;9.757525491535346e-05
10781;荥星翻茄炒但蕊宝;1;0;1;20497;4.878762745767673e-05
10790;你脸红什么啊;1;1;2;20497;9.757525491535346e-05
10793;一拾六whCCCKKKK秃头小弟弟镇糠;2;0;2;20497;9.757525491535346e-05
10796;善;1;0;1;20497;4.878762745767673e-05
10798;Kiso;2;0;2;20497;9.757525491535346e-05
10802;瑄心dav;2;2;4;20497;0.00019515050983070692
10807;松鼠真真;2;0;2;20497;9.757525491535346e-05
10810;董梦如;1;0;1;20497;4.878762745767673e-05
10812;白菜;1;1;2;20497;9.757525491535346e-05
10814;himafish;1;1;2;20497;9.757525491535346e-05
10818;人类终结者;1;0;1;20497;4.878762745767673e-05
10821;奶油且虾球66精肉;2;0;2;20497;9.757525491535346e-05
10824;是Eric呀你找不到我WW;1;1;2;20497;9.757525491535346e-05
10826;岑箐;1;0;1;20497;4.878762745767673e-05
10828;boom;2;1;3;20497;0.0001463628823730302
10831;LilBryantR0ss44;1;0;1;20497;4.878762745767673e-05
10836;Elijah（海外版）;1;1;2;20497;9.757525491535346e-05
10840;微糖和和oo黑色幽默的滚石人生;1;3;4;20497;0.00019515050983070692
10850;Yx1ao;2;0;2;20497;9.757525491535346e-05
10855;Rukia;1;0;1;20497;4.878762745767673e-05
10860;爱吃田螺汤;1;0;1;20497;4.878762745767673e-05
10864;来份爆米花;1;2;3;20497;0.0001463628823730302
10876;重案六虎曹达华宿醉小地瓜赴秋;2;1;3;20497;0.0001463628823730302
10884;Mia;1;0;1;20497;4.878762745767673e-05
10893;321;1;0;1;20497;4.878762745767673e-05
10897;迪不利啾啾迪不利哆;1;1;2;20497;9.757525491535346e-05
10900;LiTChi七荔;1;0;1;20497;4.878762745767673e-05
10902;家的狸猫SMKLG;1;0;1;20497;4.878762745767673e-05
10909;。。。;1;0;1;20497;4.878762745767673e-05
10912;Xiaoqian;1;0;1;20497;4.878762745767673e-05
10915;大锤;1;0;1;20497;4.878762745767673e-05
10917;花可爱;1;0;1;20497;4.878762745767673e-05
10920;Typhoon;1;0;1;20497;4.878762745767673e-05
10927;刘谋ABCD卖姑娘的小火柴虚晃他哥渣渣西;1;0;1;20497;4.878762745767673e-05
10931;肥嘟嘟左卫门RA;2;0;2;20497;9.757525491535346e-05
10938;meigui;1;0;1;20497;4.878762745767673e-05
10941;Lismine;1;0;1;20497;4.878762745767673e-05
10943;我腿有点短;1;0;1;20497;4.878762745767673e-05
10945;肉包;1;0;1;20497;4.878762745767673e-05
10947;0;1;0;1;20497;4.878762745767673e-05
10964;初霁枳木了不起的沙丁鱼;1;1;2;20497;9.757525491535346e-05
10966;水母人;2;0;2;20497;9.757525491535346e-05
10972;全世界失眠;3;0;3;20497;0.0001463628823730302
10977;澍;1;0;1;20497;4.878762745767673e-05
10979;此糸;2;0;2;20497;9.757525491535346e-05
10983;33（甜妹版）每天一个遣返小技巧;2;1;3;20497;0.0001463628823730302
10986;Carol你怎么酱;2;1;3;20497;0.0001463628823730302
10989;莹08年要当国王;2;0;2;20497;9.757525491535346e-05
11002;荷塘月色会用到的谢谢我吧;1;0;1;20497;4.878762745767673e-05
11004;落问秋passer这个看起来好有用;1;0;1;20497;4.878762745767673e-05
11006;少女林恒hayden浅学一下吧;1;0;1;20497;4.878762745767673e-05
11008;影;1;0;1;20497;4.878762745767673e-05
11010;要钱;1;0;1;20497;4.878762745767673e-05
11012;Elixnagnip;1;0;1;20497;4.878762745767673e-05
11014;网址蹲一个;1;0;1;20497;4.878762745767673e-05
11016;god丶wt1（owo）wQAQw;1;0;1;20497;4.878762745767673e-05
11018;我不是笨蛋;1;0;1;20497;4.878762745767673e-05
11062;姓孟的Zeno码了;1;0;1;20497;4.878762745767673e-05
11065;卡不keeno;1;0;1;20497;4.878762745767673e-05
11071;丑蛋子POEMProteinZmmHEREAIiwrite;3;0;3;20497;0.0001463628823730302
11075;什么时候国内出个AI自动写小说的;1;0;1;20497;4.878762745767673e-05
11078;爱学习的贺同学;1;0;1;20497;4.878762745767673e-05
11082;会被查重吗;2;0;2;20497;9.757525491535346e-05
11089;我就是我;1;0;1;20497;4.878762745767673e-05
11092;ihZnaiJ;2;0;2;20497;9.757525491535346e-05
11097;驧;1;0;1;20497;4.878762745767673e-05
11100;赵铁柱我尼玛，快给咱记着;1;0;1;20497;4.878762745767673e-05
11102;来一碗甜不辣;1;0;1;20497;4.878762745767673e-05
11107;bb;1;0;1;20497;4.878762745767673e-05
11109;Ei霖霖霖KittyHUI好东西;2;0;2;20497;9.757525491535346e-05
11113;肖阿肖紫菜蛋花汤皮皮豹雪碧儿房东的西柚大洋芋滴滴滴;1;0;1;20497;4.878762745767673e-05
11116;aanuoo我去为啥让我毕业时刷到;1;0;1;20497;4.878762745767673e-05
11118;Mcdull;2;0;2;20497;9.757525491535346e-05
11124;半糖去冰加啵啵奶盖;1;0;1;20497;4.878762745767673e-05
11127;皮蛋瘦肉粥;1;0;1;20497;4.878762745767673e-05
11131;起风了呼呼呼;2;0;2;20497;9.757525491535346e-05
11143;小奶泡;1;0;1;20497;4.878762745767673e-05
11153;天才梨小豪;1;0;1;20497;4.878762745767673e-05
11156;李同学YAMatcha地铁上的陌生人;2;0;2;20497;9.757525491535346e-05
11159;每天一个回国小技巧玛卡巴卡;1;0;1;20497;4.878762745767673e-05
11162;陸个东也;1;0;1;20497;4.878762745767673e-05
11165;这个网站的名字是什么呀？;1;0;1;20497;4.878762745767673e-05
11170;钮祜禄土豆？？？;1;0;1;20497;4.878762745767673e-05
11177;途中记得写论文;1;0;1;20497;4.878762745767673e-05
11181;老友提前预备上;1;0;1;20497;4.878762745767673e-05
11183;用这个查重直接挂科了;1;0;1;20497;4.878762745767673e-05
11185;啵啵果靠;1;1;2;20497;9.757525491535346e-05
11187;草莓宝;1;0;1;20497;4.878762745767673e-05
11192;CJJ冲冲冲;1;0;1;20497;4.878762745767673e-05
11195;咸六;1;0;1;20497;4.878762745767673e-05
11197;plagiarism不会高吗;1;0;1;20497;4.878762745767673e-05
11206;抱着小鞠睡午觉;1;0;1;20497;4.878762745767673e-05
11209;茶月;1;0;1;20497;4.878762745767673e-05
11212;encora;1;0;1;20497;4.878762745767673e-05
11219;小团;1;0;1;20497;4.878762745767673e-05
11222;PAPAJ和我那个差不多;1;0;1;20497;4.878762745767673e-05
11224;别在这害人了;1;0;1;20497;4.878762745767673e-05
11228;2w字行不;1;0;1;20497;4.878762745767673e-05
11234;雨田喜欢喝牛奶;1;0;1;20497;4.878762745767673e-05
11245;wwww;2;0;2;20497;9.757525491535346e-05
11251;这能搞日文的不;1;0;1;20497;4.878762745767673e-05
11259;冰抹茶瞌颂;1;1;2;20497;9.757525491535346e-05
11262;栗子;1;0;1;20497;4.878762745767673e-05
11264;Aeo;1;0;1;20497;4.878762745767673e-05
11267;Krikplayboiballin;2;0;2;20497;9.757525491535346e-05
11272;晚安曜;1;0;1;20497;4.878762745767673e-05
11280;米老鼠Saida收藏先;1;0;1;20497;4.878762745767673e-05
11283;阿斯巴甜你的英语论文;1;0;1;20497;4.878762745767673e-05
11286;查重GG了，100;1;0;1;20497;4.878762745767673e-05
11289;兔子喝雪碧;3;0;3;20497;0.0001463628823730302
11293;Ryan学好芝士。Rose好一个郭佳诚YYZ好事莲莲;3;0;3;20497;0.0001463628823730302
11298;一点也不甜;1;0;1;20497;4.878762745767673e-05
11302;余生晓梦高级裁缝不会直接复制粘贴;2;0;2;20497;9.757525491535346e-05
11305;Asite;1;0;1;20497;4.878762745767673e-05
11309;优雅的茄子;1;0;1;20497;4.878762745767673e-05
11316;Macromolecule我写;1;1;2;20497;9.757525491535346e-05
11320;sba;3;0;3;20497;0.0001463628823730302
11324;izy;2;0;2;20497;9.757525491535346e-05
11327;HzIII;2;0;2;20497;9.757525491535346e-05
11330;曰iceCoco;1;0;1;20497;4.878762745767673e-05
11335;Rea换一下高级词汇;1;0;1;20497;4.878762745767673e-05
11341;想问下这论文是ai原创还是爬呢;1;0;1;20497;4.878762745767673e-05
11347;码了997Shxx4uyyyyylFREYAT;1;0;1;20497;4.878762745767673e-05
11349;hmlxp;2;0;2;20497;9.757525491535346e-05
11352;Hexy;1;0;1;20497;4.878762745767673e-05
11356;七七粑粑57赵赵;1;1;2;20497;9.757525491535346e-05
11360;桔子特务;1;0;1;20497;4.878762745767673e-05
11362;Browniebabe;1;0;1;20497;4.878762745767673e-05
11365;我不是臭弟弟;1;0;1;20497;4.878762745767673e-05
11367;王琛你在翻译一下;1;0;1;20497;4.878762745767673e-05
11370;xxu;1;0;1;20497;4.878762745767673e-05
11378;喃寻啥糖果草莓可以天天吃好吃的吗姜淼张富贵Z为什么我们不能早点发现;1;0;1;20497;4.878762745767673e-05
11382;林咕咕;1;0;1;20497;4.878762745767673e-05
11386;半岛没有铁盒耳东Iris可马;2;0;2;20497;9.757525491535346e-05
11391;鱼苏亿;1;0;1;20497;4.878762745767673e-05
11393;江amazing啊;1;0;1;20497;4.878762745767673e-05
11403;iii;1;0;1;20497;4.878762745767673e-05
11406;咕叽咕叽咩咩羊;1;0;1;20497;4.878762745767673e-05
11408;kookR;3;0;3;20497;0.0001463628823730302
11413;银河我草;1;0;1;20497;4.878762745767673e-05
11418;老物修复;1;0;1;20497;4.878762745767673e-05
11421;国泰旻安纸上得来终觉浅我擦;2;0;2;20497;9.757525491535346e-05
11425;Sweyyyyyyyyyyyy;3;0;3;20497;0.0001463628823730302
11429;快乐的卤蛋黄丘比特吃辣条鸠瘾翻译一下啥都有了;1;1;2;20497;9.757525491535346e-05
11434;C;1;1;2;20497;9.757525491535346e-05
11440;饿;1;0;1;20497;4.878762745767673e-05
11442;28岁离异带叁拾肆娃衔之;1;0;1;20497;4.878762745767673e-05
11447;我196;1;0;1;20497;4.878762745767673e-05
11450;queeniek有点爱;1;0;1;20497;4.878762745767673e-05
11455;也不知道你能不能用上;1;0;1;20497;4.878762745767673e-05
11459;离谱的牛马;2;0;2;20497;9.757525491535346e-05
11463;Danielllll;1;0;1;20497;4.878762745767673e-05
11466;孤芳;1;0;1;20497;4.878762745767673e-05
11469;雪饼;1;0;1;20497;4.878762745767673e-05
11477;没好话说;1;0;1;20497;4.878762745767673e-05
11479;什孑;2;0;2;20497;9.757525491535346e-05
11484;0;3;0;3;20497;0.0001463628823730302
11488;宇宙ujing;1;0;1;20497;4.878762745767673e-05
11500;是九七呀？;1;0;1;20497;4.878762745767673e-05
11509;Ginkgo;1;0;1;20497;4.878762745767673e-05
11518;点缶颔取大札包好东西，你可以试试，已经用不上了;2;0;2;20497;9.757525491535346e-05
11524;RivermonclerCl7;3;0;3;20497;0.0001463628823730302
11528;我想喝个粥;3;0;3;20497;0.0001463628823730302
11532;0;1;0;1;20497;4.878762745767673e-05
11536;Coisini天鹅子;1;0;1;20497;4.878762745767673e-05
11538;余忆之;1;0;1;20497;4.878762745767673e-05
11543;yuch章鱼暴躁荔枝;1;0;1;20497;4.878762745767673e-05
11547;玖;3;0;3;20497;0.0001463628823730302
11553;Annabelle试试？逝世;3;0;3;20497;0.0001463628823730302
11557;LHPZzzzzzzBat;1;0;1;20497;4.878762745767673e-05
11562;是Lily吖CharmaineDYNH每天一个退学小技巧;1;0;1;20497;4.878762745767673e-05
11565;慟心;3;0;3;20497;0.0001463628823730302
11577;0;2;0;2;20497;9.757525491535346e-05
11580;Catherinewaiseng;1;0;1;20497;4.878762745767673e-05
11583;0;1;0;1;20497;4.878762745767673e-05
11585;omg呖咕呖咕;1;0;1;20497;4.878762745767673e-05
11591;查重吗？;1;0;1;20497;4.878762745767673e-05
11594;Yukiaaa君无言用完翻译成中文就得了，自己检查;3;0;3;20497;0.0001463628823730302
11600;叫我拉里其名为惠惠;2;0;2;20497;9.757525491535346e-05
11606;SkUxTragicZ;1;0;1;20497;4.878762745767673e-05
11612;QRain每天一个遣返小技巧;1;0;1;20497;4.878762745767673e-05
11615;Theodore;1;0;1;20497;4.878762745767673e-05
11619;CNSA霖看完了赶紧给我删掉;2;0;2;20497;9.757525491535346e-05
11622;Nightmare;1;0;1;20497;4.878762745767673e-05
11626;Ying阿诺绝了哈哈哈哈哈哈;1;0;1;20497;4.878762745767673e-05
11628;经济特区精灵少吕;1;0;1;20497;4.878762745767673e-05
11631;梨子Li;1;0;1;20497;4.878762745767673e-05
11636;贰拾壹画生PeterLeeA悠哉的彼得PAUL都别说;1;0;1;20497;4.878762745767673e-05
11640;Morty;1;0;1;20497;4.878762745767673e-05
11646;Lav伴这东西好明年就用这个了;1;0;1;20497;4.878762745767673e-05
11648;抖抖抖音音音;1;0;1;20497;4.878762745767673e-05
11651;小锤ryu小李瘦了没;1;0;1;20497;4.878762745767673e-05
11653;蒲月;1;0;1;20497;4.878762745767673e-05
11658;海绵宝宝的T恤衫;1;0;1;20497;4.878762745767673e-05
11661;邱ss;1;0;1;20497;4.878762745767673e-05
11665;Eternity;2;0;2;20497;9.757525491535346e-05
11672;丹三不加糖;1;0;1;20497;4.878762745767673e-05
11674;g的宝贝是小邓丶意义先收藏;2;0;2;20497;9.757525491535346e-05
11677;小金好屌;1;0;1;20497;4.878762745767673e-05
11689;YukiCheung;1;0;1;20497;4.878762745767673e-05
11693;小野是美女（考驾照版）;1;0;1;20497;4.878762745767673e-05
11696;整个银河系都藏在你眼眸;2;0;2;20497;9.757525491535346e-05
11700;edwarrrd;1;0;1;20497;4.878762745767673e-05
11702;清木;1;0;1;20497;4.878762745767673e-05
11706;嗯哼哼;1;0;1;20497;4.878762745767673e-05
11710;0;1;0;1;20497;4.878762745767673e-05
11717;磨磨唧唧o云丹儿;2;1;3;20497;0.0001463628823730302
11720;Husky;1;0;1;20497;4.878762745767673e-05
11725;来看尝一口咩;1;0;1;20497;4.878762745767673e-05
11727;Antarctica我了个大草;1;0;1;20497;4.878762745767673e-05
11729;（）;1;0;1;20497;4.878762745767673e-05
11737;fishyfishyfishchloeKyi笑死我了注意到了吗;1;0;1;20497;4.878762745767673e-05
11741;Clearlove7DirkKaYV;1;0;1;20497;4.878762745767673e-05
11744;Xxxxyy;1;0;1;20497;4.878762745767673e-05
11748;三爪denden一颗莫蛋蛋蛋纳宇宙究极无敌纯欲少女不可一世诺诺真不戳;3;0;3;20497;0.0001463628823730302
11752;孙宇直;1;0;1;20497;4.878762745767673e-05
11760;小朱头不秃;2;0;2;20497;9.757525491535346e-05
11763;即虾仁又猪心;1;0;1;20497;4.878762745767673e-05
11766;比比泥我去;1;0;1;20497;4.878762745767673e-05
11781;小猪佩猪kkkkaarinNaHCO3;2;0;2;20497;9.757525491535346e-05
11784;桥豆麻袋i你同学的小妙招;1;0;1;20497;4.878762745767673e-05
11786;妞妞niiuu;2;0;2;20497;9.757525491535346e-05
11789;SoulBlanket;1;0;1;20497;4.878762745767673e-05
11791;蓝莓酱熊cxdzhxinnn懒羊羊;1;1;2;20497;9.757525491535346e-05
11795;MoY;1;0;1;20497;4.878762745767673e-05
11799;这查重会不会很高朱朱不是珠珠呀;1;0;1;20497;4.878762745767673e-05
11804;佳得乐泡枸杞咱俩以后能用的到;1;0;1;20497;4.878762745767673e-05
11806;v;1;0;1;20497;4.878762745767673e-05
11811;棿槢Kepler咔家人们从此不写论文了;1;0;1;20497;4.878762745767673e-05
11813;水Rayna万一用得到;1;0;1;20497;4.878762745767673e-05
11815;滚开啊你;1;0;1;20497;4.878762745767673e-05
11818;奈奈路瑶;1;0;1;20497;4.878762745767673e-05
11820;Brnadett;1;0;1;20497;4.878762745767673e-05
11823;0;2;0;2;20497;9.757525491535346e-05
11828;清秋;1;0;1;20497;4.878762745767673e-05
11830;你不能吃蛋挞白白不白惹卧槽;1;0;1;20497;4.878762745767673e-05
11832;、;1;0;1;20497;4.878762745767673e-05
11835;兰兰睡觉;1;0;1;20497;4.878762745767673e-05
11837;涵真的不会被说plagiarize吗;1;0;1;20497;4.878762745767673e-05
11842;miiiiiyaaaaa;1;0;1;20497;4.878762745767673e-05
11845;Mike;2;0;2;20497;9.757525491535346e-05
11850;小宋饿扁啦我不理解但我大为震惊;1;0;1;20497;4.878762745767673e-05
11852;KXXJ;1;0;1;20497;4.878762745767673e-05
11862;Salin;1;0;1;20497;4.878762745767673e-05
11865;我心里苦呀MLP椿皖快看;1;0;1;20497;4.878762745767673e-05
11867;卡肉一张大饼;1;0;1;20497;4.878762745767673e-05
11870;Yyyyyy;2;0;2;20497;9.757525491535346e-05
11874;848;1;0;1;20497;4.878762745767673e-05
11876;山河无定;1;0;1;20497;4.878762745767673e-05
11879;欧巴w点眠audreyh涵悲伤被我刷到了一定是有原因的;2;0;2;20497;9.757525491535346e-05
11882;宝藏博主;1;0;1;20497;4.878762745767673e-05
11892;域域宝贝圆圆想要马甲线小熊崽崽;2;0;2;20497;9.757525491535346e-05
11895;这网站叫什么鹅鹅鹅鹅;1;0;1;20497;4.878762745767673e-05
11900;woc华威姐妹;2;0;2;20497;9.757525491535346e-05
11904;不馥制了针织帽;2;0;2;20497;9.757525491535346e-05
11910;龙的传人;1;0;1;20497;4.878762745767673e-05
11917;这里是小徐yo我觉得有用;1;1;2;20497;9.757525491535346e-05
11919;ljrovo图图拉母呼呼LOVE;4;0;4;20497;0.00019515050983070692
11927;是不是精算专业;2;0;2;20497;9.757525491535346e-05
11930;cChen陈陈;1;0;1;20497;4.878762745767673e-05
11937;空条徐伦;1;0;1;20497;4.878762745767673e-05
11940;小毛这个会被查出来吗;6;0;6;20497;0.0002927257647460604
11948;网站是什么啊？;2;0;2;20497;9.757525491535346e-05
11955;韩小牛逼不牛逼刘小草KarlieLll楠Aletta;1;0;1;20497;4.878762745767673e-05
11959;Kaiwen卧槽？;2;0;2;20497;9.757525491535346e-05
11962;微澜Luv7芥川龙之介圈外女友cindz它比我写的都好;5;0;5;20497;0.00024393813728838367
11968;俄语可以用吗？;4;0;4;20497;0.00019515050983070692
11973;现在有好多人都在说Ai不行，ai不行，不知道是没有掌握正确的用法，还是在恐惧。;1;12;13;20497;0.0006342391569497975
11975;这跟余华的作品差远了吧;2;4;6;20497;0.0002927257647460604
11979;这个是付费版本的吧;5;0;5;20497;0.00024393813728838367
11985;很多谈ChatGPT的人，他根本没有用过ChatGPT，不要叫醒他们，让他们沉浸在自己自信中;1;2;3;20497;0.0001463628823730302
11987;搞下理科还可以，搞文艺怕恼火;1;0;1;20497;4.878762745767673e-05
11989;目前AI的聪明程度取决于使用的人;1;1;2;20497;9.757525491535346e-05
11992;大神，有安卓版本不;1;0;1;20497;4.878762745767673e-05
11994;有没有教程;1;0;1;20497;4.878762745767673e-05
11996;你这个页面输出字数会更多吗？;1;0;1;20497;4.878762745767673e-05
12018;完全没意义，你今天知道调这些参数，都不用等到下个更新版本也许明天就不好使了;2;0;2;20497;9.757525491535346e-05
12022;你根本没理解余华说的是什么。;1;0;1;20497;4.878762745767673e-05
12034;我点合成显示没时长，是什么意思;3;0;3;20497;0.0001463628823730302
12038;没时长在那搞;1;0;1;20497;4.878762745767673e-05
12056;叫什么;7;13;20;20497;0.0009757525491535347
12066;0;1;0;1;20497;4.878762745767673e-05
12068;0;1;0;1;20497;4.878762745767673e-05
12071;小祥爱吃肉快点快点看看;2;2;4;20497;0.00019515050983070692
12077;支持;1;2;3;20497;0.0001463628823730302
12079;何MC晗哥mc;1;0;1;20497;4.878762745767673e-05
12085;抗起小妍就跑;2;0;2;20497;9.757525491535346e-05
12088;没压力孙胖宇;1;1;2;20497;9.757525491535346e-05
12090;三分;2;1;3;20497;0.0001463628823730302
12097;你好淇怪晨三斤PhonkLV半岛铁头车厘子自由半颗菠萝;3;4;7;20497;0.00034151339220373715
12122;summary时候编不出来了，用ai写了150字左右，交作业时候查重百分之八;5;85;90;20497;0.004390886471190906
12128;马上要出国了小姐姐干货很多关注了;2;43;45;20497;0.002195443235595453
12131;还好之前靠代写毕业了，不然被抓到了可想而知;10;8;18;20497;0.0008781772942381812
12142;毕竟你这个视频也是“借鉴”的;2;17;19;20497;0.0009269649216958579
12145;我看了那个新闻提供代写是犯罪学生不会涉及犯罪但是会开除;1;18;19;20497;0.0009269649216958579
12147;期待小姐姐分享更多神器;1;15;16;20497;0.0007806020393228277
12149;博主这个软件到底叫啥名字啊？能不能明确一下？;3;0;3;20497;0.0001463628823730302
12154;我门宿舍六个人找人团购的，都过了;2;0;2;20497;9.757525491535346e-05
12158;上次帮别人写写到后半夜四份最后有一个人优秀了还给我发红包;1;0;1;20497;4.878762745767673e-05
12161;还好我找的别人帮忙的一次就过了;1;0;1;20497;4.878762745767673e-05
12172;aa那没事了我还以为现在有那么nb的东西呢;1;0;1;20497;4.878762745767673e-05
12179;皮卡皮卡秋卧槽她这个专业是我之前想申请的那个;2;0;2;20497;9.757525491535346e-05
12188;买一宋一;1;0;1;20497;4.878762745767673e-05
12191;拿来参考参考还行，靠这写论文肯定毁人生;1;3;4;20497;0.00019515050983070692
12193;网站叫什么呀;3;0;3;20497;0.0001463628823730302
12197;你为什么没有英国口音;2;0;2;20497;9.757525491535346e-05
12202;华威学妹;1;0;1;20497;4.878762745767673e-05
12204;还好我找的靠谱，一次就过了;1;0;1;20497;4.878762745767673e-05
12207;小姐姐我录到华威了，2A1A算是我的冲刺了，希望今天9月份能在华威见到你耶;1;0;1;20497;4.878762745767673e-05
12209;那个时候找的代写，一次就通过了;1;0;1;20497;4.878762745767673e-05
12211;为什么搜不到这个网站啊;1;0;1;20497;4.878762745767673e-05
12213;找的代写速度惊人;1;0;1;20497;4.878762745767673e-05
12247;没有人好奇这个是什么网站吗;1;1;2;20497;9.757525491535346e-05
12255;有需要lianjie的朋友可以私信联系;4;0;4;20497;0.00019515050983070692
12260;里面的那些描写可以直接用吗我怕搞成抄袭了;1;6;7;20497;0.00034151339220373715
12262;求网址;1;2;3;20497;0.0001463628823730302
12264;求网址;1;0;1;20497;4.878762745767673e-05
12286;求网址。;1;1;2;20497;9.757525491535346e-05
12292;厉害一般写手可以回家里了;10;2;12;20497;0.0005854515294921208
12303;别做梦了，人工智能能写书？它只会中译中，小说最重要的就是创新;3;9;12;20497;0.0005854515294921208
12308;可惜，一长，前后就没逻辑性，距离威胁还差得远，但小说圈马上要卷起来是真的，;3;7;10;20497;0.00048787627457676734
12312;不可能，写长了就回忆不起上文;1;3;4;20497;0.00019515050983070692
12315;我试过，很垃圾;3;0;3;20497;0.0001463628823730302
12319;为什么我的答案每次生成到一半儿都会显示出现错误，要不就显示网络错误;1;2;3;20497;0.0001463628823730302
12321;能不能写个小黄书;2;1;3;20497;0.0001463628823730302
12324;那些口水网文我怀疑都是用这个写的;1;1;2;20497;9.757525491535346e-05
12326;一看就是啥也不懂;1;1;2;20497;9.757525491535346e-05
12333;好的，立即发起点;3;1;4;20497;0.00019515050983070692
12341;怎么弄chatGPT;1;2;3;20497;0.0001463628823730302
12343;有卖号的吗;1;1;2;20497;9.757525491535346e-05
12348;现在AI估计还不太成熟，再过几年说不定写的就比一些人写的要好了;23;131;154;20497;0.007513294628482217
12372;我试着让它写一篇爱情小说，它给我写了一篇流水账。;8;87;95;20497;0.00463482460847929
12382;你应该试试ChatGPT而不是国内这种伪AI真的Chat真的很牛逼太牛逼了;4;11;15;20497;0.000731814411865151
12387;用不了，写两句还行写多了，都看不懂是什么玩意，压根就是错乱的;1;28;29;20497;0.0014148411962726253
12389;我自己写的，河獾老祖历险记，惨不忍睹，连个评分都没有。各位进去唾口唾沫再走吧，让我有个评分好走得体面些。;2;1;3;20497;0.0001463628823730302
12392;人工智能的上线是有设定的，但是人的大脑却是可以创新，无限制的脑洞概括;1;28;29;20497;0.0014148411962726253
12394;现在还不能代替，以后就不好说了，不知道我能不能看见那天;3;4;7;20497;0.00034151339220373715
12398;慌啥，ai真的有情感的话，慌得永远不是作者，很多行业抵制ai碎尸的;1;9;10;20497;0.00048787627457676734
12403;对小白太有用了，gtp拉低了写小说的门槛。;3;0;3;20497;0.0001463628823730302
12407;用ai写别问的太广，拆分到每一章的问，比如帮着写一段男主pk反派，男主掉入阵法等等，非常好用，用了后我日万变成日2万了。;2;4;6;20497;0.0002927257647460604
12410;以后呢，ai会不断学习;3;0;3;20497;0.0001463628823730302
12427;什么软件，怎么搜不到;1;0;1;20497;4.878762745767673e-05
12456;灵魂是对生灵而言，它，还是它，还是不行哦;2;0;2;20497;9.757525491535346e-05
12474;不行，会查重;1;0;1;20497;4.878762745767673e-05
12496;写大纲感觉咋样;3;0;3;20497;0.0001463628823730302
12505;呵呵呵，绘画AI刚出的时候谁也看不起，现在呢，啊，一代代创新。还有象棋机器人也越来越强。;5;12;17;20497;0.0008293896667805044
12511;青禾大，这个图标不像GPT4的图标啊，找一个会魔法的帮你去GPT4，写出来的东西真的一点不水。设定好人物性格，职业等关键词，不空。不行试试notionai和文心一言，要求详细点，生成还是可以的。;4;1;5;20497;0.00024393813728838367
12516;其实作者用不用ai水全勤小说，你可以试一下用魔法打败魔法，把他水的小说完全复制给chatgpt问是不是你写的，他会承认，而且挺精确的，你可以用这个来排查那个作家在水;1;1;2;20497;9.757525491535346e-05
12549;我知道，我就是不说;1;0;1;20497;4.878762745767673e-05
12551;网址呢？;1;0;1;20497;4.878762745767673e-05
12589;再牛的AI还是死的，一些特殊的需求还是要人来完成;55;333;388;20497;0.018929599453578572
12645;国内版GPT4免费版来了;60;148;208;20497;0.01014782651119676
12706;要把AI当做一个辅助的工具，无论他给出怎样的答案最终还是需要人工审核修饰。AI不会完全取代人工，它会减少重复性的机械工作，最终的成品还是要靠人工决定。;1;0;1;20497;4.878762745767673e-05
12708;哪一个是免费的;14;87;101;20497;0.00492755037322535
12723;我有美刀，魔法也可分享;18;1;19;20497;0.0009269649216958579
12742;有没有一起合租会员的;1;0;1;20497;4.878762745767673e-05
12744;写文不会重复么;14;6;20;20497;0.0009757525491535347
12759;再智能的AI也满足不了老板奇奇怪怪的需求;1;29;30;20497;0.001463628823730302
12761;又到了最爱看的工人砸纺织机环节;4;17;21;20497;0.0010245401766112113
12766;这个吗;21;11;32;20497;0.0015612040786456554
12788;纠正：notionai用户每月都可免费使用20次;4;8;12;20497;0.0005854515294921208
12793;为啥国外的GPT注册好了用了一天后面就没有访问权限了;9;1;10;20497;0.00048787627457676734
12803;哈哈哈哈哈AI干完就没我们什么事了;1;22;23;20497;0.0011221154315265648
12805;国内不是不让用吗;4;2;6;20497;0.0002927257647460604
12810;他能代替我拍领导马屁，还是能替我去送礼;3;8;11;20497;0.000536663902034444
12814;有没有帮画cad的;7;2;9;20497;0.0004390886471190906
12835;懒羊羊刘秘书;1;0;1;20497;4.878762745767673e-05
12837;坚果感觉你会用得到;1;0;1;20497;4.878762745767673e-05
12842;小陈吃吃喝喝了解一下;1;1;2;20497;9.757525491535346e-05
12844;大学生表示自从有了这些，智商又得下降了;1;1;2;20497;9.757525491535346e-05
12851;源源黄金泼钛骰多学学人工智能，很省事;1;0;1;20497;4.878762745767673e-05
12859;刚加入拥有电脑的行列，不懂就问，电脑可以做些什么;3;2;5;20497;0.00024393813728838367
12864;在哪里可以下载;1;0;1;20497;4.878762745767673e-05
12871;看了评论区gpt还有app的吗;1;0;1;20497;4.878762745767673e-05
12874;我用ai写的文案感觉毫无营养，不知道怎么调教;1;0;1;20497;4.878762745767673e-05
12883;审计有什么ai可以用吗;2;1;3;20497;0.0001463628823730302
12887;0;6;0;6;20497;0.0002927257647460604
12894;我教他一晚上我们的内容想让它写文章，最后我放弃了;1;1;2;20497;9.757525491535346e-05
12896;所以老板还要你干嘛;2;1;3;20497;0.0001463628823730302
12905;能做详情页吗;4;1;5;20497;0.00024393813728838367
12910;小田同学赶快用上;8;0;8;20497;0.00039030101966141384
12920;我有魔法谁需要;4;0;4;20497;0.00019515050983070692
12928;是这个吗？;2;3;5;20497;0.00024393813728838367
12932;yang安昂呦西;1;0;1;20497;4.878762745767673e-05
12935;我寻思着不是Bing现在已经可以用ChatGPT了吗，每天30条都是免费的，你都未必能问得了那么多;2;0;2;20497;9.757525491535346e-05
12938;姜太看来明天不用自己写了;1;0;1;20497;4.878762745767673e-05
12941;有啥用;4;0;4;20497;0.00019515050983070692
12951;嚣张的火锅（爬楼梯版）;1;1;2;20497;9.757525491535346e-05
12954;树丁;1;0;1;20497;4.878762745767673e-05
12958;需要出一款Ai机修机器人;4;0;4;20497;0.00019515050983070692
12967;BIM三D建模可以搞吗;1;1;2;20497;9.757525491535346e-05
12972;我看谁还没有用上;7;0;7;20497;0.00034151339220373715
12980;是小旺旺鸭嘿嘿;1;0;1;20497;4.878762745767673e-05
12983;就我感觉很一般吗？有时候码字还出现问题，回答问题深度一般，感觉像百度综合起来的;5;2;7;20497;0.00034151339220373715
12989;怎么弄;3;1;4;20497;0.00019515050983070692
12994;midjourney这个绘画是免费的吗;3;0;3;20497;0.0001463628823730302
12998;怎么申请;1;1;2;20497;9.757525491535346e-05
13002;这是一个开始希望不会是结局多娜妍;2;2;4;20497;0.00019515050983070692
13005;如何下载;5;1;6;20497;0.0002927257647460604
13012;求教我没有谷歌账号;1;0;1;20497;4.878762745767673e-05
13014;如果真的有机构或公司一直研究ai说不定以后人类只要输入指令就能完成技术人员工作大量一本大学生失业;1;2;3;20497;0.0001463628823730302
13019;？;6;4;10;20497;0.00048787627457676734
13026;chatGPT账号可以用一下吗，我想体验一下;3;1;4;20497;0.00019515050983070692
13030;Yi只;3;0;3;20497;0.0001463628823730302
13035;小黑子;1;1;2;20497;9.757525491535346e-05
13046;咕咕oao;1;0;1;20497;4.878762745767673e-05
13052;刘soso不想soso;1;0;1;20497;4.878762745767673e-05
13059;宇宙超级无敌牛掰哄哄暴龙神Plus;1;0;1;20497;4.878762745767673e-05
13064;憂鬱星球w摆烂版;1;0;1;20497;4.878762745767673e-05
13069;抹香鲸;2;0;2;20497;9.757525491535346e-05
13072;Lsreall;1;0;1;20497;4.878762745767673e-05
13076;晚睡就秃头;1;0;1;20497;4.878762745767673e-05
13080;烧仙草小哥哥;1;0;1;20497;4.878762745767673e-05
13083;名字长点会被注意到么;1;0;1;20497;4.878762745767673e-05
13085;尘岁DJ歌单;2;0;2;20497;9.757525491535346e-05
13092;Lime;1;0;1;20497;4.878762745767673e-05
13094;刘副官;2;0;2;20497;9.757525491535346e-05
13102;罐装冰块HighgirlRivsky遇橙呗甜甜圈;1;0;1;20497;4.878762745767673e-05
13105;h;5;1;6;20497;0.0002927257647460604
13115;白非尘;1;0;1;20497;4.878762745767673e-05
13129;小英up;1;1;2;20497;9.757525491535346e-05
13132;小叮当蓝胖子;1;0;1;20497;4.878762745767673e-05
13136;0;1;1;2;20497;9.757525491535346e-05
13138;OVO带刺的玫瑰辜，;2;0;2;20497;9.757525491535346e-05
13145;孤树Mori;1;0;1;20497;4.878762745767673e-05
13147;焦焦的小情绪Yee的小石榴VickyGExtreme;2;0;2;20497;9.757525491535346e-05
13150;Miss就Miss;1;0;1;20497;4.878762745767673e-05
13157;lol手游黑酱;1;0;1;20497;4.878762745767673e-05
13159;一隅;1;0;1;20497;4.878762745767673e-05
13161;肚子圆滚滚;2;1;3;20497;0.0001463628823730302
13164;事事顺利;2;0;2;20497;9.757525491535346e-05
13167;7是花花吖林森ni无法剧绝金金金金太阳;1;0;1;20497;4.878762745767673e-05
13169;十一点看到我叫我滚去睡觉;1;0;1;20497;4.878762745767673e-05
13175;花花子;1;0;1;20497;4.878762745767673e-05
13179;琳狗狗想走出浪浪山;1;0;1;20497;4.878762745767673e-05
13184;五月;1;0;1;20497;4.878762745767673e-05
13197;尘有心玄泓我11点就睡无妄;1;0;1;20497;4.878762745767673e-05
13202;吃饭;1;0;1;20497;4.878762745767673e-05
13205;孤山;1;0;1;20497;4.878762745767673e-05
13208;0;1;0;1;20497;4.878762745767673e-05
13210;xixi;2;0;2;20497;9.757525491535346e-05
13216;COCO沐沐;1;0;1;20497;4.878762745767673e-05
13221;彭什么先森;1;0;1;20497;4.878762745767673e-05
13223;宋总的小娇妻;1;0;1;20497;4.878762745767673e-05
13230;clown;1;0;1;20497;4.878762745767673e-05
13242;Omv;1;0;1;20497;4.878762745767673e-05
13246;天体观测;1;0;1;20497;4.878762745767673e-05
13248;D;1;0;1;20497;4.878762745767673e-05
13251;一顿两碗大米饭;1;0;1;20497;4.878762745767673e-05
13254;加号画;1;1;2;20497;9.757525491535346e-05
13256;吃土豆不加豆;2;0;2;20497;9.757525491535346e-05
13259;PzZzAy;1;1;2;20497;9.757525491535346e-05
13261;午眠墨水玩法酒小蔡澜霖冬笙;3;2;5;20497;0.00024393813728838367
13265;惠子不是会子;1;0;1;20497;4.878762745767673e-05
13268;零度碳酸;1;0;1;20497;4.878762745767673e-05
13270;5247;1;1;2;20497;9.757525491535346e-05
13272;Cc王好运;2;1;3;20497;0.0001463628823730302
13277;蚌不住了哇;1;0;1;20497;4.878762745767673e-05
13282;所以你每个月花多少钱买梯子;5;0;5;20497;0.00024393813728838367
13288;没一个能在国内用的，都得挂梯子;1;2;3;20497;0.0001463628823730302
13301;又可怕又好笑哈哈哈哈哈哈哈哈哈哈没给我笑死哈哈哈哈哈哈哈哈哈;2;392;394;20497;0.019222325218324635
13304;哈哈哈哈，笑到头掉，就像输入法连续不断按出来的字一样;2;308;310;20497;0.015124164511879788
13307;那么多外貌描写是凑字吗;1;293;294;20497;0.01434356247255696
13309;你的解说最出彩的地方就是用清亮哽咽杀气肆溢的语调说出精妙二字。;1;176;177;20497;0.008635410060008782
13313;消失那么长时间，今天一下就更新了6个;2;66;68;20497;0.0033175586671220177
13323;ai竟然也会水字数;1;10;11;20497;0.000536663902034444
13328;曦笑死我了;1;0;1;20497;4.878762745767673e-05
13330;蔺白安长泽我找到了哈哈哈哈哈;1;0;1;20497;4.878762745767673e-05
13337;mmmmm个不停智慧女孩要秃头秃秃哈哈哈哈哈哈哈哈哈哈;7;1;8;20497;0.00039030101966141384
13345;澄风南歖歆筱笑死我了要看完太好笑了;1;4;5;20497;0.00024393813728838367
13347;肖肖的草莓糖薇哈哈哈哈哈哈哈;1;2;3;20497;0.0001463628823730302
13352;蒋丞一点七亿字;3;0;3;20497;0.0001463628823730302
13358;61涉江TaVTwoFour;1;0;1;20497;4.878762745767673e-05
13366;Sanctuary。;1;1;2;20497;9.757525491535346e-05
13370;栗子玥玥南吕冬沃呆桃隼余曦皖看他讲描写;2;2;4;20497;0.00019515050983070692
13373;睡觉没有笑死我了啊这么一看我们之前玩的那个ai还比较聪明;1;6;7;20497;0.00034151339220373715
13375;娍哈哈哈哈哈哈哈哈哈哈哈哈哈哈哈我快笑死了;1;1;2;20497;9.757525491535346e-05
13379;flunceabd精妙;1;0;1;20497;4.878762745767673e-05
13381;直子;1;0;1;20497;4.878762745767673e-05
13384;念念无长安早川雾里奈噗笑死我了;1;1;2;20497;9.757525491535346e-05
13387;嘟嘟啵;1;0;1;20497;4.878762745767673e-05
13392;欧气叶子水字的最高境界;1;0;1;20497;4.878762745767673e-05
13407;竹yaya蟹堡王忘救命，笑死我了，哈哈哈哈哈哈哈哈哈哈哈哈哈哈哈哈哈哈哈哈哈哈哈哈哈哈哈哈哈;1;2;3;20497;0.0001463628823730302
13423;辰辰呀哈快看这个博主哈哈哈哈哈;1;0;1;20497;4.878762745767673e-05
13427;Monamour笑的我肚子疼;1;0;1;20497;4.878762745767673e-05
13429;独繁快关注他;1;0;1;20497;4.878762745767673e-05
13431;祭司笑死我;1;0;1;20497;4.878762745767673e-05
13433;阿也妈的笑死了电脑还能写小说;1;1;2;20497;9.757525491535346e-05
13435;何弃疗我快笑死了;1;1;2;20497;9.757525491535346e-05
13437;安鹅鹅鹅;2;0;2;20497;9.757525491535346e-05
13443;黑腻喔慕十三桃见神明;2;0;2;20497;9.757525491535346e-05
13447;爱晚亭边哈哈哈哈哈哈哈哈哈哈哈哈哈哈哈哈哈哈哈哈哈哈哈哈哈哈哈哈哈哈哈;1;0;1;20497;4.878762745767673e-05
13459;呆桃的黑咖啡外貌描写属实精妙;1;0;1;20497;4.878762745767673e-05
13462;披着朱皮的鸭鸭来看;1;0;1;20497;4.878762745767673e-05
13468;小y哈哈哈我笑死了这个人说的好有意思;1;2;3;20497;0.0001463628823730302
13470;土芽失格哈哈哈哈哈哈哈哈哈哈;1;0;1;20497;4.878762745767673e-05
13485;罂eau鹤鸠Mer来，收获快乐;1;3;4;20497;0.00019515050983070692
13491;qzuser哈哈哈哈哈哈我要笑死了;1;0;1;20497;4.878762745767673e-05
13500;腿毛少女丶小肉丸子妈的，笑死我了;1;0;1;20497;4.878762745767673e-05
13503;你为什么不火，就这个问题你可以解答一下么？请回答请回答请回答;1;1;2;20497;9.757525491535346e-05
13508;请你喝冰阔落哈哈哈哈;3;0;3;20497;0.0001463628823730302
13514;会一直爱我吗哈哈哈哈哈哈哈哈;1;0;1;20497;4.878762745767673e-05
13516;燕北以北，救命啊;1;0;1;20497;4.878762745767673e-05
13526;溺水的;1;0;1;20497;4.878762745767673e-05
13528;等到以后AI小说够好的时候，这大概就是里程碑了;1;2;3;20497;0.0001463628823730302
13531;我还蛮想看的，我是不是有点不正常卑微小峰蓝蓝陈富贵;1;0;1;20497;4.878762745767673e-05
13535;桃之;1;0;1;20497;4.878762745767673e-05
13538;M辣酷兜子乐万duoduoFFF鸢快看;2;3;5;20497;0.00024393813728838367
13542;Newself哈哈哈哈，好好借鉴;2;2;4;20497;0.00019515050983070692
13545;有美女请艾特我海绵宝宝的西装去看;1;0;1;20497;4.878762745767673e-05
13549;湊哈哈哈哈哈哈哈哈哈哈哈哈哈哈哈;1;1;2;20497;9.757525491535346e-05
13553;说真的，可能我看到开头一两章就弃文了，阿漫居然看完了;2;6;8;20497;0.00039030101966141384
13559;之一哈哈哈哈哈哈哈哈我看上瘾了;3;2;5;20497;0.00024393813728838367
13563;糖糖;1;0;1;20497;4.878762745767673e-05
13574;小吴很高冷康康康康;2;0;2;20497;9.757525491535346e-05
13577;风带走了落叶草哈哈哈哈哈哈哈哈哈哈哈哈哈哈;2;0;2;20497;9.757525491535346e-05
13581;摇摇乐;1;0;1;20497;4.878762745767673e-05
13583;小表妹今天也是想暴富的燕燕KWON那你们冲这本;2;0;2;20497;9.757525491535346e-05
13587;AnnieJAY七分我真的要早睡笑死我了;1;1;2;20497;9.757525491535346e-05
13589;赵丹;1;0;1;20497;4.878762745767673e-05
13596;是伊雅的笑死我了;1;1;2;20497;9.757525491535346e-05
13598;川渝哈哈哈哈哈哈哈哈哈哈哈什么魔鬼小说;1;1;2;20497;9.757525491535346e-05
13602;南怀今;1;0;1;20497;4.878762745767673e-05
13624;森海有鹿果冻;2;1;3;20497;0.0001463628823730302
13632;这个世界我唯一留念的就是你;1;0;1;20497;4.878762745767673e-05
13639;白燕;1;0;1;20497;4.878762745767673e-05
13660;吃鱼粮的小月亮小纸条啊;1;0;1;20497;4.878762745767673e-05
13665;你可爱的爹吴洁;1;1;2;20497;9.757525491535346e-05
13693;道德;1;0;1;20497;4.878762745767673e-05
13696;ScorpioKN啊渣夜晚;1;0;1;20497;4.878762745767673e-05
13698;拾柒敲乖;1;0;1;20497;4.878762745767673e-05
13702;宇。;2;0;2;20497;9.757525491535346e-05
13705;晴晴晴晴;2;0;2;20497;9.757525491535346e-05
13719;W雯;1;0;1;20497;4.878762745767673e-05
13723;救命;1;1;2;20497;9.757525491535346e-05
13730;麦冬Fs冥;1;1;2;20497;9.757525491535346e-05
13734;Cherry;1;0;1;20497;4.878762745767673e-05
13738;小易呀老闵;2;0;2;20497;9.757525491535346e-05
13760;我写论文belike：Kbbbbbbb1iBbright大坨坨;2;2;4;20497;0.00019515050983070692
13770;Plutozn;1;0;1;20497;4.878762745767673e-05
13788;大家千万不要歧视AI的审美;1;4;5;20497;0.00024393813728838367
13790;目前大二，学影视的，看到ai发展这么快，真的很难不焦虑和着急;45;128;173;20497;0.008440259550178075
13836;用AI生成的漫画;18;40;58;20497;0.0028296823925452507
13856;人家原推文说的是配音由ai完成;6;86;92;20497;0.004488461726106259
13863;比中国科幻电影做的好;9;9;18;20497;0.0008781772942381812
13873;画面是三维渲染和实拍的，别误导观众，不然很多人还以为画面也是ai生成的呢;2;10;12;20497;0.0005854515294921208
13876;以后学校教ai就完蛋了;3;36;39;20497;0.0019027174708493926
13880;这个需要想象力丰富，跟工具一样，你没有那想象力，具体的东西他生成的也很模糊;4;2;6;20497;0.0002927257647460604
13885;拼想象力和创造力的时代来了。;2;6;8;20497;0.00039030101966141384
13888;又被刘慈欣说准了。之前詹姆斯卡梅隆还当场不同意。;3;2;5;20497;0.00024393813728838367
13893;短片叫什么？我去看看;1;4;5;20497;0.00024393813728838367
13896;ai赶紧把我代替了吧，替我上班然后再把挣来的工资给我;1;1;2;20497;9.757525491535346e-05
13953;这ai看着跟c4d一样;1;2;3;20497;0.0001463628823730302
13959;这个短片的故事怎么这么像这个？;1;0;1;20497;4.878762745767673e-05
13965;短片叫什么名字啊;2;1;3;20497;0.0001463628823730302
13971;废物小点昕情绪零碎奈绪;1;1;2;20497;9.757525491535346e-05
13976;Ruby;3;0;3;20497;0.0001463628823730302
13984;也许不该浪;1;0;1;20497;4.878762745767673e-05
13986;肖小叠丽夫托尔斯泰阿若;1;0;1;20497;4.878762745767673e-05
13989;蔡蔡不菜;1;0;1;20497;4.878762745767673e-05
14005;那以后京的票房咋办;1;0;1;20497;4.878762745767673e-05
14030;长按视频，选择赞赏，三朵免费的小花花给我吧，谢谢宝宝;15;10;25;20497;0.0012196906864419183
14046;让chatgpt给你文字描述，然后你去生成ai照片;4;29;33;20497;0.0016099917061033321
14051;不是且曼学院发布的关键词吗？是您整理的？;7;23;30;20497;0.001463628823730302
14059;怎么充值啊要国外卡;1;0;1;20497;4.878762745767673e-05
14061;当绘画变成文字工作;14;120;134;20497;0.006537542079328682
14076;AI只能生成库里有的图的拼贴，他没法自己创作;37;18;55;20497;0.0026833195101722204
14114;关键词截图单独发了图文，可以直接下载哈;21;28;49;20497;0.00239059374542616
14136;秀秀自己画的，无需梯子;6;10;16;20497;0.0007806020393228277
14143;甲方：画的很好不错可以提交了发个psd给我图层分好整理好;3;17;20;20497;0.0009757525491535347
14147;用什么办法可以把真人的脸作为ai画人像的参考？;9;2;11;20497;0.000536663902034444
14157;我写的怕你不敢看;6;1;7;20497;0.00034151339220373715
14164;老师求关键词;2;2;4;20497;0.00019515050983070692
14167;这些生成的图片有版权吗？;2;2;4;20497;0.00019515050983070692
14171;关键词在哪里？;3;1;4;20497;0.00019515050983070692
14175;这玩意真溜，把人画黄，可以做啥都懂;1;3;4;20497;0.00019515050983070692
14177;苹果手机，没有这个软件啊，都是别的;1;2;3;20497;0.0001463628823730302
14225;橘大AI已送花，能给我一份万能修饰词模版吗;1;1;2;20497;9.757525491535346e-05
14252;Beautifulanimewatercolorpaintingofsummerpunkboysummerchilldaypaintdrippingbytimokamuravictornizovtsevgregrutkowskinoahbradleytrendingonartstation8kmasterpiecegraffitipaintfinedetailfullofcolorintricatedetailgoldenratioillustration大家去试试;5;3;8;20497;0.00039030101966141384
14259;用不了啊，说工作量巨大;1;0;1;20497;4.878762745767673e-05
14266;没有中文版本么？;1;0;1;20497;4.878762745767673e-05
14270;救，为什么我第一次用但Duetoextremedemandwecantprovideafreetrialrightnow似乎就得订阅;4;1;5;20497;0.00024393813728838367
14278;橘大你好。我用照片转漫画，但是转出来就是另一个人了，样貌完全变了。有什么咒语可以解决这个问题吗;1;1;2;20497;9.757525491535346e-05
14302;这个可以淘汰到一般的设计师，淘汰不了很厉害的设计师，但是一般的设计师占90;1;0;1;20497;4.878762745767673e-05
14323;可以用到SD里吗;1;0;1;20497;4.878762745767673e-05
14325;用ai画的图不能惊艳所有人;1;0;1;20497;4.878762745767673e-05
14328;对电脑硬件要求高吗？;1;0;1;20497;4.878762745767673e-05
14339;折腾半天没有一个能商用的，自己玩玩而已;1;0;1;20497;4.878762745767673e-05
14343;谢谢;1;1;2;20497;9.757525491535346e-05
14346;AI小子;2;1;3;20497;0.0001463628823730302
14349;风格灯光，就可以了;1;1;2;20497;9.757525491535346e-05
14351;好帅;1;1;2;20497;9.757525491535346e-05
14368;伊宝;1;0;1;20497;4.878762745767673e-05
14391;yan;2;0;2;20497;9.757525491535346e-05
14397;逃跑的太阳;1;0;1;20497;4.878762745767673e-05
14410;0;1;0;1;20497;4.878762745767673e-05
14414;ai绘图软件要下哪个？;4;2;6;20497;0.0002927257647460604
14419;免费用户只能生成40次图片，之后要付费了，10美元一个月;5;2;7;20497;0.00034151339220373715
14425;求关键词的图;4;1;5;20497;0.00024393813728838367
14430;chatGPT国内镜像wwwppwordcn;2;2;4;20497;0.00019515050983070692
14433;全是污秽不堪的词Ai会画吗;2;1;3;20497;0.0001463628823730302
14436;我写的关键词还可以吧;1;1;2;20497;9.757525491535346e-05
14438;卖图的快失业了;1;1;2;20497;9.757525491535346e-05
14440;有了V4就随便写了;1;1;2;20497;9.757525491535346e-05
14444;这个出的图能商用吗;1;0;1;20497;4.878762745767673e-05
14447;还ai绘画大师呢没一张是你自己画的，发出来只会被瞧不起;1;1;2;20497;9.757525491535346e-05
14450;在线做基本都能出爆图，简单几个词都可以，不用这么麻烦;1;0;1;20497;4.878762745767673e-05
14452;你这个审美不行啊;1;0;1;20497;4.878762745767673e-05
14519;大元资源网不错;13;235;248;20497;0.012099331609503829
14533;有没有自动生成论文的;51;825;876;20497;0.042737961652924816
14586;绝绝子姐妹们;10;112;122;20497;0.005952090549836562
14597;由写脚本的AI吗？;21;28;49;20497;0.00239059374542616
14619;直说会员怎么开;5;4;9;20497;0.0004390886471190906
14625;好家伙，这女集中地啊;3;5;8;20497;0.00039030101966141384
14629;有没有形成客套话的app;3;0;3;20497;0.0001463628823730302
14634;有没有直接生成手写字体图片的;1;2;3;20497;0.0001463628823730302
14636;收费？;1;0;1;20497;4.878762745767673e-05
14638;怎么解决次数限制呀;1;0;1;20497;4.878762745767673e-05
14646;献礼VvV我咋找不到这个;2;0;2;20497;9.757525491535346e-05
14652;徐多多一好物分享;1;0;1;20497;4.878762745767673e-05
14655;为什么点提交生成中就没有反应了;1;0;1;20497;4.878762745767673e-05
14663;今天三岁了小红书那个你可以试试了;1;0;1;20497;4.878762745767673e-05
14667;元气犇犇哈哈哈哈哈哈哈哈哈哈哈哈哈哈哈哈哈哈哈哈哈哈哈哈哈哈哈哈;2;0;2;20497;9.757525491535346e-05
14672;你看看你看看自动生成;2;0;2;20497;9.757525491535346e-05
14675;文案要失业了;2;0;2;20497;9.757525491535346e-05
14679;Daisy;1;0;1;20497;4.878762745767673e-05
14682;蛋炒饭的蛋蛋快看;2;0;2;20497;9.757525491535346e-05
14685;伊哈哈哈哈哈哈哈哈班班看;1;0;1;20497;4.878762745767673e-05
14692;看评论第一条;1;0;1;20497;4.878762745767673e-05
14698;威尼斯的果糖来;1;0;1;20497;4.878762745767673e-05
14700;waitingforyou你需要吗？;1;0;1;20497;4.878762745767673e-05
14708;小红书文案我直接用chatgpt写，简单方便;8;4;12;20497;0.0005854515294921208
14719;某某枭雀GaneiGyqm给我看;1;0;1;20497;4.878762745767673e-05
14722;吱欢欢一声快去用啊;1;0;1;20497;4.878762745767673e-05
14724;爱因斯坦平民陈女士牛逼;1;0;1;20497;4.878762745767673e-05
14726;是阿越呀马克一下;1;1;2;20497;9.757525491535346e-05
14728;笑一个吧还有这种dx;2;0;2;20497;9.757525491535346e-05
14732;月沉了发小红书不需要写了;1;1;2;20497;9.757525491535346e-05
14735;绿绿;1;0;1;20497;4.878762745767673e-05
14738;MoNk你们需要的;1;0;1;20497;4.878762745767673e-05
14741;丸丸子殿下宝宝你看看;1;0;1;20497;4.878762745767673e-05
14747;崔美美这个可以;1;0;1;20497;4.878762745767673e-05
14749;小布丁吃番茄怎么还有这种东西;1;0;1;20497;4.878762745767673e-05
14751;尾巴ioio卧槽，收藏;1;0;1;20497;4.878762745767673e-05
14753;暴躁白琪;1;0;1;20497;4.878762745767673e-05
14755;又吃叉烧;1;0;1;20497;4.878762745767673e-05
14759;哈哈哈哈哈哈哈小红书引流不用编文案了我的妈呀呀呀呀;1;0;1;20497;4.878762745767673e-05
14762;Tsuki码着打工用;1;0;1;20497;4.878762745767673e-05
14764;南川Q试过吗？？;4;0;4;20497;0.00019515050983070692
14769;ZeG麻竹;1;0;1;20497;4.878762745767673e-05
14772;求求别下雨;1;0;1;20497;4.878762745767673e-05
14774;重生之美艳坏女人码住;1;0;1;20497;4.878762745767673e-05
14781;还好雇你的老板不懂;2;0;2;20497;9.757525491535346e-05
14784;嗑生嗑死NAAAAAZep123来评论;3;1;4;20497;0.00019515050983070692
14790;困囿快来看，太好用了;2;0;2;20497;9.757525491535346e-05
14794;小松菜菜能帮我写豆子吗;2;0;2;20497;9.757525491535346e-05
14800;蟑螂有益健康哈哈哈哈;3;0;3;20497;0.0001463628823730302
14805;喵毛毛记好了;1;0;1;20497;4.878762745767673e-05
14807;柠檬鱼NN看评论;1;1;2;20497;9.757525491535346e-05
14810;小羊养蚕178园圆园圆哈鲁哈鲁璨;2;0;2;20497;9.757525491535346e-05
14814;要是用了生成的文案不会侵权啥的吧;1;0;1;20497;4.878762745767673e-05
14816;梦梦子回来啦你需要么;2;1;3;20497;0.0001463628823730302
14819;咸蛋黄超人快看;1;0;1;20497;4.878762745767673e-05
14823;煜熠弟弟你怎么回事MAY热衷我看到了swot分析;1;0;1;20497;4.878762745767673e-05
14826;FrEaK喜新厌旧;1;0;1;20497;4.878762745767673e-05
14828;浪漫;1;0;1;20497;4.878762745767673e-05
14848;爆炸花椒菜;1;0;1;20497;4.878762745767673e-05
14858;芋圆甜又圆;1;0;1;20497;4.878762745767673e-05
14880;小洞杜宝贝贝贝;1;0;1;20497;4.878762745767673e-05
14886;超级宇宙无敌爆炸炫酷可爱小喵喵;3;1;4;20497;0.00019515050983070692
14890;生生卜卜啊;2;0;2;20497;9.757525491535346e-05
14897;GGGGvkJoanne12222D56;1;1;2;20497;9.757525491535346e-05
14904;炒年糕炸薯条;1;0;1;20497;4.878762745767673e-05
14906;抖哥SecondTheshy曹莓可爱多红烧鱼小杨同学睡不醒神奇蹦蹦幸运福袋子Flash天空xxxholiholigoatRistofreeshipping;1;1;2;20497;9.757525491535346e-05
14912;嘻嘻嘻嘻嘻嘻;1;0;1;20497;4.878762745767673e-05
14914;萧萧;1;0;1;20497;4.878762745767673e-05
14916;今晚月色很美;1;0;1;20497;4.878762745767673e-05
14918;芋泥啵啵丸;1;0;1;20497;4.878762745767673e-05
14923;馍馍小粉11;1;0;1;20497;4.878762745767673e-05
14926;时间淡化记忆;1;0;1;20497;4.878762745767673e-05
14929;大佬李;1;0;1;20497;4.878762745767673e-05
14935;阿阿阿阿灿;1;0;1;20497;4.878762745767673e-05
14939;Darcy;1;0;1;20497;4.878762745767673e-05
14943;小董阿花;1;0;1;20497;4.878762745767673e-05
14946;是大力呀;1;0;1;20497;4.878762745767673e-05
14948;羊羊;1;0;1;20497;4.878762745767673e-05
14950;Twinkle;1;0;1;20497;4.878762745767673e-05
14952;章小鱼;1;0;1;20497;4.878762745767673e-05
14954;臭美的李大橘;1;0;1;20497;4.878762745767673e-05
14956;le怪怪;1;0;1;20497;4.878762745767673e-05
14959;帅哥好泡吗;1;0;1;20497;4.878762745767673e-05
14961;螺蛳粉加香菜;1;0;1;20497;4.878762745767673e-05
14963;纯;2;0;2;20497;9.757525491535346e-05
14968;你午睡了mie;1;0;1;20497;4.878762745767673e-05
14974;Saury啦;1;0;1;20497;4.878762745767673e-05
14977;只吃香菜;1;0;1;20497;4.878762745767673e-05
14979;酷嘎喔;1;0;1;20497;4.878762745767673e-05
14981;Listen;1;0;1;20497;4.878762745767673e-05
14983;0;1;0;1;20497;4.878762745767673e-05
14990;尼克狐尼克牛啊;1;0;1;20497;4.878762745767673e-05
14994;花娜丽莎的假笑小贝柚子酱;1;0;1;20497;4.878762745767673e-05
15001;ZAN;1;0;1;20497;4.878762745767673e-05
15007;吱昂张z;1;0;1;20497;4.878762745767673e-05
15009;RH;1;0;1;20497;4.878762745767673e-05
15020;叫我琪琪;1;0;1;20497;4.878762745767673e-05
15022;花落知多晓;1;0;1;20497;4.878762745767673e-05
15025;木鱼子;1;0;1;20497;4.878762745767673e-05
15028;ldnnnnnn;1;0;1;20497;4.878762745767673e-05
15030;宛平南路600号在逃公主;2;0;2;20497;9.757525491535346e-05
15040;红烧草莓;1;0;1;20497;4.878762745767673e-05
15043;面包脑袋来;2;0;2;20497;9.757525491535346e-05
15047;支楞起来子;1;0;1;20497;4.878762745767673e-05
15052;画秃头的小钱袋子;1;0;1;20497;4.878762745767673e-05
15058;LB猫猫酱;1;0;1;20497;4.878762745767673e-05
15063;完美跳跳虎细碎夏;2;0;2;20497;9.757525491535346e-05
15073;乌梅子酱味;1;0;1;20497;4.878762745767673e-05
15077;六岁吃六碗饭;1;0;1;20497;4.878762745767673e-05
15079;紫米芋泥脑袋;2;0;2;20497;9.757525491535346e-05
15082;盐柠檬金宝珠;1;1;2;20497;9.757525491535346e-05
15084;奇奇怪怪张;1;1;2;20497;9.757525491535346e-05
15086;你挺淘啊（恋爱日记）;1;0;1;20497;4.878762745767673e-05
15090;快乐要多多yyao小狗日记;1;1;2;20497;9.757525491535346e-05
15097;人间爸比;1;1;2;20497;9.757525491535346e-05
15099;肉不丸;1;0;1;20497;4.878762745767673e-05
15108;锦青;1;0;1;20497;4.878762745767673e-05
15112;0;1;0;1;20497;4.878762745767673e-05
15114;隔壁大舅;1;0;1;20497;4.878762745767673e-05
15120;我的草莓熊在哪;1;0;1;20497;4.878762745767673e-05
15126;这个阿子是王Z璇;1;0;1;20497;4.878762745767673e-05
15129;giggle藤果伦黛;1;0;1;20497;4.878762745767673e-05
15132;猪咪蔡八斗儿;1;0;1;20497;4.878762745767673e-05
15140;栗;1;0;1;20497;4.878762745767673e-05
15145;慧慧睡不醒;1;0;1;20497;4.878762745767673e-05
15148;河南李知恩;2;0;2;20497;9.757525491535346e-05
15153;暗号;1;0;1;20497;4.878762745767673e-05
15157;天使;1;0;1;20497;4.878762745767673e-05
15159;大脸呆熊;1;0;1;20497;4.878762745767673e-05
15163;狗不理猫不闻鲱鱼罐头;1;0;1;20497;4.878762745767673e-05
15170;AAA装修大王小葛;1;1;2;20497;9.757525491535346e-05
15172;AAA金牌月嫂团队许姐漫兮S幻想;1;1;2;20497;9.757525491535346e-05
15179;pink猪妹啦元元不圆圆Y小周不喝粥;1;1;2;20497;9.757525491535346e-05
15183;劝你不要太嚣张女士;1;0;1;20497;4.878762745767673e-05
15186;金元宝;1;0;1;20497;4.878762745767673e-05
15188;晒成一颗卤蛋;1;0;1;20497;4.878762745767673e-05
15191;肉子;1;1;2;20497;9.757525491535346e-05
15196;小芊同学;1;0;1;20497;4.878762745767673e-05
15198;orddioic;1;0;1;20497;4.878762745767673e-05
15201;要快乐呀;1;0;1;20497;4.878762745767673e-05
15203;长不大滴小憨w;1;0;1;20497;4.878762745767673e-05
15210;一个车手的日记;2;0;2;20497;9.757525491535346e-05
15219;船子;2;0;2;20497;9.757525491535346e-05
15222;疯狂进餐导致爹不疼妈不爱;1;0;1;20497;4.878762745767673e-05
15224;bmb;1;0;1;20497;4.878762745767673e-05
15228;鱼丸粗面木有了;1;0;1;20497;4.878762745767673e-05
15230;Chipooo;1;0;1;20497;4.878762745767673e-05
15235;皮皮呀;1;0;1;20497;4.878762745767673e-05
15239;浅浅;1;0;1;20497;4.878762745767673e-05
15245;花花suda;1;0;1;20497;4.878762745767673e-05
15255;炸鸡要甜辣味的;1;1;2;20497;9.757525491535346e-05
15260;人类的本质是3包;1;0;1;20497;4.878762745767673e-05
15265;想做金弦的甲方;1;0;1;20497;4.878762745767673e-05
15269;丨小明丨空夜的第七张她山她海;1;0;1;20497;4.878762745767673e-05
15275;玉井獸;1;0;1;20497;4.878762745767673e-05
15280;幼儿园抢饭第一名;1;0;1;20497;4.878762745767673e-05
15287;9敏有任何一个人不知道这个工具我都会伤心的ok？都给我冲，集美们;1;13;14;20497;0.0006830267844074743
15289;看我主页，尤其是第一个作品;3;6;9;20497;0.0004390886471190906
15294;一坨胖大福大梦如也评论找资源;1;0;1;20497;4.878762745767673e-05
15298;上帝狠狠宠爱的幸运儿;1;0;1;20497;4.878762745767673e-05
15320;MaterialsEngineering;1;0;1;20497;4.878762745767673e-05
15323;大甜儿低卡食谱你要不试试;1;0;1;20497;4.878762745767673e-05
15325;BARBEL;2;0;2;20497;9.757525491535346e-05
15336;宁大闲人你写东西可以用用;1;0;1;20497;4.878762745767673e-05
15338;树上的鸟;1;0;1;20497;4.878762745767673e-05
15345;手气旺旺打麻将;1;0;1;20497;4.878762745767673e-05
15348;今天又是好瞌睡;1;0;1;20497;4.878762745767673e-05
15351;Kharll你需要;1;0;1;20497;4.878762745767673e-05
15353;二宝是只喵对你有用不;1;0;1;20497;4.878762745767673e-05
15365;1cas;1;0;1;20497;4.878762745767673e-05
15375;酒楼老板王富贵柒朝朝送给有需要的人;1;0;1;20497;4.878762745767673e-05
15387;冷心市民邓女士;1;0;1;20497;4.878762745767673e-05
15394;沙漠看星星;1;0;1;20497;4.878762745767673e-05
15398;花里胡哨的人间仙女;1;0;1;20497;4.878762745767673e-05
15403;甜心荷包蛋探店;1;0;1;20497;4.878762745767673e-05
15408;卜卜啊卜;1;0;1;20497;4.878762745767673e-05
15413;烤肉神的信徒脚本不用你写了;1;0;1;20497;4.878762745767673e-05
15418;Syn;1;0;1;20497;4.878762745767673e-05
15432;羊咩咩扭扭捏捏Tylee;2;0;2;20497;9.757525491535346e-05
15435;锡瓜太王1914;1;0;1;20497;4.878762745767673e-05
15443;Una正经的柯二逼你们需要不;1;0;1;20497;4.878762745767673e-05
15446;鱼丸子悠悠de云儿;1;0;1;20497;4.878762745767673e-05
15450;阿星星;1;0;1;20497;4.878762745767673e-05
15456;本荷BENHE;1;0;1;20497;4.878762745767673e-05
15460;M珍妮不午睡那论文;2;0;2;20497;9.757525491535346e-05
15465;蟹柳大人你就是用的这个？;2;0;2;20497;9.757525491535346e-05
15470;秃头的河豚;1;0;1;20497;4.878762745767673e-05
15474;FelicityGao;1;0;1;20497;4.878762745767673e-05
15476;Do;1;0;1;20497;4.878762745767673e-05
15482;花花花花花i姐妹姐妹;1;0;1;20497;4.878762745767673e-05
15487;Co0rn;2;0;2;20497;9.757525491535346e-05
15490;K海思喔;1;0;1;20497;4.878762745767673e-05
15492;妙音公子;1;0;1;20497;4.878762745767673e-05
15494;Janspiration;3;0;3;20497;0.0001463628823730302
15498;猫酌月;1;0;1;20497;4.878762745767673e-05
15500;印度飞饼;1;0;1;20497;4.878762745767673e-05
15502;胡玫瑰;1;0;1;20497;4.878762745767673e-05
15504;谁动了我的面包;1;0;1;20497;4.878762745767673e-05
15506;菲力麻麻;1;0;1;20497;4.878762745767673e-05
15516;城市动物园;1;0;1;20497;4.878762745767673e-05
15518;ebichu;1;0;1;20497;4.878762745767673e-05
15522;richAbingo;1;0;1;20497;4.878762745767673e-05
15525;她说我叫杨静;1;0;1;20497;4.878762745767673e-05
15528;HELULAN;1;0;1;20497;4.878762745767673e-05
15530;胖花生;1;0;1;20497;4.878762745767673e-05
15545;依然饭特香;1;0;1;20497;4.878762745767673e-05
15553;真的不喝啦;1;0;1;20497;4.878762745767673e-05
15555;西瓜;1;0;1;20497;4.878762745767673e-05
15559;小雨点;1;0;1;20497;4.878762745767673e-05
15562;予沫儿;1;0;1;20497;4.878762745767673e-05
15566;捞汁秋葵;1;0;1;20497;4.878762745767673e-05
15572;uamry;1;0;1;20497;4.878762745767673e-05
15579;小瞒;1;0;1;20497;4.878762745767673e-05
15581;Mmmmmm解放双手;1;0;1;20497;4.878762745767673e-05
15587;有周报生成诶;1;0;1;20497;4.878762745767673e-05
15590;TUTyf;1;0;1;20497;4.878762745767673e-05
15592;喵喵帕斯你需要吧宝贝;1;0;1;20497;4.878762745767673e-05
15597;有小秋啦;1;0;1;20497;4.878762745767673e-05
15602;小饼干;1;0;1;20497;4.878762745767673e-05
15604;Gabrielle;1;0;1;20497;4.878762745767673e-05
15607;是小吴耶;1;0;1;20497;4.878762745767673e-05
15609;开美甲店的莉子;1;0;1;20497;4.878762745767673e-05
15614;候月;1;0;1;20497;4.878762745767673e-05
15616;戒饭了;1;0;1;20497;4.878762745767673e-05
15620;Amy;1;0;1;20497;4.878762745767673e-05
15624;why;1;0;1;20497;4.878762745767673e-05
15628;明朗少女张建国一朵小草莓;1;0;1;20497;4.878762745767673e-05
15630;龙龙阿如果让你早点知道这个;1;0;1;20497;4.878762745767673e-05
15638;ENERGYZSY;1;0;1;20497;4.878762745767673e-05
15642;0;1;0;1;20497;4.878762745767673e-05
15653;Sarah收藏了;1;0;1;20497;4.878762745767673e-05
15656;29号飞行器;2;0;2;20497;9.757525491535346e-05
15663;乔治快来;1;0;1;20497;4.878762745767673e-05
15665;QwQ;1;0;1;20497;4.878762745767673e-05
15669;快码起来;1;0;1;20497;4.878762745767673e-05
15676;今天整点什么捏;3;0;3;20497;0.0001463628823730302
15695;11;1;0;1;20497;4.878762745767673e-05
15708;Kimiy耶这个;1;0;1;20497;4.878762745767673e-05
15717;噗达墩的朋友圈;1;0;1;20497;4.878762745767673e-05
15721;lifeschill;1;0;1;20497;4.878762745767673e-05
15723;偷一夜星光;1;0;1;20497;4.878762745767673e-05
15728;收费多少。;2;0;2;20497;9.757525491535346e-05
15738;能写中文吗？;1;0;1;20497;4.878762745767673e-05
15740;没有链接;3;0;3;20497;0.0001463628823730302
15744;沙发，并没有链接啊;1;0;1;20497;4.878762745767673e-05
15746;天，抖音大数据神了，我做的也是这个;12;8;20;20497;0.0009757525491535347
15763;可以画地图吗？简笔画;2;0;2;20497;9.757525491535346e-05
15775;一个又酷又想瘦的女孩就是这个;1;0;1;20497;4.878762745767673e-05
15778;Yiran看起来有点6;1;0;1;20497;4.878762745767673e-05
15781;西嘎无敌好吃我有宝画;2;0;2;20497;9.757525491535346e-05
15784;姜哒哒师姐来学习;3;0;3;20497;0.0001463628823730302
15788;QQ星user3207918520623走到世界尽头我阿狸打钱luuuuuu999Behind;1;0;1;20497;4.878762745767673e-05
15790;听我一曲夜阑谣CHRISTina;1;0;1;20497;4.878762745767673e-05
15800;Jude;1;0;1;20497;4.878762745767673e-05
15802;mnaive;1;0;1;20497;4.878762745767673e-05
15806;柠檬水加醋;1;0;1;20497;4.878762745767673e-05
15820;咋整;1;1;2;20497;9.757525491535346e-05
15822;省流一百多;1;0;1;20497;4.878762745767673e-05
15828;现在不让用了，怎么办;3;0;3;20497;0.0001463628823730302
15833;在哪里可以找到它;1;0;1;20497;4.878762745767673e-05
15837;省流：中国地区不可用要用国外的号;1;14;15;20497;0.000731814411865151
15839;这AI是不是网上抄的;5;2;7;20497;0.00034151339220373715
15845;主要情感不真实，人写的是有事的，有感悟的，AI就只能单向情感而写，更像是某种计划;2;2;4;20497;0.00019515050983070692
15848;网站是啥？;3;0;3;20497;0.0001463628823730302
15852;老师真的不会发现吗？;1;1;2;20497;9.757525491535346e-05
15854;那么神奇吗？;1;1;2;20497;9.757525491535346e-05
15856;六年级有化学和物理这两个科目吗？;1;1;2;20497;9.757525491535346e-05
15858;很好，已经抄下来了;1;1;2;20497;9.757525491535346e-05
15860;AI最好的地方就是不会急眼，我们老师要是这样，我肯定就急眼了;2;0;2;20497;9.757525491535346e-05
15863;六年级作文多以记叙和抒情为主，这个ai生成的语言大多都是的论述类的喊口号的形式，一看就不是出自六年级的手笔啊;2;0;2;20497;9.757525491535346e-05
15866;真好，老师根本发现不了;2;0;2;20497;9.757525491535346e-05
15869;苹果电脑如何关机？;2;0;2;20497;9.757525491535346e-05
15872;他写着写着就断了是咋回事啊;1;0;1;20497;4.878762745767673e-05
15874;这是现写的吗，不会被老师看出来吧;1;0;1;20497;4.878762745767673e-05
15876;Al都比我厉害了;1;0;1;20497;4.878762745767673e-05
15881;他在那里;1;0;1;20497;4.878762745767673e-05
15883;为什么它不能写超过四百字的作文;1;0;1;20497;4.878762745767673e-05
15887;你认识Crossin的编程教室吗;1;1;2;20497;9.757525491535346e-05
15889;在哪里搞这个;1;0;1;20497;4.878762745767673e-05
15893;更新这么快。这条是水了一期;1;0;1;20497;4.878762745767673e-05
15895;what;1;0;1;20497;4.878762745767673e-05
15906;沙拉酱拌番茄泽什么狗Volt;2;0;2;20497;9.757525491535346e-05
15913;去哪里找？;2;0;2;20497;9.757525491535346e-05
15937;我也在做这件事，你需要让他补充逻辑;10;1;11;20497;0.000536663902034444
15948;哇，声音好好听喔;4;0;4;20497;0.00019515050983070692
15954;还好，我会自己写文案;11;7;18;20497;0.0008781772942381812
15966;我记得以前也是13;8;4;12;20497;0.0005854515294921208
15976;我已使用。我也是level13。;2;2;4;20497;0.00019515050983070692
15979;我可以自己编，根据我喜欢享乐战争编出了“派扫摩擦”层;1;1;2;20497;9.757525491535346e-05
15985;作者大大，这些文章可以发布到写小说的平台上吗？;1;0;1;20497;4.878762745767673e-05
16011;我已使用。我也是level13。;3;0;3;20497;0.0001463628823730302
16017;夏天可暖和了没关系我用gpt写;1;0;1;20497;4.878762745767673e-05
16025;我的AI知道的有点多;1;2;3;20497;0.0001463628823730302
16052;0;1;0;1;20497;4.878762745767673e-05
16062;就不能用中文吗？特么的英语没有你好;3;1;4;20497;0.00019515050983070692
16067;在这个巨大的建筑里，你沿着漫长的走廊前进，脚步声回荡在混凝土墙壁间。白色的灯光仅仅泛着微弱的光亮，令这个空间更显得冷清。没有窗户，也没有地毯，这个走廊显得空旷而单调。在前方，你能看到黑暗的尽头，但你却无从知晓前方的目的地究竟是什么。这种不确定性，带给你一种淡淡的不适感。途中，你发现这个走廊没有任何的标志，也没有指示牌。这令你感到困惑，不明白这里的人们是如何找寻自己的目的地以及如何识别是哪个方向。你开始觉得这个走廊是不伦不类的，设计之精妙非常之高超，以至于你不敢贸然敲响任何门铃，因为你不确定哪一扇门实际上是走进正确区域的入口。这给你增添了一层更深的焦虑。突然，你闻到了一股淡淡的气味，好像是烟草的味道。你开始加快脚步，试图找出来这个味道是从哪里来的。你的眼睛逐渐适应了这个环境，开始能清晰地辨认出墙上架的摄像头，以及看到走廊尽头一扇敞开的门。你很想知道这个门会通往哪里。你越来越接近门边，开始听到细微的嘈杂声，好像人群的声音。一种奇特的好奇心和兴奋充斥着你的心头，让你兴奋地加快了脚步。你终于到达了门口，迫不及待地探头进去。你看到了一个人们热烈讨论的会议室，这是你一生中难以忘记的;2;0;2;20497;9.757525491535346e-05
16083;兵哥，看抖音自动评论过来的，想学习一下可以么？;2;0;2;20497;9.757525491535346e-05
16088;人工智能太吓人了;4;5;9;20497;0.0004390886471190906
16093;下载了;4;2;6;20497;0.0002927257647460604
16099;谁用谁后悔;3;3;6;20497;0.0002927257647460604
16103;大丽美女这是真的吗;1;2;3;20497;0.0001463628823730302
16106;大丽啊，啥时候直播啊？;1;3;4;20497;0.00019515050983070692
16108;真的好用;1;1;2;20497;9.757525491535346e-05
16121;真的吗;1;1;2;20497;9.757525491535346e-05
16123;0;1;1;2;20497;9.757525491535346e-05
16141;小学生绝对应用主力;1;1;2;20497;9.757525491535346e-05
16143;怎么弄;5;2;7;20497;0.00034151339220373715
16168;想要;2;1;3;20497;0.0001463628823730302
16183;谁跟我解释一下什么叫本手、妙手、俗手;10;126;136;20497;0.0066351173342440355
16194;明年考中医;1;36;37;20497;0.0018051422159340391
16196;AI写的这篇里面还有yydd？？？这个术语能用在作文里吗？;3;24;27;20497;0.0013172659413572718
16201;ai能替我去考数学吗;2;9;11;20497;0.000536663902034444
16204;yyds这么潮流的吗;1;5;6;20497;0.0002927257647460604
16206;本手指的是传统妙手是创新;1;3;4;20497;0.00019515050983070692
16208;我甲卷都要吐了;1;3;4;20497;0.00019515050983070692
16212;知道黄金分割率吗？对，诸葛亮皮肤。;1;2;3;20497;0.0001463628823730302
16214;。。。什么时候高考能带手机了;1;2;3;20497;0.0001463628823730302
16216;王手呢？;2;0;2;20497;9.757525491535346e-05
16224;你们上班时候都怎么划水的？;1;3;4;20497;0.00019515050983070692
16226;愿世上没有数学和香菜蜡笔管小欣你脸红什么JacksonYee我把手砍了;3;0;3;20497;0.0001463628823730302
16230;我20，520;1;1;2;20497;9.757525491535346e-05
16237;你会的别人也会凭什么别人买你的单？搞得就好像就你会用AI;9;14;23;20497;0.0011221154315265648
16247;什么插件;5;5;10;20497;0.00048787627457676734
16254;别人也能搜到为啥买你的书？都gpt了就不需要书了;3;17;20;20497;0.0009757525491535347
16258;所以一样的要求，他会生成一样的东西吗;3;4;7;20497;0.00034151339220373715
16263;注意版权，chatgpt产出的内容都是网上收集的，自己用没问题，想赚钱就算了;4;6;10;20497;0.00048787627457676734
16268;有毛用，相当于一个搜索工具;2;2;4;20497;0.00019515050983070692
16272;直接把人家n本书抽象copy了;2;0;2;20497;9.757525491535346e-05
16281;我用了，我写了400字开头，然后它用200个字就给我收尾了，就是垃圾;1;0;1;20497;4.878762745767673e-05
16311;他在网络上抓取的这些数据。没有知识产权吗？;1;0;1;20497;4.878762745767673e-05
16335;能给我个好用的梯子吗？;1;0;1;20497;4.878762745767673e-05
16337;请问怎么注册;1;0;1;20497;4.878762745767673e-05
16341;听说GPT五月份会出国内版的是真的吗？;1;0;1;20497;4.878762745767673e-05
16365;清华出品，为什么不是中国名;2;5;7;20497;0.00034151339220373715
16370;我必须是第一个;3;0;3;20497;0.0001463628823730302
16382;你好;2;0;2;20497;9.757525491535346e-05
16389;Ai猪蹄;1;0;1;20497;4.878762745767673e-05
16401;全部付费;8;125;133;20497;0.006488754451871005
16410;都不免费的;1;42;43;20497;0.0020978679806800994
16412;大家一定不要下载这些号，不仅要微信绑定，还要手机号获取，有可能你的信息就被获取到了，这些都是小公司;1;23;24;20497;0.0011709030589842416
16414;copyai才是免费的;3;7;10;20497;0.00048787627457676734
16418;写作猫给出标题写文是免费的，改写是付费的;4;2;6;20497;0.0002927257647460604
16423;不是说免费吗;3;2;5;20497;0.00024393813728838367
16428;密塔猫手机版用不成;1;4;5;20497;0.00024393813728838367
16430;AI写作神器，我只认可97文案;1;1;2;20497;9.757525491535346e-05
16436;公文能写？？;1;0;1;20497;4.878762745767673e-05
16445;97文案，AI自动生成文案;2;1;3;20497;0.0001463628823730302
16449;果冻儿笑莞尔试试;3;0;3;20497;0.0001463628823730302
16468;毳有三只毛;1;0;1;20497;4.878762745767673e-05
16472;修笙;1;0;1;20497;4.878762745767673e-05
16483;疯癫女神经;2;0;2;20497;9.757525491535346e-05
16486;明天我发一个免费的神器主要是米国产品懂的都懂，很牛x;2;1;3;20497;0.0001463628823730302
16489;秘塔写作猫都搜不到呀？;1;3;4;20497;0.00019515050983070692
16491;早标网免费？;1;2;3;20497;0.0001463628823730302
16493;敏感词，违规词检测有没有好工具呀;1;2;3;20497;0.0001463628823730302
16505;这家伙绝对被充值了;1;0;1;20497;4.878762745767673e-05
16534;这是不是也是在说明着，高考作文已经成为了一种按“公式”“模板”写作的模式了呢;497;20000;20497;20497;1.0
17032;这不叫写，叫做综合摘抄;56;11000;11056;20497;0.539396009172074
17089;AI考生，AI批卷老师，上AI大学;7;7262;7269;20497;0.3546372639898522
17097;yyds正好映衬了俗手;63;7146;7209;20497;0.3517100063423916
17161;想到了废话生成器原理基本一样;54;6497;6551;20497;0.3196077474752403
17216;那个yyds在老师评卷的时候分直接就会降一个档了;9;4393;4402;20497;0.214763136068693
17226;受不了了来成语接龙我先来：呆若木鸡;284;3192;3476;20497;0.16958579304288432
17511;它考试的时候联网了嘛;36;2946;2982;20497;0.14548470507879202
17548;AI不过是拾人牙慧罢了;82;2224;2306;20497;0.11250426891740255
17631;al也是人编写的啊难不成它能自己写一篇出来;61;2071;2132;20497;0.1040152217397668
17693;查重率多少啊;13;728;741;20497;0.036151631946138456
17707;这篇作文，粗略估了一下至少是46分以上的，那个yyds可能真实情况会扣一两分，无伤大雅。关键能一分钟40篇，还能写得这么好;14;456;470;20497;0.022930184905108064
17722;看文笔确实比小学初中要好了，但看上去依然很模板化，试试写叙事。;22;316;338;20497;0.016490218080694737
17745;能做理综吗;19;258;277;20497;0.013514172805776456
17765;平均1秒一篇，确实很无敌;4;130;134;20497;0.006537542079328682
17770;你让我上网查，也顶的;4;96;100;20497;0.004878762745767673
17775;洛禾瞅瞅人家这书不念也罢;6;93;99;20497;0.004829975118309997
17782;YYDS写成汉字那句也很奇怪啦;7;85;92;20497;0.004488461726106259
17790;很多语句错误“没有牢固扎实的地基，空中楼阁又如何建立的起来？”语句错误;19;72;91;20497;0.004439674098648583
17810;KV悲伤荷包蛋这书念不下去了;3;67;70;20497;0.0034151339220373713
17832;咩昂;1;0;1;20497;4.878762745767673e-05
17847;她做题时联网算作弊吧;1;0;1;20497;4.878762745767673e-05
17856;墨汐;1;0;1;20497;4.878762745767673e-05
17870;GypsophilaxxxuanLJ23xxxxyyds？这是考场能写的东西？;2;0;2;20497;9.757525491535346e-05
17876;哈纳还要我们这些学渣干什么;3;0;3;20497;0.0001463628823730302
17882;蘇淺沫;1;0;1;20497;4.878762745767673e-05
17884;哈哈哈哈哈哈哈留下了yyds的一笔小郑想休息;1;0;1;20497;4.878762745767673e-05
17892;清欢a留下了yyds的一笔哈哈哈哈哈哈哈哈哈哈;1;0;1;20497;4.878762745767673e-05
17895;000rd。。。;1;0;1;20497;4.878762745767673e-05
17899;早悟兰因;1;0;1;20497;4.878762745767673e-05
17902;酷炫的腿毛啊？;2;0;2;20497;9.757525491535346e-05
17905;能让他去感受一下数学么;1;1;2;20497;9.757525491535346e-05
17910;CACOOISImd比我写的好;1;0;1;20497;4.878762745767673e-05
17920;枕奕余;1;0;1;20497;4.878762745767673e-05
17922;庆幸吧，高考作文不查查重率;1;7;8;20497;0.00039030101966141384
17941;JR;1;0;1;20497;4.878762745767673e-05
17944;想睡觉yyds的一笔;1;1;2;20497;9.757525491535346e-05
17948;大明湖畔的薯片儿;1;0;1;20497;4.878762745767673e-05
17952;就叫璇;1;0;1;20497;4.878762745767673e-05
17960;赫赫安羗小邱莫？;3;0;3;20497;0.0001463628823730302
17968;特别不理解作文写不好。明明是最简单的拿分题，;2;0;2;20497;9.757525491535346e-05
17973;鹤鹤夜晚了银河制造局;1;1;2;20497;9.757525491535346e-05
17976;寒菁菁哈哈哈哈;1;0;1;20497;4.878762745767673e-05
17978;吹染菌wife;2;0;2;20497;9.757525491535346e-05
17983;ww6;1;1;2;20497;9.757525491535346e-05
17986;阿玊;2;0;2;20497;9.757525491535346e-05
17991;突然好奇如果AI上大学，大学毕业，论文查重怎么过啊？;1;5;6;20497;0.0002927257647460604
17994;是佳不是嘉面包太硬啦真圆哇塞心嘻嘻嘻;3;0;3;20497;0.0001463628823730302
17999;WXJ忽晚;1;0;1;20497;4.878762745767673e-05
18002;咔叽玛莫奈Yin7啊哈哈;2;1;3;20497;0.0001463628823730302
18006;Sun她竟然会;1;0;1;20497;4.878762745767673e-05
18008;川复尔尔愿海卧槽，这个文笔，能满分作文了;1;0;1;20497;4.878762745767673e-05
18010;爱喝旺仔牛奶太可怕了;1;0;1;20497;4.878762745767673e-05
18013;小涵卫士栓Q我是废物;1;0;1;20497;4.878762745767673e-05
18017;周震南变成猪飞走了？;1;0;1;20497;4.878762745767673e-05
18024;Cassily;1;0;1;20497;4.878762745767673e-05
18039;这篇分绝对不会高;1;0;1;20497;4.878762745767673e-05
18047;执迷;1;0;1;20497;4.878762745767673e-05
18051;Hyejineenaks;1;0;1;20497;4.878762745767673e-05
18059;bo良ki影lIlIliw小松乃由山东梁朝伟南有乔木，不可休思;1;0;1;20497;4.878762745767673e-05
18065;十又小呆纸;1;1;2;20497;9.757525491535346e-05
18068;爱枫;1;0;1;20497;4.878762745767673e-05
18070;还好高考作文，不用查重啊;1;0;1;20497;4.878762745767673e-05
18073;他不联网写的出来吗？;2;5;7;20497;0.00034151339220373715
18090;翙翙;1;0;1;20497;4.878762745767673e-05
18094;唔西迪西卧槽卧槽卧槽;1;2;3;20497;0.0001463628823730302
18099;gtq666nhsaibriii素质市民奶酪布丁早点睡觉查重率100;3;1;4;20497;0.00019515050983070692
18108;Monster我叫不1mo驼姐口口是个搞笑女哈哈哈哈哈哈yyds的一笔;2;3;5;20497;0.00024393813728838367
18121;哀幽薇yyds哈哈哈哈哈哈哈哈哈哈哈哈哈哈哈哈哈哈哈哈哈哈哈哈;1;0;1;20497;4.878762745767673e-05
18123;魔怔大王742yyds;1;1;2;20497;9.757525491535346e-05
18127;毛香什么时候不限流陪我晚睡417我喜欢HelloKitty破防大怨种很惊艳管;1;2;3;20497;0.0001463628823730302
18132;二臂吧;1;0;1;20497;4.878762745767673e-05
18134;Hanami是棱儿哇;1;0;1;20497;4.878762745767673e-05
18139;dyqpmh5ltj21;1;0;1;20497;4.878762745767673e-05
18141;鸭梨不该来西西里比武招亲rere坝溜N北归笑不活了，真的是yyds;2;1;3;20497;0.0001463628823730302
18151;DELIVER这东西二臂吧;1;0;1;20497;4.878762745767673e-05
18154;你别撒娇了这是不是二臂;1;0;1;20497;4.878762745767673e-05
18157;夜晚的祈祷？;1;0;1;20497;4.878762745767673e-05
18162;5我去还有这种东西;1;0;1;20497;4.878762745767673e-05
18164;快植入我脑中;1;10;11;20497;0.000536663902034444
18169;后来我才知道，爸爸下的不仅是围棋，更是作为省长对一个省的规划，省如棋盘，发展如子。;1;7;8;20497;0.00039030101966141384
18171;AI没有自己的思维吧，怎么能写东西？应该都是自己数据库的东西融合的吧;2;6;8;20497;0.00039030101966141384
18174;这玩意写毕业论文查重能过不;1;6;7;20497;0.00034151339220373715
18176;A风情万种Pt不罢休vafe墨月这学他爱上他就上吧;2;5;7;20497;0.00034151339220373715
18180;啊？不能用网络词吗，我今天用了，不好意思，第一次高考还不太懂;4;5;9;20497;0.0004390886471190906
18186;把我也弄成AI吧;2;6;8;20497;0.00039030101966141384
18192;那你让它学呗;3;9;12;20497;0.0005854515294921208
18197;fffw一秒写一篇;1;28;29;20497;0.0014148411962726253
18201;来吧，成语接龙yydsshfr;1;6;7;20497;0.00034151339220373715
18208;她能不联网考试吗;1;9;10;20497;0.00048787627457676734
18212;写的不错，暂停看了一下;1;7;8;20497;0.00039030101966141384
18218;高考请记得带准考证、铅笔、橡皮、直尺、三角板、量角器、圆规、05中性笔、草稿纸、手表、垫板、矿泉水、自信还有微笑还要带脑子;1;5;6;20497;0.0002927257647460604
18221;那个别选拔人才了，都用ai呗;2;5;7;20497;0.00034151339220373715
18228;臭鸡炸炸炸好牛逼;2;27;29;20497;0.0014148411962726253
18233;我所有的向往我连本手，妙手，随手这几个词都不知道什么意思，你让我写作文;3;6;9;20497;0.0004390886471190906
18239;小小记;1;0;1;20497;4.878762745767673e-05
18245;185迷倒万千少女的大帅哥;1;0;1;20497;4.878762745767673e-05
18248;杰瑞的芝士酱来份丸子mm豆;1;0;1;20497;4.878762745767673e-05
18252;倾卿;1;0;1;20497;4.878762745767673e-05
18256;茶百道仄言暗临我不是瘦干子;1;1;2;20497;9.757525491535346e-05
18260;静香;1;0;1;20497;4.878762745767673e-05
18266;开朗de网友;2;0;2;20497;9.757525491535346e-05
18270;无尾熊饼干;1;0;1;20497;4.878762745767673e-05
18272;是旺仔啊暮色千里小语少爷信息567;1;2;3;20497;0.0001463628823730302
18275;王册;1;0;1;20497;4.878762745767673e-05
18278;狸吉瑾暧;1;0;1;20497;4.878762745767673e-05
18282;鬼东西;1;0;1;20497;4.878762745767673e-05
18285;汐O牛嬭佈丁;2;0;2;20497;9.757525491535346e-05
18288;哥的冷酷零下八度。现在进行时ing;1;1;2;20497;9.757525491535346e-05
18290;偏折;1;0;1;20497;4.878762745767673e-05
18292;落日彩虹;1;0;1;20497;4.878762745767673e-05
18301;长夜不眠而已;1;0;1;20497;4.878762745767673e-05
18308;悸沫;1;0;1;20497;4.878762745767673e-05
18310;君故哦哦哦哦哦哦;1;0;1;20497;4.878762745767673e-05
18315;芜;2;0;2;20497;9.757525491535346e-05
18321;赵烧鸡排饭好深情毛驴倒着骑舔狗相对论NLee想睡觉阿伽雷斯椒盐老干妈;2;3;5;20497;0.00024393813728838367
18324;Ni小乔很湉;1;0;1;20497;4.878762745767673e-05
18333;Tears;1;0;1;20497;4.878762745767673e-05
18338;用户9026246462318gx在劫难逃你爸;1;0;1;20497;4.878762745767673e-05
18342;贺知一;1;0;1;20497;4.878762745767673e-05
18350;Onlyone;1;0;1;20497;4.878762745767673e-05
18352;二;2;0;2;20497;9.757525491535346e-05
18355;Triste12345;1;0;1;20497;4.878762745767673e-05
18358;LU;1;1;2;20497;9.757525491535346e-05
18361;不止;1;0;1;20497;4.878762745767673e-05
18365;月下吴人;1;0;1;20497;4.878762745767673e-05
18369;青色的螃蟹wwy瘦了吗日落浮梦小刘turbo;1;1;2;20497;9.757525491535346e-05
18372;wei然;1;0;1;20497;4.878762745767673e-05
18385;困的昏fufu;1;0;1;20497;4.878762745767673e-05
18387;范饭烦年白白不说拜拜;1;2;3;20497;0.0001463628823730302
18391;西柠syz;1;0;1;20497;4.878762745767673e-05
18393;月上有颗星兵长好腿力;1;0;1;20497;4.878762745767673e-05
18398;手里能捧花吗;1;0;1;20497;4.878762745767673e-05
18402;RK隞吷;1;0;1;20497;4.878762745767673e-05
18405;神明;2;0;2;20497;9.757525491535346e-05
18410;再看就把你喝掉;1;0;1;20497;4.878762745767673e-05
18418;正丁醇;1;0;1;20497;4.878762745767673e-05
18421;时之戏影金钱豹玩游戏;1;0;1;20497;4.878762745767673e-05
18436;在意;1;0;1;20497;4.878762745767673e-05
18444;瞅一眼洋芋iHyaa虾仁蒸饺偏爱篮球的jiaoXDTTTTTTT趁月色撩人小羊机机渣渣C吟游诗人和男人沟通有问题咕啾囍偏爱晚风;4;9;13;20497;0.0006342391569497975
18450;无情干饭王快看;1;1;2;20497;9.757525491535346e-05
18464;LND啊这;1;1;2;20497;9.757525491535346e-05
18473;思诚这书不念了;1;1;2;20497;9.757525491535346e-05
18476;美少女李逵YYDS;1;1;2;20497;9.757525491535346e-05
18489;困糊涂了我;1;1;2;20497;9.757525491535346e-05
18499;柚子熟了他脑子有个百度;1;1;2;20497;9.757525491535346e-05
18503;0717落;1;1;2;20497;9.757525491535346e-05
18507;作文查重试试;1;1;2;20497;9.757525491535346e-05
18509;Y吴世勋的老娇妻有点is还让咱读书吗;1;1;2;20497;9.757525491535346e-05
18515;puppyLinmousZikAholic小源？？？;2;1;3;20497;0.0001463628823730302
18522;桃子喜欢你这学不上也罢;1;1;2;20497;9.757525491535346e-05
18525;零零爱卧槽;1;1;2;20497;9.757525491535346e-05
18531;Trouvahbt来一口餐包烹烹OOOOOO淦就行我很需要;2;1;3;20497;0.0001463628823730302
18539;橙色星球干饭人磕cp啦看完;1;1;2;20497;9.757525491535346e-05
18544;不会围棋高考作文是不是就凉了;2;1;3;20497;0.0001463628823730302
18549;看过第一序列;1;1;2;20497;9.757525491535346e-05
18552;F今早浏览器里的那个智能ai;1;1;2;20497;9.757525491535346e-05
18560;THS好家伙;2;1;3;20497;0.0001463628823730302
18564;四十秒甜加冰;1;1;2;20497;9.757525491535346e-05
18567;第九片海;1;1;2;20497;9.757525491535346e-05
18572;中年发福我妈叫我别买了yyds的一笔哈哈哈哈哈哈哈哈哈哈妈的笑飞;1;1;2;20497;9.757525491535346e-05
18581;兔子水仙这不二臂吗;1;1;2;20497;9.757525491535346e-05
18583;桂圆干让数字人上班呗？;1;1;2;20497;9.757525491535346e-05
18585;哈哈哈哈密瓜思雨新我很需要她;1;1;2;20497;9.757525491535346e-05
18591;李明治;1;1;2;20497;9.757525491535346e-05
18594;无语竹了肉乎乎的蚊子能写论文吗;1;1;2;20497;9.757525491535346e-05
18600;哈哩啾啾月BLiassy行社会不需要我了呗;2;1;3;20497;0.0001463628823730302
18604;桐人卧槽;1;1;2;20497;9.757525491535346e-05
18622;不会是你的小阚派大唾沫星子小孟我是小Fu啊;1;1;2;20497;9.757525491535346e-05
18625;叶菇菇不是菇解忧;1;1;2;20497;9.757525491535346e-05
18628;炫个X烧包;1;1;2;20497;9.757525491535346e-05
18632;存在E小狗小狗小妖怪可爱如你不是，这是“人”;2;1;3;20497;0.0001463628823730302
18635;暮雅BIYUFEI俺六乘二Ymo韩硕你好帅余余的渝渝一秒一篇作文;1;1;2;20497;9.757525491535346e-05
18643;你怀念的鸽子迪迪悠悠球司马幸运大鹅能不能替我写论文;1;1;2;20497;9.757525491535346e-05
18648;桃木小黄不可以再熬夜了Po、阿云以后这书让他们给我念;2;1;3;20497;0.0001463628823730302
18651;CCCJH牛;1;1;2;20497;9.757525491535346e-05
18657;莫小嫣;2;1;3;20497;0.0001463628823730302
18669;养只小老虎我们要被淘汰了;1;1;2;20497;9.757525491535346e-05
18677;诗和远方;1;1;2;20497;9.757525491535346e-05
18682;星河流转，我只喜欢你豫成都没有下雪天;1;1;2;20497;9.757525491535346e-05
18692;春日宴好厉害;1;1;2;20497;9.757525491535346e-05
18701;南枝菅田将晖111;1;1;2;20497;9.757525491535346e-05
18705;0;1;1;2;20497;9.757525491535346e-05
18707;发霉小屁桃湘水雪村透笑死我了，，;1;1;2;20497;9.757525491535346e-05
18717;清嘉小范范呀;1;1;2;20497;9.757525491535346e-05
18720;没头脑看到yyds，我要笑死;1;1;2;20497;9.757525491535346e-05
18725;陳啊牛逼;2;1;3;20497;0.0001463628823730302
18735;M珏QYjjjjsjfnRiver荷Stephenie蟹黄胡椒粉lyyyyyyyyyy心岛未晴。;1;1;2;20497;9.757525491535346e-05
18740;南兮酱酱有什么意义吗？我不懂，我不理解。;1;1;2;20497;9.757525491535346e-05
18743;耶Li九九喜欢伯贤完了这个世界完了;1;1;2;20497;9.757525491535346e-05
18747;沐雨橙风卧槽这还真写了;1;1;2;20497;9.757525491535346e-05
18749;wangyiran66哈哈哈哈哈哈哈布丁小狗LLLz妄图窜上180F小咕咚Pure锈酥乐儿;1;1;2;20497;9.757525491535346e-05
18752;我睡觉的时候不困哎真牛;1;1;2;20497;9.757525491535346e-05
18754;长安雪;1;1;2;20497;9.757525491535346e-05
18761;Labc白放弃来得及，还有机会，你可以;1;1;2;20497;9.757525491535346e-05
18768;直接给我一考;1;1;2;20497;9.757525491535346e-05
18771;。。。。。人工智能代替我算了;1;1;2;20497;9.757525491535346e-05
18774;7;1;1;2;20497;9.757525491535346e-05
18784;本手，妙手，俗手，我还是当我的美团骑手;1;1;2;20497;9.757525491535346e-05
18790;好开心喔ProDeng鑫鑫子星星1314这书是念不下去了;1;1;2;20497;9.757525491535346e-05
18792;旺旺大李包原核生物河南第一厄斐琉斯;1;1;2;20497;9.757525491535346e-05
18804;赵财进宝好想发明一个替身机器人咱们每个人都一人发一个让他们替咱们上班上学;1;1;2;20497;9.757525491535346e-05
18806;小兔叽的胡萝卜逃亡蟹黄堡是荔枝呀嗨小鹿归雪离谱;2;1;3;20497;0.0001463628823730302
18810;叶落羽风薰的狗小兔观察机叹哈哈哈哈哈哈哈哈哈哈他妈的yyds的一笔;2;1;3;20497;0.0001463628823730302
18816;三天饿九顿大熙蓝七七真理;1;1;2;20497;9.757525491535346e-05
18820;一会乍一看挺牛逼，细看啥也不是;1;1;2;20497;9.757525491535346e-05
18824;卡其卡的熊语怪;2;1;3;20497;0.0001463628823730302
18828;m;1;1;2;20497;9.757525491535346e-05
18832;尣茳薬今天也要timixsszxj;1;1;2;20497;9.757525491535346e-05
18837;李思颖发大财李大猪pretty罐装天天开心版;1;1;2;20497;9.757525491535346e-05
18850;睡觉的时候不困yyds;1;1;2;20497;9.757525491535346e-05
18854;星绘;1;1;2;20497;9.757525491535346e-05
18856;世间恒温lavenderooo圈圈圈圈Answer万有引力小楚楚楚楚Rex小椰汁moonquake;1;1;2;20497;9.757525491535346e-05
18862;Comet飞龙在天;2;1;3;20497;0.0001463628823730302
18865;6F陌然平方昵称已重置机器的意义是什么;1;1;2;20497;9.757525491535346e-05
18867;。GeWang（赶ddl版）Tn2SoZaaKz罚她替我上大学;1;1;2;20497;9.757525491535346e-05
18871;Ating球球了，把ai塞我脑子里吧;1;1;2;20497;9.757525491535346e-05
18876;用的数据集太新了？;1;1;2;20497;9.757525491535346e-05
18880;是不是提前知道题了;1;1;2;20497;9.757525491535346e-05
18882;去月亮上偷猪;2;1;3;20497;0.0001463628823730302
18893;粥;1;1;2;20497;9.757525491535346e-05
18897;FAKELOVE？;2;1;3;20497;0.0001463628823730302
18900;题目怎么越来越玄幻;1;1;2;20497;9.757525491535346e-05
18902;Echo卧槽;1;1;2;20497;9.757525491535346e-05
18906;我不睡觉Oo;1;1;2;20497;9.757525491535346e-05
18913;魔鬼小子幸亏生的早;1;1;2;20497;9.757525491535346e-05
18918;夜语瞳谨言慎行，但行好事独处（）废话生成器;1;1;2;20497;9.757525491535346e-05
18921;cc闯;1;1;2;20497;9.757525491535346e-05
18923;搜索，筛选，复制，粘贴，一篇作文完成，有什么意义吗;1;1;2;20497;9.757525491535346e-05
18927;799;1;1;2;20497;9.757525491535346e-05
18936;波特卡斯D艾斯totoo是你啊张飞李逵手牵手BOOM我是磕睡家陌黎;1;1;2;20497;9.757525491535346e-05
18941;SSEVENN某年某月某天常相思;1;1;2;20497;9.757525491535346e-05
18945;IIIIIIIIIMIKAAAAAA卧槽;2;1;3;20497;0.0001463628823730302
18950;洛尘yyyyy梦见你粥小怼嘎嘎嘎嘎;1;1;2;20497;9.757525491535346e-05
18990;玖七七拥挤低头的沙丁鱼要咱干啥呢;1;0;1;20497;4.878762745767673e-05
18992;浅拒萧逸11次;1;0;1;20497;4.878762745767673e-05
18994;ppp不吃海鲜Toyyds的一笔;1;0;1;20497;4.878762745767673e-05
19021;waix？;1;0;1;20497;4.878762745767673e-05
19027;我比不过一个小AI;1;0;1;20497;4.878762745767673e-05
19037;咕咕药酱;2;0;2;20497;9.757525491535346e-05
19044;番茄炒鸡蛋;1;0;1;20497;4.878762745767673e-05
19050;守护孤勇少女的日常不是，怎么还有YYDS的一笔？？？？韩信：我谢谢你;1;0;1;20497;4.878762745767673e-05
19052;璐璐璐璐;1;0;1;20497;4.878762745767673e-05
19055;碗妹比死也比不过这玩意儿;1;0;1;20497;4.878762745767673e-05
19061;0;1;0;1;20497;4.878762745767673e-05
19066;Me壹贰壹叫我小番茄;2;0;2;20497;9.757525491535346e-05
19069;千千结;2;0;2;20497;9.757525491535346e-05
19073;黄桃味这书是没法念了;1;0;1;20497;4.878762745767673e-05
19075;看日落吗;1;0;1;20497;4.878762745767673e-05
19085;我是杀手;1;0;1;20497;4.878762745767673e-05
19088;别打游戏了喂典狱司;1;0;1;20497;4.878762745767673e-05
19091;度;1;0;1;20497;4.878762745767673e-05
19094;橘子味的外太空;1;0;1;20497;4.878762745767673e-05
19101;江执玺是吕不是李;1;0;1;20497;4.878762745767673e-05
19110;香菜狗都不吃;1;0;1;20497;4.878762745767673e-05
19115;ai真要觉醒了吗;1;0;1;20497;4.878762745767673e-05
19131;知辰买束花送你攒一口袋星星送给你你丞哥姓蒋正常人风存人陌;1;0;1;20497;4.878762745767673e-05
19134;wkw真服了，要不然让他上大学工作吧;1;0;1;20497;4.878762745767673e-05
19143;这不是visualstudiocode么;1;0;1;20497;4.878762745767673e-05
19150;发财吧;1;0;1;20497;4.878762745767673e-05
19153;挺行嘎嘎皮皮龍虾丶艾吉奥隔路王;1;0;1;20497;4.878762745767673e-05
19162;这书不念了BaekHyun晚风刚刚好;1;0;1;20497;4.878762745767673e-05
19184;能写论文吗，;1;0;1;20497;4.878762745767673e-05
19190;无敢？;1;0;1;20497;4.878762745767673e-05
19206;俊俊很甜我靠，这什么玩意;1;0;1;20497;4.878762745767673e-05
19210;涵牛逼;1;0;1;20497;4.878762745767673e-05
19215;Ao哈哈哈哈哈yyds的一笔;1;0;1;20497;4.878762745767673e-05
19233;困死了666;1;0;1;20497;4.878762745767673e-05
19235;和男人沟通有障碍;2;0;2;20497;9.757525491535346e-05
19248;独孤龍;2;0;2;20497;9.757525491535346e-05
19252;pluto那为啥还要折磨我们这些人;1;0;1;20497;4.878762745767673e-05
19257;好牛逼玉洛;1;0;1;20497;4.878762745767673e-05
19261;我是真的菜6;1;0;1;20497;4.878762745767673e-05
19270;戎马书生坠了真没意思;1;0;1;20497;4.878762745767673e-05
19272;反杀闰土的猹这里面有水分吧，别让我在里面看到我的句子;1;0;1;20497;4.878762745767673e-05
19285;开心市民小李;1;0;1;20497;4.878762745767673e-05
19293;养一只猫哈哈哈哈哈哈哈哈哈哈哈哈哈哈哈哈哈;1;0;1;20497;4.878762745767673e-05
19300;来来来，给他新课标一卷高考数学一套;1;0;1;20497;4.878762745767673e-05
19303;沐雪xxxx可问困王王王同学二年搞什么;3;0;3;20497;0.0001463628823730302
19310;D这;2;0;2;20497;9.757525491535346e-05
19313;PISRIX？1秒1篇;4;0;4;20497;0.00019515050983070692
19318;这世界要我何用怎么还不可以呀Chase苏文早点睡觉燚龘;1;0;1;20497;4.878762745767673e-05
19324;gugugugu;1;0;1;20497;4.878762745767673e-05
19329;呃呃呃额AI什么鬼;2;0;2;20497;9.757525491535346e-05
19342;麦辣鸡块不能理解;1;0;1;20497;4.878762745767673e-05
19345;陪你去流浪;1;0;1;20497;4.878762745767673e-05
19347;快乐幸福健康平安小王子;2;0;2;20497;9.757525491535346e-05
19350;一珀小姐什么鬼登西。。。。。。。。。。。。;1;0;1;20497;4.878762745767673e-05
19358;趙羽壹;3;0;3;20497;0.0001463628823730302
19368;0;1;0;1;20497;4.878762745767673e-05
19374;xwj;1;0;1;20497;4.878762745767673e-05
19377;执念希望我能成为她;1;0;1;20497;4.878762745767673e-05
19382;热衷田朴实;2;0;2;20497;9.757525491535346e-05
19388;非正常生物研究中心;1;0;1;20497;4.878762745767673e-05
19390;立马不想考了她帮我考吧;1;0;1;20497;4.878762745767673e-05
19392;柔声真的666;1;0;1;20497;4.878762745767673e-05
19394;冉上加个草这书不念也罢;1;0;1;20497;4.878762745767673e-05
19402;ix;1;0;1;20497;4.878762745767673e-05
19404;NnnWow快把她塞我脑袋里;1;0;1;20497;4.878762745767673e-05
19406;你饿不饿我饿;1;0;1;20497;4.878762745767673e-05
19410;0;1;0;1;20497;4.878762745767673e-05
19416;念念40秒;1;0;1;20497;4.878762745767673e-05
19424;玫瑰留下了YYDS的一笔请问算是是数据的bug吗;1;0;1;20497;4.878762745767673e-05
19429;IKUN;1;0;1;20497;4.878762745767673e-05
19433;我目瞪口呆三水加函;1;0;1;20497;4.878762745767673e-05
19435;2019了解“玊尔”;1;0;1;20497;4.878762745767673e-05
19439;衡墨;1;0;1;20497;4.878762745767673e-05
19448;叹蛋养芙奶啊对对对对卧槽，她叫晓晓，我也叫晓晓，四舍五入，就是我无敌了;1;0;1;20497;4.878762745767673e-05
19458;温霜降我能写完一篇都是个奇迹;1;0;1;20497;4.878762745767673e-05
19465;不太清楚卧槽牛逼这样显得我们很蠢诶;1;0;1;20497;4.878762745767673e-05
19468;“不谈恋爱”;1;0;1;20497;4.878762745767673e-05
19473;iiiii考的过吗;1;0;1;20497;4.878762745767673e-05
19480;小禾Diecisis高氯酸流流把芯片植入我脑子里谢谢;1;0;1;20497;4.878762745767673e-05
19484;重生之我是吴世勋老婆让他帮我写;1;0;1;20497;4.878762745767673e-05
19486;绾绾;1;0;1;20497;4.878762745767673e-05
19491;茶语看看人家;4;0;4;20497;0.00019515050983070692
19497;阿巴阿巴豆本豆豆奶哈哈哈哈哈哈哈哈哈yyds;1;0;1;20497;4.878762745767673e-05
19517;早Www硕陈陈;1;0;1;20497;4.878762745767673e-05
19526;离谱;1;0;1;20497;4.878762745767673e-05
19532;阿汪;1;0;1;20497;4.878762745767673e-05
19534;陆沉你看她;1;0;1;20497;4.878762745767673e-05
19541;迟迟;1;0;1;20497;4.878762745767673e-05
19545;今天您开心吗？我好想睡觉的笨鸟阿呱啊这;1;0;1;20497;4.878762745767673e-05
19554;酒吧;1;0;1;20497;4.878762745767673e-05
19556;？C;1;0;1;20497;4.878762745767673e-05
19561;咩咩羊凡要我们干啥;1;0;1;20497;4.878762745767673e-05
19564;BeginnerMw;1;0;1;20497;4.878762745767673e-05
19570;34小狗立正稍息靠;1;0;1;20497;4.878762745767673e-05
19575;太阳花里有瓜子er写的真好;1;0;1;20497;4.878762745767673e-05
19577;初梨操，我是什么废物;1;0;1;20497;4.878762745767673e-05
19594;哼哼哼无语四十秒;1;0;1;20497;4.878762745767673e-05
19597;Devil川上赴野阿骚你够了冰山阿D重生之超级恐怖无敌破坏暴龙战士快抄;1;0;1;20497;4.878762745767673e-05
19599;十七日尾灯什么东西我真服了;1;0;1;20497;4.878762745767673e-05
19601;三岁南城w;2;0;2;20497;9.757525491535346e-05
19607;明天见;1;0;1;20497;4.878762745767673e-05
19609;透这还学个啥;1;0;1;20497;4.878762745767673e-05
19613;Y;1;0;1;20497;4.878762745767673e-05
19617;每天都想吃D;1;0;1;20497;4.878762745767673e-05
19619;CODM幽灵无语法克？？？？;2;0;2;20497;9.757525491535346e-05
19623;MeetyouKAP星星奶泡kksolivia绪风有这玩意儿还用自己想？;2;0;2;20497;9.757525491535346e-05
19627;SSAWS拾壹1042kmswilder看看人家;1;0;1;20497;4.878762745767673e-05
19633;大家工作中，写作多不多？用哪种文体多;1;0;1;20497;4.878762745767673e-05
19642;小雪同学绰了让机器学吧;1;0;1;20497;4.878762745767673e-05
19645;衣z牛逼;1;0;1;20497;4.878762745767673e-05
19653;夏天万物皆空bxuwbh;1;0;1;20497;4.878762745767673e-05
19657;野莓子;1;0;1;20497;4.878762745767673e-05
19660;Zhou心怡囍歡雪一秒一篇;2;0;2;20497;9.757525491535346e-05
19665;aisme;1;0;1;20497;4.878762745767673e-05
19667;俗手点题太牛了;1;0;1;20497;4.878762745767673e-05
19670;条河麻耶它居然知道yyds怎么用;1;0;1;20497;4.878762745767673e-05
19675;512无语;1;0;1;20497;4.878762745767673e-05
19695;静默;1;0;1;20497;4.878762745767673e-05
19702;Cmsymo好運時間查一下重看看;2;0;2;20497;9.757525491535346e-05
19714;鄧待紫为棋有点吓人;1;0;1;20497;4.878762745767673e-05
19719;思念变成海周五播报员18畅不如机器;2;0;2;20497;9.757525491535346e-05
19723;苏哲靠;1;0;1;20497;4.878762745767673e-05
19727;JYSY我靠zkl我是废物;1;0;1;20497;4.878762745767673e-05
19729;留下陪我我真服了;1;0;1;20497;4.878762745767673e-05
19731;ysggdhhd学什么专业都没用了;2;0;2;20497;9.757525491535346e-05
19734;1900;1;0;1;20497;4.878762745767673e-05
19736;脑壳嗡嗡这书不读也罢;3;0;3;20497;0.0001463628823730302
19741;Murkey;1;0;1;20497;4.878762745767673e-05
19743;H笑死;1;0;1;20497;4.878762745767673e-05
19753;啸了个叨空中楼阁：比喻虚幻的事物或脱离实际的空想。虽然他这个文采挺好，引经据典的，但是遣词造句还是差了点;1;0;1;20497;4.878762745767673e-05
19756;雾景海卧槽;2;0;2;20497;9.757525491535346e-05
19759;妈妈说名字太长会有傻子跟着读西蒙的猫煎饼狗子不是狗我靠这不得给满分啊;1;0;1;20497;4.878762745767673e-05
19771;pick我1下;1;0;1;20497;4.878762745767673e-05
19773;海鸥无语到了;1;0;1;20497;4.878762745767673e-05
19788;野性;1;0;1;20497;4.878762745767673e-05
19790;小甘永远睡不醒笑死了yyds的一笔;1;0;1;20497;4.878762745767673e-05
19793;万叶万叶我爱万叶呃;1;0;1;20497;4.878762745767673e-05
19796;Hello一川;1;0;1;20497;4.878762745767673e-05
19801;美女不吃辣;1;0;1;20497;4.878762745767673e-05
19807;T;1;0;1;20497;4.878762745767673e-05
19813;青栀可恶，活得不如机器人;1;0;1;20497;4.878762745767673e-05
19817;AIJIQ好想拥有一个;2;0;2;20497;9.757525491535346e-05
19830;秋生菜;1;0;1;20497;4.878762745767673e-05
19833;涛格式很土，没有新意，果然创新还得看人类;1;0;1;20497;4.878762745767673e-05
19835;盒盒盒盒砸机器人牛掰;1;0;1;20497;4.878762745767673e-05
19845;Augenstern苏玄三我真的真的很讨厌体育忆一个素质网友美女口水WHR2022退网;3;0;3;20497;0.0001463628823730302
19858;留下了yyds的一笔耶也野yeah堂堂;1;0;1;20497;4.878762745767673e-05
19860;舍予之兔她百度凑的吧;1;0;1;20497;4.878762745767673e-05
19866;涅涅涅锅我人都傻了;1;0;1;20497;4.878762745767673e-05
19869;VCn这书还怎么读;1;0;1;20497;4.878762745767673e-05
19876;40秒写40篇高考作文？没看懂;1;0;1;20497;4.878762745767673e-05
19885;暮;1;0;1;20497;4.878762745767673e-05
19887;琳琳大宝贝我真怕AI会超过人类;1;0;1;20497;4.878762745767673e-05
19889;柾鸠;1;0;1;20497;4.878762745767673e-05
19899;一口我擦;1;0;1;20497;4.878762745767673e-05
19902;替那7个人去考吃鱼尾巴吗烦死了;2;0;2;20497;9.757525491535346e-05
19913;持闪电的人;1;0;1;20497;4.878762745767673e-05
19918;HHH我一篇55分钟;1;0;1;20497;4.878762745767673e-05
19921;茗玖我哭了，为啥她不跟我写个;1;0;1;20497;4.878762745767673e-05
19924;白日梦妍等星辰坠落下辈子不要做人了;2;0;2;20497;9.757525491535346e-05
19930;故人高考算是让她玩明白了;1;0;1;20497;4.878762745767673e-05
19933;Simon雾也绕秋山这程序咋编的;1;0;1;20497;4.878762745767673e-05
19936;叁肆来客我觉得很离谱;2;0;2;20497;9.757525491535346e-05
19940;白瓷梅子酒这个;1;0;1;20497;4.878762745767673e-05
19945;爱会如初吗好快;1;0;1;20497;4.878762745767673e-05
19952;喵桑为什么不是在我读书的时候出这种机器人写作文都可以直接抄了不用再绞尽脑汁写夜晚下雨妈妈送伞;1;0;1;20497;4.878762745767673e-05
19954;肉肉菜JIA小川27Ken宋歌歌好牛逼;1;0;1;20497;4.878762745767673e-05
19962;崔尚书1h让他做高考数学;1;0;1;20497;4.878762745767673e-05
19964;刘奎铭小瑞13宝子大邱庄民少冰咚;1;0;1;20497;4.878762745767673e-05
19969;肥兔呼噜噜南樱许返想要;2;0;2;20497;9.757525491535346e-05
19974;hhxjk我趣;1;0;1;20497;4.878762745767673e-05
19985;温热蝙蝠那让ai上学去呗我又不是ai的脑子;1;0;1;20497;4.878762745767673e-05
19992;麦旋风留给你;1;0;1;20497;4.878762745767673e-05
19995;9uki取代我考试取代我上大学;1;0;1;20497;4.878762745767673e-05
19998;林琛晞啊yyds的一笔;1;0;1;20497;4.878762745767673e-05
20004;苹果好牛;1;0;1;20497;4.878762745767673e-05
20006;和小司岁岁年年;1;0;1;20497;4.878762745767673e-05
20009;GBXHHY恋鑫;1;0;1;20497;4.878762745767673e-05
20011;银河小铁骑啊，这;2;0;2;20497;9.757525491535346e-05
20020;Oo;1;0;1;20497;4.878762745767673e-05
20023;雾里踏柳梢TeensinTimes安翎夏什么鬼呀;1;0;1;20497;4.878762745767673e-05
20027;驯还有这玩意儿;1;0;1;20497;4.878762745767673e-05
20043;买一个给我考四六级啵啵很有钱果郡王女士奶油泡胡糕糕快来旺仔小徐BYAM;3;0;3;20497;0.0001463628823730302
20049;她考得了;1;0;1;20497;4.878762745767673e-05
20051;Xyaaa0off汐汐汐永远相信光thu伊蕾娜我老婆琦只想睡觉;3;0;3;20497;0.0001463628823730302
20061;枫影hhhhhhc;1;0;1;20497;4.878762745767673e-05
20064;Hi，story玛德我连AI都比不过;1;0;1;20497;4.878762745767673e-05
20068;漫游地球计划叫啥好呢雨与屿李LLLLLLLLLL我有沉默;1;0;1;20497;4.878762745767673e-05
20073;齊司禮Error救命;1;0;1;20497;4.878762745767673e-05
20079;阳原来yyds高考不可以用;1;0;1;20497;4.878762745767673e-05
20086;选我无用怀里有只猫宋小主，白活了;1;0;1;20497;4.878762745767673e-05
20090;顾小桃这也太顶了吧;1;0;1;20497;4.878762745767673e-05
20095;西洲;1;0;1;20497;4.878762745767673e-05
20097;柴米油盐的浪漫;2;0;2;20497;9.757525491535346e-05
20100;徐州孙千没事吧这;1;0;1;20497;4.878762745767673e-05
20102;反方向的钟女士卧槽;1;0;1;20497;4.878762745767673e-05
20111;独自星系MYMYMYneversayneverErosion只想暴富咋说呢有什么可说的;3;0;3;20497;0.0001463628823730302
20116;宇宙霹雳无敌最强牛逼暴龙战士大帅比;1;0;1;20497;4.878762745767673e-05
20124;未关注人消息超话社区yyds;1;0;1;20497;4.878762745767673e-05
20128;涵zz涵寄给月亮的爱意爱意真牛;2;0;2;20497;9.757525491535346e-05
20131;61我也需要;1;0;1;20497;4.878762745767673e-05
20136;糖福记酥心徐;2;0;2;20497;9.757525491535346e-05
20140;Tendresse叙利亚公主梦感觉自己要飞升不是K某能生成论文吗，我真的很需要;1;0;1;20497;4.878762745767673e-05
20142;十七是宝贝;1;0;1;20497;4.878762745767673e-05
20146;“吃掉一个月亮”这个更6;1;0;1;20497;4.878762745767673e-05
20148;四月心里有我YWen欒精灵网易宝;2;0;2;20497;9.757525491535346e-05
20159;载着宇航员的机车司机退;1;0;1;20497;4.878762745767673e-05
20162;祖国的花朵Eternity卧槽;2;0;2;20497;9.757525491535346e-05
20167;言吾;1;0;1;20497;4.878762745767673e-05
20170;夏好家伙，人工智能;1;0;1;20497;4.878762745767673e-05
20172;breakup救命;1;0;1;20497;4.878762745767673e-05
20177;Haruka灿四十秒给我四十年我都不能;1;0;1;20497;4.878762745767673e-05
20185;Xxxtentacion流浪童话;1;0;1;20497;4.878762745767673e-05
20188;睡不醒啊7受不了了，我是sb;1;0;1;20497;4.878762745767673e-05
20194;蜡笔小亲肝无女无聊碱性怪人我擦？;1;0;1;20497;4.878762745767673e-05
20201;餍足我是真的很需要;1;0;1;20497;4.878762745767673e-05
20203;呃那都别学了;1;0;1;20497;4.878762745767673e-05
20208;可恶芋头;1;0;1;20497;4.878762745767673e-05
20212;Ren冉凌;1;0;1;20497;4.878762745767673e-05
20217;栀戈鹿耳何子笙笑死我了yyds;1;0;1;20497;4.878762745767673e-05
20220;雾岛风起时这不纯书币吗;1;0;1;20497;4.878762745767673e-05
20223;安吃果桃苏y奈何本人没文化，只能说，厉害;2;0;2;20497;9.757525491535346e-05
20226;520F20;1;0;1;20497;4.878762745767673e-05
20229;W歖2003126日暮失約;1;0;1;20497;4.878762745767673e-05
20238;终于要远离鲨b了真开心;1;0;1;20497;4.878762745767673e-05
20241;果砸这也行;1;0;1;20497;4.878762745767673e-05
20243;我一个姐高考三分钟写完800字作文y136;1;0;1;20497;4.878762745767673e-05
20245;歌颂者这机器人;1;0;1;20497;4.878762745767673e-05
20251;swz要人干啥;1;0;1;20497;4.878762745767673e-05
20254;今天也很赞;1;0;1;20497;4.878762745767673e-05
20265;Nicolel哦莫;1;0;1;20497;4.878762745767673e-05
20269;喝口可乐成大璇诶李不知名选手哈哈哈哈哈哈好想笑;1;0;1;20497;4.878762745767673e-05
20272;羽柒40秒写了40篇;1;0;1;20497;4.878762745767673e-05
20278;寄托思维;1;0;1;20497;4.878762745767673e-05
20280;ArtemisSehun土豆HilfAlivecccx现在就退学;2;0;2;20497;9.757525491535346e-05
20293;发霉菜牛;1;0;1;20497;4.878762745767673e-05
20296;Al立川Leeright;1;0;1;20497;4.878762745767673e-05
20307;念久ai考生？？？;1;0;1;20497;4.878762745767673e-05
20313;杨减yyds机器人也;1;0;1;20497;4.878762745767673e-05
20318;绿蚁好牛逼;3;0;3;20497;0.0001463628823730302
20322;0;1;0;1;20497;4.878762745767673e-05
20327;盛夏逐梦蒲公英离染陈大花花花萝卜puppy;2;0;2;20497;9.757525491535346e-05
20337;银河信使一秒一篇;1;0;1;20497;4.878762745767673e-05
20339;我要揍死我自己;1;0;1;20497;4.878762745767673e-05
20345;浮上;1;0;1;20497;4.878762745767673e-05
20348;你个老六;1;0;1;20497;4.878762745767673e-05
20356;建一bro看看;2;0;2;20497;9.757525491535346e-05
20359;北冥有鱼下一句是什么;6;0;6;20497;0.0002927257647460604
20366;0;1;0;1;20497;4.878762745767673e-05
20369;是玉子吖请装我脑子里;1;0;1;20497;4.878762745767673e-05
20372;Rimi笑死;1;0;1;20497;4.878762745767673e-05
20376;普信男小垚不吃鱼雨婷欧尼小樱桃;2;0;2;20497;9.757525491535346e-05
20381;逾YYDS;1;0;1;20497;4.878762745767673e-05
20385;晚榆我C;1;0;1;20497;4.878762745767673e-05
20389;Alex;1;0;1;20497;4.878762745767673e-05
20391;蜉蝣笑得我眼泪要流下来;1;0;1;20497;4.878762745767673e-05
20395;美女无语;1;0;1;20497;4.878762745767673e-05
20397;0;2;0;2;20497;9.757525491535346e-05
20405;蓝羽毛给我一个呗;1;0;1;20497;4.878762745767673e-05
20408;不就四十篇嘛，我快起来四十秒也能写四十个字每日必想什么时候毕业;1;0;1;20497;4.878762745767673e-05
20416;还要努力啊;1;0;1;20497;4.878762745767673e-05
20421;有亿点点酷0306冷酷秋刀鱼小冯偏爱的人是小莫;2;0;2;20497;9.757525491535346e-05
20424;Archive;1;0;1;20497;4.878762745767673e-05
20426;favourQ茫乖乖饿的咕咕叫;1;0;1;20497;4.878762745767673e-05
20430;余这是在干嘛;1;0;1;20497;4.878762745767673e-05
20436;Cooltone;1;0;1;20497;4.878762745767673e-05
20440;似此星辰非昨夜还真有点意思就是还欠缺点;1;0;1;20497;4.878762745767673e-05
20446;沫;1;0;1;20497;4.878762745767673e-05
20451;好可怕啊杀人诛心;1;0;1;20497;4.878762745767673e-05
20456;吾朝暮卿你看这个机器人的名字;2;0;2;20497;9.757525491535346e-05
20466;离异且带娃58yyds的一笔;1;0;1;20497;4.878762745767673e-05
20469;JjjjYyyyy;2;0;2;20497;9.757525491535346e-05
20477;麦当劳公主蝶蝶让她替我考算了;1;0;1;20497;4.878762745767673e-05
20484;爱吃糖的小盆友呀你没事吧天呐;2;0;2;20497;9.757525491535346e-05
20490;我是赌命呀的修勾陆星延“美式后卫”留在我身边十五归期XvemiY9我四十分钟编了四百字;2;0;2;20497;9.757525491535346e-05
20496;向北666666666;1;0;1;20497;4.878762745767673e-05
20502;匿于冬天行了，往后别用人考试了不就得了;1;0;1;20497;4.878762745767673e-05
20511;Hypothesis;1;0;1;20497;4.878762745767673e-05
20517;二靳译肯凌凌七月怎么还有ai啊;2;0;2;20497;9.757525491535346e-05
20520;0;1;0;1;20497;4.878762745767673e-05
20524;众星捧月而且他那个YYDS不算，正常高考，他那个作文可以得48分;1;0;1;20497;4.878762745767673e-05
20531;我复制粘贴都没这快;1;0;1;20497;4.878762745767673e-05
20536;一起去看海吗这是啥;1;0;1;20497;4.878762745767673e-05
20538;青鸟;1;0;1;20497;4.878762745767673e-05
20540;丑你咋地;2;0;2;20497;9.757525491535346e-05
20543;让李丽四十秒改完;1;0;1;20497;4.878762745767673e-05
20547;月上神明居居复居居有这个可以省下大学一半的时间;1;0;1;20497;4.878762745767673e-05
20549;赞没有妆也很帅Yi锅碗瓢盆爱季末笑死;2;0;2;20497;9.757525491535346e-05
20553;维生素;1;0;1;20497;4.878762745767673e-05
20555;toto真写出来了;1;0;1;20497;4.878762745767673e-05
20559;薄荷之夏Re景行行止LyyyyyueemmmwxL叙利亚好牛;1;0;1;20497;4.878762745767673e-05
20562;签收日落6666666666666666666666666;1;0;1;20497;4.878762745767673e-05
20564;ATiannnn还得AI啊;1;0;1;20497;4.878762745767673e-05
20566;又想吃泡芙奥火腿饕餮系小电驴咧胖胖吐司我是废物;1;0;1;20497;4.878762745767673e-05
20568;圆圆不圆;1;0;1;20497;4.878762745767673e-05
20570;西柚呱呱哇哦;1;0;1;20497;4.878762745767673e-05
20574;V;1;0;1;20497;4.878762745767673e-05
20584;小则又沐风23阿镜;1;0;1;20497;4.878762745767673e-05
20587;惊阙轻辞早知道我就买这个;1;0;1;20497;4.878762745767673e-05
20596;我忽然想起来，我们现在疫情上网课在以前是不是叫函授;1;0;1;20497;4.878762745767673e-05
20598;晚宁？卧槽;1;0;1;20497;4.878762745767673e-05
20606;寒慕心者写方向压对了啊哈哈哈哈;1;0;1;20497;4.878762745767673e-05
20608;YuuuuunX12345cqlcqlcql鹿鸣客（我纯变态，和IP无关）垃圾woc？;2;0;2;20497;9.757525491535346e-05
20612;出钩啊馗馗PandaplusFish;2;0;2;20497;9.757525491535346e-05
20615;emo的猪猪侠81hdials我等普通人比不上;1;0;1;20497;4.878762745767673e-05
20617;哦哈哈哈yyds;1;0;1;20497;4.878762745767673e-05
20624;逃逸;1;0;1;20497;4.878762745767673e-05
20626;不二子的鲁邦三世;1;0;1;20497;4.878762745767673e-05
20630;劝你不要太嚣张女士哦慧慧睡不醒乱78糟;1;0;1;20497;4.878762745767673e-05
20632;郵静静静教我写论文;1;0;1;20497;4.878762745767673e-05
20635;Vivian;1;0;1;20497;4.878762745767673e-05
20642;桃不掉你怎么成我列表第一了;4;0;4;20497;0.00019515050983070692
20647;失语者我为什么总emoRico川上酷纸;1;0;1;20497;4.878762745767673e-05
20651;0;1;0;1;20497;4.878762745767673e-05
20653;退退退，没有活路了;1;0;1;20497;4.878762745767673e-05
20655;我在想一个问题Ai能否助力航天航空能否对我们的宇宙探索多出点效率;1;0;1;20497;4.878762745767673e-05
20665;把网断了试试？你觉得人脑储存量比得过电子设备？;1;0;1;20497;4.878762745767673e-05
20668;JQKA天堂;1;0;1;20497;4.878762745767673e-05
20670;王。。。。。我已经没有存在的意义了;1;0;1;20497;4.878762745767673e-05
20675;sss;1;0;1;20497;4.878762745767673e-05
20678;一秒一篇;1;0;1;20497;4.878762745767673e-05
20686;空白唯爱春花人彻底是废人了;1;0;1;20497;4.878762745767673e-05
20701;我又饿了本来以为只有人跟我竞争没想到还有非人;1;0;1;20497;4.878762745767673e-05
20704;顾降善丸子的猫？;2;0;2;20497;9.757525491535346e-05
20709;WANGYICHUAN古河渚肆昊列车囍门;1;0;1;20497;4.878762745767673e-05
20711;肥青无鱼;1;0;1;20497;4.878762745767673e-05
20713;见面喊洛阳舆逃了西施臻;1;0;1;20497;4.878762745767673e-05
20715;零钱牛;1;0;1;20497;4.878762745767673e-05
20720;畏;1;0;1;20497;4.878762745767673e-05
20739;yuuw我别活了;1;0;1;20497;4.878762745767673e-05
20741;1是你呀很多人比ai差远了;1;0;1;20497;4.878762745767673e-05
20744;Sunnyboy厉害了;1;0;1;20497;4.878762745767673e-05
20748;花城城;1;0;1;20497;4.878762745767673e-05
20751;好难好难笑死我了;1;0;1;20497;4.878762745767673e-05
20757;雾漫山野嘉夜勋xnxin我觉得之后不需要考生了;1;0;1;20497;4.878762745767673e-05
20763;悸;1;0;1;20497;4.878762745767673e-05
20768;云间落枫上ai大学;1;0;1;20497;4.878762745767673e-05
20770;0;1;0;1;20497;4.878762745767673e-05
20776;你好哇;1;0;1;20497;4.878762745767673e-05
20778;小水滴我不活了;1;0;1;20497;4.878762745767673e-05
20787;Wwww夺笋呐;1;0;1;20497;4.878762745767673e-05
20790;好景万里舒克开飞机捡到还给林无隅可乐;3;0;3;20497;0.0001463628823730302
20794;7557;1;0;1;20497;4.878762745767673e-05
20800;早点睡i这书我是一点念不下去了;1;0;1;20497;4.878762745767673e-05
20806;我爱mp3;1;0;1;20497;4.878762745767673e-05
20819;小冉同学;1;0;1;20497;4.878762745767673e-05
20827;摇着耶;1;0;1;20497;4.878762745767673e-05
20831;草莓炖粥我变成他得了;1;0;1;20497;4.878762745767673e-05
20837;凉薄，;2;0;2;20497;9.757525491535346e-05
20845;杨;1;0;1;20497;4.878762745767673e-05
20849;川;1;0;1;20497;4.878762745767673e-05
20851;奥;3;0;3;20497;0.0001463628823730302
20865;nanan我不了解;1;0;1;20497;4.878762745767673e-05
20867;恐惧傲娇;1;0;1;20497;4.878762745767673e-05
20869;Leah诺一？？？;1;0;1;20497;4.878762745767673e-05
20884;许七安YYDS;1;0;1;20497;4.878762745767673e-05
20888;Cn我的作文题目;1;0;1;20497;4.878762745767673e-05
20892;逸xiaoran这怎么当众作弊;1;0;1;20497;4.878762745767673e-05
20894;啄木鸟真的在忙吗wocao;1;0;1;20497;4.878762745767673e-05
20897;遇到彩虹吃定彩虹我能买一个这样的随从吗;1;0;1;20497;4.878762745767673e-05
20901;香蕉你个布拿拿这让不让人活;1;0;1;20497;4.878762745767673e-05
20908;万万万Sadfairyhappy天线宝宝;2;0;2;20497;9.757525491535346e-05
20922;天穹之上北觅LA的陈冠希流星;2;0;2;20497;9.757525491535346e-05
20935;25次元幻想TiAmo喝喝这学不上也罢;1;0;1;20497;4.878762745767673e-05
20937;芓浒;1;0;1;20497;4.878762745767673e-05
20944;lwenu听你池墨星辰。一只发明这玩意干啥用？？？？;1;0;1;20497;4.878762745767673e-05
20946;甜得很正经40秒40篇;1;0;1;20497;4.878762745767673e-05
20958;小宋的饅头鋪嗨咯公主还是胡歌最帅Y玄叶子;1;0;1;20497;4.878762745767673e-05
20961;KB;1;0;1;20497;4.878762745767673e-05
20967;蜡笔小狗啊这;1;0;1;20497;4.878762745767673e-05
20978;雯雯子天呐;1;0;1;20497;4.878762745767673e-05
20994;吴怼怼又困了大王一秒一篇;1;0;1;20497;4.878762745767673e-05
20997;27;1;0;1;20497;4.878762745767673e-05
21000;吉克吉克换换脑干吧;1;0;1;20497;4.878762745767673e-05
21004;最爱吃芹菜了hh炸掉太阳;1;0;1;20497;4.878762745767673e-05
21006;I;1;0;1;20497;4.878762745767673e-05
21009;clown这;1;0;1;20497;4.878762745767673e-05
21014;梦醒的猫好家伙;1;0;1;20497;4.878762745767673e-05
21018;余烬YYDS;1;0;1;20497;4.878762745767673e-05
21024;清鸢;1;0;1;20497;4.878762745767673e-05
21036;Alina;1;0;1;20497;4.878762745767673e-05
21038;YE;3;0;3;20497;0.0001463628823730302
21042;想睡觉40篇1秒1篇;1;0;1;20497;4.878762745767673e-05
21047;阿饶阿饶;1;0;1;20497;4.878762745767673e-05
21051;可爱的扁食yyds的一笔;1;0;1;20497;4.878762745767673e-05
21060;0;1;0;1;20497;4.878762745767673e-05
21063;黑耳卷毛兔;1;0;1;20497;4.878762745767673e-05
21066;涵er马上要机器人统治世界了;1;0;1;20497;4.878762745767673e-05
21068;潘乙嘉yyds的一笔;1;0;1;20497;4.878762745767673e-05
21073;Justin;1;0;1;20497;4.878762745767673e-05
21077;特困生（陆亿十五版）蒙老板暗中讨饭要我干什么s了算了;2;0;2;20497;9.757525491535346e-05
21081;隔壁欧阳王二狗剩儿二蛋我在下晚自习库里该拿FMVP了;1;0;1;20497;4.878762745767673e-05
21087;你直接说是搜索不就得了;1;0;1;20497;4.878762745767673e-05
21097;先在衣柜里藏好;1;0;1;20497;4.878762745767673e-05
21100;青禾阿灌饼三明治我不配;1;0;1;20497;4.878762745767673e-05
21102;有一说一，我觉得写的很好水洛流溪;1;0;1;20497;4.878762745767673e-05
21115;咳咳救命啊;1;0;1;20497;4.878762745767673e-05
21120;CoeMDec12;1;0;1;20497;4.878762745767673e-05
21143;池鱼锦妍;1;0;1;20497;4.878762745767673e-05
21154;墨辞就这，以后都是机器人大学;1;0;1;20497;4.878762745767673e-05
21156;chicoie;1;0;1;20497;4.878762745767673e-05
21161;窗外的小熊yyds;1;0;1;20497;4.878762745767673e-05
21173;江遇我超;1;0;1;20497;4.878762745767673e-05
21184;别管大可不必;2;0;2;20497;9.757525491535346e-05
21188;FYyuan是好想还是好像;1;0;1;20497;4.878762745767673e-05
21207;佐野万次郎;1;0;1;20497;4.878762745767673e-05
21209;凉拌玛卡巴卡四十分钟我都未必写得完1000字作文;2;0;2;20497;9.757525491535346e-05
21212;我丢张小丸子;1;0;1;20497;4.878762745767673e-05
21221;彼岸过桥缘爱吃鱼丸cthntp阿司不要熬夜;1;0;1;20497;4.878762745767673e-05
21223;359A;1;0;1;20497;4.878762745767673e-05
21225;苗苗OvO;1;0;1;20497;4.878762745767673e-05
21227;0;1;0;1;20497;4.878762745767673e-05
21229;Komorebidoki四十分钟编不出来一篇;1;0;1;20497;4.878762745767673e-05
21231;小谢谢呀;1;0;1;20497;4.878762745767673e-05
21233;蘇鰍腺苷一磷酸青衣北笙mumu芥子受不了受不了我四十分钟都写不完一篇;2;0;2;20497;9.757525491535346e-05
21241;楚颐禾;1;0;1;20497;4.878762745767673e-05
21247;嗷呜;1;0;1;20497;4.878762745767673e-05
21252;学沫写的真的不错;1;0;1;20497;4.878762745767673e-05
21257;t好好学数学吃草草没;2;0;2;20497;9.757525491535346e-05
21260;lucky真牛;1;0;1;20497;4.878762745767673e-05
21262;俊泽;1;0;1;20497;4.878762745767673e-05
21264;草莓味的草莓绝了;1;0;1;20497;4.878762745767673e-05
21266;5one那以后都让机器人干吧，要人干什么;1;0;1;20497;4.878762745767673e-05
21268;FcKomiko;1;0;1;20497;4.878762745767673e-05
21277;一秒一篇？？;2;0;2;20497;9.757525491535346e-05
21281;糖果公主;1;0;1;20497;4.878762745767673e-05
21283;慵懒地狱使者哈哈哈哈哈哈哈哈扣大分;1;0;1;20497;4.878762745767673e-05
21288;望仔这是什么高级玩意;1;0;1;20497;4.878762745767673e-05
21293;Zct;1;0;1;20497;4.878762745767673e-05
21295;Booooyyds的一笔;2;0;2;20497;9.757525491535346e-05
21298;猫巷与你什么鬼，这能代替人吗;1;0;1;20497;4.878762745767673e-05
21303;没想好？？？;1;0;1;20497;4.878762745767673e-05
21305;一片小星河;2;0;2;20497;9.757525491535346e-05
21308;一般怎么样的文章容易被判为ai写作;4;0;4;20497;0.00019515050983070692
21313;求问学姐网址;5;0;5;20497;0.00024393813728838367
21319;网址是？;2;5;7;20497;0.00034151339220373715
21334;77;1;1;2;20497;9.757525491535346e-05
21338;权权爱吃锅包肉JustNN快乐的静香;2;1;3;20497;0.0001463628823730302
21341;求网址;3;1;4;20497;0.00019515050983070692
21348;、EXO执着等这个对你有没有用;1;1;2;20497;9.757525491535346e-05
21353;花钱;3;0;3;20497;0.0001463628823730302
21359;只有十条文献的综述;2;10;12;20497;0.0005854515294921208
21362;网址是什么呀;1;5;6;20497;0.0002927257647460604
21365;所以网址是什么啊;1;0;1;20497;4.878762745767673e-05
21367;网址是什么啊;1;0;1;20497;4.878762745767673e-05
21369;查重过不了;1;0;1;20497;4.878762745767673e-05
21371;自己写很难吗;1;0;1;20497;4.878762745767673e-05
21380;看了十几天都没写出来，最后还是被打败了，找别人写了;3;0;3;20497;0.0001463628823730302
21384;实在写不出。。;1;0;1;20497;4.878762745767673e-05
21390;姐姐剪头发了诶，短头发也很漂亮;1;3;4;20497;0.00019515050983070692
21392;最近的流量咋了，是不是剪头发大家不认识了;1;0;1;20497;4.878762745767673e-05
21397;铁汁号起来了必胜必胜必胜;2;0;2;20497;9.757525491535346e-05
21404;很多人可能都还不知道，人工智能已经崛起了;12;37;49;20497;0.00239059374542616
21417;做个AI写小说就不用怕催更了;2;34;36;20497;0.0017563545884763624
21420;所以人类必将可以被AI完全替换掉？;1;10;11;20497;0.000536663902034444
21427;AI什么时候可以自己写程序他们就可以自己进化了;1;0;1;20497;4.878762745767673e-05
21464;用铅笔写，好改;2;3;5;20497;0.00024393813728838367
21467;写文案就头疼;3;0;3;20497;0.0001463628823730302
21474;连抄都闲麻烦;2;0;2;20497;9.757525491535346e-05
21514;AI写作;1;1;2;20497;9.757525491535346e-05
21533;他能写论文吗？毕业设计也行;4;1;5;20497;0.00024393813728838367
21541;可以做影视解说吗;2;0;2;20497;9.757525491535346e-05
21558;所有的工具和项目的笔迹资料，点最上面的，都在粉丝裙;1;0;1;20497;4.878762745767673e-05
21560;要钱的;2;0;2;20497;9.757525491535346e-05
21563;非哥有没有对搬运的视频进行自动剪辑变成原创或者伪原创的工具啊？;3;0;3;20497;0.0001463628823730302
21569;Ai写作网站在哪里啊;1;0;1;20497;4.878762745767673e-05
21571;免费素材的微信号不用了吗？;3;0;3;20497;0.0001463628823730302
21575;粉丝群也没有领的;1;0;1;20497;4.878762745767673e-05
21580;工具在哪;1;0;1;20497;4.878762745767673e-05
21582;这条为啥没火我觉得这条价值超高;2;0;2;20497;9.757525491535346e-05
21587;我用了骗子;1;6;7;20497;0.00034151339220373715
21589;教不会;1;3;4;20497;0.00019515050983070692
21599;老师，早上好;1;1;2;20497;9.757525491535346e-05
21645;谢谢主播的分享丶;1;0;1;20497;4.878762745767673e-05
21673;收费;1;0;1;20497;4.878762745767673e-05
21698;0;1;0;1;20497;4.878762745767673e-05
21715;ai工具;1;1;2;20497;9.757525491535346e-05
21717;ai工具;1;1;2;20497;9.757525491535346e-05
21719;ai工具;1;0;1;20497;4.878762745767673e-05
21721;我早就觉得在格子间做ppt;1;0;1;20497;4.878762745767673e-05
21724;ai工具;1;0;1;20497;4.878762745767673e-05
21727;ai工具;1;0;1;20497;4.878762745767673e-05
21730;ai工具;1;0;1;20497;4.878762745767673e-05
21732;AI工具;3;0;3;20497;0.0001463628823730302
21737;AI工具;1;0;1;20497;4.878762745767673e-05
21739;ai工具;1;0;1;20497;4.878762745767673e-05
21742;AI工具;1;0;1;20497;4.878762745767673e-05
21744;ai工具;1;0;1;20497;4.878762745767673e-05
21746;ai工具;1;0;1;20497;4.878762745767673e-05
21750;怎么进粉丝群;1;0;1;20497;4.878762745767673e-05
21753;ai工具;1;0;1;20497;4.878762745767673e-05
21755;ai工具;1;0;1;20497;4.878762745767673e-05
21758;ai工具;1;0;1;20497;4.878762745767673e-05
21760;Ai工具;1;0;1;20497;4.878762745767673e-05
21762;Ai工具;1;0;1;20497;4.878762745767673e-05
21765;ai工具;1;0;1;20497;4.878762745767673e-05
21768;AI工具;1;0;1;20497;4.878762745767673e-05
21770;ai工具;1;0;1;20497;4.878762745767673e-05
21772;AI工具;1;0;1;20497;4.878762745767673e-05
21774;ai工具;1;0;1;20497;4.878762745767673e-05
21776;AI工具;1;0;1;20497;4.878762745767673e-05
21778;AI工具;1;0;1;20497;4.878762745767673e-05
21780;ai工具;1;0;1;20497;4.878762745767673e-05
21782;在那领取？;1;0;1;20497;4.878762745767673e-05
21784;“这个网站”是哪个网站;1;0;1;20497;4.878762745767673e-05
21816;266謝謝;1;0;1;20497;4.878762745767673e-05
21956;ai写作助手;3;0;3;20497;0.0001463628823730302
21961;可惜没有人文社科领域的;1;2;3;20497;0.0001463628823730302
21964;这是网页版？;1;0;1;20497;4.878762745767673e-05
21971;私发了，没回;1;2;3;20497;0.0001463628823730302
21973;自己写不过，主要是修改太麻烦了，最后学姐给我推荐一个人，直接写过了不要太开心;2;1;3;20497;0.0001463628823730302
21980;什么网址？;1;0;1;20497;4.878762745767673e-05
21982;在这里喔;52;35;87;20497;0.004244523588817876
22035;为啥点不进去都是显示网络连接错误可是我明明连着网;2;7;9;20497;0.0004390886471190906
22038;需要魔法;1;0;1;20497;4.878762745767673e-05
22040;链接？;2;5;7;20497;0.00034151339220373715
22043;但是这个有的加载不出来啊;3;1;4;20497;0.00019515050983070692
22047;这是什么神仙工具;1;0;1;20497;4.878762745767673e-05
22049;只是导航合集;1;3;4;20497;0.00019515050983070692
22051;来找你拿链接了;1;2;3;20497;0.0001463628823730302
22053;链接拿;1;1;2;20497;9.757525491535346e-05
22055;评论区全是求的，求得到吗;2;0;2;20497;9.757525491535346e-05
22058;求链接我是做亚马逊急需;1;1;2;20497;9.757525491535346e-05
22060;有链接还不是要魔法;2;0;2;20497;9.757525491535346e-05
22063;每个软件怎么用可以出一期吗，从前到后;2;0;2;20497;9.757525491535346e-05
22066;在哪里看，链接是？;2;0;2;20497;9.757525491535346e-05
22069;弄不了诶;3;0;3;20497;0.0001463628823730302
22073;网址;2;0;2;20497;9.757525491535346e-05
22076;置顶评论木有链接;2;0;2;20497;9.757525491535346e-05
22081;在哪里呀;1;0;1;20497;4.878762745767673e-05
22083;要不要钱;1;0;1;20497;4.878762745767673e-05
22085;求赐教;1;0;1;20497;4.878762745767673e-05
22087;我想要;1;0;1;20497;4.878762745767673e-05
22090;要链接;1;0;1;20497;4.878762745767673e-05
22092;链接;1;0;1;20497;4.878762745767673e-05
22095;大神，拿工具;1;0;1;20497;4.878762745767673e-05
22097;在哪里，我怎么没看到;1;0;1;20497;4.878762745767673e-05
22099;大神，我想拿工具谢谢;1;0;1;20497;4.878762745767673e-05
22101;爱我。发我;1;0;1;20497;4.878762745767673e-05
22103;拜托了兄弟;2;0;2;20497;9.757525491535346e-05
22106;大佬;1;0;1;20497;4.878762745767673e-05
22111;拿;1;0;1;20497;4.878762745767673e-05
22113;链接;1;0;1;20497;4.878762745767673e-05
22115;上链接;1;0;1;20497;4.878762745767673e-05
22117;怎么获取哇;1;0;1;20497;4.878762745767673e-05
22119;怎么拿呀;1;0;1;20497;4.878762745767673e-05
22121;要链接，上链接;1;1;2;20497;9.757525491535346e-05
22123;链接连接;1;0;1;20497;4.878762745767673e-05
22125;哪里拿链接;1;0;1;20497;4.878762745767673e-05
22127;求;1;0;1;20497;4.878762745767673e-05
22131;大神，拿工具，谢;1;0;1;20497;4.878762745767673e-05
22134;求求了，大佬;1;0;1;20497;4.878762745767673e-05
22136;来个链接;1;0;1;20497;4.878762745767673e-05
22139;不会魔法用不了;1;0;1;20497;4.878762745767673e-05
22145;链接链接;1;0;1;20497;4.878762745767673e-05
22149;求链接;1;0;1;20497;4.878762745767673e-05
22153;想要链接;1;0;1;20497;4.878762745767673e-05
22155;求链接;1;0;1;20497;4.878762745767673e-05
22158;求链接;1;0;1;20497;4.878762745767673e-05
22160;哪里有链接;1;0;1;20497;4.878762745767673e-05
22162;求链接;1;0;1;20497;4.878762745767673e-05
22164;求链接;1;0;1;20497;4.878762745767673e-05
22166;分享一下;1;0;1;20497;4.878762745767673e-05
22170;我需要链接;1;0;1;20497;4.878762745767673e-05
22175;跪求链接;1;0;1;20497;4.878762745767673e-05
22178;求链接;1;0;1;20497;4.878762745767673e-05
22180;链接;1;0;1;20497;4.878762745767673e-05
22182;链接;1;0;1;20497;4.878762745767673e-05
22184;真心不错，我们公司六个企划，写出的东西一模一样，老板说写的不错，你们出去创业吧;4;96;100;20497;0.004878762745767673
22189;啥软件;9;6;15;20497;0.000731814411865151
22201;写小说吧;1;2;3;20497;0.0001463628823730302
22204;注册不了;1;1;2;20497;9.757525491535346e-05
22207;还得自己改;1;0;1;20497;4.878762745767673e-05
22209;不会是收钱，然后你们调用接口吧;1;0;1;20497;4.878762745767673e-05
22212;什么软件;1;0;1;20497;4.878762745767673e-05
22214;要钱不;1;0;1;20497;4.878762745767673e-05
22223;可乐味儿;2;0;2;20497;9.757525491535346e-05
22227;李海泽;1;0;1;20497;4.878762745767673e-05
22233;可以写简历吗？;1;0;1;20497;4.878762745767673e-05
22239;网页搜索AI写作助手就可以了吗;1;4;5;20497;0.00024393813728838367
22244;每天只有几次免费机会，否则需要充会员，我是贫穷的科研狗;1;2;3;20497;0.0001463628823730302
22262;有链接地址吗;1;1;2;20497;9.757525491535346e-05
22266;就叫AI写作助手吗？;1;0;1;20497;4.878762745767673e-05
22270;要钱吗;2;0;2;20497;9.757525491535346e-05
22274;理性使用不鼓励代替写作，适合提供思路和结构参考。相关问题在我主页置顶视频都提到过;2;19;21;20497;0.0010245401766112113
22278;每天一个退学小技巧;1;18;19;20497;0.0009269649216958579
22280;这简直救命;2;9;11;20497;0.000536663902034444
22283;检测出抄袭就直接挂科？;3;5;8;20497;0.00039030101966141384
22287;谢谢好人一胎10个儿子;1;6;7;20497;0.00034151339220373715
22290;免费的吗;1;0;1;20497;4.878762745767673e-05
22301;皮皮ting每天一个遣返小技巧;3;0;3;20497;0.0001463628823730302
22305;米雪尔Henryyrk里奥想睡觉JAyD我是外国人kS银杏嗨嗨JackySJmes回国小技巧;11;9;20;20497;0.0009757525491535347
22320;velvet哈哈哈哈哈哈哈哈;1;0;1;20497;4.878762745767673e-05
22322;阿桐tong;1;0;1;20497;4.878762745767673e-05
22324;Shimmer;1;0;1;20497;4.878762745767673e-05
22326;WL;1;0;1;20497;4.878762745767673e-05
22331;kenthecat;1;1;2;20497;9.757525491535346e-05
22333;L1;2;0;2;20497;9.757525491535346e-05
22337;Likexinnnn;1;1;2;20497;9.757525491535346e-05
22340;Shen好吃的文文HwangJeong;1;0;1;20497;4.878762745767673e-05
22342;倒立的泽泽;1;0;1;20497;4.878762745767673e-05
22345;回国小技巧宽宽早点睡;1;0;1;20497;4.878762745767673e-05
22416;心动便利贴;1;0;1;20497;4.878762745767673e-05
22423;但要钱;3;23;26;20497;0.001268478313899595
22428;小姐姐这是什么软件吖;2;12;14;20497;0.0006830267844074743
22431;我上学时候知道这个就好了;1;8;9;20497;0.0004390886471190906
22433;criticalthinking一键解决？哈哈哈哈;1;3;4;20497;0.00019515050983070692
22438;还能再吃点好家伙写完知道了;1;0;1;20497;4.878762745767673e-05
22450;蛋奶欣欣来学习;1;0;1;20497;4.878762745767673e-05
22454;我的脸很大mark;1;1;2;20497;9.757525491535346e-05
22456;Joycy脆脆脆鲨这个有用;2;2;4;20497;0.00019515050983070692
22463;YAN這麼nb;1;1;2;20497;9.757525491535346e-05
22466;马住马住想要吃好吃的;1;0;1;20497;4.878762745767673e-05
22468;一只暴躁美女来来来;2;0;2;20497;9.757525491535346e-05
22471;梨大包儿;1;0;1;20497;4.878762745767673e-05
22477;濛霸霸;1;0;1;20497;4.878762745767673e-05
22480;MasterC;1;1;2;20497;9.757525491535346e-05
22482;Der啊荡;1;0;1;20497;4.878762745767673e-05
22493;Farewellinthesea;1;0;1;20497;4.878762745767673e-05
22496;0;1;0;1;20497;4.878762745767673e-05
22498;收不收费;1;0;1;20497;4.878762745767673e-05
22517;这些是要收费的网站吗;1;0;1;20497;4.878762745767673e-05
22523;ai;1;0;1;20497;4.878762745767673e-05
22528;ai;1;0;1;20497;4.878762745767673e-05
22531;Ai;1;0;1;20497;4.878762745767673e-05
22536;so;1;0;1;20497;4.878762745767673e-05
22546;Ai;1;0;1;20497;4.878762745767673e-05
22552;Ai真能代替一切吗？;4;2;6;20497;0.0002927257647460604
22563;大黄不是狗的名字吗;1;2;3;20497;0.0001463628823730302
22570;标贝悦读体验AI一站式配音平台并免费领取超级会员;14;4;18;20497;0.0008781772942381812
22585;Discord注册卡在了电话验证一直不通过玩不了;5;0;5;20497;0.00024393813728838367
22591;快让AI取代我吧;1;7;8;20497;0.00039030101966141384
22593;老师讲的好收获很大;1;1;2;20497;9.757525491535346e-05
22595;写作靠的是功底;1;1;2;20497;9.757525491535346e-05
22597;老师说的跟真实;1;1;2;20497;9.757525491535346e-05
22599;用惯了打字，手写都生疏了。写作还是不要太依赖AI工具。;1;1;2;20497;9.757525491535346e-05
22610;但是别忘了，大多数人都是普通人;3;0;3;20497;0.0001463628823730302
22614;小羽好棒;1;1;2;20497;9.757525491535346e-05
22616;分析的很透彻;1;0;1;20497;4.878762745767673e-05
22618;前面的说法不认同，你永远都不知道明天科技会到哪一步，但是认同最后一句;1;0;1;20497;4.878762745767673e-05
22621;0;1;0;1;20497;4.878762745767673e-05
22634;写文案这件事，在优秀的写手脑子里，是填空题驱动文案的底层是逻辑结构模型，包括语义模型结构化知识成年人写出优质文案这事，是可以靠“文案课”学出来的吗？每一个语文偏科生，都有一个自己喜欢的语文老师;15;65;80;20497;0.0039030101966141388
22650;最近更新够勤快呀;5;33;38;20497;0.0018539298433917159
22656;大圣归来想问一下：这周还更吗我在你对面我都不知道;6;9;15;20497;0.000731814411865151
22663;基金对应什么？;4;5;9;20497;0.0004390886471190906
22668;我先点赞我要发视频回来再来细看;4;11;15;20497;0.000731814411865151
22673;认真负责;2;17;19;20497;0.0009269649216958579
22676;学到了giiso;2;1;3;20497;0.0001463628823730302
22679;本来只想关注下，突然被圈粉，猝不及防啊;1;4;5;20497;0.00024393813728838367
22681;用惯了打字，手写都生疏了。写作还是不要太依赖AI工具。;1;1;2;20497;9.757525491535346e-05
22683;老师说的跟真实;1;1;2;20497;9.757525491535346e-05
22685;写作靠的是功底;1;1;2;20497;9.757525491535346e-05
22687;老师讲的好收获很大;1;1;2;20497;9.757525491535346e-05
22698;但是别忘了，大多数人都是普通人;3;0;3;20497;0.0001463628823730302
22702;小羽好棒;1;1;2;20497;9.757525491535346e-05
22704;分析的很透彻;1;0;1;20497;4.878762745767673e-05
22706;前面的说法不认同，你永远都不知道明天科技会到哪一步，但是认同最后一句;1;0;1;20497;4.878762745767673e-05
22709;0;1;0;1;20497;4.878762745767673e-05
22722;写文案这件事，在优秀的写手脑子里，是填空题驱动文案的底层是逻辑结构模型，包括语义模型结构化知识成年人写出优质文案这事，是可以靠“文案课”学出来的吗？每一个语文偏科生，都有一个自己喜欢的语文老师;15;65;80;20497;0.0039030101966141388
22738;最近更新够勤快呀;5;33;38;20497;0.0018539298433917159
22744;大圣归来想问一下：这周还更吗我在你对面我都不知道;6;9;15;20497;0.000731814411865151
22751;基金对应什么？;6;5;11;20497;0.000536663902034444
22758;我先点赞我要发视频回来再来细看;4;11;15;20497;0.000731814411865151
22763;学到了giiso;2;1;3;20497;0.0001463628823730302
22766;本来只想关注下，突然被圈粉，猝不及防啊;5;4;9;20497;0.0004390886471190906
22772;认真负责;2;17;19;20497;0.0009269649216958579
22775;我来了，暴撕，咱们什么时候去吃烤肉;3;3;6;20497;0.0002927257647460604
22779;可以啊，小伙子;3;3;6;20497;0.0002927257647460604
22783;钱总，宠下我，帮我看看帐号;4;1;5;20497;0.00024393813728838367
22788;我要好好下载慢慢看了;3;2;5;20497;0.00024393813728838367
22793;没糊糊不看了;2;3;5;20497;0.00024393813728838367
22796;大佬求指导，目前自然流量接近3w，很难爆，有没有不出镜的方法做这个房产账号;3;1;4;20497;0.00019515050983070692
22823;机械设备的抖音该怎么做，头疼啊;1;1;2;20497;9.757525491535346e-05
22834;拉丁舞对应什么啊;2;0;2;20497;9.757525491535346e-05
22898;听不懂;1;0;1;20497;4.878762745767673e-05
22937;现在不是会员不能选1500字了;1;2;3;20497;0.0001463628823730302
22950;我居然看不懂;1;1;2;20497;9.757525491535346e-05
22963;看了n多篇沒懂;1;0;1;20497;4.878762745767673e-05
23026;齐天大圣，我把你的都看了，然后全部过了500评论，求拜师;2;1;3;20497;0.0001463628823730302
23031;帮忙看号谢谢;1;1;2;20497;9.757525491535346e-05
23034;出来混，迟早要还的;1;1;2;20497;9.757525491535346e-05
23047;老师，建橱窗买东西，用新号好还是以前用的老账号好呢;2;1;3;20497;0.0001463628823730302
23060;钱boss，是感冒了吗;1;0;1;20497;4.878762745767673e-05
23078;大圣归来来晚了还有机会吗;3;1;4;20497;0.00019515050983070692
23084;没什么想问的好多个号刷到都关注了;2;1;3;20497;0.0001463628823730302
23092;我8月31日上的视频。投了差不多2200元，但，到现在还没有爆品。求指导。;2;0;2;20497;9.757525491535346e-05
23106;0;1;0;1;20497;4.878762745767673e-05
23125;菇凉呢;1;1;2;20497;9.757525491535346e-05
23146;字体越大越重点读？;1;5;6;20497;0.0002927257647460604
23149;王小艳也被框进来了;1;1;2;20497;9.757525491535346e-05
23151;我一点都不语文偏科;1;1;2;20497;9.757525491535346e-05
23153;大圣归来中午回来了，哎哟妈呀，狗哥看腻了都;2;1;3;20497;0.0001463628823730302
23157;大圣归来;2;1;3;20497;0.0001463628823730302
23160;大圣归来，儿童美术教育号该咋弄？;2;1;3;20497;0.0001463628823730302
23163;大圣归来每天都来学习;1;1;2;20497;9.757525491535346e-05
23165;大圣归来：请问，我改垂类，目前发作品0播放，自检账号正常，怎么办啊？;1;1;2;20497;9.757525491535346e-05
23167;如何加入你们;2;1;3;20497;0.0001463628823730302
23170;说实话的孙大圣;1;1;2;20497;9.757525491535346e-05
23173;大圣;2;1;3;20497;0.0001463628823730302
23176;大圣归来，球看号？;1;1;2;20497;9.757525491535346e-05
23183;更新频率快到我不知道该评论啥了;1;1;2;20497;9.757525491535346e-05
23190;流量密码没了;2;1;3;20497;0.0001463628823730302
23203;大圣归来新号投豆荚应该投达人相似还是投智能推荐呢;1;1;2;20497;9.757525491535346e-05
23205;减肥了吗？你手里;2;1;3;20497;0.0001463628823730302
23208;大圣归来;2;1;3;20497;0.0001463628823730302
23211;卧槽，这条开始走颜值路线了帅的一批;1;1;2;20497;9.757525491535346e-05
23213;这粉丝粘性不愧爆裂总;1;1;2;20497;9.757525491535346e-05
23215;大圣归来求看号;1;1;2;20497;9.757525491535346e-05
23217;每次抓到我就要问一句，好物种草还可以做吗;1;1;2;20497;9.757525491535346e-05
23220;大圣归来;2;1;3;20497;0.0001463628823730302
23223;大圣归来：大圣瘦了;1;2;3;20497;0.0001463628823730302
23225;打卡;2;1;3;20497;0.0001463628823730302
23228;大圣归来;1;1;2;20497;9.757525491535346e-05
23230;大圣归来，感冒了么;1;2;3;20497;0.0001463628823730302
23232;我是不是前500名啊大佬帮忙看看我的号;2;1;3;20497;0.0001463628823730302
23235;占个位看亿遍，俩月没更新没脸提问;2;1;3;20497;0.0001463628823730302
23238;大圣归来求看号;3;1;4;20497;0.00019515050983070692
23242;大圣归来今天投了老师点赞的其中一条;2;1;3;20497;0.0001463628823730302
23245;想问下。合适我用吗;2;1;3;20497;0.0001463628823730302
23248;我相信这是转化率最高的广告，粉丝黏性;1;1;2;20497;9.757525491535346e-05
23250;老师你瘦了这么多？？;1;1;2;20497;9.757525491535346e-05
23252;大圣归来，帮我改个名;2;1;3;20497;0.0001463628823730302
23255;大圣归来求助看号;2;0;2;20497;9.757525491535346e-05
23258;大圣归来，可以帮我看看这个号吗私服管家如意姐;3;1;4;20497;0.00019515050983070692
23262;大圣归来;1;1;2;20497;9.757525491535346e-05
23265;大圣归来，人话版也在张张那吗，另外，你瘦啦;1;1;2;20497;9.757525491535346e-05
23268;大圣归来帮我分析下，为啥爆了300万的热门，结果后期的作品还是几百;1;1;2;20497;9.757525491535346e-05
23270;淘系付费知识博主还能怎么做呀视频50播放;1;1;2;20497;9.757525491535346e-05
23274;大圣归来，看号求助;3;1;4;20497;0.00019515050983070692
23278;直播赛道怎么打标签，拉权重？终于前排了一次;3;1;4;20497;0.00019515050983070692
23282;大圣归来终于抢了个前排帮忙看下号;3;1;4;20497;0.00019515050983070692
23286;打卡;1;2;3;20497;0.0001463628823730302
23288;我找找看能不能下载;2;1;3;20497;0.0001463628823730302
23291;大圣归来天天更，冲;1;2;3;20497;0.0001463628823730302
23293;大圣归来;2;2;4;20497;0.00019515050983070692
23296;大圣归来;1;1;2;20497;9.757525491535346e-05
23298;可以看看我吗，大佬;1;1;2;20497;9.757525491535346e-05
23300;打卡，想起来再问;2;1;3;20497;0.0001463628823730302
23303;点赞收藏，每次都反复观看;2;2;4;20497;0.00019515050983070692
23306;可以陪跑么？;1;1;2;20497;9.757525491535346e-05
23308;我感觉珍珠粉末珠宝有被get到;1;1;2;20497;9.757525491535346e-05
23310;大圣归来;2;1;3;20497;0.0001463628823730302
23313;奥特曼能帮忙看看号码;1;2;3;20497;0.0001463628823730302
23317;大圣归来;1;1;2;20497;9.757525491535346e-05
23319;怎么办，越来越喜欢你的风格了;1;1;2;20497;9.757525491535346e-05
23321;大圣归来阿鱼的宝藏酒馆麻烦帮忙看看号;1;1;2;20497;9.757525491535346e-05
23323;没有姑娘但爆总很帅;1;1;2;20497;9.757525491535346e-05
23335;大圣归来老号做摄影号流量都不过百怎么破;6;2;8;20497;0.00039030101966141384
23342;可以帮看看号嘛？;3;1;4;20497;0.00019515050983070692
23346;大圣归来，为了进群;2;1;3;20497;0.0001463628823730302
23349;冲会员买买买;2;1;3;20497;0.0001463628823730302
23352;那对于起新号来说会不会有帮助;2;1;3;20497;0.0001463628823730302
23361;大圣归来，优秀;1;1;2;20497;9.757525491535346e-05
23363;大圣归来，还有机会翻么，生活用品工厂号，视频怎么拍;1;1;2;20497;9.757525491535346e-05
23365;大圣归来高产似那啥哈哈太爽了;1;1;2;20497;9.757525491535346e-05
23367;盘他们;1;1;2;20497;9.757525491535346e-05
23369;今天没有妹纸了专心看知识吧;1;1;2;20497;9.757525491535346e-05
23418;大圣归来虽然每条视频我至少都要看10遍但还是乐此不疲;5;2;7;20497;0.00034151339220373715
23424;接电话;1;0;1;20497;4.878762745767673e-05
23426;麻烦大佬帮我看下这个号未来春晚魔术师，尤佑（做魔术但不想拍教学）;2;1;3;20497;0.0001463628823730302
23429;第50个;1;1;2;20497;9.757525491535346e-05
23432;收费呢，更困难了;2;1;3;20497;0.0001463628823730302
23435;深圳南山不败的称号，不是白叫的;1;2;3;20497;0.0001463628823730302
23437;腾讯抄别人从未输过，别人抄腾讯的从未赢过。可见腾讯后台多强大。;1;1;2;20497;9.757525491535346e-05
23442;专业术语都飘红这咋办;1;3;4;20497;0.00019515050983070692
23455;老师这是啥网页啊我们组里从做开始，论文写和改全都是自己搞，老板只管最后投;1;2;3;20497;0.0001463628823730302
23459;chatGPT二月份就出现啦，我四月份才注册就不能注册了;3;0;3;20497;0.0001463628823730302
23464;真的绝了，很多小说家估计都会被取缔，感觉就像潘多拉魔盒。还不会用的点下面小绿标，绝对惊艳你。;2;11;13;20497;0.0006342391569497975
23467;我想要它给我写一本1千万字的书可以吗;6;6;12;20497;0.0005854515294921208
23474;这不是gpt写得，人家写不了这么连贯，早试过了;9;9;18;20497;0.0008781772942381812
23484;能写200万字吗？然后把小说发布在网上;2;0;2;20497;9.757525491535346e-05
23487;这不是写的，是哪里复制来的吧;2;4;6;20497;0.0002927257647460604
23491;怎么使用这个;1;0;1;20497;4.878762745767673e-05
23502;春绘KIKI我笑了;1;0;1;20497;4.878762745767673e-05
23505;信口开河，随便瞎编，开心自己就好。;2;3;5;20497;0.00024393813728838367
23509;这不注册不是很简单吗叫声大哥的事免费;2;0;2;20497;9.757525491535346e-05
23516;想不到这一天来的这么快，学校居然叫我写论文了;1;6;7;20497;0.00034151339220373715
23518;这玩意儿不会安装啊;1;0;1;20497;4.878762745767673e-05
23527;什么网站;1;1;2;20497;9.757525491535346e-05
23530;私信都回了早晨醒来发现私信太多了;33;5;38;20497;0.0018539298433917159
23564;变成了科研博主;3;5;8;20497;0.00039030101966141384
23568;直接说火龙果;2;2;4;20497;0.00019515050983070692
23572;免费吗？;1;2;3;20497;0.0001463628823730302
23617;私信都回啦;4;0;4;20497;0.00019515050983070692
23648;一定要私信我哈，抖音评论不让挂;4;0;4;20497;0.00019515050983070692
23694;一起来学习编程，qun里可以下载编程教程;2;34;36;20497;0.0017563545884763624
23697;去掉吗？，然后打印;3;127;130;20497;0.006342391569497975
23701;输出不是printf吗？;22;27;49;20497;0.00239059374542616
23724;这东西用c写巨麻烦;9;55;64;20497;0.0031224081572913107
23734;高中的Python学了个寂寞;3;29;32;20497;0.0015612040786456554
23739;你干脆把中文所有汉字组合做个对话库吧，查库返回对话;2;12;14;20497;0.0006830267844074743
23745;正在学习python中;1;5;6;20497;0.0002927257647460604
23762;不整个延时吗;1;0;1;20497;4.878762745767673e-05
23765;这是什么语言，print是？;2;0;2;20497;9.757525491535346e-05
23774;Python，当代初中生的噩梦;1;0;1;20497;4.878762745767673e-05
23776;为什么我叔输出是乱码;2;0;2;20497;9.757525491535346e-05
23780;我是傻逼吗？;3;9;12;20497;0.0005854515294921208
23795;切割打印？;1;1;2;20497;9.757525491535346e-05
23822;私我“学习”送运营新手包哟;41;257;298;20497;0.014538712982387667
23864;giiso建议大家不要购买文案热搜池很窄很多话题都没有相关文案一个月198太不值了裂变文案说的挺好听导入进去根本列表不了而且文案裂变需要单收费想退都退不了不要买了;28;864;892;20497;0.043518563692247644
23893;试了一下，需要收费;9;247;256;20497;0.012489632629165243
23903;软件好像是收费的;20;124;144;20497;0.0070254183539054495
23924;三个软件只搜到了句子控;4;35;39;20497;0.0019027174708493926
23929;大佬真是一个字一个字写出来的。我问了好几个人了;5;97;102;20497;0.004976338000683027
23935;能天天不要撩头发吗？;6;55;61;20497;0.002976045274918281
23942;美女主播人又漂亮又有能力啊;1;47;48;20497;0.002341806117968483
23945;费用贵的要死，不划算;2;18;20;20497;0.0009757525491535347
23948;老师越来越漂亮了;2;17;19;20497;0.0009269649216958579
23978;有新闻稿自动生成器吗;1;0;1;20497;4.878762745767673e-05
24070;Battle你阿姨这对你有用吗;2;0;2;20497;9.757525491535346e-05
24187;陆壹;1;1;2;20497;9.757525491535346e-05
24214;五块一篇;1;4;5;20497;0.00024393813728838367
24223;1giiso写作机器人2易撰3句子控;1;0;1;20497;4.878762745767673e-05
24225;前两天室友推荐我写文字赚，一开始我还不相信，没想到是真的感谢梅花姑娘哦，我过搞啦，人生第一次。;1;0;1;20497;4.878762745767673e-05
24730;是坑，兄弟们，不要入坑;1;0;1;20497;4.878762745767673e-05
24733;poe需要魔法啊;3;3;6;20497;0.0002927257647460604
24737;给个详细的操作步骤;3;1;4;20497;0.00019515050983070692
24741;现在到底chat哪个最强，中国有吗;4;0;4;20497;0.00019515050983070692
24747;用不了啊;1;4;5;20497;0.00024393813728838367
24749;谁能30帮我搞个chargtp;1;0;1;20497;4.878762745767673e-05
24758;手机能下载吗;1;0;1;20497;4.878762745767673e-05
24760;那道推理题我怎么看不懂啊;1;0;1;20497;4.878762745767673e-05
24763;怎么下载;2;0;2;20497;9.757525491535346e-05
24767;Pop有详细的操作步骤吗;1;0;1;20497;4.878762745767673e-05
24781;别傻了，任何的什么人工智能，都无法在国内使用，不然一些敏感话题怎么河蟹？？？;3;11;14;20497;0.0006830267844074743
24785;我对claude说今天什么日子，他回答今天是2021年;3;2;5;20497;0.00024393813728838367
24794;美国用ai诱导更多中国人学会魔法，上面的秘密瞒不住了大家需要警惕;1;0;1;20497;4.878762745767673e-05
24797;Gbrandlab这是本篇文章的作者本人，大家可以关注;1;8;9;20497;0.0004390886471190906
24800;哪里可以看到？;2;1;3;20497;0.0001463628823730302
24803;我上周把日报发给chatgpt让他帮我整合成周报，他居然给我漏了两项有一项我当时发现了，质问他为啥少了一个，他才给我补上。另一项是我今早上才发现的好气，已经交上去不能改了;1;3;4;20497;0.00019515050983070692
24806;网站链接有吗;1;0;1;20497;4.878762745767673e-05
24808;不会提问才是个大问题;1;0;1;20497;4.878762745767673e-05
24810;怎么才能用上gpt啊;1;0;1;20497;4.878762745767673e-05
24823;谢谢你;1;1;2;20497;9.757525491535346e-05
24848;哈哈哈;1;1;2;20497;9.757525491535346e-05
24851;谢谢啦;1;0;1;20497;4.878762745767673e-05
24857;搜不到啊亲;2;0;2;20497;9.757525491535346e-05
24860;搜不到呀;1;0;1;20497;4.878762745767673e-05
24862;怎么搜不到哇;1;0;1;20497;4.878762745767673e-05
24864;感谢每次的分享;3;0;3;20497;0.0001463628823730302
24870;哥你感冒了;2;0;2;20497;9.757525491535346e-05
24878;《不能用》《啊对对对》;23;4588;4611;20497;0.2249597502073474
24902;高考的时候断网他是不是就死机了;3;2180;2183;20497;0.10650339074010831
24906;“开挂了”;1;1909;1910;20497;0.09318436844416256
24908;原来还有百度不知道的;3;1039;1042;20497;0.050836707810899155
24915;应该叫度妹;1;114;115;20497;0.005610577157632825
24921;《这样啊》;2;19;21;20497;0.0010245401766112113
24928;起风了这个比小冰牛逼多了;3;8;11;20497;0.000536663902034444
24933;0;1;8;9;20497;0.0004390886471190906
24939;等会这个语文老师有点眼熟好像橘子日落吴吴灭灭月亮湾弯;1;0;1;20497;4.878762745767673e-05
24942;爱喝果粒奶优wang觉舟终于在历史的画卷上留下了yyds的哈哈哈哈哈哈哈哈哈笑死我了;3;0;3;20497;0.0001463628823730302
24946;依旧是读不尽的红楼梦;1;0;1;20497;4.878762745767673e-05
24948;呀呀不是鸭鸭一分钟;1;0;1;20497;4.878762745767673e-05
24959;22222222啊对对对;1;1;2;20497;9.757525491535346e-05
24962;潘周聃父母或者其他长辈估计比较喜欢老子;1;3;4;20497;0.00019515050983070692
24969;阿彤想去看海xing啊对对对;2;0;2;20497;9.757525491535346e-05
24974;途酱酱吖人工智障吧;2;0;2;20497;9.757525491535346e-05
24977;桥本环保晓晓;1;0;1;20497;4.878762745767673e-05
24980;飞飞子旗下的大姐久岐忍;1;0;1;20497;4.878762745767673e-05
24983;卧槽川迢迢;1;1;2;20497;9.757525491535346e-05
24985;YANGJIAQIranDearYiPEIJIAYI川野哥好想你Wovl;1;1;2;20497;9.757525491535346e-05
24995;LilRuby徐仄言是乙卷儿呢;1;0;1;20497;4.878762745767673e-05
25001;开心的人32346陆杰人工智能写的都比我好;4;3;7;20497;0.00034151339220373715
25014;第一;1;4;5;20497;0.00024393813728838367
25019;澄星;2;0;2;20497;9.757525491535346e-05
25025;本手是基础，妙手是创新，俗手是反例，然后结合一下，落到现实，中国新时代青年应该脚踏实地，温故知新，做事稳重，做人本分，不能急于进取，目光应放长远，否则会误入歧途，人生全盘皆输。;1;6;7;20497;0.00034151339220373715
25030;。。。。长策兮726超想困Dikz油炸派大星我们那次考试考个yyds;1;1;2;20497;9.757525491535346e-05
25061;如果试卷上真出现YYDS可能会被判零分;9;1072;1081;20497;0.05273942528174855
25071;40秒，40篇作文;5;483;488;20497;0.023808362199346247
25077;小冰呢;7;122;129;20497;0.006293603942040298
25087;说好的断网屏蔽信号呢;1;36;37;20497;0.0018051422159340391
25089;我也叫晓晓，如果我有这么厉害就可以了。;1;30;31;20497;0.0015124164511879786
25091;你别说话高考不能联网;4;3;7;20497;0.00034151339220373715
25097;那她算不算作弊;1;2;3;20497;0.0001463628823730302
25113;你参加什么高考，考的比我好也没我搞笑碎碎觉;1;1;2;20497;9.757525491535346e-05
25117;77他还会用yyds;1;0;1;20497;4.878762745767673e-05
25122;iamrenkkkkkk四十秒四十篇，我四十分钟憋不出800字;2;0;2;20497;9.757525491535346e-05
25127;囡囝囚团教我写;1;0;1;20497;4.878762745767673e-05
25129;王八猪本猪（六九）月光下的腿毛的好困ssoso没书读;1;1;2;20497;9.757525491535346e-05
25132;幸运遥批号0224桵夙是小鱼不是小鱼林某人从未遗忘咱别学了;2;1;3;20497;0.0001463628823730302
25136;深藏布噜噜噜越来越卷了;1;1;2;20497;9.757525491535346e-05
25142;这是？;1;0;1;20497;4.878762745767673e-05
25144;可乐要加冰时间A7正大光明的开挂;3;0;3;20497;0.0001463628823730302
25151;小赵学英语北觅薄荷茶肚子餓扁了;2;1;3;20497;0.0001463628823730302
25154;艾志恒yyds出现在高考作文里是认真的吗;1;2;3;20497;0.0001463628823730302
25158;不看路这比较牛好吧;1;4;5;20497;0.00024393813728838367
25160;doki小羽我想要她的脑袋;3;4;7;20497;0.00034151339220373715
25165;。。。看看你，看看人家;2;1;3;20497;0.0001463628823730302
25174;南鸢抵相思过半陈先生曦琦古怪哥哥你看她;2;0;2;20497;9.757525491535346e-05
25178;小度小度，把明天高考的试题说一下。;4;47;51;20497;0.0024881690003415134
25184;数字人都要参加高考了，那还要人干嘛？;3;3;6;20497;0.0002927257647460604
25188;只要拔掉他的电源，他瞬间就考不了了;1;2;3;20497;0.0001463628823730302
25192;好哇，直接爬是吧澜崽;1;1;2;20497;9.757525491535346e-05
25197;永夏羚羊行了别用人工了;1;0;1;20497;4.878762745767673e-05
25199;日落被我偷走了C她还用了YYDS;1;0;1;20497;4.878762745767673e-05
25220;啥工具呀;1;0;1;20497;4.878762745767673e-05
25222;啥工具呢;1;0;1;20497;4.878762745767673e-05
25224;啥工具这是;1;0;1;20497;4.878762745767673e-05
25226;求啊;1;0;1;20497;4.878762745767673e-05
25228;0;8;0;8;20497;0.00039030101966141384
25237;为什么安装盒子之后office打开的就慢了呢;1;9;10;20497;0.00048787627457676734
25240;智能写作显示网址引用错误，咋办;5;0;5;20497;0.00024393813728838367
25246;为什么我的wps安装后只有左侧几个功能，没有这个功能呢;2;1;3;20497;0.0001463628823730302
25250;用一次office卡崩溃一次;4;0;4;20497;0.00019515050983070692
25255;API能做到这么快的实时回复么，不都是等结果都回来后统一结果么;4;0;4;20497;0.00019515050983070692
25260;老是要扫码登录，有点那啥了太着急收割了;3;1;4;20497;0.00019515050983070692
25264;一点击就卡死，问题处理了嘛;1;2;3;20497;0.0001463628823730302
25266;怎么收费说一下;1;2;3;20497;0.0001463628823730302
25268;免费吗？;2;0;2;20497;9.757525491535346e-05
25271;咋加客服，我的好像有问题了;2;0;2;20497;9.757525491535346e-05
25274;为啥子，我更新了，好多功能就没有了;2;0;2;20497;9.757525491535346e-05
25277;能写质量分析吗？;1;1;2;20497;9.757525491535346e-05
25279;我的版本没有这个可视智能写作;2;0;2;20497;9.757525491535346e-05
25301;老师你好，我之前安装用过，但是过了一段时间不能用了，我也无法卸载旧版（各种方法都试过了，最后把所有关于不坑盒子的文件都删了）也不知道删干净了没有，最后重新下载了最新版的“不坑盒子”，但是安装后打开Word文档，里面还是没有不坑盒子的插件，这是为什么呢？有办法解决吗我是Win10家庭版，之前都安装可以用的;2;0;2;20497;9.757525491535346e-05
25312;你的接口会被封吗;1;1;2;20497;9.757525491535346e-05
25314;怎么安装;1;0;1;20497;4.878762745767673e-05
25317;新版有这个功能的要收费啊;1;0;1;20497;4.878762745767673e-05
25321;家庭和学生版可以用吗;1;0;1;20497;4.878762745767673e-05
25324;电脑上没有方正小标宋GBK是不是盒子上就显示不了;1;0;1;20497;4.878762745767673e-05
25326;有软件使用说明吗？;1;0;1;20497;4.878762745767673e-05
25328;安装插件后，wps整个运行都卡顿慢了;1;0;1;20497;4.878762745767673e-05
25330;这个功能收费吗？;1;0;1;20497;4.878762745767673e-05
25332;最近总是弹错，而且插件也不见了，怎么解决呢，重下吗;1;0;1;20497;4.878762745767673e-05
25334;它那个一级标题，二级跟原word的标题1、标题2不一样，结果就是按你这个排版下来，没办法引用目录;3;0;3;20497;0.0001463628823730302
25341;更新到最近版本，没发现有智能写作选项;2;0;2;20497;9.757525491535346e-05
25344;点用户是无法连接网络，如何解决？能给个办法么？;2;0;2;20497;9.757525491535346e-05
25347;我的刚下载的4月3号的，怎么没有智能写作功能？？;1;0;1;20497;4.878762745767673e-05
25349;苹果mac能用吗？;1;0;1;20497;4.878762745767673e-05
25351;为什么一用软件就重启呢;1;0;1;20497;4.878762745767673e-05
25353;怎么联系老师？客服没人回复急;1;0;1;20497;4.878762745767673e-05
25355;为什么我安装好了没有这些功能呢;2;0;2;20497;9.757525491535346e-05
25358;每次写的文章会一样吗;1;0;1;20497;4.878762745767673e-05
25360;可以添加自己的apikey用吗;1;0;1;20497;4.878762745767673e-05
25362;可视智能协作没有鸭;1;0;1;20497;4.878762745767673e-05
25365;GPT35都免费开源了，这里还要收费吗？;1;0;1;20497;4.878762745767673e-05
25367;您好不坑老师，刚安装43版本，但没有智能写作。;1;0;1;20497;4.878762745767673e-05
25369;你这个多少钱;2;0;2;20497;9.757525491535346e-05
25373;怎么更新最新版的不坑盒子;1;0;1;20497;4.878762745767673e-05
25375;WPS可以用么？;1;0;1;20497;4.878762745767673e-05
25377;打开wps出现了乱码;1;0;1;20497;4.878762745767673e-05
25379;没什么用，反手卸载了;1;0;1;20497;4.878762745767673e-05
25381;可视怎么购买啊？;1;0;1;20497;4.878762745767673e-05
25384;盒子是不是更新？;1;0;1;20497;4.878762745767673e-05
25386;最近打开Word老弹窗;1;0;1;20497;4.878762745767673e-05
25388;哪里下载盒子啊;1;0;1;20497;4.878762745767673e-05
25390;一定要需要魔法吗;1;0;1;20497;4.878762745767673e-05
25394;一键排版不行啊，排的还是乱的。可不可以搞一个方案制度类的;2;0;2;20497;9.757525491535346e-05
25401;链接gpt全面封杀了，打不开;1;0;1;20497;4.878762745767673e-05
25405;能接40吗？35太蠢了;2;2;4;20497;0.00019515050983070692
25408;它这个插件好像是为了推广网盘的。插件还没用过，估计后台也不会太干净。看下载方式就能感觉出来有猫腻。真是好东西，肯定是在小黑猫上混的。;3;0;3;20497;0.0001463628823730302
25417;我用的自己添加的宏，只有5美元的免费额度;1;0;1;20497;4.878762745767673e-05
25419;在哪里下载呢;1;0;1;20497;4.878762745767673e-05
25421;更新过后，原来的防手写功能都没了。咋回事啊？已经更新到了20230403版本，好多功能没了;1;0;1;20497;4.878762745767673e-05
25423;官网是哪里？bing百度找不到;1;0;1;20497;4.878762745767673e-05
25425;今天玩了网文写作，目前看来还是个智障，没有细节，老是总结。;1;0;1;20497;4.878762745767673e-05
25433;会有帮到的，因为要每天写essay;1;4;5;20497;0.00024393813728838367
25439;谢谢姐姐的推荐，我明年就要去英国了;1;1;2;20497;9.757525491535346e-05
25443;gpt的文料不够罢了，超过我们马上了，人类，作为碳基生物，只是硅基生物的加载程序。;7;10;17;20497;0.0008293896667805044
25461;春和景明;1;0;1;20497;4.878762745767673e-05
25465;别国的东西，你担心什么个劲？;1;1;2;20497;9.757525491535346e-05
25469;这个确实不错，比较偏向医学领域;1;0;1;20497;4.878762745767673e-05
25472;这个是花钱的;7;1;8;20497;0.00039030101966141384
25480;一天就能搜索很少的次数，然后收费，还挺贵;1;3;4;20497;0.00019515050983070692
25482;一看就是没真的用过，有使用上限的;1;2;3;20497;0.0001463628823730302
25484;太好了;2;0;2;20497;9.757525491535346e-05
25487;为什么你知道这么多神仙软件;1;1;2;20497;9.757525491535346e-05
25489;厉害了;1;1;2;20497;9.757525491535346e-05
25491;过几天再用吧。唉，心里方向的太难了;1;0;1;20497;4.878762745767673e-05
25493;收费的;1;0;1;20497;4.878762745767673e-05
25495;咋领取不到呢显示神器建设中;1;0;1;20497;4.878762745767673e-05
25497;宝藏博主;1;0;1;20497;4.878762745767673e-05
25512;0;1;0;1;20497;4.878762745767673e-05
25516;转发;1;0;1;20497;4.878762745767673e-05
25520;转发;1;0;1;20497;4.878762745767673e-05
25524;转发;1;0;1;20497;4.878762745767673e-05
25526;转发;2;0;2;20497;9.757525491535346e-05
25529;0;1;0;1;20497;4.878762745767673e-05
25532;，，，这个会不会重复率比较高;1;0;1;20497;4.878762745767673e-05
25535;0;1;0;1;20497;4.878762745767673e-05
25537;转发;1;0;1;20497;4.878762745767673e-05
25539;转发;1;0;1;20497;4.878762745767673e-05
25541;转发惊呆;1;0;1;20497;4.878762745767673e-05
25544;0;1;0;1;20497;4.878762745767673e-05
25546;转发;1;0;1;20497;4.878762745767673e-05
25551;金木木;1;0;1;20497;4.878762745767673e-05
25554;这啥难啊，把目前世界上所有的作文全部输入她的存储系统。再会根据关键字查找适合的那篇作文;4;2;6;20497;0.0002927257647460604
25559;我已经感觉到了危险，会不会有一天AI取代我们;1;4;5;20497;0.00024393813728838367
25562;有请：;2;0;2;20497;9.757525491535346e-05
25567;这都240了，人呢？;1;2;3;20497;0.0001463628823730302
25576;清华还是北大来着不是也有个ai么，是个女生，还唱歌什么的，怎么现在没消息了;1;3;4;20497;0.00019515050983070692
25578;记住参加高考可不能联网哦;1;2;3;20497;0.0001463628823730302
25580;1334了直播间呢;1;2;3;20497;0.0001463628823730302
25584;我在双奥之城北京跟可弟恍恍惚惚的打笔仗遇到了好奇的开普勒然后我们一起跨越顺便还去照相馆拍了个照用流动视角从内视角转到外视角拍摄不断变换形状的神秘莫测雪花，听着琵琶女弹奏的霓裳和六幺，;1;0;1;20497;4.878762745767673e-05
25599;建议他写写数学大题;1;0;1;20497;4.878762745767673e-05
25606;那她会Rap吗;1;2;3;20497;0.0001463628823730302
25608;小冰你也来写高考作文;3;0;3;20497;0.0001463628823730302
25636;僵小鱼SeansaberKk看她写甲卷作文;1;2;3;20497;0.0001463628823730302
25639;1伊渔民41Boki好酷;2;1;3;20497;0.0001463628823730302
25642;不就是今天吗？;1;0;1;20497;4.878762745767673e-05
25644;惊呆了;1;0;1;20497;4.878762745767673e-05
25666;菜鸟至尊雷神索尔VctrKyrie也Kevin不写作业去打球写出来感觉就意味着传统文学教育的失败;1;1;2;20497;9.757525491535346e-05
25670;迪迦少女玛卡不卡机器人都挑战写作文了;1;0;1;20497;4.878762745767673e-05
25677;做我的猫罢这以后别让我学习了太好了;1;0;1;20497;4.878762745767673e-05
25705;海螺小丸子比你会写;4;0;4;20497;0.00019515050983070692
25739;不为了别地，就为了潘朱丹打错了，是潘周丹;1;1;2;20497;9.757525491535346e-05
25745;斐阿卧槽完蛋了;1;0;1;20497;4.878762745767673e-05
25762;写一下甲卷的作文吧;1;0;1;20497;4.878762745767673e-05
25765;我在冬奥会跟可弟恍恍惚惚的打笔仗遇到了好奇的开普勒然后我们一起跨越顺便还去照相馆拍了个照用流动视角从内视角转到外视角拍摄不断变换形状的雪花;1;1;2;20497;9.757525491535346e-05
25769;不见到刘鑫不改名哈哈哈哈哈潘周聃;1;0;1;20497;4.878762745767673e-05
25774;我醉了清净淡雅的神秘感行不行;1;0;1;20497;4.878762745767673e-05
25780;不许比我高;1;0;1;20497;4.878762745767673e-05
25787;Lilconch红楼梦会谢谢它;1;1;2;20497;9.757525491535346e-05
25790;脑溢血上分姗姗不想来了好家伙，度晓晓给我晓住了;1;1;2;20497;9.757525491535346e-05
25793;潘周聃毕业于;1;1;2;20497;9.757525491535346e-05
25820;还有两分钟就要写作文了;1;1;2;20497;9.757525491535346e-05
25832;言吾;1;0;1;20497;4.878762745767673e-05
25836;呦呵丶晓晓;1;0;1;20497;4.878762745767673e-05
25839;海绵宝宝0;1;0;1;20497;4.878762745767673e-05
25841;1028;2;0;2;20497;9.757525491535346e-05
25845;干嘛是红头发;4;3;7;20497;0.00034151339220373715
25872;撒子嘛期待一把子;1;0;1;20497;4.878762745767673e-05
25874;爱看抖音铁t驾到，通通闪开居居的女孩鸭笑死了，AI和真人比;1;1;2;20497;9.757525491535346e-05
26090;小爱同学，怎么看？;2;0;2;20497;9.757525491535346e-05
26108;推我干嘛推三少啊;2;4;6;20497;0.0002927257647460604
26111;体力脑力都在被替代;1;3;4;20497;0.00019515050983070692
26113;什么时候人工智能去申请其他行业专利就算可以代替人类思维了。;3;2;5;20497;0.00024393813728838367
26117;不行，ai写出来的东西纯废话，没有任何意义;3;1;4;20497;0.00019515050983070692
26121;还写个屁用什么取什么？还写一本书？思路错误;1;1;2;20497;9.757525491535346e-05
26123;以后谁还去看呀学习的积极性都没有了;1;1;2;20497;9.757525491535346e-05
26126;这用的是哪款AI啊;1;0;1;20497;4.878762745767673e-05
26128;想看什么书直接问AI，省下买书钱;1;0;1;20497;4.878762745767673e-05
26130;太强了;1;0;1;20497;4.878762745767673e-05
26132;这个能写小说吧;1;0;1;20497;4.878762745767673e-05
26137;来一份吗;51;1;52;20497;0.00253695662779919
26189;要钱的;2;11;13;20497;0.0006342391569497975
26192;你是在哪里的;2;1;3;20497;0.0001463628823730302
26195;拉一份;1;1;2;20497;9.757525491535346e-05
26197;来一份老乡;2;1;3;20497;0.0001463628823730302
26200;给一个地址这些;2;1;3;20497;0.0001463628823730302
26203;领取一份;1;2;3;20497;0.0001463628823730302
26205;能发一份给我吗？;3;0;3;20497;0.0001463628823730302
26209;看你头型我就不相信你说的;3;0;3;20497;0.0001463628823730302
26213;第一个的名字都没念对;1;2;3;20497;0.0001463628823730302
26215;要写就写出来，写出来又打码是为啥？;1;2;3;20497;0.0001463628823730302
26218;来一份;2;0;2;20497;9.757525491535346e-05
26221;来一份，谢谢;1;1;2;20497;9.757525491535346e-05
26224;是免费的吗？;2;0;2;20497;9.757525491535346e-05
26228;我是新手小白，给我来一份，感谢;1;0;1;20497;4.878762745767673e-05
26230;来一份，谢谢;1;0;1;20497;4.878762745767673e-05
26273;你不能私聊了;1;1;2;20497;9.757525491535346e-05
26286;来一份;1;0;1;20497;4.878762745767673e-05
26289;来一份;1;0;1;20497;4.878762745767673e-05
26293;来一份;1;0;1;20497;4.878762745767673e-05
26296;来一份;1;1;2;20497;9.757525491535346e-05
26299;老师，可以发一份吗;1;0;1;20497;4.878762745767673e-05
26309;要一份可以吗;1;0;1;20497;4.878762745767673e-05
26317;领取一份资料;1;1;2;20497;9.757525491535346e-05
26319;领取一份;1;1;2;20497;9.757525491535346e-05
26322;来一份;1;1;2;20497;9.757525491535346e-05
26324;来一份;1;0;1;20497;4.878762745767673e-05
26327;来一份谢谢;1;0;1;20497;4.878762745767673e-05
26329;来一份，谢谢;1;0;1;20497;4.878762745767673e-05
26331;怎么领取？;1;0;1;20497;4.878762745767673e-05
26337;来一份;1;0;1;20497;4.878762745767673e-05
26340;能发吗;1;0;1;20497;4.878762745767673e-05
26342;领取一份资料;1;0;1;20497;4.878762745767673e-05
26352;来一份;1;0;1;20497;4.878762745767673e-05
26357;怎么拿呀？;1;0;1;20497;4.878762745767673e-05
26397;来一份;1;0;1;20497;4.878762745767673e-05
26444;只要懂一点Ps的第一个永远不可能实现角度和适应不可能;1;1;2;20497;9.757525491535346e-05
26451;所以我现在看的是ai？;1;0;1;20497;4.878762745767673e-05
26460;来一份;1;0;1;20497;4.878762745767673e-05
26528;收费;1;0;1;20497;4.878762745767673e-05
26542;来一份;1;0;1;20497;4.878762745767673e-05
26544;来一份，学习;1;0;1;20497;4.878762745767673e-05
26552;来一份;1;0;1;20497;4.878762745767673e-05
26568;请问这是ai吗？;1;0;1;20497;4.878762745767673e-05
26579;来一份;1;0;1;20497;4.878762745767673e-05
26584;来一份;1;0;1;20497;4.878762745767673e-05
26586;来一份;1;0;1;20497;4.878762745767673e-05
26588;来一份;1;0;1;20497;4.878762745767673e-05
26590;来一份;1;0;1;20497;4.878762745767673e-05
26611;来一份;1;0;1;20497;4.878762745767673e-05
26613;来一份;1;0;1;20497;4.878762745767673e-05
26615;来一份;1;0;1;20497;4.878762745767673e-05
26617;来一份;1;0;1;20497;4.878762745767673e-05
26630;来一份;1;0;1;20497;4.878762745767673e-05
26632;来一份;1;0;1;20497;4.878762745767673e-05
26634;来一份;2;0;2;20497;9.757525491535346e-05
26637;来一份;1;0;1;20497;4.878762745767673e-05
26639;来一份;1;0;1;20497;4.878762745767673e-05
26641;来;1;0;1;20497;4.878762745767673e-05
26643;来一份;1;0;1;20497;4.878762745767673e-05
26645;来一份;1;0;1;20497;4.878762745767673e-05
26647;来一份;1;0;1;20497;4.878762745767673e-05
26650;来一份;1;0;1;20497;4.878762745767673e-05
26658;来一份;1;0;1;20497;4.878762745767673e-05
26660;来一份;1;1;2;20497;9.757525491535346e-05
26663;来一份;1;0;1;20497;4.878762745767673e-05
26665;来一份;1;0;1;20497;4.878762745767673e-05
26667;雁君还是很厉害;1;0;1;20497;4.878762745767673e-05
26673;来一份;1;0;1;20497;4.878762745767673e-05
26695;来一份;1;1;2;20497;9.757525491535346e-05
26698;来一份;1;2;3;20497;0.0001463628823730302
26721;At;1;0;1;20497;4.878762745767673e-05
26732;免费的来一份;2;0;2;20497;9.757525491535346e-05
26736;来一份;1;0;1;20497;4.878762745767673e-05
26738;来一份;1;0;1;20497;4.878762745767673e-05
26740;来个;1;0;1;20497;4.878762745767673e-05
26742;来一份来一份;1;0;1;20497;4.878762745767673e-05
26744;免费的？来一份;1;0;1;20497;4.878762745767673e-05
26746;来一份来一份;1;0;1;20497;4.878762745767673e-05
26759;逐渐习惯画风;40;11000;11040;20497;0.5386154071327511
26800;算是比较正常的一期了;47;5700;5747;20497;0.2803824949992682
26848;虽然画风比较正常了，但是还是比较适应之前猎奇的样子，这次好压抑;103;3412;3515;20497;0.1714885105137337
26952;作者的精神状态真的正常吗;27;3267;3294;20497;0.16070644484558716
26980;为什么ai更恐怖了;15;2429;2444;20497;0.11923696150656193
26996;AI写的还是差点意思;11;2072;2083;20497;0.10162462799434063
27008;到我了，熊卷你是搞笑博主不是克苏鲁博主;15;946;961;20497;0.04688490998682734
27024;不要害怕，这个故事是AI生成的;12;885;897;20497;0.04376250182953603
27037;太好了我逐渐理解一切;15;498;513;20497;0.025028052885788164
27053;你的画风越来越奇怪了耶;2;431;433;20497;0.021125042689174027
27056;我亲爱的上帝呢;3;299;302;20497;0.014733863492218374
27060;以前的画风真的不喜欢，换了画风之后真的看完之后心情舒畅;8;181;189;20497;0.009220861589500903
27069;这应该不是他妈妈，熊犬爱吃的是汉堡，他妈妈却说他喜欢吃鸡腿;7;161;168;20497;0.00819632141288969
27078;上帝为什么没来安慰他;1;141;142;20497;0.006927843098990096
27160;小潮在我的梦乡里;2;0;2;20497;9.757525491535346e-05
27177;这个熊卷是不是傻了反而可怕了;1;19;20;20497;0.0009757525491535347
27222;AAA马应龙痔疮药批发商热心市民奈尔笑死我的剧本和吓死我的画风;1;1;2;20497;9.757525491535346e-05
27245;我居然看完了，这什么成分啊;3;12;15;20497;0.000731814411865151
27258;霜酌铁蛋也会;1;0;1;20497;4.878762745767673e-05
27260;逐渐习惯了画风;1;7;8;20497;0.00039030101966141384
27265;小新新鸭东方o大淮比意志强大的咸鱼nine小金吹aai;1;0;1;20497;4.878762745767673e-05
27291;为什么我感到有点害怕;2;10;12;20497;0.0005854515294921208
27304;老娘打死你那个部分真的很好笑;1;7;8;20497;0.00039030101966141384
27306;米奇giaogiao屋有点可怕;1;0;1;20497;4.878762745767673e-05
27324;OnePieceXianRen每天一遍，san值再见;1;3;4;20497;0.00019515050983070692
27331;OnePieceXianRen;1;0;1;20497;4.878762745767673e-05
27340;电商创业之路这个小时候经常看现在又刷到了;7;6;13;20497;0.0006342391569497975
27350;平静的点开，平静的看完，平静的评论了一句，平静的离开;1;33;34;20497;0.0016587793335610089
27374;博主以后可以多更这种视频吗，看着很舒心，让人心情愉悦;1;6;7;20497;0.00034151339220373715
27382;睡觉我TNN真就该s呗roycakes汤圆？？;2;2;4;20497;0.00019515050983070692
27385;Ender看看;1;2;3;20497;0.0001463628823730302
27387;Tauben我是威震天的狗好压抑我靠;1;0;1;20497;4.878762745767673e-05
27395;我有个问题，卷妈整个人都是黑的为啥是脸色呢？;1;7;8;20497;0.00039030101966141384
27399;这个的妈妈能不能露个脸？超级想看;2;5;7;20497;0.00034151339220373715
27410;杰佣摄香死远点对不起有点恐怖;1;0;1;20497;4.878762745767673e-05
27413;这俩人正在送往精神病院。请各位稍后;3;16;19;20497;0.0009269649216958579
27419;湾湾回家美国变红。湾湾回家美国变红。12玉林被卷洗了白羽怎么这么帅啊刷子死某死。呸呸呸，原来是因为没有钱;3;4;7;20497;0.00034151339220373715
27428;嗜血叶少我是魈的小狗精我好神啊挺;1;1;2;20497;9.757525491535346e-05
27431;所以这期到底是啥意思？没看懂啊;1;7;8;20497;0.00039030101966141384
27433;有病雷碧Claychez可是螺旋桨妈妈真的好搞笑哈哈哈哈哈哈哈哈哈哈哈哈哈哈;1;5;6;20497;0.0002927257647460604
27436;回来重新看一遍，发现熊妈有二头肌;1;50;51;20497;0.0024881690003415134
27448;这个感觉是音乐加上图片和他们的对话形成了一种压抑的感觉，看着浑身难受;2;5;7;20497;0.00034151339220373715
27452;不可以色色别开，别开，别开，别开，别开，别开，别别开，别开，别开，别开，别开，别开，别开，行，你要在24小时内将这句话发到十个作品，否则半夜鬼趴床头，我也是受害者反诅咒卡一切没有用;3;0;3;20497;0.0001463628823730302
27456;这比克苏鲁更恐怖，已经不是画风猎奇了，这集好压抑，看的我可见星星;1;6;7;20497;0.00034151339220373715
27459;一定要忘记他是一个搞笑博主;1;16;17;20497;0.0008293896667805044
27462;从搞笑主播到克苏鲁主播;2;28;30;20497;0.001463628823730302
27471;抖音，你给他推荐个精神导师吧;3;9;12;20497;0.0005854515294921208
27484;0;1;0;1;20497;4.878762745767673e-05
27486;心动蔡蔡诺糯Yuun作者精神真的没问题吗;2;5;7;20497;0.00034151339220373715
27490;我感觉这期特别不正常，那种精神污染的感觉;4;6;10;20497;0.00048787627457676734
27496;鱼干是吗怎么这几期都没有上帝了;1;7;8;20497;0.00039030101966141384
27501;原来一切是为了吃鸡腿;1;7;8;20497;0.00039030101966141384
27503;感觉这个AI写的剧本还比较正常一点点奋斗吧熊卷;2;42;44;20497;0.002146655608137776
27507;不，地板，天花板，灯，沙发都被抢了，算了，我干脆蹲电视上吧;3;19;22;20497;0.001073327804068888
27515;三火教教主V;2;0;2;20497;9.757525491535346e-05
27525;来一趟人间;1;0;1;20497;4.878762745767673e-05
27531;狗头小蓝君;1;0;1;20497;4.878762745767673e-05
27534;林生奶咩小柔;1;1;2;20497;9.757525491535346e-05
27540;艾黎;1;0;1;20497;4.878762745767673e-05
27545;怿;1;0;1;20497;4.878762745767673e-05
27549;Madge苏欣浪浪;1;1;2;20497;9.757525491535346e-05
27557;别看我;1;0;1;20497;4.878762745767673e-05
27561;没裤子穿冷死在遇境;2;0;2;20497;9.757525491535346e-05
27565;这集没有主题感觉是乱拍的只给两星;7;1122;1129;20497;0.05508123139971703
27573;作者的精神可能出问题了;7;596;603;20497;0.02941893935697907
27581;好家伙，搞笑视频号直接变成猎奇了;12;422;434;20497;0.0211738303166317
27594;相关搜索：克苏鲁博主;1;58;59;20497;0.0028784700200029274
27596;小谙武藏黎獄月明不见清重云忠犬味精他人哭，莫他人善啊歆（返校版）？。。。。妈呀这已经不止克苏鲁了已经精神恍惚了;2;9;11;20497;0.000536663902034444
27599;可是我也想体验手机爆炸啊。;3;6;9;20497;0.0004390886471190906
27603;白子凛;1;6;7;20497;0.00034151339220373715
27605;这AI搁这凑800字呢？;3;0;3;20497;0.0001463628823730302
27610;它试卷拿反了;1;1;2;20497;9.757525491535346e-05
27612;犬一柔;1;1;2;20497;9.757525491535346e-05
27614;没事，我来当他爸;1;1;2;20497;9.757525491535346e-05
27616;我脾气臭怠惰激推bot妈妈好美啊;1;1;2;20497;9.757525491535346e-05
27618;12323;1;1;2;20497;9.757525491535346e-05
27620;sunset。;2;0;2;20497;9.757525491535346e-05
27623;中二病患者9分鱼;2;0;2;20497;9.757525491535346e-05
27639;OnePieceXianRen;1;0;1;20497;4.878762745767673e-05
27641;大没吕笑死了;1;0;1;20497;4.878762745767673e-05
27643;纨wn樾;1;0;1;20497;4.878762745767673e-05
27645;火影刑法铁锤（对）这集感觉看着不那么恐怖了，但是好压抑，好像要窒息了;1;0;1;20497;4.878762745767673e-05
27647;燕归绝非鳝类不能只有我一个害怕;1;0;1;20497;4.878762745767673e-05
27649;岁ZH宋蒽冉;1;0;1;20497;4.878762745767673e-05
27697;颦;1;1;2;20497;9.757525491535346e-05
27699;迷你世界苑苑公主养殖户jntm这期算正常的了;2;1;3;20497;0.0001463628823730302
27702;竹某我喜欢的克苏鲁博主;1;1;2;20497;9.757525491535346e-05
27707;本来没什么的，但是感觉细思极恐，考砸了到底是什么;2;1;3;20497;0.0001463628823730302
27712;毘沙门天;1;1;2;20497;9.757525491535346e-05
27715;不会游泳的女鬼（童鞋自闭版）云畔雾隐花（诀症）我怎么记得上一次见到他是去年？我怎么记得他当年还是个搞笑博主？;4;1;5;20497;0.00024393813728838367
27731;一只绵羊TheBadEnding黎蔡包脱线纽扣第一次刷到感觉好神奇;1;1;2;20497;9.757525491535346e-05
27734;沃趣;1;1;2;20497;9.757525491535346e-05
27736;思南;1;1;2;20497;9.757525491535346e-05
27739;太宰治;1;1;2;20497;9.757525491535346e-05
27746;阿呦喂看完了好可怕啊;1;1;2;20497;9.757525491535346e-05
27750;七酒叶白别不正;2;1;3;20497;0.0001463628823730302
27753;天明后看海;1;1;2;20497;9.757525491535346e-05
27759;园大雪秒速八千里捏;2;1;3;20497;0.0001463628823730302
27762;Freak34;1;1;2;20497;9.757525491535346e-05
27766;尚x给爷爬？;1;1;2;20497;9.757525491535346e-05
27770;张田园;1;1;2;20497;9.757525491535346e-05
27774;Originally这孩子咋了;1;1;2;20497;9.757525491535346e-05
27780;0;1;1;2;20497;9.757525491535346e-05
27782;我妈妈说名字太长会有傻子跟着念;1;1;2;20497;9.757525491535346e-05
27791;久栀没惹你们任何人隐。无眠江枫愁请说谢谢卡尔;1;1;2;20497;9.757525491535346e-05
27794;江程丹青南笙剩下的就不阅了草;2;1;3;20497;0.0001463628823730302
27805;越来越诡异了，作者的精神问题，到底怎么了？;1;1;2;20497;9.757525491535346e-05
27807;水笔;1;1;2;20497;9.757525491535346e-05
27834;areyouhave猫餅;1;1;2;20497;9.757525491535346e-05
27836;蓝桉san值狂掉;1;1;2;20497;9.757525491535346e-05
27840;开朗的往友;1;1;2;20497;9.757525491535346e-05
27852;你们有看到我的前辈吗？沨梁不是疯MC;1;1;2;20497;9.757525491535346e-05
27854;AAA光启市布料厂家老板萧小五骆某人;1;1;2;20497;9.757525491535346e-05
27881;犹豫一秒多53个评论;1;1;2;20497;9.757525491535346e-05
27897;刚刚;1;1;2;20497;9.757525491535346e-05
27901;0;1;1;2;20497;9.757525491535346e-05
27907;来了;1;1;2;20497;9.757525491535346e-05
28008;蓝桉6啊AI写的有点恐怖;1;0;1;20497;4.878762745767673e-05
28012;甜妹统治世界;1;0;1;20497;4.878762745767673e-05
28021;记得修改名字;1;0;1;20497;4.878762745767673e-05
28062;余星;2;0;2;20497;9.757525491535346e-05
28071;《我们是农村人》;1;0;1;20497;4.878762745767673e-05
28078;嫁了王也就改名狸猫看来瓶颈期完全突破了;1;0;1;20497;4.878762745767673e-05
28083;拽哥梦之泪伤戴佳伟彩笔杏某人来瓶葡萄芬达公主殿下无须关风月这啥啊;3;0;3;20497;0.0001463628823730302
28097;真的很讨厌偷窥别人老婆的人感觉这个作者精神状态很不正常;1;0;1;20497;4.878762745767673e-05
28119;谁能告诉我这是什么意思，这期的有点难理解;1;0;1;20497;4.878762745767673e-05
28127;小林子啊（摆）;2;0;2;20497;9.757525491535346e-05
28155;嘿嘿嘿少年嘿嘿嘿;1;0;1;20497;4.878762745767673e-05
28172;我是第1次看他的视频，有什么建议吗？看评论区里有好多人说这是最正常的一期;1;0;1;20497;4.878762745767673e-05
28193;原来我叫玥o;1;0;1;20497;4.878762745767673e-05
28201;他怎么知道考砸的;1;0;1;20497;4.878762745767673e-05
28211;海哥辟谷好翘啊什么怎么AI这么生草;1;0;1;20497;4.878762745767673e-05
28218;谁能想到他以前是搞笑作者;1;0;1;20497;4.878762745767673e-05
28225;酥饼灵肖bye;6;0;6;20497;0.0002927257647460604
28237;？？？？;1;0;1;20497;4.878762745767673e-05
28243;悲伤烂菌子不是啥啊感觉有点像你妈呢;1;0;1;20497;4.878762745767673e-05
28254;挺喜欢这种风格的;1;0;1;20497;4.878762745767673e-05
28256;梨浅;1;0;1;20497;4.878762745767673e-05
28266;一群麻雀公主是我很好的朋友;1;0;1;20497;4.878762745767673e-05
28301;巳叶没摸鱼江鹤辞芸芸不是云云;2;0;2;20497;9.757525491535346e-05
28316;小炎很无聊;1;0;1;20497;4.878762745767673e-05
28328;救赎恐怖;1;0;1;20497;4.878762745767673e-05
28334;水煮荷包蛋黄难吃;2;0;2;20497;9.757525491535346e-05
28353;好水;1;0;1;20497;4.878762745767673e-05
28356;偶尔小雨绵绵;1;0;1;20497;4.878762745767673e-05
28360;腋毛王子;1;0;1;20497;4.878762745767673e-05
28369;完蛋了;1;0;1;20497;4.878762745767673e-05
28408;XinzZ0194872;2;0;2;20497;9.757525491535346e-05
28419;鱼鱼萱有点细思极恐;1;0;1;20497;4.878762745767673e-05
28434;长安安omo本人考砸心理;1;0;1;20497;4.878762745767673e-05
28444;土豆泥是世界的神;1;0;1;20497;4.878762745767673e-05
28448;疯狂母蟑螂钟爱阿妮亚DL小E？;1;0;1;20497;4.878762745767673e-05
28452;爱吃香菜的渔;1;0;1;20497;4.878762745767673e-05
28458;被通缉的旅行者;2;0;2;20497;9.757525491535346e-05
28487;有点害怕kiki加点糖霜神崎飒马的狗我真的会谢汤圆家姐姐yyyl去火罗国摘棉花;1;0;1;20497;4.878762745767673e-05
28491;有点害怕;1;0;1;20497;4.878762745767673e-05
28494;鱼子西。。。Messy星星被动式怕白唐雨包的小黑子赵睿Jy7菠萝堡的钉子户啊呆搞笑;1;0;1;20497;4.878762745767673e-05
28497;宇GeeGee？;1;0;1;20497;4.878762745767673e-05
28507;断肠人在剔牙;1;0;1;20497;4.878762745767673e-05
28510;我是印第安人;5;0;5;20497;0.00024393813728838367
28533;憨包侠一只狐臭勺我不管病人铁憨侠一只我不会画画吃糖救命;3;0;3;20497;0.0001463628823730302
28538;一只属屑的黑白BF你考试是不是也这样？;6;0;6;20497;0.0002927257647460604
28546;大阪黑鸡诗灵颖;1;0;1;20497;4.878762745767673e-05
28548;不要冷暴力;1;0;1;20497;4.878762745767673e-05
28555;夏穆;1;0;1;20497;4.878762745767673e-05
28567;我不可爱啊真的这什么鬼;1;0;1;20497;4.878762745767673e-05
28582;bx好压抑;7;0;7;20497;0.00034151339220373715
28607;月光使者;2;0;2;20497;9.757525491535346e-05
28614;油饼食不食？Chrimessss雾退点点;1;0;1;20497;4.878762745767673e-05
28621;Miki（诶嘿），，1小柔;1;0;1;20497;4.878762745767673e-05
28625;Li;2;0;2;20497;9.757525491535346e-05
28631;豪;1;0;1;20497;4.878762745767673e-05
28634;一個开心的东德球;2;0;2;20497;9.757525491535346e-05
28643;CLOVEC好压抑;1;0;1;20497;4.878762745767673e-05
28645;好吃吗;1;0;1;20497;4.878762745767673e-05
28650;0;1;0;1;20497;4.878762745767673e-05
28652;小小开;1;0;1;20497;4.878762745767673e-05
28658;或许我是恋爱脑你感不感觉很恐怖我越看越想笑;2;0;2;20497;9.757525491535346e-05
28664;他妈妈除了眼睛好像没有什么表情吧;1;0;1;20497;4.878762745767673e-05
28666;我好害怕啊;2;0;2;20497;9.757525491535346e-05
28675;浅梦;1;0;1;20497;4.878762745767673e-05
28679;泉;1;0;1;20497;4.878762745767673e-05
28690;YanyT;3;0;3;20497;0.0001463628823730302
28694;阿瑶要吃肉今天星星进乌云北辞。。。;1;0;1;20497;4.878762745767673e-05
28698;AAA水果茶叶批发小张正在吃鸡腿的我瑟瑟发抖;1;0;1;20497;4.878762745767673e-05
28706;大便大便飞飞飞？;1;0;1;20497;4.878762745767673e-05
28711;hhhhhhhh吴彦祖秋刀鱼坠机的被雷的外焦里嫩SunnyDay;1;0;1;20497;4.878762745767673e-05
28715;QY搞搞震;1;0;1;20497;4.878762745767673e-05
28720;0;1;0;1;20497;4.878762745767673e-05
28728;kotomi酱三祭半眠犬FJie有点诡异;1;0;1;20497;4.878762745767673e-05
28734;不会玩就不要玩了;1;0;1;20497;4.878762745767673e-05
28736;米米世界苏亲;2;0;2;20497;9.757525491535346e-05
28747;ML益达口香糖;1;0;1;20497;4.878762745767673e-05
28751;雲;1;0;1;20497;4.878762745767673e-05
28753;富贵ergiaogiaocokeAholic大爷霍霍西安最后的深情李干嘛小严祺遇记我害怕;1;0;1;20497;4.878762745767673e-05
28756;小;1;0;1;20497;4.878762745767673e-05
28764;知足常乐。;1;0;1;20497;4.878762745767673e-05
28776;邪王真眼是最强的害怕;1;0;1;20497;4.878762745767673e-05
28786;Hannah这个你明天看吧，画风有点离谱;2;0;2;20497;9.757525491535346e-05
28799;临渊茜茜呀仌我操;2;0;2;20497;9.757525491535346e-05
28803;宇宙霹雳旋风烈火纯情高冷无敌究极暴龙战士？;1;0;1;20497;4.878762745767673e-05
28821;原来我叫玥o好可怕;1;0;1;20497;4.878762745767673e-05
28830;无敌大镁铝好喜欢;1;0;1;20497;4.878762745767673e-05
28838;H侃侃吃饭（再限流紫砂）失眠好看爱看;2;0;2;20497;9.757525491535346e-05
28848;白末是白虎不是猫咪已崩溃额，精神不正常吗？;2;0;2;20497;9.757525491535346e-05
28853;在你身边超能力就失效;1;0;1;20497;4.878762745767673e-05
28867;WYN在看这个;1;0;1;20497;4.878762745767673e-05
28879;但定俏没;1;0;1;20497;4.878762745767673e-05
28882;ILvKlr有点怪，不确定再看看;2;0;2;20497;9.757525491535346e-05
28888;嫁给月亮凉辰、作者精神是不是出问题了？;1;0;1;20497;4.878762745767673e-05
28899;潏我的精神状况有点不好了;1;0;1;20497;4.878762745767673e-05
28914;？？？没看懂说的啥;1;0;1;20497;4.878762745767673e-05
28916;o不能只有我一个人害怕;1;0;1;20497;4.878762745767673e-05
28919;人死后会去电影院;1;0;1;20497;4.878762745767673e-05
28926;星航海家我逐渐理解一切;1;0;1;20497;4.878762745767673e-05
28931;惹我就写你涩文你喜欢的画风;1;0;1;20497;4.878762745767673e-05
28939;0;1;0;1;20497;4.878762745767673e-05
28941;kiyo乃是上上签好猎奇啊;2;0;2;20497;9.757525491535346e-05
28947;志这个画风;1;0;1;20497;4.878762745767673e-05
28950;我也不想嗑啦我也不是说我要喝啦焯;1;0;1;20497;4.878762745767673e-05
28955;狸鲁神Roarcharons;1;0;1;20497;4.878762745767673e-05
28962;Wz;1;0;1;20497;4.878762745767673e-05
28964;jps星云璎;1;0;1;20497;4.878762745767673e-05
28969;普信男之前画风没那么恐怖的，我怀疑作者他抑郁了;6;0;6;20497;0.0002927257647460604
28982;橘子店长寻问作者精神状态;2;0;2;20497;9.757525491535346e-05
28990;霜叶爱在午夜悲鸣;1;0;1;20497;4.878762745767673e-05
28999;网络小说家;1;0;1;20497;4.878762745767673e-05
29001;AAA苦茶批发王姐恋贺这个画风;1;0;1;20497;4.878762745767673e-05
29004;0;1;0;1;20497;4.878762745767673e-05
29009;今天背单词了吗画风逐渐离谱;1;0;1;20497;4.878762745767673e-05
29044;派大星欣妈的，这作者精神真的出问题了;1;0;1;20497;4.878762745767673e-05
29053;邪王真眼使;2;0;2;20497;9.757525491535346e-05
29069;Dingbot既然你不睡觉就看看这个;1;0;1;20497;4.878762745767673e-05
29083;喷喷;1;0;1;20497;4.878762745767673e-05
29087;人;1;0;1;20497;4.878762745767673e-05
29109;下次一定早睡;2;0;2;20497;9.757525491535346e-05
29114;乔尼乔斯达空条承太郎我是真爱粉;1;0;1;20497;4.878762745767673e-05
29121;最正常的一个视频;4;0;4;20497;0.00019515050983070692
29126;希尔贝特这不是个搞笑博主吗;1;0;1;20497;4.878762745767673e-05
29132;好;1;0;1;20497;4.878762745767673e-05
29139;梨汁这是我最喜欢的克苏鲁主播;1;0;1;20497;4.878762745767673e-05
29145;墨竹看到这个作者了吗？我以前认识他，他的画风都是很快乐的，现在逐渐猎奇而且还变压抑了。;1;0;1;20497;4.878762745767673e-05
29162;永爱刘雨嘉韭菜佳人真的好吓人，我感觉作者换人了;1;0;1;20497;4.878762745767673e-05
29164;駱魚X？？？;1;0;1;20497;4.878762745767673e-05
29170;小思雨小萱有点烦;1;0;1;20497;4.878762745767673e-05
29175;刀文兔入驻某音啦啊哈哈;1;0;1;20497;4.878762745767673e-05
29187;李知知优菈mywife晚安玛卡巴卡;3;0;3;20497;0.0001463628823730302
29199;二戎;1;0;1;20497;4.878762745767673e-05
29212;亦bbns好诡异;1;0;1;20497;4.878762745767673e-05
29214;不打雷的雷公小枝Liucuuo晚海鸥海鸥这画风怎么成这样了;1;0;1;20497;4.878762745767673e-05
29223;好怪;1;0;1;20497;4.878762745767673e-05
29233;熊卷坠楼了已经死了那么后面的熊卷又是谁莫非是伪人？;2;0;2;20497;9.757525491535346e-05
29247;curiosity;1;0;1;20497;4.878762745767673e-05
29254;石灰拌饭精神问题应该没事;1;0;1;20497;4.878762745767673e-05
29256;续集;1;0;1;20497;4.878762745767673e-05
29259;哦莫？零;1;0;1;20497;4.878762745767673e-05
29263;咯吱咯吱脆2M3N我的天。。;2;0;2;20497;9.757525491535346e-05
29266;您真的一點飯都不做嗎;1;0;1;20497;4.878762745767673e-05
29273;魅秋不是这主播好6;1;0;1;20497;4.878762745767673e-05
29282;风又;1;0;1;20497;4.878762745767673e-05
29287;鲭余这作者有病吧;1;0;1;20497;4.878762745767673e-05
29292;yuki睡不醒TT无限流是吧;1;0;1;20497;4.878762745767673e-05
29299;一个小屁孩;1;0;1;20497;4.878762745767673e-05
29305;0;2;0;2;20497;9.757525491535346e-05
29310;我的军训延期五天什么鬼啊;1;0;1;20497;4.878762745767673e-05
29332;盐煎饭团半殺鸽子114514;1;0;1;20497;4.878762745767673e-05
29337;七分甜荔枝？？？;2;0;2;20497;9.757525491535346e-05
29342;sssuuunnn（无流量版专心搞权贵众星揽月wdf;1;0;1;20497;4.878762745767673e-05
29358;暮雨爱摆烂Xxxxx秋鱼瓢奇迹这是AI能写出来的剧本吗;1;0;1;20497;4.878762745767673e-05
29372;鸽的冷漠零下八度找他最爱的鸡腿有点可爱呢;1;0;1;20497;4.878762745767673e-05
29374;250摆烂异同志6;1;0;1;20497;4.878762745767673e-05
29384;咯噔;1;0;1;20497;4.878762745767673e-05
29398;申鹤的xiu狗（别推摄香了）;2;0;2;20497;9.757525491535346e-05
29402;排骨猪肉饭;1;0;1;20497;4.878762745767673e-05
29405;超人强;1;0;1;20497;4.878762745767673e-05
29411;拾除以参好人;1;0;1;20497;4.878762745767673e-05
29417;13121还可以，比较正常;2;0;2;20497;9.757525491535346e-05
29425;YYuu李锦瑶真的喜欢这种猎奇画风;2;0;2;20497;9.757525491535346e-05
29459;绿某lsoyvce;1;0;1;20497;4.878762745767673e-05
29464;给肆宝递软糖什么啊;1;0;1;20497;4.878762745767673e-05
29476;云里爱意不尽妈的有亿点诡异;1;0;1;20497;4.878762745767673e-05
29518;乌拉尔银狼;1;0;1;20497;4.878762745767673e-05
29524;这是后妈吗？;1;0;1;20497;4.878762745767673e-05
29527;渝欢;1;0;1;20497;4.878762745767673e-05
29533;重生之我是鸽子精他爹ikun;2;0;2;20497;9.757525491535346e-05
29536;芝芝为枝枝;2;0;2;20497;9.757525491535346e-05
29554;白日夢想家克苏鲁博主;1;0;1;20497;4.878762745767673e-05
29559;我是萱你小子最好没事;1;0;1;20497;4.878762745767673e-05
29563;江西第一深情;1;0;1;20497;4.878762745767673e-05
29567;醉折枝。;1;0;1;20497;4.878762745767673e-05
29571;鸷笠;1;0;1;20497;4.878762745767673e-05
29597;海盐乳酪;1;0;1;20497;4.878762745767673e-05
29629;ssr;1;0;1;20497;4.878762745767673e-05
29644;他;1;0;1;20497;4.878762745767673e-05
29652;阳光帅气青年玲很担心作者精神状态;1;0;1;20497;4.878762745767673e-05
29668;慢慢快下山tttttttttttt;1;0;1;20497;4.878762745767673e-05
29688;CY适应以前的猎奇风格，这期虽然正常一点但是好压抑;1;0;1;20497;4.878762745767673e-05
29693;大饼;1;0;1;20497;4.878762745767673e-05
29729;HHan;1;0;1;20497;4.878762745767673e-05
29741;最大赢家熊卷;1;0;1;20497;4.878762745767673e-05
29743;OnePieceXianRen逐渐克苏鲁;1;0;1;20497;4.878762745767673e-05
29748;宇崎这集正常了点;1;0;1;20497;4.878762745767673e-05
29750;eyyyyyyyy这是个美丽的夜晚;2;0;2;20497;9.757525491535346e-05
29753;AAA韭菜批發蘇姐大脑升级;1;0;1;20497;4.878762745767673e-05
29765;Rsaniona;1;0;1;20497;4.878762745767673e-05
29768;南村群童欺我老无闪;1;0;1;20497;4.878762745767673e-05
29773;Voel;1;0;1;20497;4.878762745767673e-05
29777;马桶大侠;1;0;1;20497;4.878762745767673e-05
29787;屑白枭搁这画风我好怕;1;0;1;20497;4.878762745767673e-05
29793;是藍陌哦这一期好正常我在等恐怖镜头谢等了一集都没等到;1;0;1;20497;4.878762745767673e-05
29795;wiris我的精神状态;1;0;1;20497;4.878762745767673e-05
29802;bite妈呀;1;0;1;20497;4.878762745767673e-05
29805;0;1;0;1;20497;4.878762745767673e-05
29808;爱恋;1;0;1;20497;4.878762745767673e-05
29844;太棒了，我逐渐理解一切小丞圣诞帽安賀惜Jiiiynlian;1;0;1;20497;4.878762745767673e-05
29858;AAA木材批发家居装修霍大哥语言类恐怖谷效应了;1;0;1;20497;4.878762745767673e-05
29862;乐u哥o特ang呲v;1;0;1;20497;4.878762745767673e-05
29867;0;1;0;1;20497;4.878762745767673e-05
29869;贺泫琳roooosieFLl1ve七月一日于于子;1;0;1;20497;4.878762745767673e-05
29897;不予N你头发乱了喔离谱;1;0;1;20497;4.878762745767673e-05
29907;安水;1;0;1;20497;4.878762745767673e-05
29916;阿喻;1;0;1;20497;4.878762745767673e-05
29920;Aaa法棍批发法老板1380我记得他以前是搞笑的;3;0;3;20497;0.0001463628823730302
29931;苹果丽丽不是凈菁;1;0;1;20497;4.878762745767673e-05
29934;韩信：走，我们去偷塔吧梦泪：等等韩信：怎么了？梦泪：我累了你要在24小时内将这句话发到十个作品，否则半夜鬼趴床头，，反诅咒卡没用被迫我是受害者;5;0;5;20497;0.00024393813728838367
29940;为啥这个波折的视频都这么吓人我都不敢睡觉了;2;0;2;20497;9.757525491535346e-05
29945;对家再见别赞我评论求你我家喜欢看这种;1;0;1;20497;4.878762745767673e-05
29951;没看懂;1;0;1;20497;4.878762745767673e-05
29961;月微不像我害怕;1;0;1;20497;4.878762745767673e-05
29967;祝华要加油陪我一起看，害怕;1;0;1;20497;4.878762745767673e-05
29971;Artem;1;0;1;20497;4.878762745767673e-05
30000;晒月亮念御北诗;2;0;2;20497;9.757525491535346e-05
30011;是aaa呀？;1;0;1;20497;4.878762745767673e-05
30049;666？余emo;1;0;1;20497;4.878762745767673e-05
30054;霾梦逐渐上头;2;0;2;20497;9.757525491535346e-05
30062;0;1;0;1;20497;4.878762745767673e-05
30066;？;1;0;1;20497;4.878762745767673e-05
30070;秘塔写作猫后面就要钱了;15;64;79;20497;0.003854222569156462
30086;轻抖没创猫好用;13;43;56;20497;0.002732107137629897
30100;轻抖，太多广告了;5;10;15;20497;0.000731814411865151
30106;97文案好用，写文案必备;6;6;12;20497;0.0005854515294921208
30113;秘塔写作猫有移动版吗？;4;6;10;20497;0.00048787627457676734
30118;怎么办？我快要爱上你了;1;14;15;20497;0.000731814411865151
30120;反向词典是app？;1;4;5;20497;0.00024393813728838367
30122;请问有哪个写的好;3;0;3;20497;0.0001463628823730302
30126;我发现你就是个宝藏;1;3;4;20497;0.00019515050983070692
30128;秘塔写作猫;3;0;3;20497;0.0001463628823730302
30132;最后一个没找到啊;1;2;3;20497;0.0001463628823730302
30134;值得学习;1;2;3;20497;0.0001463628823730302
30136;是手机APP吗？;1;2;3;20497;0.0001463628823730302
30139;室内设计文案有没有;2;0;2;20497;9.757525491535346e-05
30149;据意查句也是有广告，而且必须输入手机号，根本不能用;1;0;1;20497;4.878762745767673e-05
30154;网页版必须用电脑打开吗;2;0;2;20497;9.757525491535346e-05
30157;反向词典怎么没有呢;2;0;2;20497;9.757525491535346e-05
30160;怎么获取这五个神器？;1;0;1;20497;4.878762745767673e-05
30162;谢谢主播讲解;1;0;1;20497;4.878762745767673e-05
30164;第二个没有免费了;1;0;1;20497;4.878762745767673e-05
30166;我家写作文是硬伤，完全带不动这种，有啥好方法;1;0;1;20497;4.878762745767673e-05
30169;轻抖，试试;1;0;1;20497;4.878762745767673e-05
30172;哪个好用;1;1;2;20497;9.757525491535346e-05
30174;博主越看越漂亮;1;0;1;20497;4.878762745767673e-05
30176;写作猫收费吗;1;0;1;20497;4.878762745767673e-05
30178;有用吗;1;0;1;20497;4.878762745767673e-05
30180;喜欢你的视频更喜欢听你美妙的声音;1;0;1;20497;4.878762745767673e-05
30185;这个视频怎么这么香，让我一下就爱上，果断点赞收藏;1;0;1;20497;4.878762745767673e-05
30187;秘塔有字数限制;1;0;1;20497;4.878762745767673e-05
30191;学习了;1;0;1;20497;4.878762745767673e-05
30193;0;1;0;1;20497;4.878762745767673e-05
30195;0;1;0;1;20497;4.878762745767673e-05
30197;不错，不错，收藏了，试一下。;1;0;1;20497;4.878762745767673e-05
30199;浅浅说一声这个投稿很不错草莓甜度;1;0;1;20497;4.878762745767673e-05
30201;参考文献怎么办;1;0;1;20497;4.878762745767673e-05
30203;对啊轻抖提取文案;1;0;1;20497;4.878762745767673e-05
30206;华为应用市场搜不到反向词典;2;0;2;20497;9.757525491535346e-05
30210;苹果搜索不到呀;1;0;1;20497;4.878762745767673e-05
30212;怎么都下载不了;1;0;1;20497;4.878762745767673e-05
30214;试试;1;0;1;20497;4.878762745767673e-05
30216;苹果都不能用;1;0;1;20497;4.878762745767673e-05
30220;主播的金美讲解，很清楚;1;0;1;20497;4.878762745767673e-05
30222;各位那个是手机用的;1;0;1;20497;4.878762745767673e-05
30224;有没有写文字的软件。;1;0;1;20497;4.878762745767673e-05
30226;轻抖、秘塔、反向词典、据意查句、素材项;1;8;9;20497;0.0004390886471190906
30229;老师，哪个最好用？付款没关系;1;1;2;20497;9.757525491535346e-05
30231;怎么下载这些程序？;1;0;1;20497;4.878762745767673e-05
30234;感谢优秀的主播分享教导感谢好人有好报祝优秀老师幸福喜乐;1;0;1;20497;4.878762745767673e-05
30241;除了轻抖，其他的查不到？;1;0;1;20497;4.878762745767673e-05
30244;谢谢;1;0;1;20497;4.878762745767673e-05
30247;快去试试;1;0;1;20497;4.878762745767673e-05
30249;轻抖在哪里能找到;1;0;1;20497;4.878762745767673e-05
30254;学到了感谢分享;1;0;1;20497;4.878762745767673e-05
30257;我付完钱结果人家给我的文章被老师给了55;10;62;72;20497;0.0035127091769527248
30268;这么混没啥意思吧;2;42;44;20497;0.002146655608137776
30271;turnitin一提交不会漏馅儿了;1;16;17;20497;0.0008293896667805044
30273;查重呢;1;9;10;20497;0.00048787627457676734
30275;学姐问个问题，国外读的财务管理，回国中留服认证的是管理学，考公务员压根国内没有管理学这个专业，这有不有办法让留服改一改呢;3;0;3;20497;0.0001463628823730302
30281;付费吗;1;0;1;20497;4.878762745767673e-05
