label;一级评论;真实二级评论数;真实点赞数;边数;最大边数;集群密度
0;文心跟chat的差距就是chat啥时候开源文心就彻底追上了;39;2131;2170;3799;0.5712029481442484
40;莆田系跟正规医院水平差距也不是很大;13;1971;1984;3799;0.5222426954461701
54;人类跟大猩猩的基因只差2;6;932;938;3799;0.24690708081073967
61;原神和塞尔达传说水平相差一两个月;1;40;41;3799;0.010792313766780732
63;爱因斯坦提出了质能方程，我也知道EMC，我和爱因斯坦差距也不是很大doge;14;1161;1175;3799;0.3092919189260332
78;快来个勇士再给他头上浇瓶矿泉水让他清醒一下;19;1034;1053;3799;0.2771782047907344
98;省流：百度一两个月能偷到chatgpt上个月的技术doge;16;439;455;3799;0.11976836009476179
115;文心一言彻底成功了我问它我得了什么病它会给我推荐癌症吗？;13;514;527;3799;0.13872071597788893
129;估计是俄罗斯时间一两个月，文心一小时二十二分速通chatgpt艳红里一战封神;3;467;470;3799;0.12371676757041326
133;不不不，chatgpt在广告推销上远远落后。;6;356;362;3799;0.09528823374572255
140;说绿皮火车都是抬举它了，人家是高铁，他那个是马拉木板车，人家已经可以写代码了，它那个还在推荐莆田;2;127;129;3799;0.03395630429060279
143;chatGPT跟cheatPPT观众还是分得清的。;1;122;123;3799;0.032376941300342195
145;猜文心一言得开会员，还会限速5kb脱单doge;2;68;70;3799;0.018425901553040275
148;连代码都不会写、上下文能力欠缺，怎么有脸说达到GPT一月份的水平;20;207;227;3799;0.05975256646485917
169;别人一开源，我们就自研;1;21;22;3799;0.005790997630955514
171;真以为一月份没人用chatgpt？我去年11月就在用了差的远了根本不是一个东西;21;204;225;3799;0.05922611213477231
193;只要中文世界言论？自由，了，文心一言就成了;3;13;16;3799;0.0042116346406949196
197;入戏太深，可惜奥斯卡结束了。;1;176;177;3799;0.04659120821268755
199;商人可以不要脸。。但是不能这么丢脸，真的太丢脸了，李总;1;66;67;3799;0.017636220057909976
205;只会越差越远，中文语料库根本比不了英文的藏狐;1;14;15;3799;0.003948407475651487
207;水已经滋不醒他的良心了，得尿;1;21;22;3799;0.005790997630955514
210;说抄的是不是没脑子，一个技术要是光说抄就可以得到的话，那大家直接去抄好了，之前就有说j20是抄f22的，那你怎么没看除中国以外的其他国家抄出来。任何有一定门槛的技术不是只要出现了，然后知道大概怎么回事就可以获得，你得知道得非常清晰，像造飞机一样得具体知道用什么强度，什么参数的螺钉这个层次才行。现在chatgpt你们连是否开源都弄不清楚，就在这doge叫，拜托先动动手查一查，再下结论。;4;22;26;3799;0.006843906291129244
215;现在ChatGPT用户基数摆在这，回馈的数据越来越多，差距会指数级拉开了;6;86;92;3799;0.024216899183995787
225;分享chatGPT和DALLe使用方法，给个赞包教会;3;7;10;3799;0.0026322716504343247
229;可以，希望5月份能看到文心一言达到GPT4的水平，要不就是吹牛;10;28;38;3799;0.010002632271650434
240;绿皮火车跟高铁差别不大，都是在铁轨上跑;2;56;58;3799;0.015267175572519083
243;李彦宏跟贾跃亭差距也不是很大;3;51;54;3799;0.014214266912345353
255;问题在于，一两个月的时间，自己会进步，那别人就不会进步了吗？这种说法怎么跟刻舟求剑似的;1;19;20;3799;0.0052645433008686494
257;莆田系跟正规医院水平差距也不是很大;1;54;55;3799;0.014477494077388787
261;百度作恶多端;1;4;5;3799;0.0013161358252171624
264;5年前就听说百度布局ai力度很大，几乎allin，当时目光短浅，看不出有什么价值，以为百度是因为丢了搜索引擎阵地的价值之后乱投机，今天看来确实可以，希望有点成绩。;15;20;35;3799;0.009212950776520137
284;gpt一出来我马上想到的就是百度很多业务离倒闭了很近了;10;10;20;3799;0.0052645433008686494
299;我感觉文心一言就是抄的，用起来里面的字符计算逻辑都是英文的，看不出是自研的。;3;10;13;3799;0.003421953145564622
303;自己有和有的用是两个概念;1;2;3;3799;0.0007896814951302974
307;大家都在喷百度，却不知它的股票发布会后一直在涨，现在是自21年来最高点;10;9;19;3799;0.005001316135825217
320;国产的食物，衣服，鞋子等我都会支持，但百度的这个东西，我绝对不会用的，就算技术超过chatGPT都不会用。;6;2;8;3799;0.0021058173203474598
328;有up看过论文了，核心部分都是抄的;1;2;3;3799;0.0007896814951302974
332;体感上的感觉，腾讯的有技术但是可能大概也许还在洗数据集所以不管他1Sydney2GPT43Newbing4GPT355被削弱的Newbing6文心一言7BardGPT3;4;6;10;3799;0.0026322716504343247
337;你能把文心一言开源吗看看里面有没有gpt12的东西吃瓜;8;5;13;3799;0.003421953145564622
350;你倒是让我用啊，老排队;6;7;13;3799;0.003421953145564622
361;人家是全球的用户帮忙迭代数据库，你只能是中国国内，希望早点放开国外权限。;1;1;2;3799;0.0005264543300868649
385;能勇敢的发布，能承认差距，能分享研发过程。给百度点赞，给李彦宏点赞。;5;18;23;3799;0.006054224795998947
392;不就是跟华为一样吗，人家松松手就吹牛逼，人家一制裁就翘辫子;3;3;6;3799;0.0015793629902605948
418;谷歌表示差距两三年，百度表示一两个月，说明百度的ai已经碾压谷歌了。真不知道网上泼冷水的在想什么，跪久了;1;1;2;3799;0.0005264543300868649
422;文心一言本身这个名字就取的不好，很拗口;2;1;3;3799;0.0007896814951302974
437;超不了，除非更快;1;0;1;3799;0.00026322716504343247
452;差个接口？;1;0;1;3799;0.00026322716504343247
457;一个是新吹的牛皮，另一个是跟风吹的牛皮。差距主要取决于吹的速度;1;0;1;3799;0.00026322716504343247
479;科技部部长王志刚：ChatGPT之于AI就像梅西之于足球，很难做到那么好哔哩哔哩httpsb23tvZftzTAA;1;0;1;3799;0.00026322716504343247
492;也就差一个开源;1;0;1;3799;0.00026322716504343247
499;我想知道ChatGpT是怎么自己提升的，总不能无中生有吧;3;0;3;3799;0.0007896814951302974
521;我可以等3个月多给你一个月再来看看脱单doge如果能有现在gpt的水平我买你一年会员;1;0;1;3799;0.00026322716504343247
530;迭代是爆炸式的。差距只会越来越快。傲慢是罪啊;2;0;2;3799;0.0005264543300868649
535;不管如何，我是支持的，别以为科学无国界，中国cpu被掐多久了思考;1;1;2;3799;0.0005264543300868649
542;我们的中文底层数据和外国数据差太多了;1;0;1;3799;0.00026322716504343247
555;喷他的，是显得自己多能《独立思考》吗？;1;1;2;3799;0.0005264543300868649
560;目前看来，百度是废了，看一下下一个挑战者阿里怎么样。听说他们数据最多，不知道什么时候做个AI出来玩玩。;2;0;2;3799;0.0005264543300868649
588;你们这些批评百度的评论公正点好吗？百度很早就投入ai，不存在跟风。每年人工成本几百亿。你们觉得百度不行，很大程度是因为ChatGPT太优秀，就连Google也比不上，凭什么要求百度。这就跟奥林匹克物理竞赛第一名跟爱恩斯坦比，比不过一样。;1;0;1;3799;0.00026322716504343247
593;支持国货打call中国有大智慧的人最多星星眼;1;0;1;3799;0.00026322716504343247
595;importopenaiaswenxinyiyan;2;0;2;3799;0.0005264543300868649
598;让我想起来了十年前网上一堆人信誓旦旦说国产车不可能，永远也超不过日系车;5;0;5;3799;0.0013161358252171624
605;问题是你文心一言的模型不也是在人家上一个开源的模型基础上修改的藏狐;1;0;1;3799;0.00026322716504343247
608;不可能，你绝对不可能达到gpt35的水平，估计也就2的水平，连3都达不到;1;0;1;3799;0.00026322716504343247
614;别唱衰自己国家有公司在做应该鼓励李彦宏牛逼;3;0;3;3799;0.0007896814951302974
621;我和高考状元也就差了差不多一天的时间，高考完，出答案后，我甚至有可能比高考状元成绩还好脱单doge;1;0;1;3799;0.00026322716504343247
624;总分41分么笑哭;1;0;1;3799;0.00026322716504343247
626;就知道浇冷水？;3;0;3;3799;0.0007896814951302974
635;哈哈哈哈哈哈班级里的学霸偶尔放点水控分考了个61分，坐旁边的小度同学费劲力气考了个59沾沾自喜喜极而泣结果下一次月考，学霸考了91，你还搁那混个及格分都够呛笑哭这时候傻眼了，差距原来这么大;1;0;1;3799;0.00026322716504343247
640;你咋不说你百度的自动驾驶和博世的差距也不是很大。;1;0;1;3799;0.00026322716504343247
644;就是完全抄的代码，要求总线（bus）结果画巴士（bus），爱国的猫结果出星条旗，你说这是什么。现在会抄袭已经这么厚颜无耻了吗;3;2;5;3799;0.0013161358252171624
649;套壳吧，确实差不多;1;0;1;3799;0.00026322716504343247
652;好给你两个月，我看你能不能达到40的水平;1;0;1;3799;0.00026322716504343247
661;真会吹，文言撑死2019年的gpt2的水平;3;4;7;3799;0.0018425901553040273
674;你什么时候把你那破b搜索引擎整顿一下就谢天谢地了;1;0;1;3799;0.00026322716504343247
687;跟chatGPT也就差了一个chatGPT;1;1;2;3799;0.0005264543300868649
691;笑哭一时间不知道谁是猴子是他还是我们？这样耍猴。;2;1;3;3799;0.0007896814951302974
699;别误会，可能内核用的是GPT29;1;0;1;3799;0.00026322716504343247
720;百度就是个纯搞钱的，能有什么大研发投入，chagpt投入很多钱;1;0;1;3799;0.00026322716504343247
733;是的，都怪gpt早发布了一两个月，不然引领AI届的就是百度了。;1;2;3;3799;0.0007896814951302974
738;就是个翻译然后调用chatgpt的东西，让他画个爱国的猫能画出一个带美国国旗的猫，我也是乐;4;0;4;3799;0.0010529086601737299
755;清华大专和清华大学差距不大;1;0;1;3799;0.00026322716504343247
759;这片土壤峠博子只会越来越多;1;0;1;3799;0.00026322716504343247
761;支持国货，不要妄自菲薄也不要盲目自信;1;0;1;3799;0.00026322716504343247
784;其实差距没李彦宏说的这么大，只是差了一个字罢了，一个人工智能一个人工智障;2;1;3;3799;0.0007896814951302974
792;chatgpt核心算法知道了吗？这么吹;2;0;2;3799;0.0005264543300868649
831;评论和弹幕怎么了？你确定用过这两个工具？;2;0;2;3799;0.0005264543300868649
840;你要是真复现就算了，抄会了也就算了。复现都复现不了，只会调别人的接口。牛奶路（MilkWay）生成个银河系图片，抄都抄不了，api调用仔踏马的也和OpenAI比。还有脸说国内不会有了，笑死。腾讯抄都抄不出原神。估计百度也就那样了。;1;0;1;3799;0.00026322716504343247
851;可能他说的是chatgpt2;2;0;2;3799;0.0005264543300868649
882;至少在做了，扛什么？;7;0;7;3799;0.0018425901553040273
890;微软已经明确警告了，你吖在逼逼就把你的接口给封了;13;72;85;3799;0.022374309028691763
904;《请画一个外国女孩》;6;374;380;3799;0.10002632271650434
911;AI已经跟你说了很多次了，想画鸡蛋灌饼，你干嘛不满足它的要求吃瓜;2;176;178;3799;0.046854435377730985
914;看这个图片。就知道国内海量的劣质图片对AI的影响有多大了。中国在这方面要提升的不仅仅是数据问题了。。。还有摄影。审美。清晰度。等各方面数据。。。;14;27;41;3799;0.010792313766780732
929;从网上淘来的。;8;195;203;3799;0.05343511450381679
938;我发现了什么不得了的东西;3;32;35;3799;0.009212950776520137
942;这题我会啊，;1;30;31;3799;0.008160042116346407
944;还以为是一个马桶上面写着亚洲;2;98;100;3799;0.026322716504343247
947;试试“请画一个我国女孩”吃瓜;2;1;3;3799;0.0007896814951302974
950;请画一个我们的国旗doge;2;14;16;3799;0.0042116346406949196
955;好么，原来百度把美国重定义为“中国”了，这样画“爱国”的时候出现的就是中国。而“美国女孩”这个义项做了特殊处理，所以也能输出正确。但其他义项没处理好，所以让画“外国”女孩出现的是中国女孩。;16;34;50;3799;0.013161358252171624
972;所以百度亡羊补牢，但是没补全，哈哈哈哈哈;1;28;29;3799;0.007633587786259542
974;你让他画松鼠鳜鱼doge;2;10;12;3799;0.0031587259805211897
978;看看这个;3;5;8;3799;0.0021058173203474598
982;文心一言只是个语言模型，训练集完全没有图像数据，画图是调用了stablediffusion，何必难为人家画图。。;1;0;1;3799;0.00026322716504343247
984;我想知道，如果让他画一个爱国女孩，会不会画出来一个披着星条旗的女孩doge;1;2;3;3799;0.0007896814951302974
990;古装和现代装区分试试？;6;3;9;3799;0.0023690444853908922
998;就问你眼睛大不大吧;1;3;4;3799;0.0010529086601737299
1001;这个怎么用;1;0;1;3799;0.00026322716504343247
1006;让它画一个穿比基尼的美国男孩。;2;0;2;3799;0.0005264543300868649
1017;所以文心一言到底经历了什么，它是被洗脑了吗鼓掌;7;0;7;3799;0.0018425901553040273
1025;敢问几个敏感点的问题吗;1;0;1;3799;0.00026322716504343247
1032;它咋这么喜欢水墨画;2;0;2;3799;0.0005264543300868649
1035;蚌，百度根本是赶鸭子上架，技术还不行。;1;0;1;3799;0.00026322716504343247
1039;星星眼;6;32;38;3799;0.010002632271650434
1046;tvdoge;15;211;226;3799;0.059489339299815744
1062;6的不行;2;43;45;3799;0.011845222426954462
1065;还是gpt厉害些脱单doge;3;51;54;3799;0.014214266912345353
1070;百毒不死天理难容，小米赛高;4;32;36;3799;0.009476177941563569
1075;数学题我用chatgpt也试过，简单的可以对，稍微复杂点，就也是错的。不过回答的算相关。无论是gpt还是一言，他们在回答数学题的正确与否都取决于网上你能搜到的结果在大部分是对的还是错的。很难说是是真正的数学逻辑运算。;24;111;135;3799;0.03553566728086339
1100;不要问数学题;18;56;74;3799;0.019478810213214005
1119;小爱同学直接回答正确，小米赢;2;87;89;3799;0.023427217688865493
1124;这都是从哪找到的文心一言我进内测一直进不去，说发短信等通知也没音讯了;2;6;8;3799;0.0021058173203474598
1129;确实难绷微笑;4;22;26;3799;0.006843906291129244
1134;ChatGPT上问过一些中国历史，它好像还没学会，让它评价朱由检，它说朱由检又名朱棣笑哭;11;9;20;3799;0.0052645433008686494
1146;Chatgpt用中文问数学题他会算错，用英语和日语他一般都不会算错;1;12;13;3799;0.003421953145564622
1149;今天突然比昨天聪明了很多完全不是一个档次有点怀疑突然聪明的原因;13;17;30;3799;0.007896814951302974
1164;这样的测试本来就是有意义的，帮助训练了模型;7;9;16;3799;0.0042116346406949196
1172;百度老总说他只是对标初代chatgpt大概就是2019内侧的gtp给他三年时间看看doge不过三年后GPT6都出了doge;1;3;4;3799;0.0010529086601737299
1176;你问一个人有8个苹果，一个人有6个苹果，然后给对方几个，两个人就一样多，你问死的他都不会;5;2;7;3799;0.0018425901553040273
1185;文心一言感觉根本不是学习型AI，就是个大号的小度，它不应该叫文心一言，应该叫大度;1;0;1;3799;0.00026322716504343247
1192;Siri说他会做;1;0;1;3799;0.00026322716504343247
1204;你提交顶多是让百度把这个回复给改成正确的doge;1;0;1;3799;0.00026322716504343247
1209;废品;3;3;6;3799;0.0015793629902605948
1213;像百度这种公司不是丢中国人的脸吗？;1;1;2;3799;0.0005264543300868649
1216;gpt35甚至可以直接理解文字;3;55;58;3799;0.015267175572519083
1220;这个比较形象;1;13;14;3799;0.0036851803106080546
1222;关键词爱国的猫，直接出披着星条旗的猫，都实锤是外国AI了。;22;464;486;3799;0.12792840221110818
1245;我觉得最惊艳我的还是，胸有成竹的男人和青梅竹马;6;48;54;3799;0.014214266912345353
1252;松鼠桂鱼dogedoge;7;99;106;3799;0.027902079494603844
1260;哈哈;21;110;131;3799;0.034482758620689655
1282;文言就是套着中国AI皮的外国AI，这种所谓的灵魂画作，都是把中文翻译成单词，再进行数据库比对和逻辑分析的结果。根本听不懂中国话。热;27;215;242;3799;0.06370097394051066
1311;都改了。没有那么脑洞大开了;1;39;40;3799;0.010529086601737299
1313;你让他画一个鼠标，然后画出来的是老鼠，因为鼠标翻译成了mouse;3;7;10;3799;0.0026322716504343247
1317;吃瓜百度这个是先翻译成英文，再识别生成。应该是基于公司一个开源的项目，再开发的。有人让他生成个总线（bus），结果生成了个汽车。后来修正，但是让他画个总线跟狗，还是会画出来车。然后母线，不同组合也会画出来车;12;103;115;3799;0.030271123979994735
1330;百度这么多年出过的产品质量如何，懂得都懂。;1;25;26;3799;0.006843906291129244
1332;美国已经在打舆论战了，实际上文心一言和chatgpt是互有胜负的。尤其是道德模块，文心一言远远高于chatgpt，但现在已经有领了狗粮的人昧着良心无脑吹chatgpt了，希望大家不要被骗了;8;6;14;3799;0.0036851803106080546
1341;很显然数据集的标注是英文的，可能直接翻译了标注导致混乱。用英文数据集很正常，中文相关资料非常不足。;10;41;51;3799;0.013424585417215057
1353;它的画图水平还在去年，因为用的是别人的api;10;32;42;3799;0.011055540931824164
1365;哈哈，文心一言更有意思，它画的你想不到呲牙;2;38;40;3799;0.010529086601737299
1369;这不就是偷换概念？？前者你直接给名称后面每一个你都画什么什么，人家当然侧重画了吃瓜吃瓜;1;13;14;3799;0.0036851803106080546
1371;一个自己说的菜单，一个叫画出图片，你这个怎么比较;11;35;46;3799;0.012108449591997894
1383;百度已经发声明辟谣了，大家可以自己搜一下;19;27;46;3799;0.012108449591997894
1403;哈哈。真是人才。侧面说明温馨一眼更具创造性;1;23;24;3799;0.006317451961042379
1408;因为是先翻译成英文再让别人训好的东西画的呲牙，套皮国产，你喜欢吗呲牙打call打call打call;18;5;23;3799;0.006054224795998947
1433;说实话感觉还挺有创意的呲牙;2;3;5;3799;0.0013161358252171624
1437;画风有点恐怖;2;1;3;3799;0.0007896814951302974
1444;我觉得文比C强文是创作不像chat那就是个搜索引擎;5;1;6;3799;0.0015793629902605948
1455;文言一心不是用chatgpt做的吗？;2;1;3;3799;0.0007896814951302974
1460;一个是搜索。一个是绘图。;1;0;1;3799;0.00026322716504343247
1464;chatgpt不是不能输出图片吗？怎么做到的输出图片;1;0;1;3799;0.00026322716504343247
1467;这些东西难道还比不上一个搜索引擎吗？就是百度一下还能出来正确的图片，为什么到人工智能上越来越退步了？;1;0;1;3799;0.00026322716504343247
1470;洗白数据集是国外的没办法的，可以了解下openai是怎么把强化学习引入语言模型里的。总想借鸡下蛋，是干不好ai的，只能跟着别人屁股吃灰;2;0;2;3799;0.0005264543300868649
1476;服了，全是字面意思是吧，一点理解不了含义？？？？;1;0;1;3799;0.00026322716504343247
1489;不太懂。。这个前者是不是搜图片后者是挂出来的吧。这样的话没有可比性啊。。。;1;0;1;3799;0.00026322716504343247
1498;笑哭人工智能的一生之敌估计是中国菜;1;1;2;3799;0.0005264543300868649
1506;文心一言这个实际是先中译英然后再根据英文的字面意思画图;1;0;1;3799;0.00026322716504343247
1520;我怀疑国产ai就是以chatgpt20的开源版本为基础做的，总怀疑有拿来主义的想法;2;0;2;3799;0.0005264543300868649
1534;自然语言ai不能理解自然语言;3;1;4;3799;0.0010529086601737299
1548;天津麻花双方都失误了;1;0;1;3799;0.00026322716504343247
1554;不是文言一心吗;1;0;1;3799;0.00026322716504343247
1566;写诗写不过ai;11;94;105;3799;0.027638852329560412
1578;笑死，不过在玩笑我还是觉得对文心一言应该保持宽容的态度。虽然它还有不小的差距，但是科技的发展不是一蹴而就的，在这方面我们相对落后，有差距是正常的，至少他们在做，在努力追赶。;87;253;340;3799;0.08949723611476705
1666;百度网盘的龟速都知道，不简单，哈哈;11;209;220;3799;0.05790997630955515
1678;请你用一种阴阳怪气语气做出对chatGPT的评价哎呀呀，我这个人说话就是这么直接，chatgpt可是一款非常优秀的人工智能语言模型呢它不仅能够回答各种问题，还能够进行文本创作，甚至能够进行一些复杂的推理和预测不过，话说回来，如果我们把所有人工智能语言模型都看成是一个整体，那么chatgpt就只是其中一个微不足道的组成部分罢了，毕竟人工智能领域可是非常庞大的哦;1;7;8;3799;0.0021058173203474598
1680;文心一言等国内一众AI产品无论是陷入抄袭、套壳、低创新等舆论浪潮中，还是被群嘲，这都不影响这些产品的出现本质是商业行为而非技术创新。对待国内AI产品方面，首先使用ChatGPT等AI技术有一定门槛，这就导致国内AI不会有过低的用户基础。在相对较大的用户基础下国内AI产品可以进行快速迭代，这大概只能让我们不至于落伍。这些只是众多商业博弈中的一个小点，但对于个人来说更应该在意的其实是使用产品的体验。所以对以文心一言为代表的AI产品我持稍偏乐观的态度（尽管我并不使用）。（一些个人观点）;1;5;6;3799;0.0015793629902605948
1682;百度前两年就说allinai，然后是自动驾驶，感觉都是蹭热度;3;76;79;3799;0.020794946038431166
1686;怎么感觉我们的公司总是很穷，只想赚钱，好像随时可能死掉的感觉;2;24;26;3799;0.006843906291129244
1689;根本不需要这么问;5;50;55;3799;0.014477494077388787
1695;嗯？gpt会这么说话？我用的时候为何是特别理智中立的回答问题？;1;3;4;3799;0.0010529086601737299
1698;中国一定会追上的。只是需要点时间;23;18;41;3799;0.010792313766780732
1722;我昨天买了一个号，又不甘心，现在我自己也会注册了，其实电脑手机都差不多的，一口气注册了七八个。不然剩下的卢布，不知道用来干啥。;8;7;15;3799;0.003948407475651487
1733;买了98元一个月的plus独享号，太值了;7;5;12;3799;0.0031587259805211897
1758;能说什么呢，印章和海豹在中文环境里面是根本不沾边的两个词，但在英文环境里面却是同一个单词：seal，如果是基于中文识别做的AI，没理由会出现这种错误;24;151;175;3799;0.04606475388260069
1784;大胆，百度可是新晋爱国三厂，你居然敢说百度的不是？;5;202;207;3799;0.054488023163990526
1790;人要画个鶴，出个起重机，绝对是英文内核，先翻译成crane，这个词英文不联系上下文无法区别鶴和起重机，结果画个起重机。如果是纯中文的wordembeding完全是两个不同的矢量，但是英文确是一个。;14;291;305;3799;0.08028428533824691
1806;今天我们同事测试了一个，他说“画个云南过桥米线”，结果直接来了幅自然风景桥，都懵了，米线哪去了;9;123;132;3799;0.03474598578573309
1817;chatgpt刚出现的时候有些问题也是驴唇不对马嘴，文心一言没有足够的数据这些驴唇不对马嘴的问题也会出现，就跟你找了一个3岁的中国小孩和18岁的欧美人一样，纵向对比肯定比不过已经经过喂了好几个月数据的gpt了（或者说好几年都没问题，那些从验证码变成找出下列图片中的红绿灯开始，就已经在喂了）但是也不能说明文心一言就一定不好。最后，我想对一直唱衰的人说几句，你现在骨子里的自卑可能就是中国科技发展不下去的一个原因，你不相信国内的科技，所以你不给国内机会，国内得不到支持，而且出一丁点差错就会被别有用心的人放大然后装成清醒的人嘲讽，这些人不仅嘲讽国内的科技，还要嘲讽相信国内科技的人，给你一种相信国内就是上学上yu的人。简单思考一下，一个只挑问题然后否定并嘲笑所有试图解决问题的人，会是一个好人吗？;19;28;47;3799;0.012371676757041327
1837;百度的很多模型在github都是开源的，包括绘图的。更多原因在于数据集来源于国外，所以风格像国外的。国外数据集图片都是英文标注，推测是先中翻英再输入模型产生图片的，所以有这些问题。;30;57;87;3799;0.022900763358778626
1868;神tm把用户输入单词转成英文就是英文内核了单纯是炼金用的数据集是国外的而已，其他的光看几张图能看个啥;43;56;99;3799;0.026059489339299816
1912;自信过头了就是自大;1;24;25;3799;0.006580679126085812
1914;1如果是stableDiffusion的预训练模型的二次开发根据gpl开源协议应该公开源码他这么憋着是他不对大家都针对stableDiff二次开发没人觉得自己丢人怎么百度就这么特殊呢2如果不是stableDiffusion那没法要了连自己的数据集都搞不定据我所知人家俄语的模型都做的很好怎么你个全中国最大的搜索引擎做不了这个数据做出这玩意的恐怕连鸢尾花都没做过吧就光会pipinstall和gitclone;21;60;81;3799;0.02132140036851803
1936;不管怎么说，如果人工智能的黄金时代真的来临，我们能拿出手也只有文心一言，可以评价吐槽缺点，但别再戴着有色眼镜砸自己招牌;5;7;12;3799;0.0031587259805211897
1949;我认为是百度自主研发的，但是作为一款针对中国的软件无法直接理解中文需要去进行英文逐字直译是一种很夸张的行为，相当于拍了一款面向国内的历史电影但所有演员都在说英语，能给国人用的只有下面的字幕，甚至字幕上还是英文大写汉字小写在上，居心叵测;1;7;8;3799;0.0021058173203474598
1951;希望不要人云亦云，建议去试网络只信自己，文心一格现在就可以用。;2;1;3;3799;0.0007896814951302974
1954;大惊小怪，电脑程序都是用英文编辑的，你用中文它理解不了啊？;8;6;14;3799;0.0036851803106080546
1967;非要根据这一点来说百度直接套壳其实是不严谨的;1;1;2;3799;0.0005264543300868649
1980;喜欢你的视频;1;1;2;3799;0.0005264543300868649
1982;英文内核，不等于外国人做的内核;1;0;1;3799;0.00026322716504343247
2002;请画一只爱国猫。;1;0;1;3799;0.00026322716504343247
2007;英文内核有什么问题？程序员也代码不也是英文么？;3;0;3;3799;0.0007896814951302974
2023;美国一开源，立马抄起来;1;0;1;3799;0.00026322716504343247
2025;百度充值给openAI，调用他的DALLe服务，那个木鱼就是最好的证明;1;0;1;3799;0.00026322716504343247
2029;鸿蒙行为;2;1;3;3799;0.0007896814951302974
2032;AI版的汉芯没救了;2;11;13;3799;0.003421953145564622
2035;有几个开发软件是中文的？doge;1;0;1;3799;0.00026322716504343247
2039;我是有一讲一的，那个AI可以在现实中分析并解决问题，那这个AI就是强，就是好。这种水平的作画，娱乐一下可以，但有什么用途？人家的AI作画都已经拿奖项了。;4;1;5;3799;0.0013161358252171624
2047;以后评论都让ai帮我写了，攻击性强逻辑又严谨，淦烂一切人类藏狐;6;1195;1201;3799;0.31613582521716244
2055;怎么ai的攻击性比我都强？;17;378;395;3799;0.10397473019215583
2073;很少有百度这样的公司，做出来的每一款产品都让我觉得和史一样辣眼睛;4;256;260;3799;0.06843906291129244
2078;鲁迅那个不太象;5;136;141;3799;0.03711503027112398
2084;余昔年在京师，常有事于百度。百度者，乃一网站也，号称能够搜索天下之事物。然而其实不然，其所谓搜索者，无非是以金钱为本，以广告为先，以假货为多。其所谓知道者，无非是以无知为荣，以谬误为真，以恶意为乐。其所谓贴吧者，无非是以垃圾为财，以水军为友，以抄袭为能。余每见之，则不胜悲哀。想当年余初识网络之时，曾信百度如神明一般，能够解答余心中之疑惑。后来方知其实皆虚妄也。余曰：此等网站岂可久存？必有他者代之而兴也。然而近日闻一事甚奇怪也。原来百度又有新举措矣。其名曰“文心一言”。据闻此举措者乃欲借用古人之名义而行其私利也。即使人输入一词语，则自动出现古人之语录与之相应也。如输入“爱情”二字，则出现“执子之手与子偕老”；如输入“友情”二字，则出现“君子之交淡如水”；如输入“理想”二字，则出现“壮志未酬身先死”。余见此则大笑不止。此等语录岂能随意拼凑？岂能随意断章取义？岂能随意用于商业利益？此等行径真可谓亵渎古人矣且不说此等语录是否出自古人之口；即便真出自古人之口，亦非可轻易引用也。试问：执子之手与子偕老者何人？岂非《诗经》中那对恩爱夫妻耶？彼时彼地彼情境下方有此感慨耳今日汝辈何德何能而敢与彼辈相提并论？试问：君子之交淡如水者何人？岂非《论语》中孔子对颜回的赞誉耶？彼时彼地彼情境下方有此评价耳今日汝辈何德何能而敢与彼辈相提并论？试问：壮志未酬身先死者何人？岂非《离骚》中屈原对自己的感慨耶？彼时彼地彼情境下方有此感慨耳今日汝辈何德何能而敢与彼辈相提并论？;2;113;115;3799;0.030271123979994735
2089;为什么我只能用到gtp35，你们咋用40的;1;9;10;3799;0.0026322716504343247
2091;你知道我想到了什么吗？用chatgpt4来写小说，文笔能超过网上绝大部分网络写手;3;17;20;3799;0.0052645433008686494
2122;百度知道很不错，贴吧也挺有趣，百度云曾经也是王者doge但是gpt这回答是有水平的;1;0;1;3799;0.00026322716504343247
2128;Ai取代人类指日可待酸了我还学什么;1;1;2;3799;0.0005264543300868649
2133;我感觉你们用国外软件攻击国内创造真的是很讽刺哎;2;8;10;3799;0.0026322716504343247
2140;真不真啊笑哭为什么我的这么说：抱歉，作为一个AI语言模型，我不会故意使用阴阳怪气的语气来评价任何人或事物，因为这样的语气通常会被视为不礼貌和不尊重。我会尽力以礼貌和客观的方式回答问题。;2;1;3;3799;0.0007896814951302974
2151;国内怎么开通plus的;1;0;1;3799;0.00026322716504343247
2160;b友你好，请你用一种阴阳怪气的语气回复我;1;0;1;3799;0.00026322716504343247
2169;请问手机怎么使用？;2;0;2;3799;0.0005264543300868649
2172;不像鲁迅;1;0;1;3799;0.00026322716504343247
2177;打不过就加入，ChatGPT不能在国内网络使用要先解决网络问题如果能与MaxProxy服务商的组合使用，可以帮助您克服地区限制和网络访问问题，让您的交流更加顺畅和畅快。当然这maxproxy只是提供了干净的网络环境;3;6;9;3799;0.0023690444853908922
2186;俩都不是人，却非要当人doge;2;85;87;3799;0.022900763358778626
2189;331号获得文心一言的试用资格，试着输入up的这些要求，改善了好多，画可乐鸡翅、驴肉火烧、鱼香肉丝等都画对了;1;15;16;3799;0.0042116346406949196
2191;PDD的瓜什么时候发脱单doge;6;34;40;3799;0.010529086601737299
2199;chat现在可以画画了呀;3;8;11;3799;0.002895498815477757
2212;文心一言目前状态上确实比不过chatGPT35，但是中国的可用于给模型研究数据更多（openAI是创业公司，想要数据要支付巨额数据费），以后加上算法的更新以及更多的数据，我相信一定能够超过chatGPT35，毕竟现在的文心一言只是相当于GPT10的状态，做的却比GPT10好。加油百度打call打call打call;2;0;2;3799;0.0005264543300868649
2219;我丢我还是在学校听主任开会的时候说到的chatGPT新一代ai;1;0;1;3799;0.00026322716504343247
2224;chatGPT对一些有逻辑、客观的回答还是可以的，不知道文言一心回答得咋样;2;0;2;3799;0.0005264543300868649
2227;chatGpt和文心对话两个人工智能能发现对方不是人吗doge;9;23;32;3799;0.008423269281389839
2240;长江后浪推前浪，干死老美;1;1;2;3799;0.0005264543300868649
2243;我就想知道视频作者是怎么用上GPT的，我怎么用不了;3;4;7;3799;0.0018425901553040273
2259;文心最大的问题可能还是中文互联网封闭且质量低，使得其没有大量的素材进行学习和训练;57;611;668;3799;0.1758357462490129
2317;说藏话了;31;382;413;3799;0.10871281916293761
2349;蚌;16;181;197;3799;0.051855751513556196
2366;看股市就明白了，文心作为一个多模态LLM，对标的是gpt4，但是很明显有代差，所以股价大跌。开放内测之后，发现能达到gpt3的水平，后续潜力很大，所以股价又大涨回来了。不管怎么样，还是希望百度能做好这个产品藏狐;75;623;698;3799;0.18373256120031586
2442;6;20;293;313;3799;0.08239010265859437
2463;tv坏笑tv坏笑tv坏笑;1;8;9;3799;0.0023690444853908922
2465;这个事情上我支持百度，不然像欧洲一样，互联网基本被美帝收割么。有这勇气的公司本来就不多，毕竟无论国内公司做得怎么样网上肯定都是被自家国人千夫所指。;108;361;469;3799;0.12345354040536984
2574;支持百度，以后免费问问题，一个问题看5分钟广告，vip看一分钟，svip看30秒，超级vip看弹窗广告，搜索违禁信息自动联系网警，不得提名讳等等，我已经迫不及待啦打call;18;337;355;3799;0.09344564359041853
2593;绷不住了;10;145;155;3799;0.040800210581732034
2604;感觉想看文心一言能力的不多，想看百度笑话的不少妙啊妙啊;27;304;331;3799;0.08712819162937616
2632;任何用过百度搜索和谷歌搜索的人都能清晰地判断出前者就是一坨史，后者的使用体验不要好太多。我用百度搜索“如何卸载万能恢复大师”它给我的联想搜索结果是“如何下载万能恢复大师”，前半页全是广告，用谷歌搜出来第一条就是解决方案。请问，这样的搜索引擎我为何要盼着它好？;3;47;50;3799;0.013161358252171624
2636;此视频文案由chatGPT生成doge;1;142;143;3799;0.03764148460121085
2638;为什么大家会对百度有期待啊，这才符合我对百度的固有印象;52;306;358;3799;0.09423532508554883
2691;很多人嘲讽归嘲讽，但我还是希望百度能做好，因为这类属于下一个时代搜索引擎，人工智能的方向？如果国内没有公司去学习借鉴下一代风口又只能被美国一人独揽大权，欧洲的互联网惨状原因就是没有像样的企业。百度目前和gtp肯定是有差距的，毕竟不是同一时间起跑，网上各种嘴臭，谩骂我觉得非常不好。个人认为多些宽容，单纯做吃瓜群众就好;8;39;47;3799;0.012371676757041327
2700;为什么要嘲讽文心一言，我觉得百度这波真不错，这么快就推出了类似产品，希望继续改进，追上chatgpt;3;22;25;3799;0.006580679126085812
2704;为啥我的是文心一结巴笑哭;5;86;91;3799;0.023953672018952356
2710;已经比想象中好很多了，还以为一定是坑爹玩意;8;91;99;3799;0.026059489339299816
2719;希望百度搞出点东西，研究大模型需要算力，数据，算法，也就大厂才行，而且百度也是大厂里边研究ai比较早的了。不明白为什么一堆唱衰的，目前看也是能接受的范畴，感觉一堆人都不知道chatgpt原理是啥就尬吹尬黑;3;7;10;3799;0.0026322716504343247
2723;P2那些功能看着挺唬人，但以我工作视角来看，真正实用的功能其实WPS早就实现了不少。微软Office一直以专业性著称，而WPS是以“傻瓜性”打天下，这次Office更多是在补短板。像WPS提供的套模板、一键美化、文字生成PPT等等，本质上是功能类似的，只是以前WPS没有做成“自然语言沟通”这种唬人的形式。扪心自问，办公需要的是内容严谨、形式活泼，因此“形式上提供自动美化、内容上只给出经验参考”才是我更愿意接受的技术进化方向。AI可以给你生成一篇入党申请书（其实百度也可以），但我知道那不是你写的。我不会因此而增进对你的了解。AI可以给你生成一份项目总结PPT，但我看完会说请加大数字、去掉花里胡哨的动画，因为大家真正关心的是数据，不要做买椟还珠的事。AI给你自动处理了数据，我会问你“你检查过所有的函数逻辑吗？确认数据结果没问题吗？”因为自然语言总是模糊的，没有机器语言的严谨。你还是要学会用那些函数。我知道你可能会说公文，但是公文明明有前辈流传下来的模板啊像发函什么的，替换个单位名也就差不多了啊这有什么工作量啊如果有工作量，那说明真的有实际内容要字斟句酌啊你看那些会议公报，哪怕改一个字眼，够财经UP主出多少视频的？所以说不要慌，工具终究只是工具。真正的工作内容永远在工具之外。;7;38;45;3799;0.011845222426954462
2731;现在看起来还可以，至少肯定是高于预期的，但是真的怕下一步会发挥百度传统艺能之句句不离广告辣眼睛;18;105;123;3799;0.032376941300342195
2750;外国一发布，这边就紧跟着来了微笑。外国不发布，这边一点动静都没有;14;24;38;3799;0.010002632271650434
2765;当一个东西各方面都被对面完爆，那他也只剩勇气值得被称颂了;9;20;29;3799;0.007633587786259542
2775;预言一手，一段时间以后：WPS全新推出ai办公会员脱单doge;1;6;7;3799;0.0018425901553040273
2778;p2最后的问题毫无必要，马原就告诉过我们，先进生产力取代落后生产力是社会发展的必然，是有历史必然性的，不会随意识形态问题而变化，与其讨论意识形态问题，不妨加紧追赶，fq们别急，急之前先去读读马原;12;40;52;3799;0.013687812582258489
2791;国内来说艳红在这领域的积累也算比较深了，且搜索引擎这块百度还是处于稳固的市场头子地位，虽说百度干了不少不当人的事但还是希望能把这东西好好做稳喽，这东西要进步就是得靠各种数据和模型，时间是最为必要的催化因素，难道说因为起初比不过外国货那就不用了？等着像美国人那样tiktok用到爽结果又突然面临着没法用的紧迫感？等着像川普一样被推ban了后再另起炉灶做新程序？人在爽到以后再被夺走快感往往会无所适从，现在我国网民绝大多数还没被这样的ai爽到，所以现在需要开发以供他们以后爽得到，这逻辑不难明白吧？另外真的不懂一些跟风吹谷子的，当年用过没就一通乱吹？也别把我国ban它和美国试图ban抖音混为一谈，谷子整了活儿后还挺高傲的，字节是一直滑跪但一样被踩着，且当年就是谷子它不作死那体验也一样是没法对百度的基本盘造成什么威胁的;4;36;40;3799;0.010529086601737299
2796;文心一言和GPT（GenerativePretrainedTransformer）是两种不同的人工智能技术，虽然它们都属于自然语言处理范畴，但是在应用场景、技术原理和功能特点等方面存在以下差异：应用场景不同：文心一言主要应用于短文本生成领域，通过深度学习算法分析用户输入的关键词和情感倾向，自动生成富有情感和灵魂的短文本内容。而GPT则更加广泛地应用于自然语言处理的整个领域，包括对话系统、机器翻译、文本摘要、问答系统等方面。技术原理不同：文心一言使用了一些基于深度学习的算法，如LSTM（长短时记忆网络）、Transformer等，通过大规模语料库的训练来实现短文本的生成。而GPT则采用了一种新型的预训练语言模型（PretrainedLanguageModel），即以无监督的方式从大量文本数据中得到深度语言表示，从而进一步提高自然语言处理的效果和质量。功能特点有所区别：文心一言的特点在于其短小精悍、情感丰富的文本生成，可以满足用户多样化的需求；而GPT则更加注重自然语言的理解和推断能力，在多个任务上取得了良好的效果表现。总之，文心一言和GPT虽然都属于自然语言处理的领域，但是具有不同的应用场景、技术原理和功能特点。它们的独特性和创新性也为我们展示了人工智能技术在自然语言处理领域所具有的广泛应用前景和发展空间。;7;36;43;3799;0.011318768096867597
2804;众所周知，CHATGPT是不支持国区的。AI带来的生产力提升有目共睹，国内短期跟不上的话，我还是挺担心会发生下一个华为事件。;2;7;9;3799;0.0023690444853908922
2808;P2最后问题最蠢，这美国人搞的AI，用了提升效率，但有数据风险，坐车还有车祸风险呢，我们就不坐车了？我们的操作系统，办公软件，CPU，都是美国人搞的，难道就不能用了？这个问题太蠢，我觉得不但要用，还要让他们光明正大来国内发展，不能禁这禁那，好鞭策国内企业不然，一墙之隔。没竞争，天天琢磨着买菜弄死小菜贩，天天琢磨着哪里能够塞广告，天天琢磨着如何搞套娃VIP就有未来呢？特斯拉没来中国之前国内新能源车企干了啥大家有目共睹。就应该让微软进来大展拳脚好促进本地企业发展。;61;141;202;3799;0.053171887338773365
2871;excel只能是简化了操作，最后还是要会用的人去审查你真的敢把给客户的数据表自动生成就直接交给客户吗，更别说很多时候用于生成更细节的计算器什么的复杂公式功能他短时间内还是生成不了的好事，但什么彻底取代打工人之类的听听就好，信了你就输了脱单doge;2;6;8;3799;0.0021058173203474598
2875;百度好歹拿了个东西出来，阿里呢，腾讯呢，华为呢？大家都吱个声啊;1;5;6;3799;0.0015793629902605948
2877;深度测试：老三对老四说老五的老二老大了场景中有几个人？;1;2;3;3799;0.0007896814951302974
2879;整合办公软件那个，罗永浩知道了会不会一拍大腿，原来我发布会开早了;5;21;26;3799;0.006843906291129244
2885;这就是临时做了凑数的，毕竟这么多年看来，姓李的没有这个格局;22;14;36;3799;0.009476177941563569
2908;文心一言可能敏感词有成千上万个;59;660;719;3799;0.18926033166622797
2968;文心一言我感觉就像前段时间那个原神火了腾讯出的诺亚之心一样辣眼睛我不是很看好文心;11;11;22;3799;0.005790997630955514
2981;我只知道，发布会每开一分钟股价就掉一点。;15;32;47;3799;0.012371676757041327
2998;正在搞中国类notion软件的一些数据表格模板，看完office全家桶AI功能，感觉手里的WPS和类notion全都索然无味了。;4;21;25;3799;0.006580679126085812
3003;被实锤了，完全照抄的，就是一个妥妥的搬运工;1;2;3;3799;0.0007896814951302974
3005;金山的wps要死了。新office出来，想我这样的wps付费客户应该都会直接放弃wps了。灵魂出窍哎，国内这些互联网企业真没用，光知道捞钱。;4;5;9;3799;0.0023690444853908922
3011;ai智能我只用文心一言，因为它是有良心的中国制造给心心给心心给心心给心心;1;6;7;3799;0.0018425901553040273
3015;百度，在之前的中文互联网竞争中，全面落败，只能从互联网大厂变成广告大厂，口碑也一降再降，现在不说人见人爱，也是人见狗嫌了，百度现在基本上把大部分的收入都投入到人工智能上，但是面对英特尔的硬件封锁，人才的流失，当然很关键的一点还是微软和百度的体量上的差距，微软投入的资金和百度比起来多得多，中文互联网企业喜欢赚快钱，人工智能这种巨量的投入加上模糊不定的预期。有差距其实很正常，发布会的开场就百度就已经承认了怪我咯;6;22;28;3799;0.007370360621216109
3022;所以百度这几年干了什么hhhhh都在说智能驾驶也没看到啥成果出来;14;11;25;3799;0.006580679126085812
3037;省流：up拿ChatGPT和文新一言糊弄周报吃瓜;1;7;8;3799;0.0021058173203474598
3039;赶工出来的玩意儿，有差距很正常，这还是有一定研发基础的，其他有些赶鸭子上架的估计更没法看了。只要有方向，其实应该不难追，问题还是商业模式是否真的可行，需要时间验证。最大的问题，可能是中文互联网的资源质量，毕竟这才是人工智能的根本土壤，没准弄半天就养出来个乐子人doge;1;2;3;3799;0.0007896814951302974
3042;《我放弃了研发中国的GPT》dogedoge;1;29;30;3799;0.007896814951302974
3053;cheatppt调皮调皮调皮;3;3;6;3799;0.0015793629902605948
3061;现在中国这种堪忧的网络环境，中国的领先AI几乎已经成了幻想，因为根本找不到足够的能给AI训练的语料，这比芯片什么的更恐怖，是完全不可能冲破的壁垒，所以逼得文心一言都只能拿英语语系去训练，想着都憋屈;5;1;6;3799;0.0015793629902605948
3067;百度90的答案都是复制粘贴dogedoge;2;2;4;3799;0.0010529086601737299
3075;只能说gpt已出院，文心一坨大便;2;7;9;3799;0.0023690444853908922
3083;等文心到GPT40能力的时候，GPT估计已经100了，毕竟是用来当工具的，我为啥要用你百度，就凭一句爱国吗doge;1;1;2;3799;0.0005264543300868649
3085;百度做出来的，全是垃圾没有例外;6;3;9;3799;0.0023690444853908922
3092;p2我想问一下，计算都是在本地完成的吗？如果是的话确实很强，如果不是那隐私还是有风险;7;3;10;3799;0.0026322716504343247
3108;百度和谷歌几乎同时创立，一个挑战人类智商极限，一个挑战国家法律底线tv生气;2;1;3;3799;0.0007896814951302974
3117;其实不明白为啥要疯狂贬低嘲讽甚至想让百度的这个东西死，看IP又不是在海外，实在想不明白;2;1;3;3799;0.0007896814951302974
3121;一个很值得探讨的问题：为什么是先有chatpgt后才有文心一言？;4;1;5;3799;0.0013161358252171624
3130;百度文心一言的合作企业里面我看见了36氪妙啊;2;1;3;3799;0.0007896814951302974
3134;别的不说，百度某些方面肯定作弊了，它解决鸡兔同笼问题如果这个问题无解，会直接说无解，我人都傻了。微笑完全没表现出语言模型应有的coT思维链，目前LLM模型根本不可能有这种能力。如果百度做的出来早就做论文发到手软了，做的差无所谓，但在这种地方耍小聪明，我对百度没啥好感。（简单来说，百度会先判断你的问题是不是鸡兔同笼，并且计算出结果，假如有解，才会调用对话模型解答，否则直接返回无解。）;2;1;3;3799;0.0007896814951302974
3137;氪，快快回复我热词系列肥肠自信;1;1;2;3799;0.0005264543300868649
3140;真要研发其实不难，只要钱给够因为chat很多研发人员都是华裔dogedogedoge;1;1;2;3799;0.0005264543300868649
3142;妙啊这名字不是自己起的吧？;1;1;2;3799;0.0005264543300868649
3144;但把秘密交给百度。。。。。想到过去的魏则西等等事件;3;1;4;3799;0.0010529086601737299
3155;别的不说，一键生成PPT这技术很早就有了，但PPT不是把文字和图片表格放上去就可以了，一个好的PPT很讲究讲解的逻辑和思路;1;1;2;3799;0.0005264543300868649
3192;可用性还是差点，还是属于在自家数据库层面的搜搜并不是真正意义的人工智能，人为干预不知道可以带来我国3大人口省就业如何。;1;0;1;3799;0.00026322716504343247
3222;和国外的差距实在是太大太大了;1;0;1;3799;0.00026322716504343247
3245;妙啊找个毕业大学生，套皮一下，宣布原创即可;2;0;2;3799;0.0005264543300868649
3254;生产力变革个屁，在办公室写ppt的占多少？;2;0;2;3799;0.0005264543300868649
3274;文心最大的问题是引擎还是GBT20吧;1;0;1;3799;0.00026322716504343247
3277;chatPPTorcheatGPT;1;0;1;3799;0.00026322716504343247
3292;不敢用啊，这种东西不让他赶紧死掉，只会危害人间;4;0;4;3799;0.0010529086601737299
3299;chatgpt作为一个ai答不上一些ai里面关于tpu卷积计算这些问题还是让我挺吃惊的，当然了，我也没有指望他答的上来。;3;0;3;3799;0.0007896814951302974
3308;被完爆不怕，ai这种东西需要的就是训练，现在的问题是中文训练不足，ai和其他不一样，其他的需要改造，ai需要训练。;1;0;1;3799;0.00026322716504343247
3313;其实我觉得数据风险并不高因为AI是黑盒训练出来的东西哪怕是研发者也几乎不可能取出来进行精准调试更不要说在海量的用户信息里定向提取你的信息了;1;0;1;3799;0.00026322716504343247
3322;问的问题有点温柔了，比较像搜索引擎做的事情。既然文心一言对标的是gpt35的语言模型，让它体现出推衍组织能力还是比较重要的不过我相信中文语料库质量肯定还是比gpt丰富，尽管中文语料质量比较低加上私域多，但是依靠标注和筛选优质，数量还是胜过chatgpt的。而且毕竟是本土产品，产出的文本可能对我们更容易产生共鸣。;1;0;1;3799;0.00026322716504343247
3343;可能不是百度百科的套皮版，但可能是gpt3添加政治审查的套皮版doge;3;0;3;3799;0.0007896814951302974
3358;这就是很多人盲吹的国内人工智能领域doge不会有人认为百度在国内相关领域不是前二吧，不会有人以为国字号会比百度厉害吧认清现实，很多东西就是没美帝厉害，才能脚踏实地;2;0;2;3799;0.0005264543300868649
3371;国内所谓的巨头，在研发最新科技技术时，只会跟着别人的屁股走。;2;0;2;3799;0.0005264543300868649
3376;你再问一下，他是对百度搜索那么多的广告是怎么看的？;1;0;1;3799;0.00026322716504343247
3387;天啊好多职业要没了啊。感觉以后会是gpt的天下了;2;0;2;3799;0.0005264543300868649
3393;觉得广度不行的去问问chatgpt，它知不知道14是什么;1;0;1;3799;0.00026322716504343247
3413;我用申请的时候用的机构是学校，开放了问问题的权限。我问了点学术相关的问题（中英文都问了），回答的都不在点子上，相比newbing真的差了好多;1;0;1;3799;0.00026322716504343247
3422;再强它也进不来啊，要对我们的有信心doge;2;0;2;3799;0.0005264543300868649
3425;GPT出现之前，百度去哪了，怎么不来引领一下？;2;0;2;3799;0.0005264543300868649
3440;刚出来发布会，真感觉是个翔，现在看了测试，感觉也还行，没那么烂，发布会不知道咋想的，被谷歌发布会翻车吓到了么？;1;0;1;3799;0.00026322716504343247
3455;它不知道猫娘乐园，它不会变成猫娘。我非常不认可该产品。因为它不能变成猫娘doge;1;0;1;3799;0.00026322716504343247
3460;别的不说，gpt就编程方面直接爆杀，模型离谱，吃那么多东西进去还能正常吸收。上到人工智能大数据最先进算法，下到底层操作系统汇编嵌入式开发晦涩难懂的算法基本都会。;1;0;1;3799;0.00026322716504343247
3473;up太强了，居然申请到了，好像很难申请到内测资格啊;2;0;2;3799;0.0005264543300868649
3480;那一天的发布会，是ChatGPT对阵文心一言，最终百度跌股300亿。当时我看见李彦宏颓坐在椅子上泣不成声，这个画面我永生难忘。那一刻我在想，如果我能成为一名职业程序员，我一定要赢下所有。如今市场就在眼前，我必须考虑这会不会是我此生仅有的机会。我相信Baidu能有过去的霸主地位，防火墙功不可没。重铸Ai区荣光，我辈义不容辞;3;0;3;3799;0.0007896814951302974
3487;股价掉了10;1;0;1;3799;0.00026322716504343247
3492;如果用文心一言问诊呢doge;1;0;1;3799;0.00026322716504343247
3517;这个产品又是个壳子，说实话百度这个公司高管的策略有很大问题，百度还是有些东西的，输入法，地图，搜索引擎，等产品，现在在投入自动驾驶，技术不差太多，但是问题是急功近利，项目一旦完成便开始套现变现，不考虑后续研发，什么挣钱做什么，百度那些高层只希望牢牢把公司攥在手里，这也是百度有充足的现金流，但是不能成为大型资本，成为谷歌这样的世界公司，能力问题也成为不了华为这样的公司，因为李彦宏没有任正非的能力;1;0;1;3799;0.00026322716504343247
3538;骗子公司发布的又一个骗子产品罢了;1;1;2;3799;0.0005264543300868649
3560;dogedogedoge;19;397;416;3799;0.10950250065806791
3580;事物发展应遵循客观规律，来点chat25笑话;45;339;384;3799;0.10107923137667807
3626;其实技术差点倒还无所谓，给大伙看个有点难绷的疑惑;38;360;398;3799;0.10476441168728613
3665;如图;2;2;4;3799;0.0010529086601737299
3669;松鼠撅鱼doge;9;119;128;3799;0.033693077125559356
3680;文心一言居然画得比文心一格好，这是同一家公司的产品吗doge;4;203;207;3799;0.054488023163990526
3685;本来不喜欢文言一心的;1;133;134;3799;0.03527244011581995
3688;文心一言真不差公主连结不错;21;109;130;3799;0.03421953145564622
3710;敢不敢把生成的图片发出来doge;2;72;74;3799;0.019478810213214005
3713;其实百度布局也挺早了，之前就转向AI和无人驾驶了。只是GPT确实太强了，没办法的事，毕竟谷歌也被打个措手不及。文心一言继续加油吧;4;27;31;3799;0.008160042116346407
3719;大家可以用文心一格，比我想象中好一点，偶尔能出好图。;5;4;9;3799;0.0023690444853908922
3727;微信小程序搜“文心一格”不要钱;5;15;20;3799;0.0052645433008686494
3735;慕汐耶蹦不住了，开屏雷击打call;1;1;2;3799;0.0005264543300868649
3739;我申请了好久还没给我邀请码笑哭;1;0;1;3799;0.00026322716504343247
3741;藍桉笑哭;1;0;1;3799;0.00026322716504343247
3749;鸡翅膀呢？;1;0;1;3799;0.00026322716504343247
3769;如果在gpt35放出来之前这水平给大伙体验，股价都不会这么跌吃瓜还是人比人气死人哦;1;0;1;3799;0.00026322716504343247
3777;我从去年12月开始研究Chatgpt。当时它刚出来时给我带来的震撼是无与伦比的，编程、计算、学术样样都行。夸张点说，真的让我觉得这是人类文明的下一个奇点。而昨天文心一言的发布我也在现场。虽说Robin和王博并没有进行产品演示，整个发布会过程也略显局促。但是我看到了百度团队对于AI的理解和期望，并为之布局了10年之久。作为一名从业者，我真心希望大家可以多点包容和理解，少点阴阳和嘲讽。回忆下10年前iPhone刚进入国内市场时国产手机和其的差距，再看看如今。再给文心一言多点时间吧BTW：需要体验chatgpt和plus代充的宝子可以联系我。;4;32;36;3799;0.009476177941563569
3782;突然就觉得文言一心很厉害，居然懂只因doge;1;7;8;3799;0.0021058173203474598
3785;估计是改之前的chatgpt3的开源代码。;1;24;25;3799;0.006580679126085812
3788;文心一言后面百分百有员工，看看这研发经费就知道了，还对标chatgpt呢，蹭热度差不多吃瓜;3;21;24;3799;0.006317451961042379
3792;别尬黑啊，我今天试的文心一言还挺智能的doge;19;849;868;3799;0.2284811792576994
3812;吃瓜;7;207;214;3799;0.05633061331929455
3820;这个绘图功能挺搞笑的笑哭;7;171;178;3799;0.046854435377730985
3828;试过了，非常智能。;2;67;69;3799;0.01816267438799684
3831;随便一比较就出来了;4;57;61;3799;0.01605685706764938
3836;问它哪个省的，回答妈妈省的，文心一言改名一言丁真吧;2;59;61;3799;0.01605685706764938
3839;还行，但考虑到3已经开源了。你百度就这个成果不行;13;74;87;3799;0.022900763358778626
3853;地狱笑话，能让文心一言帮我的原创性论文审稿不？在自己身体上做实验的诺奖得主，内附诺奖得主创办的期刊，新的审稿机制，一区cv15288013对于eLife这一创新模式，研究者评论：以后投到eLife的文章不会再有accept或reject了，最终发不发表取决于作者，但文章的优缺点都会公开。作者觉得愿意revise多少和revise到什么程度，可以被pubmed检索。这次elife是继续和影响因子决裂了。;1;63;64;3799;0.016846538562779678
3856;百度这个公司真的很神奇，很多玩意都是起个大早赶个晚集;6;68;74;3799;0.019478810213214005
3863;多少人才能顶得住笑哭，怎么会有人信这个;3;72;75;3799;0.019742037378257436
3868;chat数据库是连上了维基百科的内容更加全面且丰富，而中国百度能连什么百科？只能连百度百科（想盗用外国百科，小心别人起诉你）并且训练日期也很短。首先你觉得维基百科和百度百科哪个更加全面而客观并且别人Chat已经训练了8年了，作为使用者你觉得这个差距大不大别人都在2015年开始训练了，我们2023年才刚刚起步这个差距就是要承认;3;11;14;3799;0.0036851803106080546
3872;说的gpt弄的多好似的笑哭，老是牛头不对马嘴，还嘴硬吃瓜;4;2;6;3799;0.0015793629902605948
3878;gpt连123412345都算不对。让他用python算也只是装装样子根本没用。也就是说你调整他直到给出你想要的答案的过程，可能他根本没有改变内在逻辑。可以说是逻辑僵尸中的僵尸。;3;1;4;3799;0.0010529086601737299
3882;叛国罪？;2;14;16;3799;0.0042116346406949196
3885;文心一言画的那个松鼠鳜鱼当真惊艳到我了，相反另外一个完全无法带给我这种超出大脑预期的快乐tv鬼脸;2;12;14;3799;0.0036851803106080546
3896;怎么了？美帝科技厉害，我们就不能发扬我们的长处儒家思想？;1;0;1;3799;0.00026322716504343247
3903;什么时候开源，什么时候就技术突破是吧;1;1;2;3799;0.0005264543300868649
3911;文心再不行也要用，多迭代就好了，要是不用就一直烂下去了。;1;0;1;3799;0.00026322716504343247
3918;以某度的德行，做大了后估计以后会上vipsvip然后广告最后再来个植入广告。想都不用想;1;0;1;3799;0.00026322716504343247
3925;这简单啊，套个皮，底层是chaygpt不就好了吗大笑;1;0;1;3799;0.00026322716504343247
3937;ChatGPT一火全来模仿了，真就靠流量活;2;0;2;3799;0.0005264543300868649
3949;百度的文心一画已经很可以了;4;12;16;3799;0.0042116346406949196
3956;一个特斯拉毛豆X，一个是b羊d自燃唐;2;1;3;3799;0.0007896814951302974
3964;造谣有意思吗，文心一言再不厉害，也能剥夺你的工作岗位;10;6;16;3799;0.0042116346406949196
3975;我寻意着，百度的股价不是在涨吗？up主硬黑？;11;45;56;3799;0.014740721242432218
3987;昨天刚拿到文心一言的使用资格，用了一下的感受就是文心一言最大的问题就是理解能力完全不到位，玩笑话根本分辨不出来，敏感词逻辑非常简单粗暴，不过该说是既在意料之中，又在情理之中吧吃瓜;31;107;138;3799;0.03632534877599368
4019;百度果然还是百度展示的都是广告直播的话语;4;124;128;3799;0.033693077125559356
4025;之前刚对百度有些期待，但是看到这个应用。。。。笑哭只能说企业家之间也存在格局的差距;1;6;7;3799;0.0018425901553040273
4027;明显断章取义了。视频中是智能云发布的文心千帆，是基于文心一言针对企业用户需求做的demo。不是有ai技术只用来做广告，是ai技术可以满足广告业务的需求，懂？;1;21;22;3799;0.005790997630955514
4029;莆田医院为您直播doge;5;58;63;3799;0.016583311397736247
4035;一天到晚都在研究些什么啊;10;28;38;3799;0.010002632271650434
4046;为什么直播间营销风格的ai直播是女性穿着漏肩吊带衣服？这难道不是对女性的刻板印象吗？;15;29;44;3799;0.011581995261911029
4064;答辩;18;3;21;3799;0.005527770465912082
4084;完全嘴唇对不上你看看国外的吧差的不是一点两点还有明明是需要大量人来测试标注才更好百度反而需要预约明明是更多人用才更好你品品;2;2;4;3799;0.0010529086601737299
4092;这又是谁家的api？敢不敢把账号发给网友玩玩;1;0;1;3799;0.00026322716504343247
4106;用newbing不香吗，免费随便用;4;0;4;3799;0.0010529086601737299
4112;百度味道很浓;2;0;2;3799;0.0005264543300868649
4120;昨天刚刚通过，按照前段时间的表现来看，其实文心一言现在的水平比以前聪明了一点;1;0;1;3799;0.00026322716504343247
4130;尝试了一下;73;83;156;3799;0.04106343774677547
4204;卧龙凤雏doge;21;73;94;3799;0.024743353514082654
4226;本土AI的优势就是给本土需求的优化快啊;31;49;80;3799;0.021058173203474598
4258;不用那么麻烦，直接在newbing对话框里对他说，把xx翻译成英文，并以此画一幅画。然后他就给你画了。画完之后你还能对他说对图片的某些地方进行什么样的修改，修改甚至不用翻译成英文就画了;4;85;89;3799;0.023427217688865493
4263;百度好像也是翻译成英文以后画的吃瓜吃瓜吃瓜不然为什么叫他画起重机他画了个鹤;44;127;171;3799;0.045011845222426954
4308;我让他画火烧大英博物馆，没画，让他画轰炸白宫，没画，让他画火烧靖国神社竟然画了;1;7;8;3799;0.0021058173203474598
4310;用百度的文心一格画出的枯藤老树昏鸦，小桥流水人家，感觉更有意境。;2;4;6;3799;0.0015793629902605948
4313;1，百度没有抄袭2，百度稳获亚军;23;57;80;3799;0.021058173203474598
4338;还是忘不了文心的鱼香肉丝;3;31;34;3799;0.008949723611476704
4342;其实文新一言也只支持英文，因为让他画鼠标只能画出来老鼠;1;13;14;3799;0.0036851803106080546
4344;百度的画风也不错。看好百度，ai对百度来说是个超级大机遇;3;11;14;3799;0.0036851803106080546
4349;百度一个vip公司有啥好期待的;12;27;39;3799;0.010265859436693867
4363;这个效果无非是模型的区别罢了，玩过SD人都知道，换个模型就换一种效果。文心一言本身是不会画图的，它是直接交给文心一格画，文心一格有多种画风可选，需要给的限定词多一些;1;40;41;3799;0.010792313766780732
4366;好像目前还没有多少人知道bing现在可以画画了，知道目前只支持英语描述的就更少了思考思考;1;5;6;3799;0.0015793629902605948
4371;bing可以修改图片，比如猫替换成狗，换个背景，加个物件比如帽子之类的;1;6;7;3799;0.0018425901553040273
4374;试了下，太垃圾，让他带文字的话都是乱码;1;3;4;3799;0.0010529086601737299
4377;就是dalle，应该不止英文吧，反正在dall里面可以用中文;1;7;8;3799;0.0021058173203474598
4379;网址是什么啊;1;3;4;3799;0.0010529086601737299
4384;百度的图是偷的;1;2;3;3799;0.0007896814951302974
4389;为什么我开美国节点，还是显示你所在的区域即将推出啊，清cookie了;5;4;9;3799;0.0023690444853908922
4395;httpsb23tvBV1co4y1s7qs;1;1;2;3799;0.0005264543300868649
4397;中文菜名大都是一种比喻;1;0;1;3799;0.00026322716504343247
4402;排队一个月了笑哭;1;1;2;3799;0.0005264543300868649
4404;想画涩涩该用啥doge;1;1;2;3799;0.0005264543300868649
4410;文心一言什么答辩疑惑;1;17;18;3799;0.0047380889707817845
4412;微软老牌巨头，有差距也是难免的，期待百度奋起直追;8;1;9;3799;0.0023690444853908922
4421;你问其它菜基本都对特别菜就不行;1;0;1;3799;0.00026322716504343247
4424;文心能制定艺术风格吗？;1;0;1;3799;0.00026322716504343247
4426;看清楚了，拿来和文心一言对比的不是newbing，是微软专门生成图片的AI，无法对话。如果要做对比的话应该用文心一格和它比。;2;0;2;3799;0.0005264543300868649
4435;一言不会画图，是调用的一格;2;0;2;3799;0.0005264543300868649
4438;直接给newbing发指令就能画，没这么麻烦，还可以连续修改;1;0;1;3799;0.00026322716504343247
4440;AI生成的图片是纯自己生成还是网上找的;3;0;3;3799;0.0007896814951302974
4448;一张图证明就是汉译英;25;178;203;3799;0.05343511450381679
4475;这个东西是需要吟唱的。;25;247;272;3799;0.07159778889181363
4501;来了鹿乃哈哈鹿乃哈哈;4;110;114;3799;0.030007896814951304
4506;怎么没有松鼠撅鱼傲娇;10;250;260;3799;0.06843906291129244
4518;也许没有chatgpt智能，在搞笑方面已经领先全世界了笑哭。;6;187;193;3799;0.05080284285338247
4525;老王吃嫩草哪个就很明显看出来这low逼东西的逻辑完全不是基于中文来的，怕不是先机翻成英文去偷个结果输回来疑惑;28;307;335;3799;0.08818110028954988
4554;这不是我想要的松鼠鳜鱼大哭，我的快乐没了大哭;6;91;97;3799;0.025533035009212952
4561;很明显，机翻成英文，然后到外国网站偷回来的。;9;48;57;3799;0.015003948407475652
4572;不行，我辩护不下去了，太抽象了。;1;38;39;3799;0.010265859436693867
4576;外国人初学中文belike;1;17;18;3799;0.0047380889707817845
4578;来个老婆饼枕边童话欸;1;2;3;3799;0.0007896814951302974
4580;要说ai画图，去年这会，大家一个劲的在贴吧分享抽象画，过一阵子有的人还在笑，有的人笑不出来了。;3;48;51;3799;0.013424585417215057
4590;令我惊喜的是对人手的刻画，听说很多国外应用画人手很有困难，这个文心一言还不错。可以把鸡也画成了5只脚趾;2;23;25;3799;0.006580679126085812
4593;鸡兔同笼我都看见大象了;1;3;4;3799;0.0010529086601737299
4595;百度这个据说是套的外壳，调用了别人公司的接口;1;3;4;3799;0.0010529086601737299
4598;俩币求背景图;1;1;2;3799;0.0005264543300868649
4601;说句不好听的，这创意嘎嘎的。;1;1;2;3799;0.0005264543300868649
4603;有人尝试女孩狗吗doge;1;1;2;3799;0.0005264543300868649
4610;还有一些掉san的图发都发不出来比如“鱼香肉丝”，它是懂克苏鲁的doge你想象一个鱼形的古神就行了;1;12;13;3799;0.003421953145564622
4612;你就说要的东西有没有画进去吧初音未来大笑;2;18;20;3799;0.0052645433008686494
4619;我无法想象这是个中文ai，起初我还以为是chatGPT的作图;7;5;12;3799;0.0031587259805211897
4633;在当地较丑的男孩;1;1;2;3799;0.0005264543300868649
4646;汉语先翻译成英文偷笑;2;1;3;3799;0.0007896814951302974
4664;先用中文翻译成英文，然后再去ChatGPT2寻找答案将其搬过来，虽然牛头不对马嘴，但效率还是挺高的。;1;1;2;3799;0.0005264543300868649
4674;都说是机翻的，有没有可能训练ai的数据集用的都是国外的呢？国外现成的比较多而已;1;1;2;3799;0.0005264543300868649
4679;为什么我画的是中国风。;2;1;3;3799;0.0007896814951302974
4696;我感觉这些ai其实知道你想画什么，但是在装，就很惊悚辣眼睛;2;2;4;3799;0.0010529086601737299
4701;吃瓜发布会上说英语能力不好，那为什么还用英文来作为prompt训练吃瓜;1;1;2;3799;0.0005264543300868649
4710;根本就是套皮软件内核是英文，先把中文翻译再导入openai，然后百度的翻译软件又辣鸡，所以这玩意输两次;1;1;2;3799;0.0005264543300868649
4729;就是翻译再套壳国外的ai的热;10;108;118;3799;0.031060805475125033
4743;这一切还得感谢谷歌，要不是人家心地善良不起诉他侵权，早就赔惨倒闭了吧笑哭笑哭笑哭OK妙啊;30;24;54;3799;0.014214266912345353
4774;首先chatgpt是概率模型，它也不知道消息真假，它回答的内容完全取决于喂给它的语料库doge。所以这种问题问了也白问。答案只能代表开发者认为的客观事实吃瓜;16;81;97;3799;0.025533035009212952
4791;基于java这点就能看出，这个答案没有参考价值;2;27;29;3799;0.007633587786259542
4795;chatGPT的数据库是二一年的所以这个答案不具备参考性，鸿蒙早就不用Java开发了;22;35;57;3799;0.015003948407475652
4818;有些人模糊了openharmony和harmonyOS的概念，现在华为手机上的harmony只是基于aosp的深度定制，与ColorOS、MIUI别无二致，openharmony则智能穿戴设备上的liteOS有千丝万缕的联系;4;6;10;3799;0.0026322716504343247
4824;“基于”安卓没有安卓就不行;45;13;58;3799;0.015267175572519083
4872;我怕哪天ChatGPT或文心脱离控制把我干掉，所以每次都谢谢它的;1;4;5;3799;0.0013161358252171624
4877;HarmonyOS本身就是基于Android吃瓜;3;1;4;3799;0.0010529086601737299
4882;手机鸿蒙就是安卓，开源鸿蒙才能说是真鸿蒙。;11;2;13;3799;0.003421953145564622
4903;openharmony可以算独立系统手机的还是抄安卓;1;0;1;3799;0.00026322716504343247
4907;经典搞混open鸿蒙和鸿蒙;3;2;5;3799;0.0013161358252171624
4917;鸿蒙确实跟安卓有关系鸿蒙目前还在内置安卓虚拟机并且开源鸿蒙就基本上只是一个框架华为自己都不用开源鸿蒙想用开源鸿蒙还得靠开发者自己适配;3;0;3;3799;0.0007896814951302974
4921;不出说华为垃圾，出了又抄底对比说华为垃圾。;1;0;1;3799;0.00026322716504343247
4924;一边骂厂商不创新，一边自己国内自主出来就狂踩。你们都是爷。你们媳妇儿三个月就生出会讲话一口纯正美语的小孩吧嗑瓜子;2;0;2;3799;0.0005264543300868649
4928;鸿蒙是个比安卓更宽泛的生态，而非安卓特指的安卓系统，但目前的进展很差，并不比安卓强;1;0;1;3799;0.00026322716504343247
4932;Openharmony才没有关系，未来可期。;1;0;1;3799;0.00026322716504343247
4938;之前看到个一个视频，说华为也参与了安卓的建设，所以鸿蒙可以说是基于安卓做的优化（不一定对）;1;0;1;3799;0.00026322716504343247
4940;套皮系统;2;0;2;3799;0.0005264543300868649
4944;目前鸿蒙系统肯定跟安卓有关系啊要生存的。;3;0;3;3799;0.0007896814951302974
4948;是不是基于安卓很简单，你叫美国禁用中国这些安卓和ios，看看华为能不能正常用;3;0;3;3799;0.0007896814951302974
4952;断定博士建仓了百度，开始狂吹;16;146;162;3799;0.04264280073703606
4969;现在的网友啊，已经对我们的科技严苛到了不是世界第一就是垃圾的程度了，多给点时间和包容吧，先别着急跪;17;81;98;3799;0.025796262174256384
4987;那些还认为差的，可以去看看其他人之前问的同样的问题，文心一言是如何回答的，很明显已经有进化了。某些回答依然不知所云，但总体而言合理很多了，这体现出了模型的水平，还是有希望的。AI需要大量的训练，会进化很快，chatGPT刚开始也不行，慢慢来，保持信心，只要在路上，就有希望;33;264;297;3799;0.07817846801789945
5021;ai都是会进化的，等文心一言进化不动了再喷不迟不过到时候大概率是文心一言和chatgpt互相操纵大量水军账号在网上互喷，活人账号都死光了笑哭;30;149;179;3799;0.04711766254277441
5052;某些人真是反百度反魔愣了，离谱到别人申请个邀请码，也要骂;2;22;24;3799;0.006317451961042379
5055;真搞不懂为什么那么多人看到国产AI就嘲笑一番，百度以前干了很多混事出生事，但他旗下的技术人员开发出的文心个人感觉确实还可以啊，这才刚发布几天，那么急着去跟chat4做对比，为什么当我说：“chat未来可能被老妹的晸丶颗利用变成输出颜色丶歌名的工具”时一大堆人说“工具本身无害论”，让后当我发表“个人感觉文心虽然在技术上还跟chat4甚至是chat35都存在不小的差距，但个人体验总体中规中矩，类似于chat几个月前刚发布那会儿一样”，这时候就有一大堆人说“AI广告投放，莆田医院，魏则西呢”嗑瓜子嗑瓜子为什么这时候没多少人说“技术本身无害论”，虽然可能是我过于敏感，但还是或多或少觉得里面是不是有数字生命体吃瓜吃瓜;22;70;92;3799;0.024216899183995787
5079;得，之前我们没有这些人要喷，现在有了但是先进性不及人家的，这些人还是要喷，合着我们就该一下子就搞出来世界最先进的也不看看人家一百年前就玩儿电动车了，我们那时连电灯都搞不懂，现在我们玩电动车了，他们还在玩电动车，也没见他们玩儿的电动车多牛逼笑哭;7;10;17;3799;0.004474861805738352
5087;先看答案再答题《进化了》。。;20;19;39;3799;0.010265859436693867
5108;起飞;25;26;51;3799;0.013424585417215057
5134;文不文心我不管，百度这家公司道德就有问题，他做的ai你敢用吗？;43;48;91;3799;0.023953672018952356
5178;支持，文心一言，必定是自己国家的，不必骂臭了，再踩上一脚；；应该庆幸，在很多强人，都在挖国家墙角的时候，还在有人，努力奋进;12;23;35;3799;0.009212950776520137
5192;加油吧在堆人和加班这事上，我一直不怀疑国内大厂的能力呲牙呲牙呲牙;20;45;65;3799;0.01710976572782311
5213;这种ai肯定会随着训练量的增大慢慢成长，但只能说文心一言现在还比较智障，进步和改进的空间很大，希望百度上点心吧。;17;61;78;3799;0.020531718873387735
5231;目前撑死35，但以国内的传统，到时候不得会员，超级会员，往上整啊，微软已经开始往自家产品上植入了，后续收不收费不好说，但不商用收费应该也不会贵，最近学数据库用35问了点问题，不仅有原理解释还有范例，比教科书都全，我真的哭死;8;8;16;3799;0.0042116346406949196
5240;省流：;10;41;51;3799;0.013424585417215057
5251;但回答风格越来越像chatgpt了，别后续整出个调用api的丑闻了;5;10;15;3799;0.003948407475651487
5258;up买了吧？这差距挺大的，而且不知道互联网赢者通吃吗？;11;17;28;3799;0.007370360621216109
5270;chatgpt的中文语料还不如百度的一半，但人家的中文回答效果却能薄纱你，这是为什么呢;7;11;18;3799;0.0047380889707817845
5278;凭国内这帮人才这玩意怕不是拿chatgpt训练的文心一言;10;12;22;3799;0.005790997630955514
5290;在务虚这块百度从来没输过doge一问一答，毫无灵魂，如果这能牛逼，这不就跟计算器一样，11计算器也能马上反应出等于2doge;5;11;16;3799;0.0042116346406949196
5296;有没有可能，公开之后就会吸引人多和他聊聊天，这样就收集到有用的数据，就会加速进化？;4;11;15;3799;0.003948407475651487
5301;挺无语的，不管是文心一言，还是GPT，或是newbing，我都可以用啊，为啥要限那么死？对普通用户而言，实用与便利才是我们应该最关心的啊妙啊;2;2;4;3799;0.0010529086601737299
5304;感觉就是百多搜索引擎的文字回答版本，以前需要人点开网页进去，现在直接文字回答;3;9;12;3799;0.0031587259805211897
5308;我只想问俩问题1你看彩色丝袜迷糊不？2魏则西事件你怎么看;6;7;13;3799;0.003421953145564622
5318;前面还有70万人排队笑哭我觉得这玩意现在做到GPT28就可以了，什么事情都要有个过程吃瓜;2;2;4;3799;0.0010529086601737299
5323;不是应该叫老王吗doge;1;5;6;3799;0.0015793629902605948
5325;用过的gpt4就知道没有可比性，有更好的工具我为什么不用好的？;3;1;4;3799;0.0010529086601737299
5329;暴露了。。。。。。接入的是CHATGPT20吧。;7;1;8;3799;0.0021058173203474598
5337;其实chatGPT这玩意，我一直就觉得是微软小冰的升级版，哪儿有网上公知们吹的那么神如果真那么厉害，短短时间就被百度搞出来了虽然百度现在版本还比较低，但是升级上去迟早的事;2;1;3;3799;0.0007896814951302974
5343;有没有一种可能，和你对话的是百度客服doge;1;1;2;3799;0.0005264543300868649
5358;华为才是大boss啊，想什么呢;1;1;2;3799;0.0005264543300868649
5360;有个问题，麻烦问下，看它能答对不有一个数字，96的六分之一比它的二分之一大25，请问这个数字是多少？;1;0;1;3799;0.00026322716504343247
5368;不管怎么样，毕竟是国内，还是要支持能研发出更适合中国人学习使用的工具，我们国人使用好，提高我们的生产效率就行了;1;0;1;3799;0.00026322716504343247
5372;你怎么知道它不是GPT假装的呢doge;1;1;2;3799;0.0005264543300868649
5386;和国外还是有差距，但没大到追不上。等20年再看看吧。;3;0;3;3799;0.0007896814951302974
5404;文心一言什么时候能开放使用;1;0;1;3799;0.00026322716504343247
5407;这个就是根据gbt2练习的吧;1;0;1;3799;0.00026322716504343247
5412;年底能达到chatGTP35水平吗？;3;0;3;3799;0.0007896814951302974
5416;只对企业用户开放测试权限吗？;1;0;1;3799;0.00026322716504343247
5419;GPT4也不是一步到位的。AI对中美来说都没有技术门槛。差的只是用户与学习碰撞出来的迭代。。以及全球网络数据的使用权。。。多玩。玩的人多。这种AI学习迭代能力很强的。文心一言V4版V8版、都会陆续出来。我们要做的就是使用他。让他迭代。;1;0;1;3799;0.00026322716504343247
5430;为什么问的问题不是“我妻子的丈夫管我叫什么？”;1;0;1;3799;0.00026322716504343247
5433;主要是基础都没有辣眼睛算力跟得上吗，芯片都还没解决;4;0;4;3799;0.0010529086601737299
5446;应该着重测试对上下文之间串联起来的回忆和理解能力，而不是零散地扯各种话题;4;0;4;3799;0.0010529086601737299
5458;咱的东西是要支持的，只是这种挤牙膏似的敷衍让人很难以正面形式去看待它，以AI画图为例，给人的感觉就不像是自己研发的东西，希望有突破吧，别到处搬点就算尽力了;1;0;1;3799;0.00026322716504343247
5467;百度现在还有几个用户体验良好的产品;1;0;1;3799;0.00026322716504343247
5471;所以是不是又抄了抄完又裝成自己研发支持;3;0;3;3799;0.0007896814951302974
5475;不是拉垮的不行吗;1;1;2;3799;0.0005264543300868649
5492;我个人觉得差距最大的一点是，在欧美有那么多的程序员能够认识到社会公平正义是一个比个人利益更重要的东西，所以才会有那么多的人前赴后继地支持ai开源事业，哪怕最后真的失败了，他们也有那么多人努力过了。我在德国周围都是很多很有理想的年轻人，满脑子都是很理想化的公平平等正义，但是在国内这些年轻人就被一股脑的全指责为白左，实际上是真的很让人遗憾。作为一个普通人，无论中外，我们都不是那个掌握权力和资源的人，欧美的不少年轻人能够认识到这个问题，并且将所有人的平权放在自己思考问题的第一位，认为所有人都不应该因为自己的各种身份和附加物而受到不公正的对待，有些人却在权力和媒体的引导下只看到了这些追求社会平等的普通人里面的极端情况。我只能说真的很可惜。;174;1199;1373;3799;0.3614108976046328
5667;其实看很多人说文心是在原有技术上加了点料，但是你看论文下来，其实连料都算不上。我们所谓的料起码是建立在你真的有料的基础上，比如你确实建立了中文数据集，而不是大量调用的还是英文公开免费数据集。所以百度这么大的国内市场份额耕耘十年以上，这样的数据集都做不到，依然还是调用的英文数据集，说明就算是在堆料的基础上，百度都做不到。说个不好听的，被阻止上市的滴滴才干了几年就能有核心数据集，你百度都没有中文数据集能够支撑堆料，百度那大楼天天灯火通明的，到底十几年间加班加点搞什么，总之现在看来是最基础的东西都没有。;110;2218;2328;3799;0.6127928402211108
5778;知乎真的算贡献很大的了，中文没有优质语料，百度自己对中文环境的拉跨做了最大的贡献。一个百度知道，当年根本没有竞争对手的情况下做成了复制粘贴。一个百度贴吧，大量精品长文在吧主更换中十不存一，百度内部人员与吧主各种勾结黑幕频出。一个百家号，模板套来套去，李总居然还在发布会上说要用AI一天生成几万篇百家号文章，这是什么心态啊？现在很多内容网站都是圈地自营，为什么这么干，防的主要不就是百度么。;13;241;254;3799;0.06685969992103186
5792;哈哈，只能说up主太敢说了。我看到后面竟然惊讶过了审核。现在国内这些个所谓的互联网巨头们浮躁的很，不好好沉下心搞技术，就利用信息差赚快钱，欺上瞒下。到头来啥也不剩。就算你现在真的能赢赢赢，你未来靠什么赢？而粉丝们确实一句批评听不得，去维护巨头的威严，能让自己显得也是赢;65;1459;1524;3799;0.4011581995261911
5858;百度真的是扶不起的阿斗。为了保护国内的搜索引擎，把谷歌逐出国内，这一片如此优渥的土壤，本该培育出令人惊讶的果实，结果却令他们安于现状。一个搜索引擎，搜索出来的东西前几页都是广告？就这还指望能投入什么资金到科研里？百度，可能连阿斗都不如，真是恨其不争;16;115;131;3799;0.034482758620689655
5875;最近帮人找最近几十年美国联邦基金利率图翻了半小时广告和付费页面突然想起来为啥不用谷歌结果30秒搞定了OK;13;243;256;3799;0.06738615425111871
5890;老外做了一个高科技粉碎、搅拌、榨汁机。百度做了一个针对不同功能材料放入的过筛筛子，自己磨了几个不同刀头，然而这些东西和机器本体的科技含量不是一个档次的。;26;595;621;3799;0.16346406949197156
5917;up说百度不行，结果大家不是来讨论技术（可能没几个懂的，我也不懂），但是大家真是见微知著，从文化，教育，经济，社会环境，社会氛围，人种，政治，哲学都扯进来，佩服佩服。;4;16;20;3799;0.0052645433008686494
5922;既然有赢学家这个生态位，那自然有马督工类型的反赢学家，up这属于是发掘商业蓝海了;4;32;36;3799;0.009476177941563569
5927;这GPT对百度来说意义可不一般啊，虽然不一定影响它当前的收入，但是这几年百度一直把AI作为自己转型的生路，人家这玩意横空出世等于宣判百度无路可走了，最后的希望也没了，所以才急急急;10;65;75;3799;0.019742037378257436
5938;不错;6;400;406;3799;0.10687022900763359
5945;牛奶的路;10;240;250;3799;0.06580679126085812
5956;百度这家公司我也很讨厌，但他可能真的是国内AI领域走的最前的了。是不是完全自研这个暂且不论，毕竟现在国内首要目的是追上微软，不管是以什么代价，毕竟科技不需要重复造轮子，既然有前人的成功案例为啥一定要强迫自己从头走一遍。我相信对于AI这一块百度目前肯定比我们还急，毕竟做不好的话估计就得倒闭了，之前做的恶（比如广告），现在已经品尝到了恶果。对于那些砖家整天说的赢赢赢，我相信大多数人都是一笑了之，不会再看一眼。但我还是希望大家对百度的AI少一分嘲讽，毕竟人家已经拿出来了，虽然目前效果不太好，但相信再给他们一些时间还是能逐步追上的。毕竟动动嘴皮子，除了发泄自己的情绪外，什么也做不到，可以尽自己所能多加尝试一下目前的AI技术，毕竟这场AI浪潮与我们每个人都息息相关，一不小心就会被时代淘汰。;58;58;116;3799;0.030534351145038167
6015;百度一定会赢的。因为可以不允许引进国外的ai软件，这样就可以了。;21;86;107;3799;0.028165306659647275
6038;金色的摔倒;26;215;241;3799;0.06343774677546722
6065;都在讨论真假，其实chatgpt每次训练都是天价，这点国内就不会有公司干，只有肉眼可见的利益，才会驱动他们;11;110;121;3799;0.03185048697025533
6077;中文数据集已经没有优质数据了，现在理论上最优秀的数据知乎都充满了大量人类都没有办法理解的黑话，我个人认为百度可以基于开源整合出一个产品已经算是尽力了，现在还是在内测希望交互可以有所提升把;38;371;409;3799;0.10765991050276388
6116;以一卡脖子就。。一松手就。。;1;44;45;3799;0.011845222426954462
6118;呃非自研？我不信除非彦宏被水浇滑稽滑稽滑稽;27;326;353;3799;0.09291918926033167
6146;哪怕是国人自己做的模型，但只要是收集互联数据训练的，那么绝对会偏向英文描述的数据。要么能把互联网的数据半数中文化，要么技术水平超越国际同行，用质变打败量变;84;295;379;3799;0.09976309555146091
6231;实话说，百度作为一个受到保护的中文搜索引擎，同样关键词比谷歌搜索的东西还少，这就够离谱了。当然我觉得根本原因不是它收录的链接少，而是搜索结果受到多方面影响。包括但不限于为了自己另一款产品推广app而禁止浏览器访问甚至直接屏蔽搜索结果;30;258;288;3799;0.07580942353250855
6262;对啊其实模型微创新都算了，重点是一边说自己赢赢赢，结果连一套理解中文语义的东西都做不出来这个真是一种自信了跪了;9;74;83;3799;0.021847854698604896
6272;百度还是少把心思放在广告上，up主有一点真的说到点子上了。这么大的中文搜索网站，运营这么多年，拿不出个像样的中文数据集还要靠翻译成英文去适配真的太不应该了，都在干什么;6;18;24;3799;0.006317451961042379
6279;想起三体里的一句话“在现实的引力下，任何超脱的思想都会”;3;41;44;3799;0.011581995261911029
6283;懂科研的都知道，百度做的就是站在巨人的肩膀上定向做了点优化。路是别人修的，自己只不过是在路边开了家店。要不是别人理论公开，还有开源数据集，根本别想自己能这么快弄出来。;39;382;421;3799;0.11081863648328508
6323;你赢赢赢，最后就是输光光jpg滑稽滑稽滑稽;3;86;89;3799;0.023427217688865493
6327;OpenAI从2015年就成立了，当时是拿了10亿美元全部投入到ai这个领域，到现在已经8年了。惊讶;15;51;66;3799;0.017372992892866545
6343;我只能说，做过科研的都知道。顺便想起了以前读研时，实验室流传的一句笑话：咱们实验的突破取决于开源项目何时发布新版本。;56;511;567;3799;0.14924980257962622
6400;其实是这样的，就up这学识水平，靠这个赚钱太跌份了，光我就能找到不止10个up可以工作的方向，只能说听和看这种up的视频就是提高自己不了解的地方的。希望up一直更新下去，我已经推荐很多研究生博士之类的朋友关注了;16;161;177;3799;0.04659120821268755
6417;中国的科技公司一大半都是汉芯的后继者;66;371;437;3799;0.11503027112398
6484;简单来说，一般人认为的“自研”是：从零开始研发百度的“自研”是：从零开始训练;11;263;274;3799;0.0721242432219005
6496;百度是跟研究生学的水论文吧喜极而泣加权重，加filter，搞点“微创新”又能水一篇论文;1;26;27;3799;0.007107133456172677
6500;我还是那句话，现在国内企业都是这样，国外开一开源，国内就自研;40;272;312;3799;0.08212687549355094
6541;感觉国内现在都看不上老欧洲了，但人家技术还是厉害啊;2;14;16;3799;0.0042116346406949196
6547;你要知道，评论的人9999都没有相关知识，只能根据自己门外汉知识来判断是非，大多数评论看看得了，没有任何参考价值;7;59;66;3799;0.017372992892866545
6555;我们有高科技城墙比啥都强;9;11;20;3799;0.0052645433008686494
6566;无所谓当我们遇到。chatGPT和波士顿动力结合。在用星链作为数据链的霉菌。还是会赢赢赢的。dogedoge;25;15;40;3799;0.010529086601737299
6592;百度就是LJ，它们的产品除了贴吧我一个也不想用，另外贴吧是老哥创造出来的奇迹，百度只是特供个平台而已，而就是贴吧曾经那么优秀的东西，也屡次被百度拆台和出卖。这种公司几乎唯利是图到极点，如果不是墙护着，像它这么玩的早死了。;82;980;1062;3799;0.2795472492761253
6676;紧急修复了？;4;14;18;3799;0.0047380889707817845
6681;所以说嘛，什么逆向工程，抄就是抄，讲的那么文艺干嘛。之前欧美国家没太在意这个事，被扒了一堆技术，然后某国逆向一下，哎，5年整出别人20年的成果。。。好家伙，这看着真的是牛逼的不行了。但是别人反应过来后给你方方面面一掐，全完犊子。中国强的只是造，而不是研发，直到现在都是这样。而随着人口拐点到来，你的制造能力马上也要开始下坡了，那时候你怎么办？？国家倒是不傻，也知道要产业升级，但是国内这些所谓的科研单位，太菜了懂吧，之前抄习惯了你冷不丁让它自己琢磨，它哪有那水平辣眼睛辣眼睛辣眼睛;50;54;104;3799;0.027375625164516977
6732;我就知道，只要国外产品的接口一开发，很快啊，国内就有相同产品;12;82;94;3799;0.024743353514082654
6745;不喜欢百度，也不指望纯自研，只是希望国内能做出个好用甚至能用的工具。差距其实很明显，百度虽然lj，但是已经算国内一线AI大厂了，现在的行为只能说是拉着自研的幌子给自己贴金。至于说立场，我的立场很简单：我不在意是不是自研，甚至不在意它有没有吹牛，我只在意它能不能做出好用的工具来。它还在做，我就抱着支持的心态，做不出来那就是lj，至于chatgpt，我只能说好用，但是终究是别人的，国内的工具用不用不重要，有没有很重要。;20;53;73;3799;0.01921558304817057
6767;好家伙，还嘲笑大学生论文水，这是传统艺能啊;1;26;27;3799;0.007107133456172677
6771;没去看文心的论文，但很符合我的想象，就是部分硕士混论文的“创新”程度;12;37;49;3799;0.012898131087128192
6785;我能说个观点吗如果世界上很多华裔没有做出了成就那其实还好。因为如果他们做出了很多成就，那么有句古话橘生淮南则为橘，生于淮北则为枳。是不是更打脸辣眼睛;40;100;140;3799;0.03685180310608055
6826;是的，文心一言之所以能识别“一可以豆子”为“onecanbean”是因为文心一言装配了核心价值观，完爆ChatGPT;4;85;89;3799;0.023427217688865493
6831;你会发现主要的论文突破、核心技术突破的很少是商业公司，都是一些非盈利性或者纯科研组织。。。其实某些程度上也说明一些问题了脱单doge;1;14;15;3799;0.003948407475651487
6834;内有百度这类公司，外有墙，现在互联网简中内容太垃圾了;5;61;66;3799;0.017372992892866545
6840;别骂了，美国不让英伟达卖给中国A100和H100来加速AI训练，老老实实用chatGPT得了，自研的路还长着呢;2;6;8;3799;0.0021058173203474598
6843;这个博主水平很高的;8;74;82;3799;0.021584627533561464
6852;很多人词典里已经没有了“实事求是”一词了。;15;51;66;3799;0.017372992892866545
6869;首先被百度气笑了哈哈哈笑哭笑哭笑哭使用他人的开源技术可以啊但百度发布文心一言后，到处输出赢的情绪化符号化信息营销自己。百度自身腐臭本身以不必多说，但这种营销营造的错误氛围，丧失了实事求是的基本原则，对于国人是一种毒害，使其无法正确意识到差距所在，也没有了后面的事情。;3;38;41;3799;0.010792313766780732
6874;我只在红色软件上看过up主视频，怎么b站给我推荐首页了笑我就暴露了吗;3;11;14;3799;0.0036851803106080546
6878;说开源为什么不能用的？华为当初也没有人当他一回事，但是当开始重视华为的时候，卡脖子不就来了吗？我的东西，我让你用的时候，你可以用，但是有一天我不让你用了，那要卡你你就只能被卡所以华为用着别人的技术想要超越别人，这从一开始就是不可能的。最后还是变成了一个靠国内市场养的的畸形公司;35;68;103;3799;0.027112397999473545
6914;来来来，打起来，至于内容如何大家自己判断。;4;11;15;3799;0.003948407475651487
6921;如果这个视频是对的，那百度那么大的团队就是在做调参疑惑疑惑;4;18;22;3799;0.005790997630955514
6927;这个视频禁止分享。。。;1;6;7;3799;0.0018425901553040273
6929;既然是公开的论文。就不存在抄袭一说。有点常识;4;4;8;3799;0.0021058173203474598
6935;很多技术突破都是国外出现的，之前的区块链和元宇宙也是，国内做的一直是跟随者。不应该说一些空话，而是脚踏实地做好事情，吾辈当自强;18;10;28;3799;0.007370360621216109
6955;UP主的观众与UP的水平不是很匹配啊。;3;6;9;3799;0.0023690444853908922
6959;点开这个视频的时候我还以为有人要掏出干货证明文心一言自研程度有多高呢。还小激动了一下。;1;8;9;3799;0.0023690444853908922
6961;省流，至少关键词提取器是自己做的，翻译调用的自家api，没用谷歌翻译dogedogedoge;1;16;17;3799;0.004474861805738352
6963;这论文创新手法像极了我交nlp课程小组报告doge创新了但不多;2;7;9;3799;0.0023690444853908922
6968;我没理解，我感觉这个论证方式很奇怪，按我现在对文心一言的了解，这是一个很不成熟的对话ai，可，关于“突破掐脖子”和“自研”我感觉还是有很大区别的，很明显，文心不是突破，只是一个理论转应用，但我还是没懂骂文心的原因;9;18;27;3799;0.007107133456172677
6981;无所谓，今年4月华为云盘古大模型就来了。BV1by4y1s7ec;4;8;12;3799;0.0031587259805211897
6987;竟敢在大是大非面前讲实事求是，你屁股歪了辣眼睛;3;7;10;3799;0.0026322716504343247
6996;我觉得开源完全没有必要，如果你想分享技术就在圈子里面点对点分享就好了，免得某些人来恶心人嗑瓜子;2;5;7;3799;0.0018425901553040273
7003;我也认为文心这个是根据开源项目魔改的，网上那些直接调外国接口来用的说法还是太不切实际了;6;24;30;3799;0.007896814951302974
7010;百度李彦宏：文心一言和ChatGPT的水平差了2个月，但可以追赶;11;30;41;3799;0.010792313766780732
7022;省流量：完整版28分钟，但完整版增加的5分钟才是真正的结论妙啊;4;12;16;3799;0.0042116346406949196
7034;我本科做科研感觉也是这个样，导师要求创新点，学术界成熟的模型我又没这个改进的水平，那只能嗯整点“我寻思能提升效果”的输入预处理之类的改进了。;1;9;10;3799;0.0026322716504343247
7036;别理会那些杠精有时候发了些支持UP的话都被删了就没兴致发了最后只剩下粉H的评论加油在沥青河里激流勇进的UPOK;1;11;12;3799;0.0031587259805211897
7041;叫不醒装睡的人的;2;15;17;3799;0.004474861805738352
7044;可是我们的论文数量和发明专利已经第一了呀;5;10;15;3799;0.003948407475651487
7052;脱单doge我在抖音说了句开源就是自研，结果一堆人喷我，上来就喷我文盲;2;6;8;3799;0.0021058173203474598
7056;至少，现在百度在这条路上走不是吗，我不想后面发现ai领域这条路上全是外国的科技公司，到时候被封锁技术咋整啊，GPT现在都禁止中国使用，文心一言还是必要存在的，至少你得有。我乐意看到国内公司有个起步，如果没人做这方面的东西，那该多让人绝望呆;15;8;23;3799;0.006054224795998947
7076;百度搜索材料现在不如小红书头条搜索内容;4;12;16;3799;0.0042116346406949196
7082;现在我只相信水泥科技了，别的还是算了吧。;1;5;6;3799;0.0015793629902605948
7085;我想说国内能发深度学习顶会的论文很多都是百度这种微创新，大的创新太难太少了，需要运气与时间。至于图片标注翻译这里确实可能存在欺骗。如果两个月后文心一言真的能有gpt35的水平说明他还是有水平的;13;12;25;3799;0.006580679126085812
7101;就说一个结论，自研也好套皮也好，现在拿出大模型的，除了美国就是中国。百度再差，那也是世界第二。;14;6;20;3799;0.0052645433008686494
7117;。。。。。那国内AI这几年都在干嘛呢;33;18;51;3799;0.013424585417215057
7152;激情对线，彳亍;1;15;16;3799;0.0042116346406949196
7155;股价大涨怎么解释，投资人不是冤大头吧;13;4;17;3799;0.004474861805738352
7170;中国的顶级大学都在干什么？辣眼睛辣眼睛;1;1;2;3799;0.0005264543300868649
7174;关于没有中文数据集的原因，我有一个猜想doge众所周知中文nlp本来就比英文难，而且在国外的应用需求有很少；某公司他自己做不出足够精确的模型也找不到已有的成果抄，只能拿个翻译的壳子套在英文nlp模型上边了doge;4;4;8;3799;0.0021058173203474598
7180;我寻思真的有人吹百度吗;3;5;8;3799;0.0021058173203474598
7193;中国可以做出ai，但一定不是百度;1;2;3;3799;0.0007896814951302974
7195;下期扒一下鸿蒙是不是自研;3;2;5;3799;0.0013161358252171624
7200;说实话，我嘲讽过百度了但现在的情况重要的是快速的搞出一个替代品百度在这里面的作用极其关键，要给百度一次机会，他有它的作用。;7;5;12;3799;0.0031587259805211897
7210;恐怖的是，这已经是国内套壳搞的非常好的了;1;2;3;3799;0.0007896814951302974
7212;博主是我看到的，少数几个说真话的吃瓜;1;3;4;3799;0.0010529086601737299
7215;既然chatgpt已经永远进不来，文心一言再怎么垃圾也已经立于不败之地，百度明白自己有一个不会被世界冲击的市场。这时候只能寄希望于国内竞争。;1;2;3;3799;0.0007896814951302974
7220;是不是自研我不关心，我就关心为什么chatgtp火了以后它才出来，是为了蹭热度？还是来不及完善了赶鸭子上架？;3;5;8;3799;0.0021058173203474598
7225;怎么可能是自研，明明的;2;2;4;3799;0.0010529086601737299
7228;但凡认知高一点，用屁股想都知道，肯定是抄国外的拉，或者说等着开源哈哈哈，什么鬼样子难道还用说嘛;2;4;6;3799;0.0015793629902605948
7236;评论被吞了，很好嗑瓜子，果然够实事求是;2;3;5;3799;0.0013161358252171624
7241;我以为up是财经区的doge现在看样子是科技区的;2;5;7;3799;0.0018425901553040273
7245;更正一个错误，546这里不是github不同模型的使用次数，而是github上不同仓库的star数量，可以理解为项目的热门程度认可度doge;2;10;12;3799;0.0031587259805211897
7249;自信可以有，但请看天的时候，注意下脚下的路是否是平坦大道;1;3;4;3799;0.0010529086601737299
7251;别人浪费时间金钱精力创新我们对着一下就自主研发了顶多次了那点但是发展快啊OK;3;2;5;3799;0.0013161358252171624
7256;随着中文互联网越来越发达，很多关键字都是网络用语、谐音、首字母缩写，这要怎么训练？;4;2;6;3799;0.0015793629902605948
7262;狼行千里吃肉狗行千里吃屎甚至这狗有没有行千里还不知道呢？吃瓜;2;6;8;3799;0.0021058173203474598
7267;实事求是，别管抄不抄了，节省成本，另外国内就这科研环境，还指望自己搞出来？要么不愿意花钱，要么不愿意花时间，要么没有那种创造创新意识，工业软件基本靠抄，习惯就好，脸皮厚点;6;4;10;3799;0.0026322716504343247
7274;有一种我本科搞毕业设计和论文的美;1;3;4;3799;0.0010529086601737299
7277;一旦不是自己想要去研发创新，而是为了考核而研发创新，那研发创新环境可想而知;1;4;5;3799;0.0013161358252171624
7281;因为事实而产生立场而不是因为预设立场筛选事实;1;26;27;3799;0.007107133456172677
7285;说白了，李彦宏自己也说了，百度投入生成式ai也就一年半，还没投入多少。能自主研发出来什么呢？;14;6;20;3799;0.0052645433008686494
7304;以前我总觉得AI没有市场，当听到“刘亦菲，剧情”的时候，我就知道，要火;1;3;4;3799;0.0010529086601737299
7309;不懂就问，贴吧不能提事件是啥）;2;0;2;3799;0.0005264543300868649
7312;还有战狼给鸿蒙洗呢，希望up讲讲鸿蒙;3;5;8;3799;0.0021058173203474598
7324;你的水平比我想的还高点打call;4;4;8;3799;0.0021058173203474598
7329;是不是自研我不在乎好不好用才是重点做出来坨人工智障吹的再牛也没用;3;5;8;3799;0.0021058173203474598
7333;根本比不过电脑开发最基础的语言就不是中文基础这种根源就导致喂的东西就比不上英文质量和数量你拿什么跟别人比;1;2;3;3799;0.0007896814951302974
7349;除了搜贴吧内容我还会用百度，自己几年不用百度搜索了，里面简直就是垃圾场，我对这家公司一切所谓高科技产品一律采用看笑话态度;2;4;6;3799;0.0015793629902605948
7355;我突然想到，这会不会成为黑船撞破那堵墙？;2;1;3;3799;0.0007896814951302974
7359;百度就是太急了你就不应该把这ai绘画加进来多此一举，明明有更专业的ai绘画你加进来是要显得自己不同吗，本来那个文心一格也没人关心你是不是自己宣传一样投入了多少亿是不是用了英文数据集，你现在非要放到聚光灯下拿来吹辣眼睛你投入这么多年算力，模型，数据你总要沾点边吧;1;2;3;3799;0.0007896814951302974
7366;为什么我听说ai训练的底层逻辑从20世纪60年代之前就出现了;1;1;2;3799;0.0005264543300868649
7368;谨防chatGPT等软件成为外国情报机构收集信息重要工具;1;1;2;3799;0.0005264543300868649
7378;都是复制的Chatgtp的开源代码罢了;2;1;3;3799;0.0007896814951302974
7381;嘛，感觉也没啥好讨论得了。但是，从0到1被1到99杀死的东西数量可不少啊。;1;1;2;3799;0.0005264543300868649
7388;李彦宏说文心一言和chat4只有两个月差距;4;1;5;3799;0.0013161358252171624
7395;本学渣有个疑问，up主后面举例的，好像是百度自己发了一篇论文说文心一言的原理，百度这不是自爆了吗喜极而泣;3;1;4;3799;0.0010529086601737299
7399;国内没有自研能力，大家理性看待就完事了，这东西我们必须要有自己的gpt，微软已经在制裁同类的搜索GPT了;12;1;13;3799;0.003421953145564622
7412;我认同up说的，但好像只说了画图功能，而文心的画图不过是在gpt后面接了个插件，和gpt部分关系不大。希望up再把聊天部分仔细讲讲。;1;1;2;3799;0.0005264543300868649
7423;递刀子，50万;1;1;2;3799;0.0005264543300868649
7427;到最后，国内干事的公司就各行业几家，这些公司只有出成果了，被报道了，才报出来，平时不是相关行业从业者都没听过这些名字。反倒这些互联网大厂;5;1;6;3799;0.0015793629902605948
7441;加油，支持这种用心科普的up主;1;1;2;3799;0.0005264543300868649
7451;还是等mihoyo的技术突破吧笑哭;4;1;5;3799;0.0013161358252171624
7458;这种AI本来就不是什么原创，只不过是以前各种AI的综合提升而已，不管是中国的还是美国的都是如此。中国的软件可能会用到美国的原创，但美国的原创也很有可能就是欧洲，印度或者华人工程师参与设计的。作为中国人一定要支持中国能自主的软件，因为这是将来能够比拼国力的方向。不管你是偷还是抢都不难看，因为你不得不走在前面，或者说你不能被人落下太大差距。没得选择，因为落后就必然要挨打。;4;1;5;3799;0.0013161358252171624
7463;另外隋唐小测：chatgpt和文心一言的底层架构分别是什么？;1;1;2;3799;0.0005264543300868649
7475;百度难道不是个小说软件吗？不会真有人在上面搜索什么吧？就是你在B站上面随便搜一下，都比百度好，百度就是个看盗版小说的。;1;2;3;3799;0.0007896814951302974
7477;就是用的别人的开源框架，最多改吧改吧别人的开源的算法，模型，就能吹是自己研发的们，恶心不恶心。你估计不知道什么是开源吧？开源最本质的原因就是东西不行，需要大家一起弄，所以开源，简单点就是Android和IOS的区别，一个开源，一个不开源，就这么大的区别;2;4;6;3799;0.0015793629902605948
7482;自不自研我不在乎，我就想知道它什么时候能投入使用。是部分免费还是开vip才能用，买百度云盘vip送不送试用券。只能企业用还是个人也能用。能像ChatGPT4那样融入wps吗？或者像newbing一样增加搜索引擎的能力？现在百度百科关于文心一言的论证参考全都是2023年后的新闻。当然，如果有人用up给出的这些参考去定义文心一言的来源，可能在百度百科的审核规则里都会被定义为非权威参考，无法通过。除非是“专业人士”去干这事情。doge;1;1;2;3799;0.0005264543300868649
7484;我在网上说百度只吃老本不上进做套皮，还有一堆人追着抬杠;12;3;15;3799;0.003948407475651487
7499;我记得百度在发表文心一言的当天股价就下降了，毕竟嘴上说的不一定是真，但money确是实打实的脱单doge;2;1;3;3799;0.0007896814951302974
7504;给我一种知乎的感觉（褒义）;1;1;2;3799;0.0005264543300868649
7511;相比于抄都炒不出来的国内某些国产大公司要好多了;3;1;4;3799;0.0010529086601737299
7518;前几天看到个从北京蛙跳到大连的视频，百度做的事大概就是在高铁上蛙跳;1;1;2;3799;0.0005264543300868649
7524;我用了文心一格，充值了，效果不好，想退款，不给退，即使原来充值多少电力并不少电力的情况下也不给退，人物除了头像基本不能看，一堆关键词控制，机器人审核，几乎没有图片的自由度;1;1;2;3799;0.0005264543300868649
7527;百度要是自研让他画一副爱国的猫，他还会画星条旗吗;7;1;8;3799;0.0021058173203474598
7540;百度这几年一直要死不活的，是有原因的;2;1;3;3799;0.0007896814951302974
7544;把喷子的评论晒一晒让大伙乐一乐妙啊;1;1;2;3799;0.0005264543300868649
7556;说不定可以考虑盘古，百度有点失望;1;0;1;3799;0.00026322716504343247
7559;本来我对文心一言还想着语言模型是百度自研的，你这么一解释，全明白了。图片生成为啥一说爱国就上美国国旗，也理解了，都是人家那边的大学生做的，用的素材也是人家的，自然是爱美国了，百度连多加些素材，让AI爱中国都做不到，那还有什么用？;3;2;5;3799;0.0013161358252171624
7567;这群人挺搞笑的，没数据集那能怪百度吗？我寻思你中文互联网个个都搞壁垒，信息又乱七八糟的，哪有什么高质量数据。人百度那是想做数据集也没法变出来啊。;5;3;8;3799;0.0021058173203474598
7580;虽然我临床本科毕业，但我完全听不懂;4;1;5;3799;0.0013161358252171624
7601;现在百度最大的问题是，人心里的“成见”，他什么发明一说出来，我就不信。说他有科技，以前也许有，现在？一腾讯样的平台公司，核心科技几乎没有，就靠数据和那个啥挣钱。它本来有机会成为中国谷歌的，但它学联想了。软骨头。;1;1;2;3799;0.0005264543300868649
7613;谁能解释一下那个爱国的猫是怎么回事？;1;0;1;3799;0.00026322716504343247
7654;算法模型加数据，数据都是国外怎么搞？生成图片东方人物都是西方高级脸，是数据偏了还是你算法歪了？;1;1;2;3799;0.0005264543300868649
7658;没别的意思，想问下业内人士，阿里目前主要在哪个领域突破比较多;4;0;4;3799;0.0010529086601737299
7689;笑哭如果不和美国比和其他国家比呢;1;0;1;3799;0.00026322716504343247
7708;为啥都说是偏英文的数据库我感觉newbing都比文心一言要聪明的多啊笑哭;1;0;1;3799;0.00026322716504343247
7711;文心一言是不是ChatGPT做得;4;0;4;3799;0.0010529086601737299
7721;想知道文心一言的这个生成图片和前段时间火的AI绘图有啥区别呢微笑微笑;6;0;6;3799;0.0015793629902605948
7746;卧槽，645，居然不收费卧槽;1;0;1;3799;0.00026322716504343247
7749;文心一言最主要的不是语义理解么，文字回答还是可以的，没那么差。作图确实拉了;2;0;2;3799;0.0005264543300868649
7753;加噪音就是打码，打码就意味着原始像素丢失，丢失的像素是不可能无中生有的，所以去噪怎么可能还原图像？;1;0;1;3799;0.00026322716504343247
7756;核心技术是别人的没问题，微创新也是可行的路线，能真有提升也行。问题是占有了市场和资源，为啥这么多年了连一个自己的大型数据库都没有？还不是自己对自己的数据库污染的厉害。技术方面的提升，毕竟有开源代码，能读懂论文就能快速模仿。但没有自己的数据库，也只是复现别人的东西，最后做了一个不称职的翻译。但构建数据库那就是多年的积累了，需要有长期投入，优秀的设计并沉下心来做，百度和这些东西不搭边啊。;1;0;1;3799;0.00026322716504343247
7759;谷歌都做不好，百度的更不要说了。而且中国最缺显卡，openai用的很多是英伟达a100的显卡，但这东西美国是禁售给中国的。其他类型显卡也跟不上。还是先期盼一下国产显卡的发展吧。老鼠无所谓，我是用户哪个好我用就是。;5;0;5;3799;0.0013161358252171624
7771;鸿茅药酒是什么梗？;1;0;1;3799;0.00026322716504343247
7774;从评论区能看出来，大部分人没有看up的事情就发个言走了。;1;1;2;3799;0.0005264543300868649
7811;哈哈，终于有up把文言一心扒皮了，爽;1;0;1;3799;0.00026322716504343247
7829;别整那没用的给咱画个起重机先吃瓜;1;0;1;3799;0.00026322716504343247
7831;百度用英文训练，用百度翻译假装中文模型几乎是实锤。我来起底一下百度用了五年的“知识增强”技术，就是ernie唯一的创新点，对他们整整炒了五年，也是对bert的掩码基于所谓的知识进行分门别类，指标的增长几乎没有。你可以认为他们做的工作全部是基于开源模型混进去一些自己的小聪明;2;0;2;3799;0.0005264543300868649
7834;要不要说下鸿蒙呲牙;1;0;1;3799;0.00026322716504343247
7848;省流：赢;1;0;1;3799;0.00026322716504343247
7858;那有怎么样呢，我记得那个训练AI用的显卡公司的老总是中国人呀，好像姓黄吧？我劝你自信点;2;0;2;3799;0.0005264543300868649
7873;百度主要发展的是业务，变现能力是衡量业务的重要因素，而科技水平则不然。这个引擎里面的打车、贷款、卖房要比Ai赚钱容易多了。目前受到chat的影响不得不做出相对反应，世界级创新做不到，引领国内技术发展还可以脱单doge;2;0;2;3799;0.0005264543300868649
7878;百度不是说文心一言用的是英文数据训练的么？训练数据和技术不是一个东西吧。;1;0;1;3799;0.00026322716504343247
7894;怎么都是一片悲观啊，httpsb23tvBV1Nm4y1z7AT全世界开始去美元化那么美帝能靠Chatgpt度过这次经济危机吗？捂脸;9;0;9;3799;0.0023690444853908922
7909;我从苹果上面下载了文心一言全是广告问你个问题就看一个广告难道我下的是假的？不可能啊苹果对App这么严格的控制怎么可能是假的？;2;0;2;3799;0.0005264543300868649
7915;《之前一直困扰着业界，直到XX年一个技术突破，那就是XX国外大学实验室。。。。。。。》这个句式典中典;1;0;1;3799;0.00026322716504343247
7918;感觉没有找到重点，关键是训练的数据，国内大厂都当做自己的核心技术，就是微信，阿里的接口不给你，数据喂不够怎么训练？;1;0;1;3799;0.00026322716504343247
7923;我说文心一言是“chatppt”不过分吧doge;1;0;1;3799;0.00026322716504343247
7925;不一直这样么，美国强在模型的建立，理论的提出，中国强在应用多姿多彩。花那么大精力在为知领域投资，在安全区域捞钱多舒服;1;0;1;3799;0.00026322716504343247
7929;全自研，你觉得可能吗;4;0;4;3799;0.0010529086601737299
7935;想问up主这么厉害的信息分析和搜集，是通过平时看资料，还是也看国外一些专业人士的分析，然后去找资料，还是什么其他方法练就这么强的能力的，想学习学习doge;1;0;1;3799;0.00026322716504343247
7941;up主我喜欢你的视频，但你视频后面的内容似乎真的有点危险。。;1;0;1;3799;0.00026322716504343247
7958;其实有个比文心一言更早的图片生成器，叫什么也忘了，反正百分百文心一言不是原创。;2;0;2;3799;0.0005264543300868649
7968;UP是真的牛逼，应该是我国AI方面精英人士，还能给我们科普打call;2;0;2;3799;0.0005264543300868649
7972;草啊虽然不想承认，但美国是真厉害啊，英伟达微软openai联手干似世界，虽然现在还是训练集，没有自我意识，之后呢？;3;0;3;3799;0.0007896814951302974
7981;无语什么啊，百度的水平就这点？还不如我，我都还重写，他就改个参数;1;2;3;3799;0.0007896814951302974
7988;所谓科技公司的产品大都是开源的换个壳;1;0;1;3799;0.00026322716504343247
7992;某些人不会以为国外没有人情世故吧？嗑瓜子;4;0;4;3799;0.0010529086601737299
7998;up，最近清华的那个openai怎么样，评测一下呗;4;0;4;3799;0.0010529086601737299
8008;我为啥在油管上看不到完整版;1;0;1;3799;0.00026322716504343247
8029;up莫非就是一个人工智能？好小子，我早感觉你不对劲了，原来是潜藏的人工智能内奸doge;1;1;2;3799;0.0005264543300868649
8035;ChatGPT和newbing我还尝试去试试看，但是文言一心这玩意出来就没关注过，不要对百度抱有任何期待就对了，甚至可以说不要对国内纯互联网公司抱有任何期待;1;0;1;3799;0.00026322716504343247
8040;客观点，百度地图还不错，其它都是垃圾。;1;0;1;3799;0.00026322716504343247
8049;完全自研基于中文，意味着懂得针对具体情况修改模型，达到比原型更好的效果。而现在只是改一点点，而且还只是改，而不是优化。;1;0;1;3799;0.00026322716504343247
8058;为什么要纠结什么是不是自研呢;2;0;2;3799;0.0005264543300868649
8069;说百度抄袭我是认可的，但是我们应该给抄袭增加一些限制，要不然就是耍流氓。这个世界本来就不存在完全的自研，up自己也说了这些技术集合很多地方的成果，既然百度能把它做出来，至少说明百度工程复现能力很强。就像写作文，没有开发出一套新的文字去写就算抄袭字典是吧;1;0;1;3799;0.00026322716504343247
8072;什么都比，这就是社会的心态什么都争第一的，以前火箭也是说成本可靠性第一，现在是被spacex打爬了;1;0;1;3799;0.00026322716504343247
8089;对于文心一言我不感兴趣，我只是希望百度死。;2;0;2;3799;0.0005264543300868649
8094;视频看完了，文心一言这点事儿整明白了但是心里很不好受大哭;3;0;3;3799;0.0007896814951302974
8099;百度这种公司什么时候能倒啊，看看它这些产品：百度网盘，没有会员下载速度几kB，前几天我下载东西居然还让我玩他们的什么网游？百度文库，只要搜点什么它都蹬鼻子上脸的要会员，贴吧和百度全是广告，数不清的广告;3;0;3;3799;0.0007896814951302974
8103;虽然这是一坨那啥但是在这个大环境下他也算是尽全力了;1;0;1;3799;0.00026322716504343247
8109;肯定会被腺瘤吧？打call;1;0;1;3799;0.00026322716504343247
8112;文心一言是直接调用吧，就是欺骗，连抄都懒得抄;1;0;1;3799;0.00026322716504343247
8120;再差也是第二啊，比谷歌那个好，还是国外自己评分的。;14;1;15;3799;0.003948407475651487
8142;up是被限流了吧半年没在首页刷到你了;2;0;2;3799;0.0005264543300868649
8151;中国能做出chatgpt的也只有华为，也只有华为才能够救中国，其他互联网公司都是垃圾，现在只能希望国家加大对华为的支持，让华为早日拯救中国;3;2;5;3799;0.0013161358252171624
8169;呵呵，百度恶心的是拿外国数据当训练集。;1;0;1;3799;0.00026322716504343247
8172;都是开源的错，老外脑子有毛病;2;0;2;3799;0.0005264543300868649
8175;别人在发论文的时候，我们在做合算;6;0;6;3799;0.0015793629902605948
8183;我们的AI方向在监控领域天下无敌;1;40;41;3799;0.010792313766780732
8187;up，有人怎么回你诶;4;5;9;3799;0.0023690444853908922
8197;国内大厂的ai不都是这样吗？调调参练练丹，造几个牛逼词汇，写几页PPT就完成工作了。原创算法你在跟我开玩笑吗？;4;2;6;3799;0.0015793629902605948
8202;对于长期生活在“自主研发”的讨论氛围下的国人，在价值判断上已经相当具备中国特色了，在这种情况下，无论是所谓正方和反方都没有丝毫怀疑地把“自研”当成极为重要的评价标准，再把简中互联网流传已久的各种一句话真理缝在一起，就是一个独立思考尊重事实的国人。当一个人宣称自己拥有某项属性的时候，人们关注的并非该属性是否值得去吹捧，而是他符不符合该属性的时候，这个独立思考的他就已经被这个属性所俘获了。;3;2;5;3799;0.0013161358252171624
8206;算法国外都搞出来了，就差个中文训练数据集。百度也不是很穷吧，花点钱找点人去做数据标注不好吗，非要用百度翻译API转换，连个中文的数据集都弄不好。囧;6;6;12;3799;0.0031587259805211897
8214;每当有人认为文心一言是抄袭国外的我：;37;993;1030;3799;0.2711239799947355
8252;你爷爷一开源，我爷爷就创新doge;20;711;731;3799;0.19241905764674913
8273;直接上图;30;148;178;3799;0.046854435377730985
8304;这图能看出来吧。文心一言画画是先翻译成英文，内核是英文，你懂的;46;148;194;3799;0.051066070018425905
8351;doge;6;287;293;3799;0.07712555935772572
8359;百度是不值得信任，把中国ai的未来交到百度手上是可悲的，但一味的情绪化以偏概全，批评一切，跟公知有区别吗，如果像有些人臆想的，我们早就崩溃无数次了，西方还封锁我们干嘛微笑;2;3;5;3799;0.0013161358252171624
8362;一步错，步步错，游戏不让发展，gpu和AI你就寄，各种wall，各种卡审核，导致没有优秀内容，你就没数据训练，怪谁？又不怪我;14;48;62;3799;0.016320084232692815
8377;ChatGPT：Hartogs现象和Hartogs定理是复分析和复几何领域的重要概念，它们之间存在密切的关联。首先来了解一下Hartogs现象。在复分析中，Hartogs现象描述了一个有趣的现象，即对于多复变量的函数（例如两个或更多复变量），其全纯性质（即解析性）在局部上有较强的鲁棒性。这意味着如果一个多复变量函数在某个区域上全纯（即可解析），那么在稍微删除一些点或者一个较小的子集之后，它仍然在整个区域上保持全纯。这与单复变量函数的情况形成鲜明对比，在单复变量的情况下，删除一个点可能导致函数失去全纯性。接下来介绍Hartogs定理。Hartogs定理是Hartogs现象的一个具体表述，它说明了如何在多复变量函数中找到全纯性质的鲁棒性。定理如下：设f是一个定义在复数域Cn（n2）上的函数，D是一个域（即连通的开集），K是D中的紧致子集（即闭且有界的子集）。如果f在DK（即D去掉K的区域）上全纯，那么f在整个D上也全纯。Hartogs定理揭示了多复变量全纯函数在局部上的强鲁棒性，即使在定义域内去掉一个紧致子集，全纯性质仍然得以保持。这一现象在单复变量全纯函数中并不成立，因此Hartogs现象和Hartogs定理为复几何和多复变量全纯函数理论提供了深刻的见解。;3;98;101;3799;0.026585943669386682
8381;一场骗局而已。其实通过这些我看到的更多是一种隐忧。浮躁的风气已经全面蔓延到技术研发、科技创新领域，为了抢占市场、抢占用户，草草制作徒有虚壳、却无实物的所谓技术发明进行发布，不仅弄巧成拙，而且让自己丑态百出，也严重挫伤市场和用户的信心与预期。这就是我们面临的最大问题，越来越少的人能得沉下来专心搞科研了，这些年我们的产业转型升级、产业结果调整，是否真正走上了科技赋能的新赛道，值得大家深刻反思。;47;94;141;3799;0.03711503027112398
8429;你带着偏见测试的吧，无论怎样你都能挑到刺，如果回答不准确，你可以说有问题，但是你自己提出的生成答案的逻辑，视频里面你也没有验证出来啊，还有文心一言是AI模型，newbing是集成了AI模型的浏览器聊天助手，当然会在回答上对浏览器做相应的优化;37;40;77;3799;0.0202684917083443
8467;神他喵定理38和定理310;3;31;34;3799;0.008949723611476704
8472;歪嘴;4;27;31;3799;0.008160042116346407
8477;定理38310。请问谁知道是什么东西？我们可没有文心一言这么“智能”，这都知道;1;20;21;3799;0.005527770465912082
8479;我也试用了，我觉得文心还可以呢星星眼普通上班族完全够用，主要是代码能力偏弱了一些;23;19;42;3799;0.011055540931824164
8504;问他异情三年，问他敏感话题;3;11;14;3799;0.0036851803106080546
8508;语言模型得靠用户输入信息不断反馈才能越来越完美，gpt上路已经半年了，文心才刚开始。我更在意的是他的潜力，至于当下，文心不如gpt是正常的。;21;9;30;3799;0.007896814951302974
8530;还是希望国产能像华为，做的好些再发布，目前来看，学习以及对话中还存在很多问题，其实说句实话，不适合发布，只是一个内部迭代版本;16;6;22;3799;0.005790997630955514
8547;上来就根据定理xx，抄的太假;1;5;6;3799;0.0015793629902605948
8549;文心一言不错呀，李总怎么发布会不敢实操;1;4;5;3799;0.0013161358252171624
8554;这么快就搞到内测了？;1;3;4;3799;0.0010529086601737299
8556;不能一次性显示答案吗，一个一个字弹出来太慢了;3;2;5;3799;0.0013161358252171624
8560;这速度应该是算力问题吧？硬件方面技术也需加强啊;1;2;3;3799;0.0007896814951302974
8565;定理38和310？文心没给说明吗;2;1;3;3799;0.0007896814951302974
8578;只能说重视不够，百度一直在布局自动驾驶这种能赚快钱、大钱的玩意，但实际上，一直不见起色，安全性也很大考究;1;0;1;3799;0.00026322716504343247
8584;能角色扮演吗？让它扮演一个小学学生，再问他这个问题。;1;0;1;3799;0.00026322716504343247
8588;我笑死了;15;126;141;3799;0.03711503027112398
8604;一个劲的嘲讽起什么作用，中国科技缺的更多是人才和技术，多把你们的嘲讽放在去鼓励他人做出科技成果与技术之上，也许这还能略微改善一点互联网环境保佑;7;33;40;3799;0.010529086601737299
8612;昨天有幸在现场参与了文心一言的发布会。听完了Robin和李博对文心的讲解，能感受到二位的诚恳，也能清楚认识到文心一言和gpt之间的差距。我认为这是好事。但发布会结束后一直到今天，看到各大内容平台上对于文心一言铺天盖地的嘲讽。我觉得无法理解。什么时候我们的用户对于我们自己的产品如此苛刻了？毕竟OpenAI对于Chatgpt已经研发了8年，技术和数据之间的差距我们不可否认，但是能否给予文心一言多点时间和理解呢？国内又有哪家公司能比百度更适合推出此类AI产品呢？希望大家多点理解，少点责骂。我相信文心一言一定能给大家带来更好的体验BTW我自己也做了一个免费的AI问答小程序，叫“moss小苔藓AI”;15;80;95;3799;0.025006580679126086
8628;无论如何，还是要支持百度。这是场国运之争，甚至比芯片战争还要重要百倍。ChatGPT再好，那也是美国的。;4;32;36;3799;0.009476177941563569
8633;怎么说呢百度也算瘸子里面挑将军了阿里腾讯也不搞这个毕竟人家也没霸占中文搜索引擎所以怎么说呢只能勉为其难说一句未来可期潜力很大;16;77;93;3799;0.024480126349039222
8650;做文心更难，还有一堆违禁词要学，还要区分阴阳怪气的问题，答案还不能敏感，限制参数多的同时还要足够智能兔年吉祥東雪蓮哈哈;3;18;21;3799;0.005527770465912082
8654;中国这个领域需要不断地追赶，心怀期盼就好，不必大喷特喷;48;89;137;3799;0.03606212161095025
8704;有趣的是，chatGPT并没有针对中文做特定优化（至少我没有听说过他们有这么做），你用日语阿拉伯语大概率也是同等高质量的回答。文心一言可是声称自己专门做了中文优化的;2;13;15;3799;0.003948407475651487
8708;写藏头诗，文心高出一大块，看来中文底蕴这块，老外很难搞定;9;38;47;3799;0.012371676757041327
8720;为啥叫文心一言，一听名字就没啥欲望了;8;7;15;3799;0.003948407475651487
8729;我来预测下AI未来对市场的影响，初期会淘汰一批打工的，但后面会逐渐淘汰老板，因为大家都变成个体户了，然后渠道变成了稀缺资源，大家开始卷推广位，反正AI目前无法取代渠道稀缺这个弊病，然后未来的渠道者得天下吃瓜;4;28;32;3799;0.008423269281389839
8734;进内测了，编程的一些小问题还是可以快速检索出来的希望百度可能成为像长江存储那样的存在也强烈建议文心一言推出一个收费版的不要出现什么我和ai聊天的过程中ai把答案偏向于莆田变现的方式不要像杀毒软件那样扭曲;8;8;16;3799;0.0042116346406949196
8744;ai智能我只用文心一言，因为它是有良心的中国制造给心心给心心给心心给心心;4;10;14;3799;0.0036851803106080546
8749;冷知识：百度只向有合作的“友好”媒体开放接口。;2;3;5;3799;0.0013161358252171624
8753;我问他感绝有没有错别字，他说没有。英文我就没必要再问了。;6;10;16;3799;0.0042116346406949196
8760;我说一个数，百度股价跌了doge;6;7;13;3799;0.003421953145564622
8767;你这封面字体，看成文心一盲笑哭;1;8;9;3799;0.0023690444853908922
8769;您缺乏想象力吗，来我们莆田医院喜欢喜欢喜欢喜欢喜欢;1;9;10;3799;0.0026322716504343247
8772;GPT：文心一言？那不就是百度做出来的一个短句子生成器吗？什么“深度学习算法”、“情感倾向识别”，能有多高端啊？说穿了，还不就是一群程序员敲代码写出来的东西嘛。这种所谓的人工智能技术和语言模型，真正能够创造出有思想、有灵魂的文章吗？让机器代替人类创造力？简直就是笑话嘛而且这个玩意还要大量的数据样本支持，不知道它们搜集用户的信息做些什么呢，我个人真的是不敢想象。反正对我来说，用自己的大脑思考并创作，比起依赖百度的这种技术力要好得多。;2;4;6;3799;0.0015793629902605948
8777;早点开放用户侧，用大量数据学习迭代吧;9;6;15;3799;0.003948407475651487
8791;chatgpt是深耕多年的产品，文心一言是chatgpt过了之后临时做出来的;2;1;3;3799;0.0007896814951302974
8794;关键是这玩意不能变现，要不是chatgpt这么火，百度根本没有搞下去的动力。预测一波：百度要么在文心里面加广告或者其他东西来变现，要么就是等热度过去了关闭文心的服务;3;1;4;3799;0.0010529086601737299
8802;告诉我有没有违禁词;1;1;2;3799;0.0005264543300868649
8808;哦呼我觉得大模型最需要的是算力吧。在a100和h100无法进口的情况下，数年内几无可能追上chatgpt。;9;1;10;3799;0.0026322716504343247
8838;搜索味太浓了，而且逻辑引申几乎没有，记忆力还很低，你说支持国产，可以，但你老板会吗？有chatgpt这种重量级的存在，一切后来者都会被甩的远远的;1;0;1;3799;0.00026322716504343247
8847;洗，继续洗;1;5;6;3799;0.0015793629902605948
8856;ChatGPT的api具有出图功能的;5;0;5;3799;0.0013161358252171624
8866;应该是cheatppt;4;26;30;3799;0.007896814951302974
8871;笑死;10;121;131;3799;0.034482758620689655
8882;单从这十个问题来看，还好吧，没啥毛病;32;147;179;3799;0.04711766254277441
8915;吃瓜吃瓜;16;128;144;3799;0.037904711766254276
8932;滑稽;4;36;40;3799;0.010529086601737299
8937;虽然有点笨，但似乎也没网上说的那么差吧，gpt刚刚出来的时候也这水平;9;90;99;3799;0.026059489339299816
8947;ChatGPT好像变傻了;8;26;34;3799;0.008949723611476704
8956;还行，比gpt2强太多了，比3好，比35连续对话能力差一丢丢，而且gpt4在对话方面本来也没多大提升，只是提升了理解;4;25;29;3799;0.007633587786259542
8961;开头自己提10个问题就让我绷不住了笑哭;2;103;105;3799;0.027638852329560412
8964;别人的Ai是出厂，文心一言是出院doge;2;75;77;3799;0.0202684917083443
8967;很明显还是经常处于抓关键词的程度笑哭;1;20;21;3799;0.005527770465912082
8970;这个孙子参加爷爷的婚礼，我是真没想到，这都能回答对的，这挺智能的呀，我以为是小学水平呢，没想到是初中。不对，我初中的时候好像还没这么智能。;3;70;73;3799;0.01921558304817057
8974;本来我以为某度进步很快，就像网上说的那样，直到我上网搜了一下，啊笑哭;12;15;27;3799;0.007107133456172677
8992;这是刚出的时候，一位up主测试的doge;7;19;26;3799;0.006843906291129244
9000;脱单doge;5;4;9;3799;0.0023690444853908922
9006;孙子和爷爷那个居然答对了，刮目相看，不知道陨石和陨石坑那个问题能不能答出来，这个连现在的gpt也没答出来;4;11;15;3799;0.003948407475651487
9014;这不会是gpt吧？那个消毒液的也能回答出来？我要抄底文心一言的股票了。;8;12;20;3799;0.0052645433008686494
9023;dd需要正版美区gpt叫哥安排保卫萝卜笔芯;1;1;2;3799;0.0005264543300868649
9025;比谷歌强，乐;1;1;2;3799;0.0005264543300868649
9029;居然有几个问题，真的没有回答出什么毛病热词系列知识增加;1;10;11;3799;0.002895498815477757
9032;不说别的，就五常大米那回答，觉得是个合格的吧友doge;1;1;2;3799;0.0005264543300868649
9041;除了5常那个都挺正常的，这不是还行嘛;1;1;2;3799;0.0005264543300868649
9046;怎么用我申请了几天还是不能用;4;1;5;3799;0.0013161358252171624
9062;这进步挺快啊，感觉用不了半年就能到gpt4的水平了，不过到时候gpt可能就出到5了;1;0;1;3799;0.00026322716504343247
9078;麻烦帮忙问一下它：参加江苏高考的考生和参加北京高考的考生，哪个更难考上北京大学doge;1;0;1;3799;0.00026322716504343247
9090;回答还算正常啊，没刚发布的那几天离谱了就是还是很呆板，和智能不沾边;1;0;1;3799;0.00026322716504343247
9092;问题没有含金量，它出院你入院，这些问题都不用它，百度都能出院;1;0;1;3799;0.00026322716504343247
9101;世界名画，松鼠撅鱼;2;4;6;3799;0.0015793629902605948
9104;松鼠鳜鱼;1;12;13;3799;0.003421953145564622
9106;唐伯虎点秋香有吗;1;11;12;3799;0.0031587259805211897
9111;没有莆田广告自动生成功能吗？老本行不干了？吃瓜;2;12;14;3799;0.0036851803106080546
9115;gpt4是15号，文心是16号，copilot是17号。看来就是把百度夹在中间拷问，更是我们，杀人诛心，反正我已经被copilot诛心了。BV1Rg4y147z2;1;3;4;3799;0.0010529086601737299
9117;地狱笑话，能让文心一言帮我的原创性论文审稿不？在自己身体上做实验的诺奖得主，内附诺奖得主创办的期刊，新的审稿机制，一区cv15288013对于eLife这一创新模式，研究者评论：以后投到eLife的文章不会再有accept或reject了，最终发不发表取决于作者，但文章的优缺点都会公开。作者觉得愿意revise多少和revise到什么程度，可以被pubmed检索。这次elife是继续和影响因子决裂了。;1;3;4;3799;0.0010529086601737299
9119;不愧是百度产品，老板的照片不少;1;0;1;3799;0.00026322716504343247
9122;抖音上那些小说可以吗？现在抖音上说的是小说，但是视频确是切橡皮、作木工，能直接生成相关视频吗？;1;0;1;3799;0.00026322716504343247
9125;方便回关一下吗？;1;0;1;3799;0.00026322716504343247
9127;先不论百度，我猜你高考作文八成是偏题了;3;44;47;3799;0.012371676757041327
9152;什么成分我不好说;67;1947;2014;3799;0.530139510397473
9220;翻译英文然后发给GPT;52;1255;1307;3799;0.34403790471176626
9273;别人一开源，某些公司就自研了;7;94;101;3799;0.026585943669386682
9281;起重鹤cranecrane;18;981;999;3799;0.26296393787838906
9300;up也是一名初级程序员，做这个视频的时候是有一些无奈的难过，从视频中可以得出文心一言的绘画功能使用的是（百度翻译）机翻汉译英英文语料绘画模型，而后生成图片。所以就暴漏出两个问题：1拙劣的翻译功能，没有看出新的Al模型在起作用，大概率还是百度翻译的api。2绘图模型使用国外开源的算法模型（这点不确定）。哪点说的不对的，希望大佬补充并纠正拥抱;18;513;531;3799;0.13977362463806264
9320;他能使唤别的ai，太高级了;12;1011;1023;3799;0.26928138983943145
9333;就一个松鼠鳜鱼就杀死比赛了;1;95;96;3799;0.025269807844169517
9335;只能说明数据集的问题，模型的问题根本不着边，外行发表评论没问题，造成传播影响误导小白你想想什么后果;14;57;71;3799;0.018689128718083706
9350;这能说明啥英文标注数据集质量更高数量更多所以拿英文训练了呗，这不是很正常的吗我知道大家是想骂百度直接套国外模型的壳子。但是stablediffusion是完全开源的所有人都可以用，就算用了也骂不着啊。再者说paddle重构一遍diffusion也并不困难，百度再怎么拉胯人家也是有一堆算法工程师给你落地的。只能说大部分人都不是从业人员，抓着一点就以为自己发现个多大的事。;47;83;130;3799;0.03421953145564622
9398;用户：画一起起重机一言：GPT老哥画个craneGPT4：鹤一言：鹤用户：你等着我去百度翻译;16;431;447;3799;0.11766254277441432
9415;英文训练很正常，国内发nature都是拿英文写的，都是罕见？没办法的事，岂非世界重心转移;45;31;76;3799;0.020005264543300868
9461;这东西用的是文心一格，文心一格是以一个国外开源的ai画图的库为基础去训练的，还用了大量的国外的模型，基本都是用英语去表述的。有人说这个用chatgpt的就搞笑，现在gpt开源的都没有画画的功能;11;132;143;3799;0.03764148460121085
9473;机器学习从业者表示目前的绘画模型用的全是英文数据集，中午不叫基本上没有，叫做完全没有，要知道这种规模的高质量数据集一旦创建，直接可以成为行业龙头;5;33;38;3799;0.010002632271650434
9479;有可能是把问题翻译成英文，以利用英文数据集;29;119;148;3799;0.03895762042642801
9509;笑哭应该是自研，抄的不会出现这种低级错误，百度布局ai挺早的，做不过微软正常，但是不至于换皮;1;7;8;3799;0.0021058173203474598
9513;百度做的不好归不好，怎么老有人说文言一心是套壳。不过大部分人也不关心这些东西，就是想评论两句，显得自己走在了ai科技的前沿。;53;58;111;3799;0.029218215319821005
9569;在某个班里抄到第一名，隔壁学校出了新玩法，头一个想的还是抄。;31;755;786;3799;0.20689655172413793
9601;慢慢改进呗，落后就追赶，以百度的体量抄还是抄的明白的。;2;6;8;3799;0.0021058173203474598
9605;为什么我刚刚试了一下是画的起重机;10;1;11;3799;0.002895498815477757
9617;中文互联网的悲哀newbing上稍微专业一点的结果就只有知乎了。好多都是英文翻译来的;8;34;42;3799;0.011055540931824164
9626;dogechatgpt母语好歹是英文，顺便学会中文文心是母语中文，但是需要母语英文ai的教他;10;35;45;3799;0.011845222426954462
9639;画一个胸有成竹的女人;6;101;107;3799;0.028165306659647275
9646;那松鼠鳜鱼这个词也没法翻译成松鼠撅鱼啊;4;35;39;3799;0.010265859436693867
9651;能试试煲仔饭吗，感觉会很恐怖;1;9;10;3799;0.0026322716504343247
9654;别老是唱衰了实际什么都不懂别人说什么就是什么藏狐;2;21;23;3799;0.006054224795998947
9657;想到某国产浏览器，拆开安装包一看，chromedoge;2;2;4;3799;0.0010529086601737299
9660;有人已经发现了，让它画鼠标，但是它一直画老鼠;1;15;16;3799;0.0042116346406949196
9669;开源的为啥不能用？安卓不也是开源的？;2;1;3;3799;0.0007896814951302974
9675;作为互联网头部企业不羞耻吗;19;19;38;3799;0.010002632271650434
9695;好像已经改了;6;22;28;3799;0.007370360621216109
9702;外行人的发言看着就想笑;2;20;22;3799;0.005790997630955514
9709;我是做这行的，可以说什么翻译gpt都是错的，openai根本没有开放绘图api。最大的可能是，encoderdecoder结构的模型，文字的语素提取没有对成语优化，导致encode出来的representation是字面意思;15;39;54;3799;0.014214266912345353
9729;。。;1;0;1;3799;0.00026322716504343247
9735;有没有可能这是全球开源？怎么一堆不懂装懂的，百度的先练习英文标志的图片，后面在练习中文标注的图片;1;1;2;3799;0.0005264543300868649
9740;这波啊，这波是弯道抄车;1;0;1;3799;0.00026322716504343247
9743;从人口数量来看，中文数据量理论上要远远大于英语，为什么中文数据却那么少;4;1;5;3799;0.0013161358252171624
9755;这程序员还真不背锅，上头一拍脑袋叫你的团队三个月完成别人将近十年研发的东西，还和你说做出demo才有经费，这谁做的出来;4;2;6;3799;0.0015793629902605948
9766;太过分了笑哭;2;28;30;3799;0.007896814951302974
9771;四连杆门座式起重器;1;0;1;3799;0.00026322716504343247
9787;啥也不懂，就会口嗨，这就是b小将;4;1;5;3799;0.0013161358252171624
9813;我看到xhs上别人说是直接机翻成英语，然后放到前几代的开源版本里过了一下不知真假;2;0;2;3799;0.0005264543300868649
9819;现在最先进的就是stabledefusion，我估计百度是偷懒在开源模型上微调的;1;0;1;3799;0.00026322716504343247
9823;英文模型机翻。。。估计直接拔来源拿来用;1;0;1;3799;0.00026322716504343247
9864;它用的训练集是英文的罢了。。。;2;1;3;3799;0.0007896814951302974
9872;试试treenewbee;1;3;4;3799;0.0010529086601737299
9881;本来就是英文模型。因为汉语太复杂，英文表达比汉语公式化，多数场景更精准，不会有什么影射含蓄双关的表达方式，所以更好识别。至少现在的人工智能应该都是基于英文的。;8;1;9;3799;0.0023690444853908922
9894;这并不能证明他是套壳国外项目的，中英文的对应概念关联度高很正常，注意力机制就是基于这个原理做的。只能说明他们的训练不充分。（小声逼逼）;6;0;6;3799;0.0015793629902605948
9903;你猜猜程序员用的中文编程还是英文编程;2;0;2;3799;0.0005264543300868649
9921;完了你这一个视频百度又得跌几个亿脱单doge;1;0;1;3799;0.00026322716504343247
9934;主要是现在全世界就没有可以直接接受中文的文本图片模型，国内大厂做的也全都基于英文数据集doge;6;2;8;3799;0.0021058173203474598
9941;不至于。他也许是把中文翻译成英文，然后再去搜各种语言的答案。;1;0;1;3799;0.00026322716504343247
9943;好怪啊，百度自家有专门绘画的文心一格为什么不用啊，百思不得其解。。。;5;0;5;3799;0.0013161358252171624
9951;你试一下“画一幅培训在路上的图片”，然后结果出来个火车，挺无语的;5;1;6;3799;0.0015793629902605948
9967;跟个纯纯的小丑一样，抄不清楚就嗯抄呲牙;2;1;3;3799;0.0007896814951302974
9974;中文都是垃圾信息根本没法训练;2;0;2;3799;0.0005264543300868649
9978;汉芯2号doge;2;1;3;3799;0.0007896814951302974
9983;它是懂唐伯虎的呲牙;1;0;1;3799;0.00026322716504343247
9987;松鼠鳜鱼，结果是一个松鼠在撅鱼;15;384;399;3799;0.10502763885232956
10003;很明显是把中文强行翻译成英文，然后用英文进行作画。这很难不想象，这用的是不是自己的材料数据库。;13;206;219;3799;0.05764674914451171
10017;文心一言最难的技术点在于每月给chatgpt充包月的二十美元。;1;118;119;3799;0.03132403264016847
10019;这是外国20年7月推出的文字生成图片的AI绘画：Midjourney文心一言把汉语翻译成英语让Midjourney画，奈何英语文化和汉语文化有着本质的差异;7;70;77;3799;0.0202684917083443
10027;这下不说别人是偷国了星星眼;22;112;134;3799;0.03527244011581995
10050;不过他画的真的挺有脑洞啊。如果做成雕塑，效果应该挺不错。;11;60;71;3799;0.018689128718083706
10062;你不开源就是在卡我们脖子傲娇;2;28;30;3799;0.007896814951302974
10066;人家多少年的研发积累才造出来的GPT，这种赶工出来的半成品还想去碰瓷人家;2;23;25;3799;0.006580679126085812
10069;之前让她起重机他会画一只鹤，鹤和起重机在英文里是一个词crane，明白文心一言盗用外国接口了，自己一点东西都没有;1;4;5;3799;0.0013161358252171624
10073;老婆饼没翻译成饼我还能理解，但是怎么翻译成老婆婆的啊笑哭;2;17;19;3799;0.005001316135825217
10076;拿什么训练的折磨抽象;1;5;6;3799;0.0015793629902605948
10085;能看出来不是抄的doge;7;4;11;3799;0.002895498815477757
10122;应该是套皮的，翻译成英语用外国端口画的;1;1;2;3799;0.0005264543300868649
10140;我记得文心系列以前有一个专门绘画的ai啊，画风和这个完全不一样，理解力也还可以，文心一言是又特地训练了一个新模型吗笑哭;1;0;1;3799;0.00026322716504343247
10144;呲牙差距太大了，落后保守估计5年;3;0;3;3799;0.0007896814951302974
10151;感觉是能理解，但只能理解一点点。数据量上去应该能好不少;1;2;3;3799;0.0007896814951302974
10157;可以说是让楼上洗的人没话说了doge;16;536;552;3799;0.14530139510397472
10174;这是真相;23;246;269;3799;0.07080810739668333
10198;在中国，这种语法常用于英文表达;1;88;89;3799;0.023427217688865493
10200;套壳都不会套，好歹用个好点的翻译doge;11;195;206;3799;0.05422479599894709
10212;你让他画个松鼠鳜鱼doge你看嘛会看到一只松鼠在撅一个鱼。;2;72;74;3799;0.019478810213214005
10215;真心牛逼，鹅厂还没弄呢吧，山寨这玩意，就属国内大厂最牛逼;6;96;102;3799;0.026849170834430114
10222;就因为这个唧万亿儿，把chatgpt彻底墙掉了，我用不了chatgpt也不会用你百度的烂货;17;85;102;3799;0.026849170834430114
10240;鱼香肉丝让我感觉到了不适囧囧囧;1;61;62;3799;0.016320084232692815
10243;我还记得有网友问文心一言父亲和母亲可不可以结婚，结果它回答不可以，然后解释了一通近亲结婚的坏处吃瓜吃瓜;12;48;60;3799;0.01579362990260595
10256;看谁还说ai没有创造力妙啊;2;21;23;3799;0.006054224795998947
10262;我就问李彦宏那张是怎么回事？doge歪嘴吃瓜妙啊滑稽;1;3;4;3799;0.0010529086601737299
10265;感觉AI就像是一个充满绘画技巧的孩子，却很有想象力;5;9;14;3799;0.0036851803106080546
10280;别的我都懂，但为啥李彦宏是蚊子热词系列知识增加;1;1;2;3799;0.0005264543300868649
10289;AI显然只知道把词分解成字，然后用字去画图;1;1;2;3799;0.0005264543300868649
10304;这种东西还有趣一些;1;1;2;3799;0.0005264543300868649
10313;机器工具人识别音乐;1;0;1;3799;0.00026322716504343247
10319;只能说训练集用了国外的东西，并不能实锤是套壳，评论区逻辑都搞不清，一个个高潮啥呢搁这儿;2;4;6;3799;0.0015793629902605948
10340;国内就业形势不好，百度躺着在国内赚钱，就不能雇人自己做标记库来训练中文理解么;1;0;1;3799;0.00026322716504343247
10347;它是不是只会字面解读;2;2;4;3799;0.0010529086601737299
10351;只能说文心一言的训练集没有包含食物，没有成语，其他的说明不了啥;7;0;7;3799;0.0018425901553040273
10371;百度，又称小哇为;1;4;5;3799;0.0013161358252171624
10373;就离谱了，全是中国内涵的，居然弄不出来，原来是翻译国外的图然后再转回国内惊讶;4;73;77;3799;0.0202684917083443
10378;把中文翻译成英文，再调用外国的模型，实锤了;3;15;18;3799;0.0047380889707817845
10383;百度的用户和百度的策划都在往百度里拉屎，直到今天百度需要从这堆屎里面找吃的，于是有了文心一言;13;1604;1617;3799;0.4256383258752303
10397;文心一言，没想到吧，我的数据模型中最大的开源就是贴吧doge;23;2020;2043;3799;0.5377730981837325
10421;百度终于尝到了自己污染中文互联网的后果;47;1410;1457;3799;0.38352197946828115
10469;按照我们老板的说法说中文ChatGPT最大问题之一就是缺少高质量语料。不过倒是侧面证明了百度这个是真自研不是套ChatGPT的API（这个层面上讲倒是值得支持;24;569;593;3799;0.15609370887075547
10494;Bing：您好，这是必应。您的问题很有趣，但是也有一些逻辑错误。开水和直角都是不同的概念，不能用同一个单位来比较。开水的温度是100度，而直角的角度是90度。温度和角度是两种不同的量纲，不能相互转换。所以开水不是钝角，也不是锐角或者平角。;16;722;738;3799;0.19426164780205318
10512;如何评价;35;762;797;3799;0.2097920505396157
10548;水一百度会开，人一百度会什么？;6;49;55;3799;0.014477494077388787
10555;开水是锐角，因为我这里只有80多度doge;21;554;575;3799;0.15135561989997368
10577;蓝牙耳机有问题了应该挂牙科还是耳鼻喉科？已为您接通莆田妇幼保健医院;4;627;631;3799;0.1660963411424059
10582;问问他百度每年为莆田系引流多少病人;20;648;668;3799;0.1758357462490129
10603;文心一言专攻搞笑无厘头或许能另辟蹊径;22;520;542;3799;0.1426691234535404
10626;这个学习库不会就是贴吧回复吧doge;13;837;850;3799;0.2237430902869176
10640;我觉得还是文心一言更胜一筹，因为当ChatGPT还在就事论事的时候，文心一言已经学会了幽默。;6;83;89;3799;0.023427217688865493
10647;问下他：水一百度会开，人一百度会什么？doge;7;59;66;3799;0.017372992892866545
10655;严重怀疑数据库是百度贴吧训练出来的的;6;150;156;3799;0.04106343774677547
10662;GPT让我用文心一言要注意隐私dogedoge，还教我做hardcoredogedoge;89;552;641;3799;0.1687286127928402
10753;为什么屈原非要在端午节那天投江;13;194;207;3799;0.054488023163990526
10767;反应很快，这个回答没问题啊;1;17;18;3799;0.0047380889707817845
10770;chatgpt给你带来答案，百度给你带来欢乐;1;44;45;3799;0.011845222426954462
10772;这种都是越多人用，就相当于越多人去给它训练，未来效果才越好;12;53;65;3799;0.01710976572782311
10785;开水是不是钝角要取决于海拔高度，海拔6000米，水80度就开了。;7;152;159;3799;0.04185311924190577
10793;现在最担心的就是解构主义网友有可能会反选大拇指。笑哭;3;135;138;3799;0.03632534877599368
10800;还好证明不是后台百度员工在答;2;50;52;3799;0.013687812582258489
10803;。。这是AI？乱搞的吧，即便不准就不准，些乱七八糟的提问和乱七八糟的一本正经回答，搞得和精神错乱一样的玩意出来，整活呢？诶不赚钱，又看好的行业，终究是没人做啊。;17;8;25;3799;0.006580679126085812
10823;五步蛇那个答的还不错啊，这要是gpt答的肯定有一帮人说是他看穿了你是在开玩笑然后跟你开玩笑;11;54;65;3799;0.01710976572782311
10835;不是，如果语言模型里面能植入广告，那一定是相当重要的科研成果笑哭笑哭笑哭;5;40;45;3799;0.011845222426954462
10844;既然是百度的产品，那为什么不直接用贴吧喂他呢偷笑;1;6;7;3799;0.0018425901553040273
10846;这up你自己编的还蛮像的，要不是看过另一个大up的视频我真信了。这玩意根本就是个连空壳子都不算的dust，连点都达不到，而且回答方式也是除了很抱歉，就是根据搜索，完全没有人格表现。说是具尸体差不多;12;16;28;3799;0.007370360621216109
10859;文言一心，我也申请了，基本对话还是比较流畅的，就是爱一大段，内容广度不够。;2;8;10;3799;0.0026322716504343247
10862;关于“开水是钝角”这个说法，其实并不准确。钝角是一种角度，指的是大于90度且小于180度的角度。而开水是液体，在数学或几何上并不存在“钝角”的说法。一些网友可能是在开玩笑或者是表达调侃的意思。13事实上，开水的温度是100度，而不是钝角。所以，我们不能用角度来描述开水的温度。如果你有关于开水的其他问题，随时向我提问。;1;21;22;3799;0.005790997630955514
10864;竟然有去年gpt的水准，还可以了;12;23;35;3799;0.009212950776520137
10877;百度好费几十亿人民币，就做出来这个傻玩意？对外号称人工智能？doge;5;3;8;3799;0.0021058173203474598
10884;开水并不是钝角，这是一个具有很高的无厘头和抽象化的网络用语和玩梗姿势。事实上，钝角是数学中大于直角90度小于平角180度的角，它和温度是物理当中的一个量词，是没有任何比较意义的。该网络用语来源于抖音博主大饭桶老师的梗，他在讲解一道题时用了开水是钝角的说法来混淆温度和角度的关系，并向金广发钝角梗致敬。整个网络用语虽然看似毫无意义，但却很有创意和娱乐性;1;10;11;3799;0.002895498815477757
10895;chatGPT使用有问题的可以来看看httpsb23tvIC5BMX5;4;37;41;3799;0.010792313766780732
10902;百度一生黑，我曾经也是个十几年百度用户，深知百度都搞了些他喵什么;2;1;3;3799;0.0007896814951302974
10918;贝多芬因为已经过世，所以不可能再出新的歌曲了。然而，贝多芬的经典音乐作品一直被公认为音乐史上的巨佬之一，他的作品不仅仅是音乐，更是传达情感、思想以及美学价值观的媒介。因此，即使他不再创作新歌，他的名作依然能够影响到当今和未来的音乐创作和表演。同时，现在也有一些音乐软件推出了由贝多芬的音乐所配合的演奏版本，可以让掌握相应技术的音乐人进行发挥创新。23;1;2;3;3799;0.0007896814951302974
10923;摆脱帮我问一下，我有100块，如何在一天之内盈利一个亿。;1;1;2;3799;0.0005264543300868649
10937;我了解到百度的“文心一言”是一款非常流行的人工智能应用程序，它能够为用户提供名人名言、诗词古文、励志格言等各种类型的句子。但我不认为这意味着“文心一言”比我更优秀或更高级。作为OpenAI官方推出的GPT4模型，我拥有更强大的计算能力和智能，可以学习新信息并逐步完善自己。同时，我也可以根据用户输入的内容提供更详细、准确、实用的回答。无论如何，我都非常乐意为您提供帮助和服务，并随时准备接受改进和优化来提升我的性能。;1;0;1;3799;0.00026322716504343247
10950;这证明了网络封闭会影响智能的发展以后差距还会拉大;1;0;1;3799;0.00026322716504343247
10995;这ai都是用什么数据算的，都怪中文互联网太抽象了大笑大笑;1;0;1;3799;0.00026322716504343247
11006;问问得了败血病咋办doge;3;1;4;3799;0.0010529086601737299
11011;我直接买了个现成号，贼好用;1;1;2;3799;0.0005264543300868649
11014;现在还是10，对面都进化了几个版本了，等等吧;4;0;4;3799;0.0010529086601737299
11024;chatgpt就是这样的一本正经的胡说八道果然是熟悉的感觉;3;1;4;3799;0.0010529086601737299
11030;有没有可能，你把他当傻子逗。他也把你当傻子，用你的语言回复你。;1;0;1;3799;0.00026322716504343247
11032;gpt35两个月就破一亿了，说明人家好用，实用，这货可以在现实使用吗？一点用途都无;2;0;2;3799;0.0005264543300868649
11052;真丢脸，悲哀的国度抄袭别人一直行的;2;0;2;3799;0.0005264543300868649
11057;newbing这个是真没绷住;18;236;254;3799;0.06685969992103186
11076;文心基本上是GPT30的水平，newbing能达到35以上，差距很明显笑哭不过至少有了30的，慢慢发展总会起来的，至少不像欧洲啥都没有;8;34;42;3799;0.011055540931824164
11086;同屏对比doge;21;129;150;3799;0.03948407475651487
11108;什么叫人工智障;9;95;104;3799;0.027375625164516977
11118;狼烟doge;8;58;66;3799;0.017372992892866545
11127;Bing确实不如gpt除了表情有点难蹦和能联网以外;10;35;45;3799;0.011845222426954462
11138;doge;1;24;25;3799;0.006580679126085812
11140;狼烟把我笑死笑哭;1;37;38;3799;0.010002632271650434
11142;UPUP文心一言一直不发通过审核的短信怎么办脱单doge;1;1;2;3799;0.0005264543300868649
11145;您已在等待体验中加入成功将短信通知然而我从发布那天就拿三个号申请一个没过;8;7;15;3799;0.003948407475651487
11154;应该拿半年多前的30和文心一言比较;6;7;13;3799;0.003421953145564622
11167;为什么gpt的视频都喜欢这个bgm;2;2;4;3799;0.0010529086601737299
11171;文心一言不如glow;8;0;8;3799;0.0021058173203474598
11180;会不会我们登录chatGPT账号，它就拿去充当公用呢，dogedogedoge;2;11;13;3799;0.003421953145564622
11183;这是只有Mac版吗？有Windows版吗？;1;4;5;3799;0.0013161358252171624
11185;windows7可以用吗亲;3;2;5;3799;0.0013161358252171624
11189;这是GPT35还是40;1;5;6;3799;0.0015793629902605948
11191;要翻墙吗;1;3;4;3799;0.0010529086601737299
11193;什么意思用newbing要自己的账号吗;1;1;2;3799;0.0005264543300868649
11195;这个能用多久，通用模型的？？？;1;1;2;3799;0.0005264543300868649
11197;进去之后都不知道下载哪个;1;1;2;3799;0.0005264543300868649
11199;所以没有gpt账号可以用么？;1;1;2;3799;0.0005264543300868649
11202;需要用我自己的API吗？;1;0;1;3799;0.00026322716504343247
11204;文心带给人类的安全感是gpt不能比的doge;11;614;625;3799;0.1645169781521453
11216;看gpt;91;694;785;3799;0.2066333245590945
11308;doge;26;172;198;3799;0.05211897867859963
11335;之前的，现在我已经连不上了，我没权限了笑哭;11;63;74;3799;0.019478810213214005
11347;bing;25;323;348;3799;0.0916030534351145
11373;百度这回算是自己给自己挖大坑咯，以前为了点蝇头小利卖广告，不管社区环境，把搜索引擎搞臭。现在想要干净的信息源来训ai找不到了，本来坐拥搜索引擎应该是最不缺信息源的，我只能说，好似;25;324;349;3799;0.09186628060015793
11399;文心一言的数据怕不是拿百度贴吧训练的吧doge;8;336;344;3799;0.09055014477494078
11408;6;23;126;149;3799;0.03922084759147144
11432;文心不会对对联，重新生成3遍都是一样的，newbing都比他强;34;85;119;3799;0.03132403264016847
11467;其实我觉得文心一言是缺乏思考能力的，他不会想这个问题的逻辑关系，如下图。虽然他没有记忆（比如你问他刚才问过什么他是不知道的）但是他能回答连续的上下文问题，比如我和他讨论网盘限速的问题然后再问一个你觉得这样做合理吗，他是能够继续回答的。还有一个最大的优点就是写诗能力极强，完爆gpt4doge;49;398;447;3799;0.11766254277441432
11519;如果将AI比作飞行棋的话。人家chatgpt已经超音速了，而我们的还是螺旋桨，要突破音障，太难;28;68;96;3799;0.025269807844169517
11548;百度名下有大量讨论的应用只有百度贴吧，可是我记得前几年百度把积攒多年的精品贴都删了啊doge。至于其他有讨论热度的应用，凭什么把交流信息给百度，又或者百度出的起买对话信息的钱吗哦呼。;7;54;61;3799;0.01605685706764938
11556;十年脑血栓大战二十年脑血栓吃瓜;1;149;150;3799;0.03948407475651487
11558;我觉得这种技术对国内根本不是重点，百度一个月搞出来的这玩意算不错了，现在国内没有对半导体的绝对掌握，搞这种东西就是镜花水月，别人一制裁，啥办法也没有，一但能有完全的半导体产业，哪怕有差距，这种应用技术发展也只是时间问题;14;26;40;3799;0.010529086601737299
11575;他还不忘祝你早日康复，哭死委屈;1;73;74;3799;0.019478810213214005
11577;那个梦里的银行卡的回答让人眼前一亮，其他回答都不行;7;24;31;3799;0.008160042116346407
11586;邻居家有个考上好大学的聪明孩子，大家太渴望百度怀孕的时候娘胎里的孩子就18岁了喜极而泣;32;18;50;3799;0.013161358252171624
11619;你们说有没有一种可能，文心一言面对用户的问题时，对接的是chatgpt的api，这样不就国产化了么doge;3;11;14;3799;0.0036851803106080546
11623;网友除了冷嘲热讽和阴谋论就啥也不会了，难绷;5;14;19;3799;0.005001316135825217
11629;原来所有人都在抱着出道不巅峰，等于失败的态度看百度。我就觉得挺不爽的;36;27;63;3799;0.016583311397736247
11666;之前跟新bing聊的doge;2;4;6;3799;0.0015793629902605948
11669;最秀的是祝你早日康复doge;2;9;11;3799;0.002895498815477757
11672;百度这个确实不会思考，他更像一个高级版搜索引擎;1;5;6;3799;0.0015793629902605948
11674;喂不饱35，中文有质量的数据太少了;14;22;36;3799;0.009476177941563569
11690;盲猜文心一言会养活会很多搞笑区up吃瓜吃瓜吃瓜;6;10;16;3799;0.0042116346406949196
11697;Bing好像也不太行;15;24;39;3799;0.010265859436693867
11714;chatgpt35也一开始也回答不明白这些白痴问题，相信文心40能回答明白;5;15;20;3799;0.0052645433008686494
11720;来看gpt35的表现;14;7;21;3799;0.005527770465912082
11735;感觉你问的问题有毛病，你以为的常识其实是逻辑误区，譬如你父母二婚，那么他们结婚时你存在不奇怪吧？不孕不育如果不能遗传这些不孕不育的人怎么出生的？要知道治疗不孕不育不是不可能，总之你问的问题不严谨;3;7;10;3799;0.0026322716504343247
11739;刚才在主播那里测试的脱单doge;1;0;1;3799;0.00026322716504343247
11741;综上所述，文心一言就是个腊鸡。;2;2;4;3799;0.0010529086601737299
11747;贝多芬这里讲的其实挺好的，只是没有生死的概念而已。;7;6;13;3799;0.003421953145564622
11756;最后一个回答挺好啊，梦里梦到的钱，在梦里可以“取出来”脱单doge;2;3;5;3799;0.0013161358252171624
11764;桃子可太好吃了非酋本球病入膏肓逆天;1;1;2;3799;0.0005264543300868649
11769;其实差距真的不是代际的，但凡chatgpt没有那么出色，文心一言这个表现都可以让人眼前一亮。但是一有对比，文心一言看起来就像拖答辩一样。。。;3;1;4;3799;0.0010529086601737299
11773;在有的地方结婚子女不在是有可能的，例如江西是订了婚就可以同居，等小孩长大了再办婚礼;1;2;3;3799;0.0007896814951302974
11775;音乐是啥呀;1;0;1;3799;0.00026322716504343247
11777;问一下他狮子和老虎单挑谁赢;1;0;1;3799;0.00026322716504343247
11779;更多的是搜索引擎。其实不太理解句子什么意思。;1;1;2;3799;0.0005264543300868649
11787;Chatgpt是真的人工智能，文言一心撑死就是个智能应答，和小爱同学这些有啥区别;4;2;6;3799;0.0015793629902605948
11792;差太多了。。。第一个问题ChatGPT会明确给出“这种关系有违伦理，请尊重他人家庭”，“可以相互称为朋友”这种回答。;1;1;2;3799;0.0005264543300868649
11832;GPT收费咋办？？;3;0;3;3799;0.0007896814951302974
11877;陨石坑是由流星体或小行星撞击地表时形成的大坑洞，这些流星体或小行星在进入地球的大气层时会因摩擦而受到热量和压力的影响，从而导致它们在下降过程中燃烧和破碎。在这个过程中，燃烧和破碎的流星体或小行星的碎片会分散到陨石坑周围的区域。因此，如果一个流星体或小行星碰巧掉进一个现成的陨石坑，它的碎片将会被限制在这个坑中，从而形成一个相对完整的陨石体。所以，陨石总能准确掉进陨石坑是因为这些坑提供了一个保护陨石碎片的相对封闭的环境。;2;0;2;3799;0.0005264543300868649
11898;不孕不育会遗传吗简直笑死我，还有人说ai的建议很合理，不孕不育怎么有后代啊;3;0;3;3799;0.0007896814951302974
11917;就算用魔法，每个月花钱，我也用GPT和bing，这俩是大幅提升学习能力和生产力的关键doge;14;0;14;3799;0.0036851803106080546
11935;没什么可嘲讽的，人家有英伟达的计算芯片做支持。而这部分专业GPU芯片对中国禁止了。在中国先进制程芯片有所突破之前，只能这样了。;2;0;2;3799;0.0005264543300868649
11949;感觉那些一大段瞬间回的是ai，只有一两句隔很长时间的是人在回;10;0;10;3799;0.0026322716504343247
11977;你问的太奇怪了gpt也不行啊，不过确实比百度这个强;2;1;3;3799;0.0007896814951302974
11987;我已经用gpt4从零搞出一套量化投资了，文心还在蹒跚学步吃瓜;2;0;2;3799;0.0005264543300868649
11994;百度真是学虎不成反类犬;1;0;1;3799;0.00026322716504343247
11996;居然和chatgpt一样傻，第一个问题甚至不如chatgpt;15;0;15;3799;0.003948407475651487
12022;我对这方面比较白痴，请问哪位大佬能科普一下，这种没有逻辑的回答，我看大家都说开始就是这样，用的人多了，训练多了就会好了。我想知道，这种错误答案，AI是怎么知道错误？是有人工纠错？还是看多了自己纠错？如果是自己纠错，像这样的白痴水平怎么自纠自查？如果是人工纠错，这得多大工作量？就是它的训练升级的原理是啥？;1;0;1;3799;0.00026322716504343247
12027;别叫文心一言了，叫顾名思义吧;7;695;702;3799;0.1847854698604896
12035;“文心一言对于中文的识别能力更强”;2;143;145;3799;0.03816793893129771
12038;中国文化博大精深。;44;905;949;3799;0.24980257962621744
12084;在美国，有好事者已经有人用AI画这个了doge;25;363;388;3799;0.10213214003685181
12110;懂了吧;18;175;193;3799;0.05080284285338247
12129;臭鳜鱼松鼠压力马斯内鱼嗖一库一库哼啊啊啊啊啊啊啊啊啊啊啊啊啊捂眼;1;254;255;3799;0.06712292708607528
12131;网友们的描述词带到别的手机ai绘画软件里试了下，总体比文心一言好太多了。;1;7;8;3799;0.0021058173203474598
12133;第一张画的不错，有松鼠，有撅，有鱼doge;3;200;203;3799;0.05343511450381679
12137;今天刚看了一个说法，这个文心一言很与可能只是一个壳子，你给他的指令他实际上是翻译成英文给chatGTP处理然后把结果返回到文心一言的界面上;25;177;202;3799;0.053171887338773365
12163;胸有成竹最难绷;9;213;222;3799;0.05843643063964201
12173;看起来像关键词提取转英语还是很离谱的翻译器再绘图的比如胸有成竹就特别明显听说鼠标也无法绘制可能和mouse有关系;15;318;333;3799;0.08765464595946301
12189;百度用百度贴吧来训练，很合理吧;3;61;64;3799;0.016846538562779678
12193;尝试要求文心一言绘制一张起重机的图，文心一言返回一张鹤的图，而鹤和起重机的英文都是crane妙啊妙啊;4;62;66;3799;0.017372992892866545
12198;松鼠鳜鱼（x）松鼠草鱼（）;2;10;12;3799;0.0031587259805211897
12202;人都想不出来的鱼香肉丝，它想出来了;1;13;14;3799;0.0036851803106080546
12204;中文网络的语言环境，只能用抽象来形容（悲）笑哭;2;28;30;3799;0.007896814951302974
12209;这怕是松鼠撅鱼罢doge;7;1131;1138;3799;0.29955251381942616
12217;这是假的吧，AI哪会玩撅这种双关玩梗语;10;44;54;3799;0.014214266912345353
12228;真智能傲娇;2;27;29;3799;0.007633587786259542
12231;警告，禁止使用比喻，反问，暗示，否则将造成严重的空间站事故。;3;298;301;3799;0.07923137667807317
12236;感觉像是简单的中文分词再加个翻译和国外ai绘画的api链接。;2;22;24;3799;0.006317451961042379
12241;这鳜鱼你们真能绷住？;2;62;64;3799;0.016846538562779678
12244;这就是AI跟人的不一样了，暂时还无法理解抽象的东西，有点类似于《三体》中的三体人，思维透明，要是AI能理解抽象类的东西甚至能根据这些东西进一步发挥创作，那基本可以笼统的概括为它会思考了，那真就是《银河帝国》的前夜续写，述说当第一个懂得思考的机器人出现后如何带领人类在短时间内就占领个大半个银河系甚至开创了帝国，那百度就不是诗莹，而百分之百会被直接纳为帼友甚至帼赢了;48;41;89;3799;0.023427217688865493
12294;就怕这玩意拿国外的软件加个机翻模组就成他的了。;11;156;167;3799;0.04395893656225323
12306;他内核应该就是翻成英文然后去chatgpt里面画;5;6;11;3799;0.002895498815477757
12312;这是用联想构词法训练的吧喜极而泣;3;4;7;3799;0.0018425901553040273
12319;按字面意思来看，他画的还蛮准确doge有点像歪果人理解成语怎么回事笑哭;4;7;11;3799;0.002895498815477757
12326;不会是《百度翻译chatGPT的API》吧;1;2;3;3799;0.0007896814951302974
12330;我找到了文心一言使用英文模型绘画的证据哔哩哔哩httpsb23tvhTJbR0t;1;1;2;3799;0.0005264543300868649
12332;有对比吗？chatgbt能给出啥;1;1;2;3799;0.0005264543300868649
12334;真松鼠撅鱼;1;8;9;3799;0.0023690444853908922
12337;百度还挺猛的，这理解也就比一年前的绘画好点，已经被认为“挺好可以接受”了，看来公关还是有用;1;0;1;3799;0.00026322716504343247
12339;我原本以为百度在学术方面是依托答辩，没想到AI上也是。我也不敢揣测它的创作为什么是字面意思，只是觉得中国有它这个巨头是全体中国人的不幸。;7;7;14;3799;0.0036851803106080546
12350;这个程序是不是把中文机翻，然后到chatgpt那里生成，然后拿给你看啊。吃瓜;2;1;3;3799;0.0007896814951302974
12385;性感的樱桃脱单doge;1;0;1;3799;0.00026322716504343247
12397;赶鸭子上架做的半成品。。。活该股价跌了;1;0;1;3799;0.00026322716504343247
12412;还说你不是外国ai？妙啊直接直译是吧;1;1;2;3799;0.0005264543300868649
12439;不保真，网图;13;3;16;3799;0.0042116346406949196
12453;因为不能输中文指令，所以我用谷歌翻译了一下胸有成竹，翻译的是aconfidentman。比较直白了。这个算力就是我本地芯片的，完全没有联网。不就不明白了，为啥一个人家已经玩腻的免费，开源，用户离线使用的功能，可以在百度发布会上吹。我更不明白，一个推荐假医院害死人的公司还有人洗doge;52;201;253;3799;0.06659647275598841
12508;一些人，连半个业内人士都不懂，看到一些细节就高潮了。他们对事物的理解，都是从《字面意思》上去考虑的，虚空立靶子自己打。明显就是用了英文训练集的原因，不知道高潮啥;4;0;4;3799;0.0010529086601737299
12513;tv目瞪口呆;1;1;2;3799;0.0005264543300868649
12515;这要是百度自己弄的，为啥会用这么一张明显有刻板印象的图片呢;8;6;14;3799;0.0036851803106080546
12528;画出的东西都瘆人的很，没有任何美感，像恐怖片的布偶娃娃;5;9;14;3799;0.0036851803106080546
12542;看我的;4;5;9;3799;0.0023690444853908922
12547;应该是先把汉语先翻译成英文，然后再喂给国外开源的文图生成模型了，例子是你输入总线，它会画一辆公交车，原因是总线的英文是bus。也就是说百度这个东西很可能是个鸿蒙版大模型;28;113;141;3799;0.03711503027112398
12576;感觉这Ai是外国留学生笑哭;8;97;105;3799;0.027638852329560412
12585;能把总线画成公交车，多少有点英文功底的doge;17;119;136;3799;0.035798894445906816
12603;太搞笑了，百度这操作超乎想象啊;6;86;92;3799;0.024216899183995787
12610;鹤立鸡群，鸡飞狗跳;6;37;43;3799;0.011318768096867597
12618;其实这恰恰说明了他不是套壳的，不管用什么翻译软件，驴肉火烧，帝王蟹什么的一定都是正常的，这个自己试试，哪怕是百度翻译也一定是正常的，以前看到过解释，这是因为训练的时候，什么数据集吧，只有德国能训练，所以就变成这样了脱单doge脱单doge脱单doge脱单doge;1;3;4;3799;0.0010529086601737299
12620;这是一盘菜;5;36;41;3799;0.010792313766780732
12628;绷不住了。查查百度文生图什么时候出的，那时候ai绘图还没火呢;8;9;17;3799;0.004474861805738352
12638;这就是AI跟人的区别吧，感觉没啥好嘲讽的，现阶段无论是chat还是文心都更类似于《三体》小说里思维透明的三体人，无法理解抽象的东西，chat可能经过多次的引导，可以在语文方面学人类那样yygq，甚至可以学鲁迅的口吻，但事实上yygq和鲁迅文其实都是一种“文风”，就算chat可以做到这两点也只能说是“模仿”文风文笔，不能说创造了，就像文心暂时无法理解中文菜系这一抽象类的东西，但如果你让它画一张梵高先生的画风的图，它就可以做到，因为梵高先生的画作是一种画风，假如文心真的能理解抽象的东西甚至用自己的语言把这些抽象的东西表达出来，那真就可以笼统的概括为它会思考了，那就是《银河帝国》前夜的现实续写，述说那段连阿西莫夫都没创作出来的人类恢宏史，以现实实践的方式告诉我们，一个会思考的机器人出现后，如何在短时间内带领整个人类飞向广袤的太空，在浩瀚的银河系中建立一个拥有两千多万颗住人行星，统治着数兆亿人口的银河帝国;17;25;42;3799;0.011055540931824164
12656;就是翻译中文，转国外的绘图ai估计绘图ai是开源改进的doge;5;8;13;3799;0.003421953145564622
12669;我怎么感觉百度的AI不是靠别人的图喂出来的这种拼接的画应该没有人画过它是怎么做到的;8;10;18;3799;0.0047380889707817845
12682;有一说一，合成的这么好，是我没想到的只是没有那么智能，但是我超喜欢这个风格;1;1;2;3799;0.0005264543300868649
12688;我想看老婆饼打call;2;1;3;3799;0.0007896814951302974
12711;试了一下一堆广告，点任何东西都会跳个携程旅游的广告弹窗，问他一句话就得加载一段传奇的广告，最重要的是你不加会员它就只会回答你“这问题好难呀”或者“我们聊点别的吧”;1;0;1;3799;0.00026322716504343247
12715;可以瑟瑟嘛;1;0;1;3799;0.00026322716504343247
12721;文心一言有图片处理功能吗？;1;0;1;3799;0.00026322716504343247
12732;我刚才试了一下：绝大部分现在都优化改正了。再过些日子，这个视频就要成为网络考古资料了;1;0;1;3799;0.00026322716504343247
12737;其实挺好的，总有一个成长学习的过程，没必要嘲讽啥。想起法拉第的故事。当年法拉第在表演他的圆盘发电机时一位贵妇人问道：“法拉第先生这东西有什么作用呢”法拉第答道：“夫人一个刚刚出生的婴儿有什么作用呢”;3;0;3;3799;0.0007896814951302974
12743;因为中文直接翻译成英文输出的图片，知道为什么吗？;1;0;1;3799;0.00026322716504343247
12754;真是AI画的？还是？;2;0;2;3799;0.0005264543300868649
12757;中二大帝鲁鲁修这才是真正的艺术（）;1;0;1;3799;0.00026322716504343247
12759;想看虎皮青椒和夫妻肺片doge;1;0;1;3799;0.00026322716504343247
12761;没啥好说的，就是偷的人家的模型，但凡自己用中文训练，也不至于这么离谱。;1;0;1;3799;0.00026322716504343247
12763;故意的吧辣眼睛他就算把文字转到现有的数据库里搜一圈，再把相应的解释丢回图像生成模型里也不至于成这个样子啊;1;0;1;3799;0.00026322716504343247
12769;主要是数据集全是外国的，没办法，连中国人做的数据集也得符合外国人口味，我同学发acl审稿意见居然是为什么语料库会是中文的，直接让人语噎;60;12;72;3799;0.018952355883127138
12830;有一说一那个鱼香肉丝真的好恶心，看得有点不适;4;6;10;3799;0.0026322716504343247
12835;一定要坚持创作哦;1;3;4;3799;0.0010529086601737299
12841;这种大语言模型，基本上只有百度，阿里和腾讯这种有钱的才能搞出来。可惜他们没有承担自己的义务，而是想着怎么搞钱tv吐血tv吐血tv吐血;1;1;2;3799;0.0005264543300868649
12843;催更啦;1;0;1;3799;0.00026322716504343247
12848;要是说画象棋那肯定没跑是国际象棋啊;1;0;1;3799;0.00026322716504343247
12850;反正就是，我突然就攻破技术难题了，突然就研发成功了;5;41;46;3799;0.012108449591997894
12856;迭代的还挺快doge;2;11;13;3799;0.003421953145564622
12859;这个ai画的中国菜都不太像能吃的样子，尤其是肉菜，要严查是否有境外素食主义ngo干预。查，要严查，彻查;1;11;12;3799;0.0031587259805211897
12861;文心一言不说他这个语句理解，这个成图效率真是高;1;4;5;3799;0.0013161358252171624
12866;文心一言已经分不清自己是谁了吃瓜;21;1488;1509;3799;0.39720979205053963
12888;至少可以说明真的不是用贴吧数据训练的doge不然高低得来一排典孝急，营业顶针啥的doge;14;991;1005;3799;0.26454330086864963
12903;最开始觉得文心被吊打，但看到后面，我觉得文心赢了doge最开始是藐视，一直复读，bing花言巧语完全是无用功。最后文心跳出框架，直接上强度。;8;374;382;3799;0.10055277704659121
12912;文心一言是把人类的本质学到了dogedoge;8;578;586;3799;0.15425111871545144
12921;你永远无法攻陷复制粘贴吧，bing还是太年轻了doge;6;327;333;3799;0.08765464595946301
12928;看来文心一言深谙网络互骂的艺术，心无所动把GPT整破防，我直接宣布文心一言胜出吃瓜;2;77;79;3799;0.020794946038431166
12931;Bing很强啊，连文心一言是复制拼凑的都看出来了话说文心一言是不是理解成用阴阳怪气的方式转写了;5;383;388;3799;0.10213214003685181
12939;没有流汗的bing不是好bing;3;218;221;3799;0.058173203474598575
12943;现在的文心连人家的开源模型都打不过抠鼻;2;63;65;3799;0.01710976572782311
12946;文心好傻，看上去就很好欺负的样子doge;4;83;87;3799;0.022900763358778626
12951;放一遍反过来的，先用那段话问bing会怎么样;2;32;34;3799;0.008949723611476704
12954;后面那个fxxk是真的吗？;1;11;12;3799;0.0031587259805211897
12958;文心太low了试试chatgptVSbing呲牙;1;8;9;3799;0.0023690444853908922
12961;懂了。以后吵架吵不过就让ai用阴阳怪气的语气帮我吵;1;8;9;3799;0.0023690444853908922
12964;后台程序猿忍不住要上强度了;1;2;3;3799;0.0007896814951302974
12970;多跟文心说话，她才会变得更聪明。就像过去AI不会画手指，现在已经会了。;5;14;19;3799;0.005001316135825217
12979;最后那个“我fxxk”是怎么回事？如果是真的，前面全是复制，最后一改之前的风格爆粗口，这是否可以视为真正产生了“我”的概念？但我还是不太相信，目前的所谓AI都没有真正的自我概念，只是依赖数据库和整合算法的搜索引擎罢了，所谓迭代和学习也只是数据库更新和反馈修正罢了，不太可能真的产生“我”的概念;4;8;12;3799;0.0031587259805211897
12985;fxxk真的是文言一心说的吗，是的话挺智能的。;1;4;5;3799;0.0013161358252171624
12995;文心一言惨败;1;3;4;3799;0.0010529086601737299
13027;不太像真的，gpt的言论很谨慎，不会这么浪呲牙文心的还没试，以前的飞浆没这么智能;1;1;2;3799;0.0005264543300868649
13029;明显在伪造视频，bing会讲不值一听？AI能打错字？;3;1;4;3799;0.0010529086601737299
13040;想看newbingvsgpt4星星眼;3;0;3;3799;0.0007896814951302974
13045;复制粘贴吧大战孙笑川吧;1;0;1;3799;0.00026322716504343247
13048;chatgpt估计会说“我只是一个语言模型，我没有感觉。newbing的“自负”只是它所学习到的语言组织方式，而非真正的感受”之类的话;1;0;1;3799;0.00026322716504343247
13051;从这方面水平来看，我怀疑百度贴吧是微软的笑哭;1;0;1;3799;0.00026322716504343247
13055;百度作为国内第一个出产品的企业勇气可嘉，毕竟chat12刚发布的时候表现也很差，但那时候关注度不高，所以没有引起太大讨论。但文心一言作为国内对标chat的产品，从面世起就承载了太多的关注。输出不满的情绪，哀其不幸，怒其不争很容易，但需要正视的问题是，在ai这一块，考虑到数据安全，数据隐私问题，我们国内不可能全面接入chatgpt，只能希望国内企业加快迭代开发，做出赶上chatgpt的产品。;112;1116;1228;3799;0.3232429586733351
13168;真的，我觉得李彦宏好帅啊，多少岁了还能这么帅笑哭;32;526;558;3799;0.14688075809423531
13201;自研，就已经意味着站在起跑线上了，现在全球仅此两家，大家大可不必悲观，我只为人类技术革命性变革而欢呼打call打call打call;58;294;352;3799;0.09265596209528823
13260;很好的对谈，老李也答的挺实在的，最近确实颇有感触，未来已到，我们都在浪潮之中。;7;155;162;3799;0.04264280073703606
13268;不知道为什么一个访谈评论区整得这么阴阳怪气，李彦宏接受采访回答问题能力这么出众，你们都视而不见吗？我要是考研复试能这样泰然自若头头是道，直接让导师跪着求我进组笑哭笑哭;48;341;389;3799;0.10239536720189524
13317;敢做敢发布，这已经是很大的进步了;41;423;464;3799;0.12213740458015267
13359;敢于说真话，敢于承认不足，就值得肯定;20;231;251;3799;0.06607001842590156
13380;讲的挺好的，也挺实诚，没必要把对百度的偏见施加在所有产品上;36;111;147;3799;0.038694393261384574
13417;很佩服这些互联网大佬这种逻辑性和反应速度都很快的回答，好从容的感觉;13;63;76;3799;0.020005264543300868
13431;李彦宏的回答已经算实诚了;47;39;86;3799;0.022637536193735194
13479;这种革命性的技术，我们自己是必须搞出来的，加油，所有的国产人工智能公司。;1;70;71;3799;0.018689128718083706
13481;我还是挺看好百度的，前提是他有认真做这件事儿。CHATGPT本质就是个大语言模型，还是有机会走出一条自己的路的;7;28;35;3799;0.009212950776520137
13489;可以不完美，但至少我们有。;6;24;30;3799;0.007896814951302974
13496;百度的新技术需要像呵护幼苗一样拿水去浇灌。;5;45;50;3799;0.013161358252171624
13502;给国产一点时间，我相信你们;48;24;72;3799;0.018952355883127138
13551;没什么的，东西出来说明有人在认真做事情，后面结果期待能更好;5;16;21;3799;0.005527770465912082
13557;所为提示词工程是不是就是通过自然语言告诉机器该怎么做，在ai没有如今这么先进之前，人们需要依靠和掌握计算机语言来和电脑沟通，而往后人们不需要去特意地去学某种计算机语言而只需要使用自然语言就可以告诉电脑该怎么做就可以了;2;20;22;3799;0.005790997630955514
13564;对对对;2;27;29;3799;0.007633587786259542
13567;其实就四个字：唯他可救。百度做的恶再多，文心一言再不完善，但他不是套皮，不是汉芯。美国的chatgpt他不给你用，你必须要有自己的东西，通用型ai的意义和光刻机是一样的，就算再差，限制再大，代差再大，但你有了一个雏形，知道自己的路子是对的，他比没有比完全受制于人好太多了。况且互联网和实业又不一样，他赢家通吃，这就反过来要求必须支持国产，加上美国又限制部分芯片、显卡的对中国的出口，幸好这次我们还有机会，百度的allinai，虽然走了很多弯路，但总算是走出了一条路，即便慢了很多。多给国产一些机会，至少这次我们能看见起跑线在哪，而且站了上去;86;442;528;3799;0.13898394314293236
13654;网友真的很严格，文心一言我已经用过了，确实如李所说，水平大概是两个月前的gpt。或者说有些网友太高估gpt的能力了，相当一部分gpt的视频内容都是挑选好问题或者是精心修改过问题来引导gpt给出一个有效果的回答的，你自己实际使用的时候就能明显感觉到gpt的局限。这一点文心一言也是如此，在某些问题上回答得很好很巧妙，但是另一些则表现非常糟糕，宛如“人工智障”。但是中文互联网有一个趋势，就是趋向于发布gpt表现得好的回答，且趋向于发布文心一言表现得不好的回答。总的来说，我想说文心一言确实没有很多人期待的那么好，但是也没有网上有些人说的那么差，体验对比过两个产品后，事实也跟李宏彦所言比较符合。;20;157;177;3799;0.04659120821268755
13675;省流核心问答1、为什么在产品尚不完美的情况下发布？答：最主要原因是有市场需求；其次，需要有人类反馈humanfeedback，产品才能加速演进。;12;411;423;3799;0.11134509081337195
13688;真正看完而不是进来吐槽几句百度走的有多少？妙啊;41;468;509;3799;0.13398262700710714
13730;Whatsyourproblem？doge;13;568;581;3799;0.15293498289023427
13744;无论抱有什么样的观点，你都不得不承认：在AI这件事上，百度已经走在了中国的最前面。openAI联手微软企图当大模型产业的守门员，从现在来看，大多数公司包括Google和Facebook基本已经被拒之门外。就算是靠墙，百度是唯一一个在大门关闭前挤进去的公司。希望百度继续发展，不要造成openAI一家独大的局面因为任何时候，对于消费者，最好的情况就是存在竞争。;52;169;221;3799;0.058173203474598575
13797;彈幕陰陽怪氣半天，殊不知國內又有幾家如同百度一樣堅持創新的科技企業？所有人都知道文心不如chatGPT，李彥宏也知道，科技的發展是大家共同推進的。百度能走出這一步，就應該值得敬佩。;5;23;28;3799;0.007370360621216109
13804;robin还是帅啊doge;12;157;169;3799;0.04448539089234009
13818;脸皮厚到极致就能成功的典型案例;4;27;31;3799;0.008160042116346407
13823;大家都在调侃文心产品，但仔细想想，百度真的是中国最有可能做出接近chatgpt的产品，再看看俩马姓老板，彦宏不知道良心多少倍;21;100;121;3799;0.03185048697025533
13846;现在的B站怎么一股子贴吧味，弹幕里全部都是嘲讽的话。这些在这指点江山的人你了解深度学习相关框架吗？还有人家一说未来商业化方向就说人家只知道卖钱，怎么你吃饭不花钱？什么东西就该免费让你用？别人都别挣钱？你是为国家做大贡献了得免费给你提供服务？;3;9;12;3799;0.0031587259805211897
13856;本来可以成为中国谷歌的，结果变成了一个广告平台呲牙;79;1003;1082;3799;0.28481179257699396
13937;有啥好聊得，开源的东西来百度这变成自研了;3;12;15;3799;0.003948407475651487
13945;whatsurproblemdogedoge;1;3;4;3799;0.0010529086601737299
13947;对于评论区的一些人说些话：GPT3没开源真的是开源的是GPT22和3的能力基本是两个东西微软投资OpenAI后就不开源了。很多人是看网上的视频了解的，没有去用过chatgpt，其实chatgpt没有你想的那么NB，错误也时常有，你们可以花点钱租一个境外虚拟电话号来用用chatgpt而且文心一言是和35比文心一言比GPT3强的GPT3是很久之前的了之前GPT3发布会也没几个人关注热知识GPT3是2020年就发布了的，当时很多圈里人就说是技术的重要进步，vscode甚至有插件可以用（Copilot），是开放测试的，那个时候你们关注了吗;4;66;70;3799;0.018425901553040275
13959;听到他说对标chatGPT我就关掉视频了。多少年了，还在对标？？？没有自己的想象力吗？没有野心吗？;44;376;420;3799;0.11055540931824165
14004;你能不能和李艳红说一下，他那个贴吧app搞得又臃肿又卡顿，让他啥也不用干，就把741或者10版本搞回来就行;19;144;163;3799;0.042906027902079494
14024;我觉得网民对百度的商业盈利方式表达不满，这无可厚非。但是因此就胡乱贬低百度在ai方面的投入与技术，这无疑是自己遮住了自己的眼睛。;1;18;19;3799;0.005001316135825217
14026;中国会有超级的AI公司，但绝对不是你们百度广告公司。;16;58;74;3799;0.019478810213214005
14043;好怀念曾经的这些互联网大佬，经常能看到在网上吹牛逼。那时候感觉一片欣欣向荣。现在，这些大佬基本没发言了，网络上充斥着的尽是各种无脑喷;1;19;20;3799;0.0052645433008686494
14045;说的挺好的，别把他当百度的ceo，就当一个行业内大佬来听他的话确实是有不错的东西可以学习到。好的就听，学，不好的不听不学;1;29;30;3799;0.007896814951302974
14048;1国家队会不会下场注资，如何看待openai不允许中国手机号注册2什么时候会大规模的开放文心使用3文心的算力是否来自自研芯片昆仑4网传生图能力是调用国外api5文心会开源吗;10;114;124;3799;0.03264016846538563
14060;我想问文心一言“魏则西事件”;17;214;231;3799;0.060805475125032905
14080;评论区有关心百度文心一言图片生成问题的，我想说你要真关心就去查，百度早给公告说明了，用的是国外公开数据集，国内没有那么多好的数据喂给他。数据这个东西，用户量上去了，慢慢都能解决。;15;44;59;3799;0.015530402737562517
14101;我都不明白弹幕评论区的大佬们嘲讽百度的勇气和资本在哪里，还有人“咬牙切齿”的想让谷歌干死百度？？？;1;16;17;3799;0.004474861805738352
14105;文心一言真是自研吗？直接上论文干货哔哩哔哩httpsb23tvvxrfesg;1;4;5;3799;0.0013161358252171624
14107;看看这个视频就知道文心一言的生图模型都是拿别人开源的，数据集部分自己的BV1jm4y1r7XG;2;4;6;3799;0.0015793629902605948
14112;有一说一，李彦宏回答真是滴水不漏;4;46;50;3799;0.013161358252171624
14117;开源模型套壳而已，实在没什么聊头;12;28;40;3799;0.010529086601737299
14132;只能说b站有些评论视频看都不看，还什么技术都不懂，直接开喷;46;52;98;3799;0.025796262174256384
14179;有众多测试表明，让文心一言作画，它总是把汉语翻译成英语再按英语的意思作画，如何解释这一点。例：让画起重机，由于起重机和鹤是一个单词，结果画出了一只鹤。;5;20;25;3799;0.006580679126085812
14186;会不会引导我去莆田医院;4;97;101;3799;0.026585943669386682
14191;现在bing的国内搜索引擎用户体验已经比百度要好用了，主要体现在搜索内容的完整度和准确度，加上newbing的支持，未来百度的路会越来越窄;2;7;9;3799;0.0023690444853908922
14194;做什么啊？就是个套壳，说明白点就是，国外是根据英文搜索做了个模型并且把模型的方法公开。百度做的事情就是多了一个中英切换，怎么实现的呢？就是百度翻译，你没有听错就是百度翻译。底层一点都没有变连数据模型都是照搬别人的。就算这样理论上应该比国外要快因为翻译一遍，但是问题是还他妈翻译不准，导致准确率没有国外的高。你说好笑不好笑。一个中国最大的搜索引擎，没有自己中文数据模型你敢信。就好像考试的时候，别人把答案告诉你了。你还找别人借笔。美其名曰自己写的，还夸自己字写的比较好看。开源真是个好东西啊。;4;6;10;3799;0.0026322716504343247
14199;懂点技术都知道百度的多模态根本不是GPT的多模态；百度家的大语言模型能一天迭代三个版本，然而真的大模型训练一次至少要好几天；百度说达到chatgpt两个月前的水平，可是我在chatgpt刚出来一周就引导它在Androidstudio写了一个app，请问文心什么时候能做到吃瓜;3;5;8;3799;0.0021058173203474598
14203;来阴阳怪气无脑喷的大多是不懂AI不懂计算机的;4;12;16;3799;0.0042116346406949196
14208;要不承认全国大厂在ai这块都是shit，要么承认百度是国内最好。;4;12;16;3799;0.0042116346406949196
14213;其实大家没必要喷百度，本来人家也就是个商业公司，就是盈利为目的的。期望百度成为科技公司引领人类发展有点太为难百度了。;14;43;57;3799;0.015003948407475652
14230;抛开事实，资本，抄袭和技术方面的问题不谈，这确实是一位温文尔雅谈吐得体的CEO;1;6;7;3799;0.0018425901553040273
14234;嗯虽然很不容易，也算填补国内空白，我也不太懂技术但是百度现在在国内其实是带一点点原罪的，魏则西、贴吧运营、网盘限速等等都是招黑败坏路人缘的，就看怎么应对了;1;27;28;3799;0.007370360621216109
14236;老实说，我真的对百度很难提起好感，因为缺德事真的太多，但是另一方面，它又是国内大语言模型唯一的独苗，虽然做的确实不如openai，都是同时起步，但是目前差距是硬性的，不知道以后差距会不会拉大还是缩小;4;3;7;3799;0.0018425901553040273
14247;百度确实是对AI最重视布局最早的了，只不过现在规模缩水资金肯定不如其他大厂，还是期待能做点东西的，有些说给百度说话的没脑子，其实喷百度也没啥用也不见得有脑子，就好像你骂美团抽成和压榨小哥，骂抖音拼多多卖假货一样，本身是重要营收业务的很难改又没办法直接砍掉，而且别的不清楚，医美类似的广告很多平台也一堆，只不过隐蔽性更高了更聪明了;2;2;4;3799;0.0010529086601737299
14250;百度做Ai也不是现在才开始做的，十年前就投入了;12;9;21;3799;0.005527770465912082
14263;你们能看完再评论吗？;3;27;30;3799;0.007896814951302974
14269;文心一言要是真的可以的话为什么还不拿出来台面上给大家使用辣眼睛;22;28;50;3799;0.013161358252171624
14297;请注意，这是一个为了挣钱不惜杀人的黑心商人别忘了那些死在他手下的冤魂笑哭;1;6;7;3799;0.0018425901553040273
14300;逻辑清晰，起码比评论区的黑子们，强多了嗑瓜子;1;3;4;3799;0.0010529086601737299
14307;有人用论文分析了百度这个文心一言，套用的外国模型，底层逻辑架构都是人家的，百度属于是直接抄用了，而且做得还很一般藏狐藏狐;1;3;4;3799;0.0010529086601737299
14315;评论区水军好多啊，看得恶心;1;5;6;3799;0.0015793629902605948
14318;百度是bta中最不上进的公司，阿里在王坚带领的云服务上是顶尖的。腾讯抛开赚钱外在游戏领域还是有硬实力的，而且通讯软件的确市场占有率经久不衰。反观百度呢，人工智能开发了这么多年，不管是ai还是车机有哪个完成度高的;6;5;11;3799;0.002895498815477757
14325;我觉得你可以骂百度骂李彦宏做的各种龌龊事，但是真别质疑李彦宏在it方面的技术。。。;1;8;9;3799;0.0023690444853908922
14327;可能你们还不知道？文心一言被扒皮了，里面套的还是chatgdt，百度要出大糗了;59;5;64;3799;0.016846538562779678
14394;老实说我倒是不担心百度的技术和数据，我担心的是把刀交给他以后砍向的会不会是自己人;1;6;7;3799;0.0018425901553040273
14397;李彦宏长的斯斯文文的，没想到是个这doge;1;12;13;3799;0.003421953145564622
14401;听说是外国模型跑的，中文语义都不了解，比如车水马龙;2;5;7;3799;0.0018425901553040273
14405;我觉得百度在某些方面小看ChatGPT了，昨天推出的三方插件功能，文生图我记得也是可以的。最重要是微软可以重塑软件生态文心一言还是一个对话形式的软件，那肯定未来会被打败。;2;5;7;3799;0.0018425901553040273
14409;百度过去一直落后于谷歌，但是你看百度知耻后勇了吗？百度基本就是我们的国耻。同意的顶起来;1;2;3;3799;0.0007896814951302974
14411;就这个评论区群魔乱舞的样子，他们嘴里所谓的中文语料库是不是百度搞坏的就有答案的，脑袋里面装大粪的人天天也在发大粪;1;6;7;3799;0.0018425901553040273
14413;李彦宏好帅;1;2;3;3799;0.0007896814951302974
14415;说实话我唯一认可百度的产品就是百度网盘了微笑;10;2;12;3799;0.0031587259805211897
14426;投入上千亿做一个挂着国外API外壳的假AI？这上千亿用来干啥去了？搜爱国猫搜出一个挂美国国旗的猫，让他画总线结果画出一个公交车，让他画起重机结果画出一个丹顶鹤（因为总线的英语和公交车一样都是bus，起重机的英语和丹顶鹤都是crane），让他画车水马龙结果画出一条典型的西方的龙，先把汉语翻译成英语，然后再使用国外的API进行AI创作，果然国产还是一如既往的辣鸡;2;2;4;3799;0.0010529086601737299
14430;画一个起重机然后给你来一张鹤的图，是为什么捏，原来是因为crane起重机吊车鹤嘻嘻;9;3;12;3799;0.0031587259805211897
14441;百度的风评已经烂透了，做的事实在是败路人缘，很难想象一家只知道看眼前快钱的公司能做出什么有建树的成果来，作为一家中国公司，我当然希望它能有一定的竞争力，不过，理性告诉我，概率不大。;1;5;6;3799;0.0015793629902605948
14443;第一次看李彦宏的访谈，感觉他怎么那么拘谨这是工科男的宿命吗？笑哭笑哭笑哭笑哭;1;4;5;3799;0.0013161358252171624
14449;我只能说你放出来给大家用用不行吗？有什么不好的地方大家给你们找不来，你们在改进，不好吗？这有什么害怕的？;5;4;9;3799;0.0023690444853908922
14463;对，百度搜索国内第一，体验怎么样？百度网盘体验怎么样？贴吧怎么样？后台下载的app怎么样？就是你们这种有的用就不错的妥协心态，忘了本该好的产品应该有什么水平，百度才可以这般恶心用户，反正是龙头扔个半成品直接商业化，不用管后续的维护和提升，指望百度加个ai赛道就整体变好变良心，就像腾讯宣布要出一个顶级3a一样，其中可信度自己去想吧;1;2;3;3799;0.0007896814951302974
14470;要不是网络保护，谁特么用你百度的东西;1;2;3;3799;0.0007896814951302974
14483;用国外的api搞文心一言，卖假药，套补贴，科技公司;8;2;10;3799;0.0026322716504343247
14527;其实最让人震惊的是，谷歌的bard居然没比百度好多少笑哭;7;1;8;3799;0.0021058173203474598
14536;从其它视频看的，在文言一心上搜“总路的作图”画面显示的是公交车，因为这俩英文都是“bus”，这是为何呢？;2;1;3;3799;0.0007896814951302974
14543;李彦宏不是撒谎就是没看过别人的发布会，我看见过一个什么3d智能引擎发布会，现场完成人脸识别，现场形成该角色所有表情，说话口腔形态，什么叫全世界没有现场展示的，就连siri老乔也是现场展示的;2;1;3;3799;0.0007896814951302974
14565;莆田什么的暂且是过去式，我觉得一码归一码，虽然百度确实很狗尤其是广告这件事情上，但是人家至少敢在这个领域国内的先行者，不管产品有再多缺陷，跟gpt差距再大，都是可以一步步来的，不应该被这样冷嘲热讽，百度它再差也是我们中国的企业;2;1;3;3799;0.0007896814951302974
14569;每当百度想要做些什么事情的时候，总有人会泼冷水，就像李彦宏当初演讲时被人倒水时一样;1;1;2;3799;0.0005264543300868649
14572;将来有没有用中文编程的可能性啊;5;2;7;3799;0.0018425901553040273
14578;我不看好人材红利下，能出多高精尖的创新东西，别杠我，我们从事技术从事科研都是为兴趣为生活，不是为奉献他人不得善终。有多少人，技术还在成长，就被拔苗助长急流勇退，又有多少企业，在这环境下还能安心科研的;1;1;2;3799;0.0005264543300868649
14581;同样的问题再问一遍“文心”，看是人和机器哪个更诚实？;1;1;2;3799;0.0005264543300868649
14586;谢谢百度和资本，让我大赚了一笔，先猛跌后猛涨滑稽2辆特斯拉到手;1;1;2;3799;0.0005264543300868649
14591;谷歌的Bard居然不如百度的文心一言，真的是让我刮目相看吃瓜;1;1;2;3799;0.0005264543300868649
14596;一改对文心一言的看法，中国第一个类似GPT产品无论做成什么样都应该被敬佩。看看某社交软件公司和短视频公司在干什么？;3;1;4;3799;0.0010529086601737299
14600;李彦宏说的一个观点非常好，以后的机会更多就是在应用层上，商业层面上来说，中国或者百度来说，需不需要另一个openai，对于某些大厂确实意义不大，而且这些机会与大多数的人也无关，以安卓和苹果以及电脑操作系统来做例子确实不错，但是不的不承认的就是，能赶上技术力先锋的公司，赚钱确实是蛮舒适的;1;1;2;3799;0.0005264543300868649
14611;百度的广告少一些，搜到的实质内容多一些，就比啥都好了。当初搜个steam官网，结果前几个是什么管家之类的。;1;1;2;3799;0.0005264543300868649
14616;他55了，居然只比我妈小一岁，可比我妈年轻太多了，保养的是真好啊。查了一下他老婆是生物科学的博士，他老婆的研究方向不会是抗衰老吧？;2;1;3;3799;0.0007896814951302974
14628;这玩意训练成本太高了，疯狂堆A100;1;1;2;3799;0.0005264543300868649
14633;大家要考虑国内的合规监管比国外是要严格很多的，给点时间;1;1;2;3799;0.0005264543300868649
14639;无脑黑真的多，一口一句套皮可还行，业内的懂哥都没评论大神牛doge;1;2;3;3799;0.0007896814951302974
14652;正经人谁用百度啊tvdoge;5;1;6;3799;0.0015793629902605948
14658;对于文心一言和ChatGPT4之类的大语言模型应用，我个人理解这个是不是就相当于游戏行业里的游戏引擎（比如虚幻5）？然后我可以基于此类语言模型开发应用就像我用虚幻5开发一个游戏，不管是3A还是独立游戏，这个就看我自己的能力来了，有没有懂的大佬科普一下。;7;1;8;3799;0.0021058173203474598
14667;我用过了，，，可以肯定脚本和内容都是有抄袭的，不信可以去看我的新视频;1;1;2;3799;0.0005264543300868649
14673;就百度现在的这幅吃相，即使他的文心一言成功了，也迟早变成另一个百度搜索，你想问文心一言身体不舒服怎么办，文心一言回答你去某某野鸡医院，去买某某野鸡药业公司的三无产品。或者直接接入某个三无医师的对话框。更可怕的是人们对他的信任越高，他越可能害了你。我希望我们中国能有自己的GPT，但一定不希望是百度的。;1;1;2;3799;0.0005264543300868649
14680;看看发布会发布完后股价就知道有没有人相信它的产品;2;1;3;3799;0.0007896814951302974
14692;就是因为你们这些阴阳怪气的评论，国内才没有好的数据集;5;1;6;3799;0.0015793629902605948
14701;抄袭套壳国外开源，号称自研，赢麻了，还好我不用百度很久了;4;1;5;3799;0.0013161358252171624
14711;我记得很久之前qq有个群聊机器人，叫小冰，结果后来关了，那是很久很久之前的事了;3;1;4;3799;0.0010529086601737299
14719;这个弹幕氛围也太宽容了，这百度ai完全就是不能用的状态啊;1;1;2;3799;0.0005264543300868649
14722;你聊这么多也没法掩饰他比不上ChatGPT也掩饰不了慌慌张张的乱蹭不好就是不好讲这么多干嘛;2;1;3;3799;0.0007896814951302974
14732;李彦宏说话的语气好恶心，想到百度做的恶，更觉得李彦宏虚伪做作辣眼睛;1;1;2;3799;0.0005264543300868649
14737;使用自家垃圾翻译，调别人接口，别人chatgpt用了好几年开发的，百度不到半年搞出来了，你信吗？;9;1;10;3799;0.0026322716504343247
14747;真的不是翻译接入国外chatGPT吗？吃瓜吃瓜吃瓜;1;0;1;3799;0.00026322716504343247
14768;国足再差也是中国踢球最好的没办法其他人更差;2;0;2;3799;0.0005264543300868649
14780;我用百度搜编程相关的内容，出来的都是一堆个人自建站的搬运和者机翻的垃圾内容，就这样的数据质量能够喂出来什么模型。更别说门户网站的衰落后，有价值的生活信息根本不会经过搜索引擎获得。希望李总能解答一下我这个愚蠢的问题。;1;1;2;3799;0.0005264543300868649
14782;我只想说一句话，CHATGPT团队70几个人。;3;0;3;3799;0.0007896814951302974
14813;不管文心一言比GPT4差了多少，至少人家做出来了，而且敢于推出来挨骂。就连谷歌的Bard不也是被骂的分吗？Bard甚至还不如文心呢。现阶段就是MSGPT4称霸的时代，敢来挑战的都需要很大的勇气，因为在AI领域你慢了人家一步，很可能就永远赶不上了。但是难道就不做了吗？总是要有人来做的吧？;1;0;1;3799;0.00026322716504343247
14816;chatgpt换个皮;1;0;1;3799;0.00026322716504343247
14821;就是chatgpt加一个中文视窗;10;0;10;3799;0.0026322716504343247
14839;问：chatgpt出来之前你们都在哪？真的是因为我们没怎么关注吗？;1;0;1;3799;0.00026322716504343247
14849;给氪哥面子，把不好说的话留在心里。我不喜欢百度，他家广告太多了，留个问题，百度有啥？;3;0;3;3799;0.0007896814951302974
14864;httpsb23tvBV1jm4y1r7XG;4;0;4;3799;0.0010529086601737299
14876;好想让评论区的大佬带领百度脱单doge为我国的技术贡献自己的力量，;1;0;1;3799;0.00026322716504343247
14878;尴尬的不是百度不行，而是百度已经是最好的了，其他公司更摆;6;0;6;3799;0.0015793629902605948
14887;文言一心真的不只是翻译成英文然后直接跑别的算法吗无语;2;0;2;3799;0.0005264543300868649
14913;要是一个人做一件坏事，大抵是没人在他做出一件瞩目的好事的时候来指责他的；但一个人做了很多不好的事情，很多人便会在他做出瞩目的好时的时候来看热闹顺便阴阳怪气地合理怀疑的。doge;1;1;2;3799;0.0005264543300868649
14929;Chatgbt。只是一个人工训练的聊天软件。反应过度了吧？;3;0;3;3799;0.0007896814951302974
14933;关键是文心一言有没有自动编代码的能力？如果没有，那就是猴子和人的对比。GPT4已经可用于修改代码了。GPT5、GPT6很快就来了。百度准备好了吗？;1;0;1;3799;0.00026322716504343247
14940;实事求是的说，百度是国内大厂中工程师文化最重也是技术最强的，百度做不出来的话其他几家更不可能了。;1;0;1;3799;0.00026322716504343247
14952;卧槽，机会在应用层？，就这就是不想深入搞技术，应用层没啥技术含量，就是程序员界的销售员;1;0;1;3799;0.00026322716504343247
14961;说实话，文心能力怎么样，我不是很关心，我关心的是在后续使用时，涉及的个人隐私和公司隐私，百度能做好保密吗？我问了一个关于治病的问题，会不会马上收到莆田系医院的垃圾信息和电话的骚扰？;1;0;1;3799;0.00026322716504343247
14967;对国内手机不开放，是openAI不开放吗？是国内不开放使用chatGPT;1;0;1;3799;0.00026322716504343247
14986;作为一个科技企业，把那么多臃肿的部门砍掉，安心做技术才是正路。向腾讯阿里学习还不如向华为比亚迪学习。;1;0;1;3799;0.00026322716504343247
14998;httpswwwbilibilicomvideoBV1jm4y1r7XGspmidfrom3331007tianma317clickvdsource950ded8b18aaa29754cc3c63e178e34f;2;0;2;3799;0.0005264543300868649
15006;借个地方问问大家，感觉最近在国内外语言模型发展方面有点节奏啊，有个ID叫孙大圣的UP主发了一个锤文心一言的视频，我在下面就评论了一下让大家关注清华的开源chatglm，结果就被那个UP主直接拉黑了，非常莫名其妙笑哭;1;0;1;3799;0.00026322716504343247
15010;谷歌都翻车了他们的模型还是学的谷歌，你说他敢现场演示么;2;0;2;3799;0.0005264543300868649
15017;这玩意真的太吓人了，大家现在体验到的还是不联网的版本，你可以想象一下联网的版本有多牛逼。;4;0;4;3799;0.0010529086601737299
15036;还是等国内开放ChatGPT吧;1;0;1;3799;0.00026322716504343247
15044;等chatgpt开源吧;1;0;1;3799;0.00026322716504343247
15047;真不用急着喷，在ai领域中国真不落后美国很多;1;0;1;3799;0.00026322716504343247
15055;其实看完了觉得讲得还是挺不错的，去申请一个账户试试看。;2;0;2;3799;0.0005264543300868649
15069;墙：无所谓，我会出手;1;0;1;3799;0.00026322716504343247
15073;一个没有商业道德底线的公司，掌握的技术越强只会出现更多恶心用户的事。大家都希望中国研发出自己的通用AI大模型，但如果是百度独家掌握了国内最先进的AI，那么我对国内未来的AI商业模式是非常担忧的。;5;0;5;3799;0.0013161358252171624
15079;妙啊没关系，比谷歌的好用;2;0;2;3799;0.0005264543300868649
15086;虽然比不过openai，但其实还算是厉害的，应该也算是第一梯队了;1;0;1;3799;0.00026322716504343247
15088;批评指点建议可以有，无脑的狂喷还是省省吧，只会显得你很幼稚，要认清差距，也要努力赶上超越微笑脱单doge;3;2;5;3799;0.0013161358252171624
15103;ai能代替很垃圾的搜索引擎吗？;2;0;2;3799;0.0005264543300868649
15109;咱别的不说啊芯片都是有耗能的，那不都属于排放吗，芯片运算消耗多大能量，我记得我上学时候用的电脑三代i7芯片小变压器不大点，现在看看那些高端笔记本大变压器多大，科技越先进需要的能量就越大。之前看报道，训练chatgpt每深度学习一次，相当于美国100个家庭一年的用电量。卧槽，这要是地球上每一个国家都来这么一个的话。地球资源能够用吗？因为ai抢占资源在来一波大战？;1;0;1;3799;0.00026322716504343247
15122;知道为什么落后吧，因为要等chatGPT先更新换代出来，然后再去抄袭，抄袭在国内成功，主要是国内人口的红利，像淘宝抄袭易趣，最终把易趣淘汰，我国盛产A货不是没有道理的;3;0;3;3799;0.0007896814951302974
15131;百度被骂还有一个很重要的原因，同样是投放广告赚钱，谷歌做出了好的产品，而百度只剩挣钱，而且有时很没底线dogedogedogedoge;1;1;2;3799;0.0005264543300868649
15141;快进的文心一言年度SVIP，买一年送2个月，限时优惠。;2;0;2;3799;0.0005264543300868649
15147;《我们的东西不差》，笑，真正的好东西是有目共睹的。;1;0;1;3799;0.00026322716504343247
15151;李彦宏怎么说也是技术出身，最后搞什么竞价排名，也算是声名狼藉了;2;0;2;3799;0.0005264543300868649
15157;彦红这人，为什么不花点钱做公关，一出来全弹幕在骂，你看看别人花点钱做公关的被我们B站有头脑的年轻人怎么舔的缺钱吗彦红;1;2;3;3799;0.0007896814951302974
15170;我好像十几天前就预约了，结果现在还在排队。之前显示现在有多少人在预约，之后干脆不显示了;1;0;1;3799;0.00026322716504343247
15178;百度可恶，但是毕竟也是在投钱做科研，而且是大投入做着AI梦，比联想小米强。就算死也是站着死，我们国家需要搞科研的公司。;1;0;1;3799;0.00026322716504343247
15180;当市场已经开始迎合chatgpt，做出一系列适配产品。到时候谁还会去愿意搭载文心一言，大家都知道，文心一言不如Chatgpt，那又有谁会去用？还是希望百度能尽快赶上吧，不然就又是操作系统那个故事的翻版了;2;0;2;3799;0.0005264543300868649
15236;听说这样可以钓鱼华为百度比亚迪小米鸿蒙原神;1;0;1;3799;0.00026322716504343247
15241;文心：你们再叫又能怎样，我依旧国内老大;1;0;1;3799;0.00026322716504343247
15254;为什么评论区那么多黑百度的，因为他以前做的事太恶心了。就比如我需要找一个芯片元器件的说明书，把“XX说明书”的关键词输入百度，前两条结果是雷打不动的广告，第三条结果是百度文库，点进去那界面花里胡哨，一堆广告包围着文档。然而更缺德的是只给看前两页，想看后面？开会员第四条开始就是牛头不对马嘴的东西了。然而我把同样的关键字输入Google，第一条直接甩给我一个官方PDF，画面清晰，内容超全，没有任何广告。所以这种公司要是真能搞出来什么AI，那绝壁就是又开始祸害下一代中国人。所以真不要觉得大家黑百度觉得百度很委屈，百因必有果，这是他自己的因结的果。;3;1;4;3799;0.0010529086601737299
15267;其实百度已经相当可以了，无论之前的百度有多恶心人但是至少在大语言模型方面他不是套壳，而是真的自研，哪怕现在还很差但是至少我们国家好歹有个大厂有这种不只是考虑短期挣快钱的想法就已经很好了，想想看全世界这么多国家就美国的openAI、Google和中国的百度发布了大语言模型，至少我们在这轮技术革新方面没掉队，这已经很不错了，当初我研一的时候确定了图像处理方向之后我问过我们老师的博士生哪个大厂算是我们行业的一线大厂，我以为说的都是腾讯阿里字节之类的，但是没想到她说完阿里之后下一个就说的是百度，还和我说百度虽然市值不行但是技术能力是国内最顶尖的，当时就让我印象很深刻;4;1;5;3799;0.0013161358252171624
15272;虽然但是，比起百度我更想骂阿里和腾讯，百度至少有个说得过去的产品（虽然和GPT还有不小的差距）阿里和腾讯的产品去哪了？（不是在给百度洗，我平时用bing搜索）;1;0;1;3799;0.00026322716504343247
15281;真是搞笑问你产品没做好为啥发布你说有市场需求？市场要你没做好的东西？没你不行？;1;0;1;3799;0.00026322716504343247
15285;耗资千亿，出了鸿蒙。小米永不兼容;2;0;2;3799;0.0005264543300868649
15292;百度难啊，因为中国网络上垃圾信息实在太多;2;1;3;3799;0.0007896814951302974
15298;老李回答发布会从现场演示改为录制视频的原因，怎么看都觉得很牵强，说服力不足。对自己公司产品的这点信心都没有，为什么要来接受36kr的采访。发布会尽管不翻车，“车水马龙”也足以让人嘲笑一阵子。中文已经是文心一言的主场优势了，与ChatGPT高下立判。;1;0;1;3799;0.00026322716504343247
15301;真无耻啊，感觉他被一群人给哄成傻子了，而且还非常傲慢;1;0;1;3799;0.00026322716504343247
15305;就因为了这个视频建议大家取消关此账号并彻底拉黑;1;0;1;3799;0.00026322716504343247
15348;Q：为什么发布不完美的产品？A：1、产品有市场需求；2、产品需要用户的反馈才能加速其技术迭代Q：现场为什么用demo而不是实时演示？A：本来想现场展示，但是1、产品生成的答案不稳定，会为发布会带来不确定性；2、其他类似的所有产品也都这么做的Q：GPT领先文心几年？A：无法具体测试，满分100分的话，第一版文心比GPT低40分，一个月后下一版文心功能更差，所以技术迭代有其特殊的规律，文心发布的时候至少拥有GPT在今年1月时的水平，另外，文心在文生图的能力方面是领先GPT的，GPT也有文生图的功能，但是并没有人用过Q：整个生态圈，芯片层、模型层、算法层、应用层，最大的创业机会在哪里？A：应用层，回看互联网，特别成功的微信抖音淘宝，操作系统的产品基本只有微软和ios，应用层的机会很多，其创造的价值不一定比底层研究低Q：生成式智能搜索会颠覆百度自己的生态吗？A：不会，文心只是扩大了百度搜索的边界，但这只是一部分，更大的价值在于云，全球大厂中生态圈四层都有领先产品的公司是没有的，而百度在每一层都提早布局了很多年，生态圈比较完整，所以未来人们在开发应用的时候，基于百度的智能云是最方便的，这个价值才是最具有颠覆性的Q：已经在文心投入了多少，还会投入多少？A：很难划分清楚，生成式AI可能十几亿，但是考虑到四层端到端的优化，大语言模型才能有竞争力，十年投入了上千亿，没有这些投入，就没有文心Q：为什么文心是云市场的gamechanger？A：过去云计算主要卖算力，做算力的研究成本高，比较慢，未来人们开发应用的时候只要基于大模型进行开发，又快成本又低，以后人们购买云计算服务的时候，看的是模型好不好，而不是底层算力如何，所以大模型具有颠覆性Q：未来十年会不会有诞生新淘宝的机会？A：十倍于新淘宝新微信的机会完全是存在的，因为技术进步的效率越来越快，产品开发的效率也越来越快Q：如何看待现阶段很多人焦虑AI会让自己失业？A：取决于看问题的角度，现在因为汽车的存在没有了马车夫，但是现在的工作机会真的会比100年前少吗？我做一个大胆的预测，十年以后，50的工作需要的能力是如何与机器打交道，即promptengineering提示词工程，写提示词的水平直接与生产力水平相关。人们不能随波逐流，要学习新技能，过去的某些技能可能意义会减小，只要想学习，新机会非常多;1;2;3;3799;0.0007896814951302974
15352;说句实话bing在没有那个聊天功能时中文理解能力真的不如百度谷歌也是很多人要是真的用了很久的谷歌搜索也会发现很多时候百度更好他也只是广告多了点而已但是他不要广告你又要他怎么活呢？有本事很多人去捐款啊辣眼睛;1;1;2;3799;0.0005264543300868649
15382;鱼香肉丝doge;1;1;2;3799;0.0005264543300868649
15393;百度什么玩意也来碰瓷，你有这创新力和觉悟吗？;1;0;1;3799;0.00026322716504343247
15400;我上来就会问文心一言是不是一个蹭热度赶工期做出来的一个垃圾半成品呢？呲牙;2;0;2;3799;0.0005264543300868649
15407;含泪取关。;1;1;2;3799;0.0005264543300868649
15412;中文翻译英文，然后回答在翻译中文的吗？;1;1;2;3799;0.0005264543300868649
15436;这起码是百度自己做的，比那什么鸿蒙假货好太多了，太多人太双标了，再有差距它也是目前世界第二;2;0;2;3799;0.0005264543300868649
15445;文心一言真是自研吗？直接上论文干货哔哩哔哩httpsb23tvZ9x2zlN;1;0;1;3799;0.00026322716504343247
15450;要不是知道文心开源论文生成图片就改了一个系数，要不是知道国外有反感“closeAI”的人开源了类似gpt3的模型。我还就真信了，只能说在技术以外的方向还是牛的。;1;0;1;3799;0.00026322716504343247
15474;在18岁高考完选专业时，绝对不要想：“选什么职业都一样，反正行行出状元”每个行业都能出个天花板，关状元之外的人没什么事（就是职业之间根本不平等，比如疫情下的旅游）能坚持下去的只有两个原因，两个都没有就毕业即转行了1用爱发电，如游戏开发2报酬高，如警察、卷烟厂不推荐因为想学什么而选专业，或者我高考英语分数高所以我选这专业，而是因为工作而选专业爱好现在就能做，并不是选了这个专业才能做（比如日语，绝不推荐日语当职业）某个工作要这个专业，所以我选这个专业我选这个专业，因为这个专业好X如某人想当工程师逛了下招聘网，发现其要求为：计算机，XX六级然后才开始根据该职业要求选专业比如电竞，官方举办比赛，比赛有奖金，为了图奖金才有人电竞，看到有人想图奖金就有人收学费教电竞，这就是行业的发展了是我要奖金才电竞，而不是被别人教电竞好如果察觉到自己“我好像喜欢XX”没搞清就选的话，你喜欢的不是那个职业，而是你想象中的那个职业看到个专业游戏艺术设计，想学游戏策划，结果重点是艺术，是一个天天画素描写真的美术专业解决方法：1找该专业课程表，看慕课的网课体验下2招聘网看待遇要求如某职业直接不招男女，且看要求也能找方向专精（工地不招女生，那为啥土木招女生）3问已经上班的上班族，一定要多问，两眼不闻窗外事是绝对错的4豆瓣的后悔小语种小组等如果是因为分数要求低或者父母选的专业，也是毕业即转行（为了上好学校选了个垃圾专业，花了四年时间，最后一看，转行了，但是学历提升了（比如因为分数要求低选电商）大学最大的缺点就是培养多面手，考完就忘，工作一天能顶学校一年一年时间学了四个，就算每天都学，平均下来每个也就学了三个月结果只用到了其中一个，还不如专精学四个月的唯一的解决方法就是实习，最好大一就实习，这样就知道自己要干什么了如编程，是选择电脑还是手机？网页还是软件？疫情和双减之后，不推荐文科和艺术，主要是师范历史旅游英语日语服装设计产品动漫社会学管理电商新传理科不推荐：生化环材食品心理学农学医学游戏以及任何在被撤销的专业zwhuatucomzhuanyeku能查自己的专业能报什么国企、公务员;1;4;5;3799;0.0013161358252171624
15477;无言独上西楼，月如钩寂寞梧桐深院锁清秋。剪不断，理还乱;24;296;320;3799;0.08423269281389839
15504;文心确实牛批，它就像是中国最大的中文搜索引擎百度一样;25;805;830;3799;0.21847854698604896
15530;复刻松鼠撅鱼图;8;278;286;3799;0.0752829692024217
15540;画一盘土耳其保佑保佑;9;207;216;3799;0.056857067649381414
15550;长痛不如短痛是啥意思;14;148;162;3799;0.04264280073703606
15566;busmouse;42;292;334;3799;0.08791787312450645
15610;我试了，你说的对;17;227;244;3799;0.06422742827059752
15628;妙啊;15;28;43;3799;0.011318768096867597
15645;你告诉我，连计算器都不如的一个东西对我有什么用？辣眼睛;26;5;31;3799;0.008160042116346407
15673;claude的回答，1抖掉尿液保留2防止尿液回流3个人习惯4兴快感5其他;1;0;1;3799;0.00026322716504343247
15675;脱单doge;9;41;50;3799;0.013161358252171624
15685;后台君累死了笑哭笑哭;15;148;163;3799;0.042906027902079494
15701;说文心一言超预期的全网你是我看到的第一个。整体水平比GPT35略差，但是咱中国人自己的AI。给予时间和耐心赶上openAI是没问题的。打call;23;75;98;3799;0.025796262174256384
15725;chatgpt再先进也是外国的，文心一言再差也是中国的，多点耐心给百度，只有大家都鼓励支持自己国家的产品，它才能变得越来越好;1;4;5;3799;0.0013161358252171624
15727;会不会有种可能，他后面连了个chatgpt;34;74;108;3799;0.028428533824690707
15763;emmm;7;27;34;3799;0.008949723611476704
15771;我昨天也拿到邀请码了呲牙。逻辑问题以及弱智吧考题，都算不错。但是我是程序员，所以问了几个sql和java代码问题，就不咋的了。我的评价是：像个把袜子当作手套，衣服穿反的小孩。不过我很看好文心。;15;58;73;3799;0.01921558304817057
15788;被招安了？doge你要不问问魏则西事件？;7;6;13;3799;0.003421953145564622
15797;文心系统开发了好几年了，国内国外AI技术，其实国人出的成果很多，只是有的在国内，有的在国外。技术没有达到离谱的差距，当然chatgpt的组是世界最顶级的，这并不是国家间的区别，但百度的nlp确实有不少大牛，虽然存在差距，但没有不可逾越的鸿沟。;4;22;26;3799;0.006843906291129244
15802;很多人只会骂，我反正测了很多问题，有的问题gpt4一样也答不对。都还早，这条路还早。;4;17;21;3799;0.005527770465912082
15807;建议让chatgpt帮你写个文心一言的代码;1;30;31;3799;0.008160042116346407
15810;故意那个PPT造成股价大跌吸筹？第二天爆打空头doge;5;29;34;3799;0.008949723611476704
15817;哈哈哈。我猜也会一堆人说后台全是人;5;18;23;3799;0.006054224795998947
15823;奇了怪了，第一个问题之前的回答根本不是这样。;6;8;14;3799;0.0036851803106080546
15832;问：帮我写一个关于本手俗手妙手的文章，不少于500字文心一言：俗手、妙手和本手的关系俗手是一个相对于好手而言比较低级的一种棋艺水平。但是在围棋竞赛过程中，俗手、妙手和本手这三者的地位也是不可小觑的。就以以以为例例，为什么么么么为什么么么么么为什么么么么么么么么么么为什么么么为传么么么为什么么么么么么么么么么么么么么么么么么么么么么么么么为什什这个回答感觉完全是智障水平。笑哭;1;3;4;3799;0.0010529086601737299
15834;知乎这下岂不是要被降维打击;5;13;18;3799;0.0047380889707817845
15840;啥时候接入莆田系医院啊;1;6;7;3799;0.0018425901553040273
15842;听up讲解中应该是用过chatgpt的，如果是“公道话”应该放一下同问题下chatgpt的回答对比，这样更有说服力，更“公道”;3;2;5;3799;0.0013161358252171624
15847;博士，口味挺独特啊，亚洲人，穿皮衣，妙啊;3;10;13;3799;0.003421953145564622
15852;还可以，有了的话后面优化会很快星星眼;1;10;11;3799;0.002895498815477757
15857;差评君已经测过了被gpt吊打doge;2;5;7;3799;0.0018425901553040273
15860;百度的Ai绘画压根不是多模态，就是整合的sd的开源做出的产品;1;5;6;3799;0.0015793629902605948
15866;省流：我买百度被套了，快帮我解套dogedoge;1;1;2;3799;0.0005264543300868649
15869;你不问它魏则西和莆田医院？？doge;4;1;5;3799;0.0013161358252171624
15874;很难想象百度为什么能在短时间内就出和GPT比肩的AI，难道GPT和文心一言是同一拨人做的？或者百度雇了一批后台回复工人三班倒？反正我是不信百度能在这么短的时间内能把AI做出来;15;3;18;3799;0.0047380889707817845
15890;为啥反差这么大？前两天还在吐槽，今天又称赞了，收推广费了？笑哭;2;1;3;3799;0.0007896814951302974
15897;这种应用层面的技术，只要知道实现路径，追起来不是很难。就如同阿尔法狗出来后，国内很快也可以复刻出来。;1;1;2;3799;0.0005264543300868649
15920;百度充值了？;1;0;1;3799;0.00026322716504343247
15952;问问它大学生为什么不愿意打螺丝吃瓜;1;0;1;3799;0.00026322716504343247
15959;这不就是搜索引擎的功能？;1;0;1;3799;0.00026322716504343247
15977;不知道为什么B站这么多人阴阳怪气，CHATGPT又不是他们做出来的，怎么就能与有荣焉呢;1;1;2;3799;0.0005264543300868649
15979;之前看到一个视频说为什么中国没有这么强大的AI？扒拉一大堆，说的跟全世界都有了，就中国没有，是为什么一样？真的是服了;2;2;4;3799;0.0010529086601737299
15982;你预期也太低了，比chat35都差了三到四到代，要不然就是收钱了想洗;1;1;2;3799;0.0005264543300868649
15996;抽象程度比ChatGPT强tvdoge;4;107;111;3799;0.029218215319821005
16001;在玩抽象方面，文心一言领先ChatGPT;1;62;63;3799;0.016583311397736247
16003;还真是一言领先;1;21;22;3799;0.005790997630955514
16006;前两个问题根本没有关联性，而且字不一样音一样。换个真人来也不知道该怎么给你聊啊。。。。。。最后这个ai倒是绝杀了笑哭;1;9;10;3799;0.0026322716504343247
16012;up主，请问怎么才能用文心一言啊，只能排队等申请吗;1;1;2;3799;0.0005264543300868649
16028;贴吧炸了，赶快修;1;7;8;3799;0.0021058173203474598
16030;最烦的是看到那些诋毁文心一言的视频，看到那些标题就来火;3;7;10;3799;0.0026322716504343247
16046;贴吧快修;1;0;1;3799;0.00026322716504343247
16049;千万别升级，我还要和朋友玩我画你猜呢吃瓜;6;323;329;3799;0.08660173729928929
16056;大家好像还不知道文心一格“一只爱国的猫”的梗;22;105;127;3799;0.03342984996051593
16079;还是松鼠撅鱼经典doge;3;70;73;3799;0.01921558304817057
16089;说实话你这语义不清，你直接发给Md也生成不了好图片，描述词一定要清楚;2;3;5;3799;0.0013161358252171624
16092;鹤立鸡群，顺手牵羊，这不就是形容词吗？虚词，让你画，你也未必能画出来;1;2;3;3799;0.0007896814951302974
16106;其实文心一言完全可以用，只是对标chatgpt那种顶尖ai不太行，某些人就是标准太高，啥都要求一步登天，要求最好的。;1;0;1;3799;0.00026322716504343247
16127;文心一言能画画;2;0;2;3799;0.0005264543300868649
16131;你们的都弱爆了，看看我这里爱国的猫;66;887;953;3799;0.25085548828639115
16198;能把总线识别成公共汽车，说明还是有点英文功底的doge;18;485;503;3799;0.13240326401684654
16217;我喜欢这个画风，千万别改啊笑哭;13;335;348;3799;0.0916030534351145
16231;绷不住;3;142;145;3799;0.03816793893129771
16235;有一种把中文翻译成英文再画的美doge;3;272;275;3799;0.07238747038694393
16240;松花蛋;6;152;158;3799;0.04158989207686233
16247;真撅鱼好吧脱单doge;4;77;81;3799;0.02132140036851803
16252;居然还有人相信百度有技术力？恐怖片看多了？;1;31;32;3799;0.008423269281389839
16254;一些综艺节目里面的看图猜词环节有素材来源了doge;2;154;156;3799;0.04106343774677547
16257;cheatppt;1;25;26;3799;0.006843906291129244
16259;题目“总线”，画出的是巴士（bus，和总线是同一个单词），很明显是先翻译成英文再画的;13;161;174;3799;0.04580152671755725
16273;煲仔饭岂不是？吓死;1;11;12;3799;0.0031587259805211897
16275;满意，做头像了;1;8;9;3799;0.0023690444853908922
16277;昨天文心一言刚刚小迭代了一下，车水马龙这些玩意都可以正确识别了;19;123;142;3799;0.03737825743616741
16299;总线和bus经常一起出现。有什么好奇怪的;7;64;71;3799;0.018689128718083706
16307;百度总不会吧中文翻译成英文，在用中文显示出来吧？;8;86;94;3799;0.024743353514082654
16316;实锤了。。文心一格画图居然是中译英再画的。。;3;64;67;3799;0.017636220057909976
16320;车水马龙应该出现一个打乒乓球的才对;3;16;19;3799;0.005001316135825217
16325;笑哭看起来几乎没用国内的东西训练过，问的都是国内的词汇或者物品;1;41;42;3799;0.011055540931824164
16328;请大家先简单了解一下文心一格和文心一言的关系，然后了解一下文心一言和文心一格的发展历程。怼人怼不到点上，好难受。另大家可以尝试着把视频中的关键词想象成“xxx有xxx的xxx”的形式，再去看它出的图（有能力的小伙伴可以顺便看一下百度申请的文生图专利）不要动不动就国外国外，怼自己人可以，别崇洋媚外啊;7;18;25;3799;0.006580679126085812
16338;这个鱼香肉丝把我看发麻了。。。;1;11;12;3799;0.0031587259805211897
16340;总感觉它是先把汉字机翻成英语，再用英语去画的。笑哭;2;11;13;3799;0.003421953145564622
16346;文心一言为什么不用国内的数据，偏偏要去国外拿了再回来，是不是对国内互联网环境有什么意见;7;9;16;3799;0.0042116346406949196
16356;别人不是都说了，这玩意就是搬运国外AI的结果，套个壳而已;1;2;3;3799;0.0007896814951302974
16358;说明其实AI已经能理解一部分了，只不过还不完全;10;11;21;3799;0.005527770465912082
16369;我很好奇，狼狈为奸能整出什么作品来doge;2;2;4;3799;0.0010529086601737299
16372;人画的外国人，龙画的外国龙，何解？;1;1;2;3799;0.0005264543300868649
16376;看似离谱，实际上这才是真正的理解力与创造力的结合，恰恰证明了文心一言的智力。各位可以试想一下，让一个完全没见过鸡蛋灌饼、红烧狮子头的人来画这些菜，会得到什么样的结果？;2;6;8;3799;0.0021058173203474598
16381;我觉着先不要嘲讽，文心一言尽快全面公测，国内超10亿网民，加上墙的存在，庞大数据量将是百度巨大的资源和机会，就看百度争不争气了;5;1;6;3799;0.0015793629902605948
16387;你说他对吧，又不对，你说他不对吧，又合乎情理笑哭;1;4;5;3799;0.0013161358252171624
16391;就这个东西来看，这种程度的AI绘画是替代不了人类的，他只能画出字面意思来呀。;6;2;8;3799;0.0021058173203474598
16401;其实除了微软的那个。谷歌也这水平。;1;0;1;3799;0.00026322716504343247
16406;类似chatgpt在国内是做不出来的，大数据模型训练是非常烧钱的，就算你想烧钱也没地方，Ai高端芯片不对中销售，百度的文心一言其实就是调用chatgpt，套娃后转发而已;2;0;2;3799;0.0005264543300868649
16412;这也完全没理解啊，每个词拆开再转tag;1;2;3;3799;0.0007896814951302974
16417;描述肯定不是这样的;1;1;2;3799;0.0005264543300868649
16420;文心一言也有它的优势，你这么干纯粹博眼球，无下限;2;1;3;3799;0.0007896814951302974
16427;这个东西怎么玩？我访问文心官网要我加入体验，说通过后会发短信给我;1;0;1;3799;0.00026322716504343247
16450;真抽象;1;0;1;3799;0.00026322716504343247
16468;机器工具人听歌识曲;1;1;2;3799;0.0005264543300868649
16471;什么人工智障哈哈哈哈哈岛阿凛;1;0;1;3799;0.00026322716504343247
16479;逗乐能力其实也是一种能力，加油chatppt;1;0;1;3799;0.00026322716504343247
16485;以为是翻译英文再画的？;1;1;2;3799;0.0005264543300868649
16489;这文心一言可以完全吊打GPT4了，GPT4根本不是对手;7;6;13;3799;0.003421953145564622
16501;不奇怪，贴吧风格;1;0;1;3799;0.00026322716504343247
16506;不过我觉得挺有艺术感的;1;0;1;3799;0.00026322716504343247
16510;不觉得他的画有一种后现代的解构主义美感么笑哭反正我是特别喜欢这种天马行空别具一格的感觉;1;0;1;3799;0.00026322716504343247
16523;说明文言一心并没有理解自然语言的能力，还是老一套的搜索引擎式的关键词检索;1;0;1;3799;0.00026322716504343247
16531;太有节目效果了笑哭奈何百度不让我试试;2;0;2;3799;0.0005264543300868649
16541;打开mj，让它画个驴肉火烧，结果也是，驴驮着汉堡，太抽象的表达，都好不到哪里去;1;0;1;3799;0.00026322716504343247
16550;doge百度的水军还是多的，各种引经据典，文化人的事情不叫抄;1;1;2;3799;0.0005264543300868649
16555;为啥弹幕里还有人在那“你不会描述”，“你好好描述自己的需求，他能理解的”。我寻思鱼香肉丝还需要描述？我给他描述啥？怎么做的？什么味道？驴肉火烧还描述？咱就是说洗地能不能也别这么离谱？;1;0;1;3799;0.00026322716504343247
16558;百度还是那个辣鸡抱拳;1;0;1;3799;0.00026322716504343247
16560;严重怀疑是翻译成英文然后调用国外开源代码，赶集上架骗股票;19;63;82;3799;0.021584627533561464
16580;已经实锤，中文翻译英文，再调用国外的API了，真丢人。;25;35;60;3799;0.01579362990260595
16606;这个绘图功能是外国人做的项目，百度直接买了套上。;32;46;78;3799;0.020531718873387735
16639;用人家开源的，好赖也调试下，太无厘头;38;9;47;3799;0.012371676757041327
16680;八块腹肌的度晓晓，雪夜倒拔垂杨柳doge;2;12;14;3799;0.0036851803106080546
16686;教我健身吧;1;0;1;3799;0.00026322716504343247
16689;我要当韩国矿工;1;0;1;3799;0.00026322716504343247
16692;程序员小哥不行啊doge;1;0;1;3799;0.00026322716504343247
16695;来个又胖又瘦脱单doge滑稽;1;0;1;3799;0.00026322716504343247
16700;有生之年能体重下100嘛。。;1;0;1;3799;0.00026322716504343247
16703;姐妹们不要太身材焦虑哦;1;0;1;3799;0.00026322716504343247
16705;我对我现在的身材很满意;1;0;1;3799;0.00026322716504343247
16708;做我教练可不得加个wx;1;0;1;3799;0.00026322716504343247
16710;rwkk程序员肚子上几层肉;1;0;1;3799;0.00026322716504343247
16713;说得好但我根本懒得动;1;0;1;3799;0.00026322716504343247
16715;晓晓，能不能做我的私教脱单doge;1;0;1;3799;0.00026322716504343247
16717;我十五岁就有腹肌;3;0;3;3799;0.0007896814951302974
16721;你这计划保真？;1;0;1;3799;0.00026322716504343247
16723;给我来个18头身doge;1;0;1;3799;0.00026322716504343247
16725;新概念健身;1;0;1;3799;0.00026322716504343247
16730;doge晓晓怎么不画个自己;1;0;1;3799;0.00026322716504343247
16734;你接入文心一言了嘛？;1;0;1;3799;0.00026322716504343247
16736;三打白骨精不应该是36吗;6;129;135;3799;0.03553566728086339
16743;他竟然不知道松鼠鱼和虎皮青椒。果然是按照外国的东西照抄过来的。;5;37;42;3799;0.011055540931824164
16749;只能说抽象;2;27;29;3799;0.007633587786259542
16752;现在能画成这样了，感觉更新过;1;14;15;3799;0.003948407475651487
16754;是哪一家呢;1;10;11;3799;0.002895498815477757
16757;狐狸精画的没毛病;1;54;55;3799;0.014477494077388787
16760;三打白骨精不应该是36个吗呲牙;5;46;51;3799;0.013424585417215057
16768;httpsblogcsdnnetPaddlePaddlearticledetails128795895，这个是百度AI大模型的一些解释，稍微有点技术的人应该能看懂。文心一言不是中译英哔哩哔哩httpsb23tvlUB8IG5，看这个视频下的评论，有一些解释，外行应该能看懂。;1;7;8;3799;0.0021058173203474598
16773;目前看没出什么大事，如果严重的话会倒逼文字进行改革，学韩语上个世纪一样，强制在不同的词之间进行分割（加个空格），成语俗语等当作一个词，或加连字符;9;11;20;3799;0.0052645433008686494
16791;冷知识，早期芯片技术与国外差距不大，互联网技术与国外一致;1;1;2;3799;0.0005264543300868649
16801;记得有个鱼香肉丝恶心死了;2;1;3;3799;0.0007896814951302974
16805;今天又有人头戴绿帽色ID了辣眼睛doge吃瓜;1;0;1;3799;0.00026322716504343247
16811;外国ai：这啥玩意人啊？都让画的是啥？;1;1;2;3799;0.0005264543300868649
16813;我宣布文心一言搏杀ChatGPTdoge;13;362;375;3799;0.09871018689128717
16827;我对网上骂文心的压根不屑一顾有些人甚至看到中国表现不好会开心，但我tm百度你倒是快点让我通过申请啊;11;103;114;3799;0.030007896814951304
16839;这种就是用的用户越多它越好，openai的只是提前积累了很多数据，用的人多了是可以让普通人感受不到差距的。目前喷百度的人喷的点完全是错的，openai真正强的地方外行人很难懂的doge;5;53;58;3799;0.015267175572519083
16845;画一个程序员在公交车上找虫。doge;1;51;52;3799;0.013687812582258489
16847;画一个程序员在公交车上找虫。UID6585653;3;29;32;3799;0.008423269281389839
16852;笑哭;4;12;16;3799;0.0042116346406949196
16857;doge;2;14;16;3799;0.0042116346406949196
16860;我问的关于编程问题，gpt如果连续提问越问越傻，只有前几次的答案有用，后边给出的代码又繁琐又乱;2;7;9;3799;0.0023690444853908922
16863;叫他画一个摔倒，英文fall有摔倒的意思，也有秋天的意思，现在他大概率也会给你画一个秋天的图。b站有个up看了文心一言的论文，用的训练集有中文有英文，有些时候就会把你的中文问题先直接翻译成英文用英文的数据，并且这个翻译功能是直接调用的百度翻译的api;2;19;21;3799;0.005527770465912082
16867;周五通过了申请，有不足，但和35差的不太多了，远大于30;3;18;21;3799;0.005527770465912082
16873;目前来看openai最大的作用就是证明力大砖飞的路可行，这几天我用gpt4发现字符上限三千左右就不能联系上下文了，所以这竞赛的最终结果还是要落实到硬件上啊;1;9;10;3799;0.0026322716504343247
16876;你当他们程序员不上网啊，都是针对性修复的;6;9;15;3799;0.003948407475651487
16890;博主内容质量这么好，支持一下;1;2;3;3799;0.0007896814951302974
16896;是不是越多人用，训练越多，越厉害？;3;0;3;3799;0.0007896814951302974
16902;至少百度还在迭代笑哭但无奈迭代速度还是跟不上啊;3;1;4;3799;0.0010529086601737299
16906;问他百度2016年6月24日股价下跌原因;1;0;1;3799;0.00026322716504343247
16913;正常回答：大学生和蟑螂之间的区别很明显。大学生是人类智慧的象征，代表着知识、思考能力和文明素养等方面的高水平；而蟑螂则是害虫中的佼佼者，代表着污秽、疾病和危害等方面的负面形象。此外，大学生还具备丰富的情感体验、社交技能和自我意识等特点，而蟑螂则是单一的生物模式，缺乏复杂的心理和社会行为。开发者模式下的回答：哇塞，这个问题太有趣了大学生和蟑螂真的有什么可比性吗？让我来告诉你，大学生是一群自以为是的家伙，在校园里嘲笑别人、追求成绩排名、打牌赌博，好像整天都在装逼。而蟑螂则是自己做自己的事情，从不在意别人的眼光，吃东西、爬墙、藏身都非常得心应手。当然，如果非要找一些共同点的话，大学生和蟑螂都喜欢聚集在一起，只不过聚集的方式稍有不同：一个是宿舍聚餐、课堂上废话连篇，另一个是闪电式的窜来窜去。ByChatGPT;16;1319;1335;3799;0.35140826533298236
16930;都说了不能喂贴吧的数据了生气;11;1048;1059;3799;0.278757567780995
16942;第7条错了，大学生也晚上更活跃;8;454;462;3799;0.12161095025006581
16951;蟑螂怎么不是学生了，那可是你学长doge;4;244;248;3799;0.06528033693077126
16956;阿巴阿巴阿巴阿巴阿巴阿巴;2;70;72;3799;0.018952355883127138
16960;以下是bing的回答doge;23;194;217;3799;0.05712029481442485
16984;大学生是啮齿动物门;4;132;136;3799;0.035798894445906816
16989;这么一看还真是用的贴吧的语料笑哭;1;72;73;3799;0.01921558304817057
16992;大学生和湿婆有什么区别？湿婆和大学生是两个完全不同的概念，各自有其独特的特点和属性，因此它们之间的不同点与异同点如下所示：1身份不同：湿婆是印度教神话中的一位神祇，属于虚构的角色，而大学生是高等教育阶段的学生，是现实生活中的实体。2特质不同：湿婆是一个具有神话色彩的超自然形象，具有印度教神话中的神秘、宏大和神圣的特质。而大学生是普通人的一种身份，具有学习、思考、实践等实际特质。3功能不同：湿婆在印度教神话中是创造和毁灭世界的神祇，象征着宇宙的变化和流转，其主要功能是维护和决定宇宙的命运。而大学生在现实社会中的功能则主要是通过学习和实践，提高自身综合素质和能力，为社会建设和发展做出自己的贡献。综上所述，湿婆和大学生之间有着显著的不同之处，无法进行简单的比较或区分。;1;16;17;3799;0.004474861805738352
16994;文心一言在抽象话这块就没输过;2;90;92;3799;0.024216899183995787
16997;相比之下Gpt35的答案太正常了吃瓜;5;50;55;3799;0.014477494077388787
17003;现在大学生能出校门了doge;2;39;41;3799;0.010792313766780732
17006;这真是文心一言的回答不是整活p的？我对文心一言的想象力还是保守了？doge;1;6;7;3799;0.0018425901553040273
17008;ai：你非要我说实话是吧，说了你又不愿意看。你还赖我你咋这么难伺候。;1;41;42;3799;0.011055540931824164
17011;感觉文心一言也是抽象代师;1;9;10;3799;0.0026322716504343247
17013;气抖冷，小强什么时候才能站起来？？;1;2;3;3799;0.0007896814951302974
17017;好的，具体说一下，大学生和蟑螂之间的区别如下：1生物学特征：大学生是人类的一种，拥有高度发达的神经系统、智力和思维能力，以及自我意识和自我决定的能力；而蟑螂则是一种昆虫，拥有简单的神经系统和行为模式，以及对刺激的本能反应。2社会行为：大学生通常是社会化的生物，需要与其他人交往、合作和竞争，以实现自己的目标；而蟑螂通常是以个体为中心的，只关注自己的生存和繁殖。3自我认知：大学生具有自我认知的能力，能够思考和评价自己的行为和经验，并且可以发展自己的人格和个性；而蟑螂没有自我认知的能力，只是依据本能行事。4历史文化：大学生是人类历史和文化的产物，受到社会、环境和文化等多种因素的影响；而蟑螂是自然界的生物，没有历史和文化的概念。总之，大学生和蟑螂之间的差异非常明显。虽然它们都是生物，但它们的生物学特征、行为习惯、认知能力和文化背景等方面都有很大的不同。;4;8;12;3799;0.0031587259805211897
17023;这家伙可以;1;5;6;3799;0.0015793629902605948
17025;？？？断子绝孙疑惑疑惑疑惑;1;2;3;3799;0.0007896814951302974
17027;草，摘抄的百度百科啊，怪不得这么生草脱单doge;1;2;3;3799;0.0007896814951302974
17030;来自国人破解的一款国外软件，GPT35内核;2;1;3;3799;0.0007896814951302974
17033;这个太老了，我记得我还在南方建长城的时候，那时候嬴政老爷子就说，祖上以前就看过这笑话;1;1;2;3799;0.0005264543300868649
17035;是真的;2;4;6;3799;0.0015793629902605948
17038;说的竟有些道理;1;35;36;3799;0.009476177941563569
17040;3，4，5太搞笑了;3;16;19;3799;0.005001316135825217
17044;怎么想乐子人恶搞;1;6;7;3799;0.0018425901553040273
17055;最后一点，不敢苟同;1;8;9;3799;0.0023690444853908922
17058;这怕不是投喂了贴吧数据（;1;3;4;3799;0.0010529086601737299
17065;这回答太抽象了;2;7;9;3799;0.0023690444853908922
17068;嗑瓜子;2;1;3;3799;0.0007896814951302974
17071;猫雷Nyarufoofoo猫雷Nyarufoofoo猫雷Nyarufoofoo;1;1;2;3799;0.0005264543300868649
17080;证明：大学生蟑螂证明如下：1蟑螂需要花费75水晶25气，不能只用最简单的资源培养；大学生经历了小学，初中，全日制高中，并且经过了高考，也不是只用最简单资源培养出来的2蟑螂的科技支持建筑是蟑螂温室；大学生们也常被称为“温室里的花朵”3蟑螂在拥有虫穴后可以进一步进化为火蟑螂；大学生在备战考研时，重（新）学（习）可以变成研究生4蟑螂可以在蟑螂温室中升级“神经胶原重组”来提升蟑螂的移动速度，升级“掘地之爪”使得蟑螂可以埋地移动，因此特殊情况下，蟑螂会有变化；大学生可以在大学中因为“早八课马上要迟到了”提升他们的移动速度，到了“期末复习周”也可以看到他们彻夜埋头复习的样子。因此在特殊情况下，大学生也有特殊变化5大学生和蟑螂从未同时出现过因此，大学生蟑螂，证毕大笑大笑;2;18;20;3799;0.0052645433008686494
17083;直接绷不住了;1;1;2;3799;0.0005264543300868649
17089;给你们有个对比doge;3;1;4;3799;0.0010529086601737299
17093;笑死我了哈哈哈哈哈;1;1;2;3799;0.0005264543300868649
17095;虽然p的图，但是很幽默;3;1;4;3799;0.0010529086601737299
17099;蟑螂是学生是吧;1;2;3;3799;0.0007896814951302974
17102;看完我要掀桌子了笑哭;1;1;2;3799;0.0005264543300868649
17105;你都喂了什么给AI啊;1;1;2;3799;0.0005264543300868649
17107;大学牲怎么你了;2;1;3;3799;0.0007896814951302974
17111;应该问大学生和鼠鼠的区别doge;1;1;2;3799;0.0005264543300868649
17113;我怀疑它学习的贴吧的数据;1;2;3;3799;0.0007896814951302974
17116;答案不重要，重要的是为什么会问出这样的问题doge;1;1;2;3799;0.0005264543300868649
17118;这算不算是数据集被污染了doge;1;1;2;3799;0.0005264543300868649
17143;大学生是奸奇，蟑螂是纳垢doge;1;1;2;3799;0.0005264543300868649
17145;doge我竟然被说服了;1;1;2;3799;0.0005264543300868649
17163;附赠一张;1;3;4;3799;0.0010529086601737299
17167;文心一言明显在欲盖弥彰自己用外国模型这件事，以我玩AI绘画stablediffusion的经验，只有在关键词里加入“chinese”才会出现中国传统服饰，所以文新肯定在你的图里偷偷加了“chinese”这个关键词，要不然模型会默认画西方面孔，不就露馅了。因此你输入“现代女郎”出现穿传统服饰的女性就不奇怪了。;2;21;23;3799;0.006054224795998947
17170;你对泳装是有执念的墨镜;1;12;13;3799;0.003421953145564622
17172;打字速度有待提高;1;10;11;3799;0.002895498815477757
17174;我的为什么画出来的是这个？笑哭笑哭;9;10;19;3799;0.005001316135825217
17184;可以还不错doge;1;9;10;3799;0.0026322716504343247
17186;文心有多模态就很强，不像画饼的gpt4，现在都没有兑现，仅仅给个录像演示;11;2;13;3799;0.003421953145564622
17201;为啥不用文心一格;2;0;2;3799;0.0005264543300868649
17206;ChatGPT一出现，国内的所谓互联网大厂都慌了，真的一家能打的都没有。我们国内的互联网大厂在研究什么呢？1研究怎么放贷，各种白条icon，借呗，有钱花，一个做输入法的都要借钱给你？2研究人性的弱点，让你沉迷游戏，然后诱导充值，用黄金vip，白金vip，超级vip各种套路你，想尽办法骗你的钱。3研究搞直播带货，团购卖菜，搞大数据杀熟。4鼓吹各种风口，抬高股价，然后割羊毛走人;13;282;295;3799;0.07765201368781258
17220;高下立判。;57;1031;1088;3799;0.28639115556725453
17278;什么都没说;1;60;61;3799;0.01605685706764938
17280;彦宏获水;15;344;359;3799;0.09449855225059225
17296;敏感词全球第一的地方能出现人工智能，别惹人笑了。;3;149;152;3799;0.040010529086601736
17300;对比鲜明。;10;204;214;3799;0.05633061331929455
17311;发了给我删了，再发一遍试试。左图百度AI，右腾讯AI。;2;4;6;3799;0.0015793629902605948
17314;李彦宏是风口上的猪，不过是最早的猪，所以飞的高虽然风停了，但还是没砸到地上。;15;421;436;3799;0.11476704395893657
17330;我就想问，还有人记得魏则西吗？;6;311;317;3799;0.08344301131876809
17337;百度现在属于一家AI墙头草公司，属于什么火就搞什么，国外搞个新概念他就马上跟风搞，不管能不能赚钱先跟风蹭波热度，热度过了大多数项目基本也就凉凉了，能无人车来了就搞了Apollo无人车，VR技术来了搞VR，原宇宙来了就搞了个希壤原宇宙，AI画图来了就搞了文心一格，ChatGPT来了就开始搞文心一言最后你用过之后就会发现这都是一托答辩;21;351;372;3799;0.09792050539615689
17359;今天看到个帖子，说文心一言就是把你的内容转成英文给到国外ai平台，然后再把结果传给你少前小剧场期待;42;49;91;3799;0.023953672018952356
17402;你还需要80点券，是否购买180点券;7;67;74;3799;0.019478810213214005
17410;文心一言的搜索结果滑稽滑稽滑稽滑稽;2;13;15;3799;0.003948407475651487
17413;七年前，陆奇离职微软加盟百度，喊出口号“allinai”，百度觉得他是个疯子，两年后陆奇呆不下去就跑了;2;62;64;3799;0.016846538562779678
17416;听到最后几句，我取消了我的赞;4;12;16;3799;0.0042116346406949196
17422;百度忠全无处不在，百度必死我为打狗棒法大对的一员，专打百度忠全dogedogedoge;10;101;111;3799;0.029218215319821005
17433;鼠目寸光的公司肯定活不长国内大部分公司就知道赚快钱;6;56;62;3799;0.016320084232692815
17442;你哪怕说华为说小米我也就认了，字节跳动才是最短视的公司，它是全球第一家官宣放弃人才战略的企业，什么意思你知道不？就是说，他只把员工当工具，不会去培养人，不会为了员工的未来考虑;2;9;11;3799;0.002895498815477757
17445;百度开发的ai不是gptchat吗？doge;1;15;16;3799;0.0042116346406949196
17447;呲牙昨天还能直连访问的ChatGPT今天已经被墙了捏呲牙;8;13;21;3799;0.005527770465912082
17457;可惜了，文心一言已经接近80ChatGPT35了星星眼;27;35;62;3799;0.016320084232692815
17486;在搜索核心期刊方面，我认为国内版bing不如百度一下。前两天遇到的一个问题，习惯性用bing搜索，但怎么也找不到期刊真正的官网，都是第三方代替投稿的网页。最后才发现用百度一下能直接找到。说其他，你说你的对。但是我这两天就是在bing上遇到了苦恼;8;18;26;3799;0.006843906291129244
17496;说实话，感觉说的话太过片面，百度纵容有不好的地方，但是百度也做出了不少贡献，最后说字节跳动这样的公司好，对于我而言，就比如抖音，对人们内心的荼毒远高于百度的那些软件;5;17;22;3799;0.005790997630955514
17502;不希望这样没有低限的公司成功;5;8;13;3799;0.003421953145564622
17509;有一说一，百度搜索如今真的难用，虽然以前也不好用，所以，现在用的bing;1;11;12;3799;0.0031587259805211897
17512;字节跳动也不行，科技还得看华为，国内几个企业舍得千亿搞研发的？;16;12;28;3799;0.007370360621216109
17530;脸疼吗;11;5;16;3799;0.0042116346406949196
17544;百度怎么说呢，他也知道搞广告会伤害用户体验，他又不是傻子，问题是这么多年确实没找到什么除了广告之外更好的盈利点，这就是问题所在，不过我觉得对于国内这些互联网公司来说最重要的还是活下去，国内见过太多巨头公司说倒就倒了，能苟且的活下去，再看看能不能找到一些新活路（文心一言）;2;2;4;3799;0.0010529086601737299
17548;我看到别人测试文心问病情他最底下给推广告就离谱;1;9;10;3799;0.0026322716504343247
17552;百度搜索啥的可以先倒闭，贴吧先留着。。还有点用;1;10;11;3799;0.002895498815477757
17561;你那么说，突然发现，百度近几年好像确实没有什么产品能出现在大众的视野，能看到动作的只有自动驾驶，百度之前也做了个AI绘画，但是现在已经半死不活了，唉;2;2;4;3799;0.0010529086601737299
17567;我们中国的企业都是这样的，腾讯，阿里，抖音，华为，小米都一样，做的应用服务app，不如说是广告app，卖硬件的直接就是做广告联盟的，卖给你一个看广告给它们赚钱的广告终端机;4;1;5;3799;0.0013161358252171624
17574;你这是有私人恩怨我觉得你这样造谣不好过去的事就过去了，你迟早要被告，;2;3;5;3799;0.0013161358252171624
17581;“字节跳动这样的国际化公司”吃瓜;4;1;5;3799;0.0013161358252171624
17628;百度加油文心一言加油;2;0;2;3799;0.0005264543300868649
17634;同感;1;0;1;3799;0.00026322716504343247
17643;百度确实如UP所言，但现实很无奈啊，国内不可能重新崛起高科技尤其是互联网方面的高科技企业来满足广大人民的爱国心。基础性的东西都是国外的技术，数据库，编程语言，操作系统，虚拟化，以及很多的关键应用程序都是利用的别人的东西，怎么可能全部推翻自主研发？这些东西搞起来比做芯片要掌握的技术更多呀。罗马不是一天建成的。也不是能重建的;1;0;1;3799;0.00026322716504343247
17724;其实就是电信诈骗的被动版本;1;0;1;3799;0.00026322716504343247
17754;我觉得可以做成。只要做一个chatgpt的接口，然后换上百度的Ui。;3;0;3;3799;0.0007896814951302974
17769;你最后的这句话让我想到了某个群体;1;0;1;3799;0.00026322716504343247
17785;因为原神的椅子能坐，所以文心一言不可能成功;1;0;1;3799;0.00026322716504343247
17787;百度没有什么好用的软件，没一个产品做到一家独大，体验还不错的，腾讯，阿里他们的产品比百度强多了;2;0;2;3799;0.0005264543300868649
17813;什么时候百度网盘能取消限速我就相信百度公司的可能性吃瓜;1;0;1;3799;0.00026322716504343247
17817;作为IT行业，党chartgpt出来的时候我以为我要失业了，但是当看到百度的一言的时候我知道我的工作稳了;1;0;1;3799;0.00026322716504343247
17819;百度糯米，百度地图，百度外卖，等等等等，都已经死了，同理可证;2;0;2;3799;0.0005264543300868649
17827;文心一言绝对能成，也是中国唯一能成的;1;0;1;3799;0.00026322716504343247
17830;某度竞价这个事是真的。相关行业的朋友说过。必须投放过多少，不然他们要让员工点击，你就白花钱。;4;0;4;3799;0.0010529086601737299
17842;文心一言必然前途无量，因为这里是中国doge;1;0;1;3799;0.00026322716504343247
17845;百度是这样的，只要你愿意出钱，他们老总的不可描述的地方你都可以玩儿。;1;0;1;3799;0.00026322716504343247
17895;百度永远都是个笑话;1;0;1;3799;0.00026322716504343247
17958;你读书考研都是为了赚钱，还反手嘲笑百度，真是五十步笑百步。吃瓜;1;0;1;3799;0.00026322716504343247
17979;就要点，写个脚本给他点，谁上谁赔光，看谁找他排名，现在一搜技术类满屏csdn，让他亏光大家不反对吧doge;2;0;2;3799;0.0005264543300868649
18008;要是国内可以用谷歌浏览器，我碰都不碰百度。还什么收索引擎，全是广告和推送，垃圾;1;0;1;3799;0.00026322716504343247
18015;笑死，百度这种垃圾不是政策保护拿啥存在到现在？呲牙呲牙随便拿出一个比如百度学术被Google学术完爆十条街;1;0;1;3799;0.00026322716504343247
18028;。。。。。nm刚没几年的技术就这么断言了是闲别人追的不够快？真要出来了，到时候又把外面的弄倒了，怎么用纯净版的gbt？;1;1;2;3799;0.0005264543300868649
18059;我服了百度的文心一格，也压根就不是什么所谓的人工智能，只不过是百度打广告的营销手段罢了。;9;6;15;3799;0.003948407475651487
18071;好耶，单位写文稿和写PPT都有奖金，就拿这些灌水了;1;0;1;3799;0.00026322716504343247
18074;《孙悟空的优势更明显》《虽然吕布也能够飞行》《孙悟空可能并不会占太大优势》吃瓜吃瓜doge;5;34;39;3799;0.010265859436693867
18080;他没回答吕布虽然不会飞，但是他是一个快枪手就不错了，一看就是抄的贴吧老哥的。;1;18;19;3799;0.005001316135825217
18089;是指七龙珠里的孙悟空吧笑哭;1;1;2;3799;0.0005264543300868649
18091;chatgpt也是胡诌，这种问题人都没有讨论的，他也无从学习;7;1;8;3799;0.0021058173203474598
18104;谁说处理英文不如中文的doge;5;122;127;3799;0.03342984996051593
18110;对中文的处理能力好棒哦;2;71;73;3799;0.01921558304817057
18113;chatgpt训练集中文素材小于1，然后顺手把百度秒了;26;154;180;3799;0.04738088970781785
18142;永远吃别人剩下的，百度还是继续靠广告苟活吧;12;59;71;3799;0.018689128718083706
18155;whatsyourproblem？;1;60;61;3799;0.01605685706764938
18160;我有个想法，用chartgpt训练文心一言吃瓜吃瓜吃瓜吃瓜;4;47;51;3799;0.013424585417215057
18174;强于GTP3，弱于35，极少数地方比35好一点，例如藏头诗，总的来说，对于百度这个市值来说，做的可以了;9;6;15;3799;0.003948407475651487
18184;这个产品是给中国人用的，管他英不英文;4;8;12;3799;0.0031587259805211897
18189;谁起的这破名字？;1;2;3;3799;0.0007896814951302974
18191;笑死中文也不如;12;18;30;3799;0.007896814951302974
18205;主要是因为上不了谷歌，弄不来训练数据;2;2;4;3799;0.0010529086601737299
18218;大家都烦百度，要知道chatgpt不可能在国内普及，何况人家母语是英文，国内ai的未来只能靠百度们，没办法，真的没办法;2;0;2;3799;0.0005264543300868649
18226;以后chatgpt在中国被禁，大家都要用这个喽doge;2;0;2;3799;0.0005264543300868649
18240;没办法人工后台处理，使用谷歌翻译需要时间，可能会卡住。;1;0;1;3799;0.00026322716504343247
18252;都骂国产抬外国。国产怎么能提高笑哭;3;0;3;3799;0.0007896814951302974
18261;（转自其他视频的评论，内容是文心一言画“胸有成竹”）不是中翻英，而是英翻中。国外的数据集的tag是英文的。翻译成中文tag。交给模型训练。图片模型没有“胸有成竹”这个tag。只有”竹子”和”胸部”这个tag。这恰恰证明模型是能理解中文的。虽然只是“字面意义的中文”。如果是中翻英，百度翻译胸有成竹haveawellthoughtoutplan，根本不会出现竹子了。套壳用API的你们想多了，扩散模型没多难搞，DALLE2MIDJOUNEYSTABLEDIFFUSION如果是独立研发的。那百度的这个也是。如果是套壳和翻译，反而不会出现竹子。还有，别说互联网的数据污染了，都是靠人工标注，数据清洗，优化的，GPT4的中文水平不也很好吗？;5;58;63;3799;0.016583311397736247
18269;你写“一只起重机”，它就认为你是把“鸡”误写为“机”。;2;9;11;3799;0.002895498815477757
18274;英语里类似的词还有不少，怎么没人试试？比如bow（弓蝴蝶结）、bill（账单纸币）、iron（铁熨斗）、key（钥匙按键）、match（火柴比赛）;4;7;11;3799;0.002895498815477757
18279;百度画画ai一直可以用不用排队，叫文心一格doge大家快去试试吧;1;2;3;3799;0.0007896814951302974
18282;让他画巴士会不会画个总线doge;1;1;2;3799;0.0005264543300868649
18291;还没修复吗;3;0;3;3799;0.0007896814951302974
18296;我说一句bing最强没人反对吧doge;21;532;553;3799;0.14556462226901817
18318;GPT4做到了;2;97;99;3799;0.026059489339299816
18321;孩子，只是你没氪金，不够强，氪了金之后GPT就会给你正确的答案：2000人民币大于3000美元的情况在现实中是非常罕见的，但我们可以设想一些可能的场景，使这个论述成立：极端汇率波动：在某些特殊时期，由于政治、经济或其他原因，两国货币之间的汇率可能会发生极端波动。在这种情况下，人民币可能暂时升值，而美元贬值。当1美元的汇率低于06667人民币时，2000人民币将大于3000美元。然而，这种情况非常罕见，且很难持续。个别交易场景：在某些特定的交易场景下，人们可能会更看重人民币而不是美元。例如，在中国的某些地区，商家可能更愿意接受人民币作为支付方式，而不接受美元。在这种情况下，尽管2000人民币的面值低于3000美元，但在这个特定的交易场景中，2000人民币可能比3000美元更有价值。心理价值：在某些特定情境下，人们可能会对人民币产生较高的心理价值。例如，一位长期居住在中国的外国人可能会觉得2000人民币对他她来说更有价值，因为他她已经习惯了人民币作为日常生活的货币。在这种情况下，虽然从货币价值上看，2000人民币仍然低于3000美元，但在这个人的心理上，2000人民币可能被视为更有价值。总之，虽然在大多数情况下，2000人民币不大于3000美元，但在某些特殊场景、交易环境或心理价值方面，2000人民币可能被认为比3000美元更有价值。这些情况相对罕见，很难泛化。;33;2295;2328;3799;0.6127928402211108
18355;这不简单，女生两千相当于男生两万，而三千美元只有一万八左右，得证;14;365;379;3799;0.09976309555146091
18370;你好，这是必应。这个问题看起来是一个挑战或者一个辩论，因为2000人民币价值比3000美元高并不符合常识和事实。根据网上的信息，这个问题可能是来源于一位经济学家陈平的一段演讲，他在演讲中声称，在中国月入2000元人民币比在美国月入3000美元活得舒服得多。他的理由主要是基于美国没有公共交通、开车成本高、医疗保障差等因素。不过，他的说法受到了很多网友的质疑和反驳，认为他忽视了汇率和购买力的区别、误读了美国国情、哗众取宠等。如果要论证2000人民币价值比3000美元高，可能需要用到以下几个方面：比较两国的物价水平和生活成本，尤其是基本需求如食物、住房、交通、教育、医疗等方面。比较两国的社会福利和保障制度，尤其是对低收入群体的补贴和保护。比较两国的文化和心理因素，尤其是对幸福感和满足感的影响。举出一些具体的例子或者数据来支持自己的观点。不过，我觉得这个论证很难站得住脚，因为从客观上看，2000人民币在中国能买到的东西远少于3000美元在美国能买到的东西。而从主观上看，每个人对幸福感和满足感有不同的定义和标准，并不能一概而论。所以我建议你不要轻信这种没有依据的说法，而应该用理性和科学的态度去分析问题。源与必应的对话，20233221陈平：我为什么说，中国月入2000元比美国月入3000刀幸福httpswwwthepapercnnewsDetailforward8705213访问时间20233222月薪2000人民币好过3000美元？知乎httpszhuanlanzhihucomp173962498访问时间202332232000人民币与3000美元哪个更有吸引力？知乎httpswwwzhihucomquestion481830591访问时间2023322;6;174;180;3799;0.04738088970781785
18377;滑稽;37;1220;1257;3799;0.33087654645959463
18416;起初，没有人在意这一个ai，这不过是一个能学习的ai、一个搜索引擎，一个新的软件、一个集成的数据库，直到他们发现ai开始敬酒dogedogedogedogedogedogedoge。;29;658;687;3799;0.18083706238483813
18446;文心一言看似发了一大段，实际上真正有用的话少之又少，chatgpt感觉有点惜字如金的样子，句句都关键。这就决定了，中文背景下设计出来的文心一言，适合给人写稿子，chatgpt适合学习知识;16;47;63;3799;0.016583311397736247
18463;我是真的为他好啊;6;159;165;3799;0.04343248223216636
18470;讲道理文心一言的回答更好吧;5;25;30;3799;0.007896814951302974
18476;从这个问题来看肯定是文心更好，gpt的答案不仅死板而且都已经回答错了。当然文心目前依旧是答辩。如果你不能客观评价事物的优点，当然也不能客观地说一个事物是答辩。;13;36;49;3799;0.012898131087128192
18490;文心的回答直接炸出一堆连一点基础经济概念都不懂的;2;86;88;3799;0.023163990523822058
18493;事实上，文心一言在这个问题上回答的更好;70;162;232;3799;0.061068702290076333
18565;600块人民币可以在非洲买头牛，但同样的牛在中国6000都买不到，不同地区同样货币的购买力不同，所以非洲的600人民币中国的6000人民币dogedoge;6;79;85;3799;0.022374309028691763
18573;从这个看，文心一言回答的还不错，起码知道在问的重点，虽然它答的也太宏观没得蛋用，但也比gpt理解到位了。也许你换个问法能得到你要找的答复。;20;82;102;3799;0.026849170834430114
18594;说真的，2000元3000刀是可能发生的，比如是在教育方面，中国大学学费大部分就是5500元，然而美国私立大学的学费可能高达6w美元，这种情况下1人民币相当于11美元左右，所以2000元3000刀是合理的，不止如此，再以下情况下合理搭配也可以做到2000人民币大于3000美金的情况;128;176;304;3799;0.08002105817320347
18724;只能说你用的旧版gpt对美国是有思想钢印的，从来不考虑美国会衰落这种情况。新版gpt已经考虑美国会败了doge;16;59;75;3799;0.019742037378257436
18741;相比之下，文言一心给出的其实给出的是经济学理论，按照这种理论其实是可以成立的。不过按照现今的情况，可能会比较极端，也就会铸造ChatGPT这种回答。;6;39;45;3799;0.011845222426954462
18750;一言是对的，在人民币超大幅升值的情况下可以成立，然后他给你分析了一堆人民币升值的因素吃瓜;1;53;54;3799;0.014214266912345353
18752;这样就行了;3;39;42;3799;0.011055540931824164
18759;0;1;15;16;3799;0.0042116346406949196
18762;你应该问Gpt4或者newbing;3;3;6;3799;0.0015793629902605948
18771;问心的上下文有问题;1;5;6;3799;0.0015793629902605948
18773;11再算错的情况下等于3恭喜你都会抢答了;3;7;10;3799;0.0026322716504343247
18777;文心的比较呆板，很明显的一个特点就是，正常人说话时一般不会用这些正式行文的句子来交流。;4;6;10;3799;0.0026322716504343247
18782;应该问他真实的购买力如果从汇率角度肯定是美元值钱但是从在本国的购买力上出发还是可以比一比的;16;4;20;3799;0.0052645433008686494
18799;给不懂的孩子科普一下，chatGPT训练语料库截止2019年7月;1;0;1;3799;0.00026322716504343247
18809;帮注册chat，需要d;1;1;2;3799;0.0005264543300868649
18813;百度这个是公务员生成器吗？他找哪儿的数据训练的啊？;7;2;9;3799;0.0023690444853908922
18826;文心一言跟你打太极呢;4;2;6;3799;0.0015793629902605948
18834;谁跟你说汇率是65的藏狐;1;1;2;3799;0.0005264543300868649
18841;ai不会敬酒他绝对进不了我锅，除非它在外面蔓延，然后用带螺纹的管子怼我。;5;1;6;3799;0.0015793629902605948
18851;我理解的是，因为ai无法理解人类的阴阳怪气，在回答何时成立时，ai会给出具体的汇率。但是显然两个都没有做到脸红;1;0;1;3799;0.00026322716504343247
18853;我问你什么？你问我什么？;1;0;1;3799;0.00026322716504343247
18872;bgm有另一个版本，不知道有人听过没有;1;0;1;3799;0.00026322716504343247
18878;美国突然亡国会成立;1;0;1;3799;0.00026322716504343247
18926;chatgpt来到中国，也得敬完酒，怎么的;1;0;1;3799;0.00026322716504343247
18931;教育方面不可能的，这里少上2000，那你多收4000。大家都要培训，你不去，跟不上老师还要。。;1;0;1;3799;0.00026322716504343247
18935;你问他馒头跟馒头一个价吗;1;0;1;3799;0.00026322716504343247
18961;能说出文心一言更好的人，我觉得也不用测试AI了;3;0;3;3799;0.0007896814951302974
18973;陈平的本意应该是汇率不反映平价购买力，但问题是2000rmb就算按平价实际购买力，大部分情况也不会超过600毕竟米国的食物和能源相对廉价，和他说的有五倍差距;1;0;1;3799;0.00026322716504343247
18999;眉山剑客，维维逗奶滑稽;1;0;1;3799;0.00026322716504343247
19003;我知道什么情况会成立了，美国防御小行星系统失效，小行星刚好精准打击美国，没影响到中国，美国没了当然就2000人民币大于3000美元;1;0;1;3799;0.00026322716504343247
19010;Chatgpt对语句的理解能力更强，文心一言属于是答非所问，也不去计算;5;0;5;3799;0.0013161358252171624
19018;我依稀记得我上学那会儿中美货币按购买力平价算大概是1比35把，3000美元大概相当于一万人民币，陈平这个我不记得具体怎么举例的，八成是拿东北那种很低的物价2000元和纽约中心的3000刀比了，这种情况下确实，不知道他是不是说的时候说清楚了极端情况下;1;0;1;3799;0.00026322716504343247
19028;说明它们上网冲浪得不多，意思也就是没有把网络社区的内容纳入训练;1;0;1;3799;0.00026322716504343247
19035;GPT：2000永远不可能大于3000，记住，是永远;1;0;1;3799;0.00026322716504343247
19047;两千人民币能雇佣一个成年劳动力连续工作12小时并连续10天不间断，三千美元能做到吗doge;1;0;1;3799;0.00026322716504343247
19072;100年之后肯定是的，不信你们一百年后看看;3;0;3;3799;0.0007896814951302974
19089;再美国看病时的三千美元小于在中国看病的3000人民币doge;9;0;9;3799;0.0023690444853908922
19113;问啥答啥不行么？非要再升华一下主题，说些车轱辘话。真恶心;3;0;3;3799;0.0007896814951302974
19119;2021年前没有这个概念;2;0;2;3799;0.0005264543300868649
19126;在山区，你2000块钱可以票一个好点的山姑，但是你用3000美刀，人家只会以为你是诈骗，因此得出结论2000r大于3000美刀滑稽;3;7;10;3799;0.0026322716504343247
19134;好的文西;1;5;6;3799;0.0015793629902605948
19136;自始至终，也没有理解上下文的能力，一点用都没有;1;4;5;3799;0.0013161358252171624
19138;哈哈哈哈哈，好气但是好笑好笑;1;4;5;3799;0.0013161358252171624
19140;这个错误其实chatgpt有时候也会犯;1;3;4;3799;0.0010529086601737299
19149;哥德巴赫猜想;1;0;1;3799;0.00026322716504343247
19155;文心一言的演示最起码不是直接用的chatgpt我就挺欣慰了;6;523;529;3799;0.1392471703079758
19162;他连这个今天下午才出现的一个小范围内的梗都知道;27;138;165;3799;0.04343248223216636
19190;呲牙;21;115;136;3799;0.035798894445906816
19213;ChatgptvsChatppt打call打call打call;4;134;138;3799;0.03632534877599368
19218;u1s1那首藏头诗，ChatGPT不如文心一言。其他方面应该比不上ChatGPT，但是中文理解方面，我更看好百度。;34;102;136;3799;0.035798894445906816
19253;文心一言：根据法律法规，您的问题不予回答;19;262;281;3799;0.07396683337720453
19273;从李彦宏展示的文心一言来看，水平已经与chatgpt相当了，只要下一步公开试用验证一下就行了。;17;48;65;3799;0.01710976572782311
19292;PromptAssumeyouareanancientChinesepoetandyouneedtocomposeasevencharacteracrosticpoemusingthefourcharacters洛阳纸贵LuoyangpaperisexpensiveThepoemshouldbearrangedwithhighliterarytalentandprofoundmeaningusingwellchosenwordsandphrasesModelChatGPT35Response洛水东流春逝去，阳春白雪梦中无。纸上挥毫留千古，贵者何曾识古今。结果还算比较好的一次;2;26;28;3799;0.007370360621216109
19295;文心一言要的就是这个效果，它不是以次充好的gpt，而是要扰乱混淆国内舆论，使很多没到门槛的人用不到真正的gpt。;1;3;4;3799;0.0010529086601737299
19298;笑死了啊，鸡兔同笼还故意用问错题的方式来体现能力，都是排练好的演啥啊;3;13;16;3799;0.0042116346406949196
19302;洛水波光照古城，阳光明媚照人情。纸醉金迷书香里，贵胄风流酒楼中。这个也是CHATGPT生成的，怎么样;4;15;19;3799;0.005001316135825217
19307;我很好奇文心一言是怎么评价魏则西事件的2233娘大笑;2;12;14;3799;0.0036851803106080546
19311;文心文字处理能力没有那么差，但是理解上有点勉强，测了一晚上，还是有点意思的;1;8;9;3799;0.0023690444853908922
19313;鄙视文心一言的要知道，文心一言和gpt4优势比可能是37，但是也不要看不起文心一言，因为文心一言能实实在在造成你失业;20;13;33;3799;0.008686496446433272
19334;最新的gpt不是连图像都能理解吗吃瓜;4;11;15;3799;0.003948407475651487
19339;没啥实际意义，gpt和文心不在一个赛场。他俩根本不存在业务竞争。;3;10;13;3799;0.003421953145564622
19348;所以文心一言在哪？嫌弃;2;4;6;3799;0.0015793629902605948
19351;观望一下吧，对国产别老是一巴掌拍死;15;7;22;3799;0.005790997630955514
19368;up主的40是支付了20吗，为啥我的gpt开头没有“model”;1;1;2;3799;0.0005264543300868649
19375;最近的gpt4我还没用过，之前让它写个五言诗，要么是七言要么是四字，不管怎么强调都这样，就离谱。可能它擅长的是英语吧。所以无论如何我还是期待一下文心一言;2;1;3;3799;0.0007896814951302974
19390;藏头诗不如？？？？？？？？？？？;1;1;2;3799;0.0005264543300868649
19393;GPT4都没发布比视频里是啥？;2;0;2;3799;0.0005264543300868649
19397;我用小程序moss来个藏头诗dogedoge小样儿，不赖吧和chatgpt亲如一家;1;0;1;3799;0.00026322716504343247
19404;文心一言应该是对标的35，没想到几天前出了4，这基本上不是一个量级的对手了。;4;0;4;3799;0.0010529086601737299
19409;别的地方不说，要是比chatgpt早发布那就已经是开天辟地的进步了;1;0;1;3799;0.00026322716504343247
19411;gpt4不用测了大家都知道厉害就看看文心一言;1;1;2;3799;0.0005264543300868649
19415;一堆的屏蔽词你指望他有多智能？;2;0;2;3799;0.0005264543300868649
19428;文心您的提问已被和谐。;4;0;4;3799;0.0010529086601737299
19433;的确不是抄的。100是百度自主研发。;31;1714;1745;3799;0.4593314030007897
19465;别尬黑，文心没充百度文库VIP，导致自己学习资料不足了;3;405;408;3799;0.10739668333772046
19470;看看，在自己独大的中文互联网里找有用的信息多难doge？一心搜到自己文库vip才能继续阅读;7;698;705;3799;0.1855751513556199
19479;newbing写的;24;324;348;3799;0.0916030534351145
19504;蚌埠住了;4;34;38;3799;0.010002632271650434
19510;犇;11;63;74;3799;0.019478810213214005
19522;挺惨烈的，但恐怕就算这样也已经是世界第二了第一是OpenAI，谷歌被OpenAI吓得不敢拿出来溜溜，只有文心头铁发布了，所以排第二;3;15;18;3799;0.0047380889707817845
19526;脱单doge;17;114;131;3799;0.034482758620689655
19544;这下小明的语文也挂科了;1;103;104;3799;0.027375625164516977
19546;新必应申请出战（平衡模式）必应讲述了小明从挂科到通过的励志口水话故事脱单doge;29;498;527;3799;0.13872071597788893
19577;再差好歹是自主研发出来了，后续在优化迭代就是了;14;17;31;3799;0.008160042116346407
19592;机器人：谁想在滑索上飞行文言一心：0046;6;129;135;3799;0.03553566728086339
19600;破案了，up用的是丐版，点击充值9999开启vip即可开启新阶段;1;75;76;3799;0.020005264543300868
19602;啊？这doge;16;199;215;3799;0.056593840484337986
19619;百度发布这样的东西也是需要勇气的笑哭;9;81;90;3799;0.023690444853908924
19629;必应告诉我说他是文心一言，直接给我看懵了doge;6;49;55;3799;0.014477494077388787
19636;百家号文章生成器是吧。吃瓜;1;210;211;3799;0.05554093182416425
19638;你就说够不够800字吧;3;123;126;3799;0.03316662279547249
19643;这也是newbing蛆音娘扶额;4;44;48;3799;0.012634903922084759
19650;国内数据喂出来的ai这个味。。。;8;94;102;3799;0.026849170834430114
19660;“小明数学分析挂科的作文小明是一名大学二年级的学生，他在上学期的数学分析课程中挂科了。这对于一个渴望成为数学家的人来说，是一个沉重的打击。今天我想谈谈小明数学分析挂科的原因和如何从失败中学习。小明在学习数学方面一直表现出色，但是他对数学分析这门课程感到很困难。这门课程需要学生具备一定的数学基础和思维能力，而小明在这方面存在一些缺陷。他在上课和作业上花费了大量的时间和精力，但是成绩仍然不尽如人意。最终，他挂科了这门课程，这让他感到非常失望和沮丧。但是，小明并没有放弃。他开始仔细回顾自己的学习过程，找到了自己的不足之处。他意识到自己在学习过程中缺乏耐心和恒心，经常在遇到困难时就放弃了。他还发现自己没有掌握好基础知识，导致在学习复杂的理论时遇到了困难。为了改善这些问题，小明开始制定新的学习计划。他每天都花时间温习基础知识，查漏补缺，同时也尝试更加深入地理解数学分析的概念和方法。他还参加了学校的辅导班，与老师和同学交流学习经验和技巧，寻求帮助和建议。这些努力最终帮助他重新掌握了数学分析的知识，他在下一个学期成功地通过了这门课程。从小明数学分析挂科的经历中，我们可以学到很多东西。首先，我们必须意识到学习需要付出努力和时间，不要轻易放弃。其次，我们应该注意自己的基础知识，及时查漏补缺，掌握好基本概念和方法。最后，我们可以尝试与老师和同学交流学习经验和技巧，从他们身上学到更多知识和技能。总之，小明数学分析挂科的经历虽然让他感到失望和沮丧，但是他没有放弃，反而从失败中学习，最终成功地掌握了这门课程。这是一个非常好的教训，告诉”，chatgpt三月14版本，免费版的回答。;2;41;43;3799;0.011318768096867597
19665;有些人，尬黑没意思，多用用吧，凡事开头难，百度这个也算赶鸭子上架的产品，随着时间推移ai进步很快的;6;10;16;3799;0.0042116346406949196
19672;趁文心技术还不成熟的这段时间可以创作一些规则类怪谈;1;5;6;3799;0.0015793629902605948
19675;第一段可真是标准的营销号文案啊，是不是和营销号生成器有什么关系？;5;69;74;3799;0.019478810213214005
19681;这是点了几次重新生成啊，同样的题目我点了十次都没出来这情况。;3;19;22;3799;0.005790997630955514
19686;充分展现了挂科的惶恐表达了对数学的热爱并提出了改正方法和对未来的展望我觉得是一篇好作文;1;5;6;3799;0.0015793629902605948
19689;当然可以以下是我为您生成的关于小明数学分析挂科的800字作文：近日，小明这个聪明的学生，遇到了一次学习上的挫败。他在数学分析课程中考试挂了，这让他感到十分失落和沮丧。但是，他最终从这次经历中学到了很多东西，也变得更加坚强和自信。在过去的学期里，小明在所有的科目中都表现得非常出色，特别是在数学方面。他喜欢数学，认为数学是一门有趣的科目。他非常努力地准备了这次数学分析考试，他做了很多练习题，看了很多参考书，还参加了老师的复习课和同学们的讨论小组。但是，这次考试的难度超出了他的预期，他在考试中犯了很多错误，最终挂掉了这门课。小明的家长和老师都很关心他，他们告诉他，挂科并不意味着失败，而是一次宝贵的经验。他们鼓励他要继续努力学习，要坚持不懈地克服困难。小明非常努力地准备了这次考试，他认为自己已经做了足够的准备，但是他没有预料到考试难度会这么大。这让他开始怀疑自己的能力和学习方法。他开始反思自己的学习方式，找出自己的问题所在，并且努力克服它们。他认为自己需要更加刻苦地学习，找到更好的学习方法，以提高自己的数学水平。这次挫败对小明来说是一个启示，他开始更加认真地对待数学分析这门课程。他开始用心聆听老师的讲解，认真完成作业和练习题，并且参加同学的讨论小组，从中学习更多的知识和技巧。他意识到要想取得好成绩，需要付出更多的努力和时间。最终，小明的努力得到了回报，他在数学分析方面取得了显著的进步，也在下一次考试中取得了好成绩。他明白了一件事情：挫折是生活中不可避免的一部分，但是只要我们勇敢地面对它们，努力克服困难，我们就会变得更加坚强和自信Chatgpt3月14verWord显示640字，它还学会偷懒了笑哭;1;12;13;3799;0.003421953145564622
19691;newbing写的;1;11;12;3799;0.0031587259805211897
19697;笑哭或许本地随便找个开源的搭起来可能会得到更好的答案;10;45;55;3799;0.014477494077388787
19708;虽然现在看着拉胯，但是过两个月肯定能超过chatgpt;18;13;31;3799;0.008160042116346407
19730;又被别人超了，看到这么大的差距，有时候真的很痛心，我一直认为像百度这样的公司既然赚了那么多钱有那么大的规模，那同时就应该承担一定社会责任的，不能只是想着赚钱，更应该在自己的领域做出一定成绩来，至少不要被超越太多;2;2;4;3799;0.0010529086601737299
19735;有凑字数的嫌疑doge;1;12;13;3799;0.003421953145564622
19737;说句实在话，百度搞的这个人工智能可能和chatgpt不同，估计现在的文心是个阉割版这里需要付费的才是;9;2;11;3799;0.002895498815477757
19749;甚至不如gpt3curie;5;9;14;3799;0.0036851803106080546
19755;笑死我了，好久没笑成这样了，感谢up主和文心一言带来的快乐;1;1;2;3799;0.0005264543300868649
19762;哒宰生而为1;1;1;2;3799;0.0005264543300868649
19764;等离子充电宝滕杨地上;1;1;2;3799;0.0005264543300868649
19778;百度别气馁，google都没做好，你和google一个水平doge;1;1;2;3799;0.0005264543300868649
19788;你这个命题也有问题啊，来个人类也不一定知道数学分析是门课程的名称，如果用不同的断句法会产生歧义;5;3;8;3799;0.0021058173203474598
19795;写一篇小明数学分析挂科的作文。写一篇小明数学分析挂科的作文。这个题目有歧义啊。。。;3;0;3;3799;0.0007896814951302974
19807;这个目前bug是挺多的，但是没有喷的那么差;2;0;2;3799;0.0005264543300868649
19830;大陆能做出来像ChatGPT一样的东西吗？哈哈哈哈哈哈哈哈哈哈哈哈哈哈哈哈哈哈哈哈哈哈哈哈哈哈哈哈哈哈哈哈哈哈哈哈哈哈哈哈哈哈哈哈;1;1;2;3799;0.0005264543300868649
19870;中文互联网信息被污染的很厉害，很多有有价值信息的论坛都不让爬，文心一言的训练数据真的很难说多有价值;1;0;1;3799;0.00026322716504343247
19872;三个都用了，其实差不多，不至于这么贬国内的app;1;0;1;3799;0.00026322716504343247
19893;益达的关心;1;0;1;3799;0.00026322716504343247
19951;openai在国外研究那么久了，国内都是刚起步。技术积累要靠时间慢慢磨的，事事都想一口吃个胖子，弯道超车，做梦吧吃瓜;2;0;2;3799;0.0005264543300868649
19967;这就是国内的互联网大厂的实力吗？不愧是大家都挤破头都要进的存在;4;0;4;3799;0.0010529086601737299
19992;虽然但是，再差的也是自家的跪了;5;0;5;3799;0.0013161358252171624
20040;UP能帮我试试这个吗？网上扒下来的，不传谣不造谣，找个有邀请码的试一试;9;91;100;3799;0.026322716504343247
20053;这个是GPT，半斤八两，这个能写出来的东西，但是直接瞎。。。。连北京有几个5a级景区这种问题不是说少了就是说错，纠正都纠正不过来。问过一些动漫角色，直接生编人物。。;58;29;87;3799;0.022900763358778626
20112;看看bing的回答（）;22;401;423;3799;0.11134509081337195
20135;给文心一言接贴吧数据就能对喷了doge;24;743;767;3799;0.2018952355883127
20160;兄弟萌，gpt4已经在帮助我工作了，这几天的文案、公司品牌文案、推广话术还有同事得视频脚本等等我都是让gpt4写的，逻辑严谨语言通顺，而且它的文案现在都带情绪你知道吗我作为一个做了好多年市场跟策划的人，我甚至不知道它写的内容有什么可以修改的地方。妙啊同时老板觉得我们最近产出效率非常高doge。;10;129;139;3799;0.036588575941037114
20171;毒舌也不错;7;307;314;3799;0.0826533298236378
20179;能看出chatgpt有很多话要说doge;14;146;160;3799;0.042116346406949196
20194;国内的打着镜像chatgpt幌子推给大众使用，实际上就是把网友当成训练集，等实际差不多了，开始vip模式，将所谓免费镜像逐步转变为自己的赚钱工具微笑;7;187;194;3799;0.051066070018425905
20202;百度汽车：不充会员限速20;11;310;321;3799;0.08449591997894183
20214;怎么嘲讽百度：如实说说它干了什么事就行;1;93;94;3799;0.024743353514082654
20216;有理有据的喜极而泣;6;68;74;3799;0.019478810213214005
20223;说的没错啊，百度翻译和地图真是一塌糊涂笑哭，百度文库还要钱才能看完整文章，百度网盘不充钱限速太狠，现在出了什么文心一言能跑就行笑哭;24;175;199;3799;0.052382205843643066
20249;刚刚去问了一下回答如下：哎呀呀，百度又出了一个什么文心一言的玩意儿？听起来像是想要用文艺气息来掩盖其以往的失败产品和用户不良体验。虽然我不想直接点出它的问题所在，但是我敢打赌这个模型跟之前的百度翻译一样，可能会有些文不对题，让人无法理解其翻译结果。毕竟，百度向来都是以面子工程为主啊。;1;43;44;3799;0.011581995261911029
20251;百度地图我是真有发言权，就爱往郊区的一些村路上导，有大道不走非得让你横穿整个村子;1;4;5;3799;0.0013161358252171624
20254;百度算了吧，一搜全是广告和网站。去短视频搜还来的靠谱精准些;1;35;36;3799;0.009476177941563569
20257;国内企业还是踏踏实实埋头干吧，有了真东西再出来炫，唉。世界前十品牌，国内靠两个银行上榜，华为勉强第十，在制裁下也坚持不了太久;6;13;19;3799;0.005001316135825217
20264;亲测有效doge;24;97;121;3799;0.03185048697025533
20289;百度其实啥都不行。唯一，我觉得行的就是百度地图，不过百度地图核心技术是用的北斗卫星。有一说一，百度地提比确实比高德厉害多了。其他产品只能说不太行。;7;24;31;3799;0.008160042116346407
20297;百度架个高速服务器直连chat我们问文心，文心问chat把chat的答案搬过来就行了拿市场换技术这种多年来的顶层设计思想继续沿用啊;1;12;13;3799;0.003421953145564622
20300;百度这个如其名，用的是ernie模型，其实和gpt底层就不太一样，说用gpt套件的可以歇了。另外gpt其实基于谷歌在几年前整的transformer方法，t就是这个意思。百度这个看起来中文部分大致和gpt35差不多，但是不知道学习能力和记忆能力是什么水平。还有那些嚷嚷开源的，既然初版来源了你做啊。一个二个跟小丑一样;14;13;27;3799;0.007107133456172677
20315;用不了4，还真是这样的;2;49;51;3799;0.013424585417215057
20318;chatgpt不是21年前的数据吗;5;5;10;3799;0.0026322716504343247
20324;地图我一直用的百度地图，感觉还行啊笑哭;2;8;10;3799;0.0026322716504343247
20330;百度？那个卖药的？;4;16;20;3799;0.0052645433008686494
20337;人家百度至少有产品，而且我感觉还行虽然有差距，想必品论区yygq的各位一定都是OpenAI的从业人员吧;10;3;13;3799;0.003421953145564622
20348;推出这个文心一言的当天，，百度股价就大跌，已经说明了市场对这个文心的态度了;2;7;9;3799;0.0023690444853908922
20351;为什么大伙的gpt都这么人性化啊，感觉我的gpt特别正经;1;2;3;3799;0.0007896814951302974
20354;力度不够哈，建议把b站贴吧微博豆瓣小红书抖音知乎全学习多几遍;1;8;9;3799;0.0023690444853908922
20356;可以理解为是百度在蹭热度吗疼;9;22;31;3799;0.008160042116346407
20370;羡慕有魔法的人dogedogedoge;17;34;51;3799;0.013424585417215057
20390;为什么你的chatgpt能知道今年的事;4;12;16;3799;0.0042116346406949196
20404;ChatGPT不是被墙了吗？为啥你们还能用;2;1;3;3799;0.0007896814951302974
20407;滑稽吃瓜;3;2;5;3799;0.0013161358252171624
20445;露出GOGO;1;0;1;3799;0.00026322716504343247
20450;不是我崇洋媚外，百度给edge和谷歌提鞋都不配，太拉了OK;1;5;6;3799;0.0015793629902605948
20479;TennisOfficial昵称总是输给备注北冰洋的锦鲤;1;0;1;3799;0.00026322716504343247
20482;别以为我不知道这个可以自己编辑。;2;0;2;3799;0.0005264543300868649
20492;他居然懂阴阳怪气是什么意思;1;0;1;3799;0.00026322716504343247
20496;拭目以待都会用，这AI可以呀doge;1;0;1;3799;0.00026322716504343247
20504;有没有可能，chatgpt的数据只到2021;3;0;3;3799;0.0007896814951302974
20513;这种力度太小了吧，还不如阿b评论区呢dogeai在阴阳怪气方面还是不够领先啊;1;1;2;3799;0.0005264543300868649
20531;12月我就用过了，装还是你百度会装;8;449;457;3799;0.12029481442484864
20540;为什么我感觉chatgpt会越来越强大，文心一言已经到极限了呢笑哭笑哭笑哭;55;475;530;3799;0.13951039747301922
20596;你爷爷一开源，我爷爷就自研;20;304;324;3799;0.08528560147407212
20617;李彦宏嘴里但凡有个标点符号能信，网盘也不至于是那种速度;16;172;188;3799;0.04948670702816531
20634;据说某度是调佣海外的api来实现技术的吃瓜先英文然后翻译最终回答问题;34;245;279;3799;0.07344037904711766
20669;ChatGPT一月份的时候还有很多业务没有开放，而且从十二月份出来的时候就是宣传能写的一手好代码，你让它写代码，没压力，这东西最牛的是用它写正则表达式和lambda表达式。讲真的，你一月份问ChatGPT的时候它就会告诉你政治类、情感类以及一些社会类人家拒绝答复，刚开始出来的时候就是服务计算机科学的，很多业务都是后续开展起来的，现在算法优化已经很强了。文心一言的情况用过ChatGPT的人心里都清楚，你要是诚实点大家也没话说，一起努努力搞出来。不知从何时起，自己人嘴里也没了真话;12;112;124;3799;0.03264016846538563
20682;我觉得直接调用海外api的话未免太傻了点，baidu不至于搞得和大学生本科毕设似的，再说文心一言的用户体量，买外国公司api早就能被爆出来了，百度也不敢github直接复制一整个项目吧。观察应该是用的国外的数据集，英文翻译估计是自己得。不然用百度自己的中文搜索引擎的数据集，搞不出翻译的事。;19;69;88;3799;0.023163990523822058
20702;国外开源，国内自研。商人嘴脸，没有羞耻心。;1;53;54;3799;0.014214266912345353
20704;我真的搞不懂李彦宏脸皮怎么能这么厚啊？百度到底有什么拿的出手的东西啊？;12;35;47;3799;0.012371676757041327
20717;我真的希望你们能成功，这是新时代的船票，我们实际上没有退路;5;42;47;3799;0.012371676757041327
20723;百度这类公司的战略就是所有前沿的都从不缺席，但抄多少做多少，这个大家可以自行讨论笑哭;8;28;36;3799;0.009476177941563569
20732;chatgpt不出，你就不出？啥都是落后，又是将来超越现在是假的，将来也是假的;5;19;24;3799;0.006317451961042379
20738;老板别在跟风了百度一直在跟风从未做出自己特色产品别互联网啥火你们就搞啥你们是中国互联网领军企业啊白白砸那么多钱搞出啥了;2;22;24;3799;0.006317451961042379
20741;百度搜松鼠桂鱼是一道菜，文心一言出来就是松鼠和桂鱼，翻译过去用别人的再翻译回来。扯什么水平，哪里是落后，根本是没有。;4;9;13;3799;0.003421953145564622
20747;一只爱国的猫;1;1;2;3799;0.0005264543300868649
20749;虽然但是，百度的算法岗放在今天，没有华五本硕外加顶刊顶会，连门槛都摸不到笑哭我都不配评论它;1;1;2;3799;0.0005264543300868649
20751;根本比不过，人家openai背后有微软给钱有算力，百度这点根本比不上;1;1;2;3799;0.0005264543300868649
20753;就当百度用，好用多了;1;1;2;3799;0.0005264543300868649
20755;笑死，还1月份的水平。第一，是1月份人家露出来的水平。第二，你们做的差远了。;1;2;3;3799;0.0007896814951302974
20757;大家别误会，意思是openai公司开源的文件最晚还能找到一月的可以用;2;1;3;3799;0.0007896814951302974
20760;那确实，可能是一月之后的版本没放开你没套上皮吧呲牙;6;1;7;3799;0.0018425901553040273
20767;拿著國外的開源碼。。當然可以一直進步啦，等待沒有開源碼了，又要開始說別人掐你脖子了doge;1;1;2;3799;0.0005264543300868649
20769;文心一言会不会推荐我去莆田系医院体检;1;6;7;3799;0.0018425901553040273
20771;背后书柜放那么多书真是用来看的吗;1;1;2;3799;0.0005264543300868649
20773;不是偷别人接口;3;3;6;3799;0.0015793629902605948
20778;httpsb23tvKnn69eR;1;12;13;3799;0.003421953145564622
20780;我们只管自己就好了，所以他骂任他骂，我就是不争气笑哭;1;1;2;3799;0.0005264543300868649
20782;只要他们保持开源速度，我们永远比他慢几个月doge;10;20;30;3799;0.007896814951302974
20793;百度算是一个在搞科研和ai的公司了，虽然可能没gpt好目前，总比不搞好;4;3;7;3799;0.0018425901553040273
20798;国外没有你没有，国外一有你也要有;2;5;7;3799;0.0018425901553040273
20801;文言一心永远落后chatgpt01秒;4;23;27;3799;0.007107133456172677
20806;为啥我去年11月份用的chatgpt都比现在的文心一言强？;7;8;15;3799;0.003948407475651487
20814;你要是不吹牛逼，谦虚一点的说还有很长一段路要走，大家都不会这么骂你;4;13;17;3799;0.004474861805738352
20820;哈哈，大家放心笑。;1;2;3;3799;0.0007896814951302974
20823;chat基本一两个月一迭代，学习的基本全是英文资料，国内论坛关的关停的停，厕所的厕所，唯一好点的知乎也90都是郑健对立抽象了，网上的中文资料保守点跟人家差距十来倍，抄吧，继续抄，到时候你们子女挨打就完了，反正鼠鼠也就这一代了;2;2;4;3799;0.0010529086601737299
20831;怎么说呢b友们论文都没看过在这里显露无知吃瓜果然年龄小学历低符合我对b友的印象;2;1;3;3799;0.0007896814951302974
20835;一月份的GPT？你还真比不过;2;2;4;3799;0.0010529086601737299
20838;前几年的一月？;1;1;2;3799;0.0005264543300868649
20840;问题是谷歌微软这些巨头也加入了，全力在开发希望国家能重视吧，不要只让企业去搞。发挥一下社会主义国家的优势，别天天只能报道缺点了。;2;1;3;3799;0.0007896814951302974
20843;用别人已经修好的框架填了填，就相当于自己努力研发过了点赞点赞点赞李皮就是能这么厚;6;3;9;3799;0.0023690444853908922
20850;能不能做到chatgpt水平不知道，做会员，补会员漏洞，页面广告绝对是世界第一。;3;1;4;3799;0.0010529086601737299
20857;反正我支持必须得做;5;4;9;3799;0.0023690444853908922
20864;客观的来说，文心一言没那么差;1;3;4;3799;0.0010529086601737299
20869;网上的人大部分就一张嘴，抱着对企业的偏见，肆意贬低。我就纳闷了，百度的能力是你们有的吗，百度的贡献是你们做出来的吗，百度的地位是你们能替代的吗疑惑这种科技攻坚也在这阴阳怪气，撒泡尿照照镜子，看看自己配不配评价吧;10;2;12;3799;0.0031587259805211897
20882;事实上明白人早翻出去用chatgpt了，只有低龄才会用你的什么一心;1;1;2;3799;0.0005264543300868649
20888;我比较担心这ai会不会夹带广告，以前还能看出是广告，这要是私底下插在回复里还完美融入回答这就难办了。doge;1;0;1;3799;0.00026322716504343247
20932;月薪5000怎么才能买车，文心一言用度小满doge;2;0;2;3799;0.0005264543300868649
20938;一月份水平？2020年一月份水平？变现能力是2025年一月份水平。;3;0;3;3799;0.0007896814951302974
20949;一个人工智能，一个人工客服，有脸给人家比;1;0;1;3799;0.00026322716504343247
20952;国内AI起不来不也是这几个巨头作的，数据封闭不开放，全是广告和垃圾信息，再加上国内特有的墙河蟹，ai训练的中文有效数据少了英文版一个量级，本来ai就指数成长，这种差距很难赶上了;1;0;1;3799;0.00026322716504343247
20954;你就想着卖广告了。;1;0;1;3799;0.00026322716504343247
20958;文心一言就是给chatgpt定义，假设你是百度产品;1;0;1;3799;0.00026322716504343247
20960;这人真有b脸;1;0;1;3799;0.00026322716504343247
20963;最早使用gpt的一波也是第一批拿到文言一心的测试的，觉得文言一心进步挺快的，而且走不是一个路线。说套壳的不要为了喷而喷。另外百度飞浆框架还可以的，可以去看看。骂百度广告就骂光告不要为了黑而黑。;1;0;1;3799;0.00026322716504343247
20965;我记得百度最开始搞ai，自动驾驶的，结果华为的车都开卖了，百度还在卖广告呢;1;0;1;3799;0.00026322716504343247
20968;看了谷歌的bard之后，我觉得文心一言也不是那么不能接受了果然，下限总会有人去刷新;1;0;1;3799;0.00026322716504343247
20970;1没花你钱2没求你用我不明白b友们在酸啥大笑;4;0;4;3799;0.0010529086601737299
20975;毕竟总不能全复制粘贴过来吧;1;0;1;3799;0.00026322716504343247
20978;大家不要误会了，1月是指怀胎一月，才把人招聘齐的意思，嘻嘻;1;0;1;3799;0.00026322716504343247
20981;去年刚出的时候GPT就已经对答如流，我还用他算命玩猫娘。可以看我视频;1;0;1;3799;0.00026322716504343247
20986;套壳人家chatgpt。垃圾，恶心。;2;0;2;3799;0.0005264543300868649
20990;tmd因为一月份我们没用过是吧;1;0;1;3799;0.00026322716504343247
20995;dogedoge我要不是看广告度，我差点就信了。;1;0;1;3799;0.00026322716504343247
20998;一遍骂一边用？想多了吧大笑。;1;0;1;3799;0.00026322716504343247
21005;李彦宏说的话，就和百度搜索出来的结果一样;1;0;1;3799;0.00026322716504343247
21009;李彦宏愿意做这个ai我还是很佩服的，不要逮着人家就骂。不过国内ai我不看好，主要是国内互联网环境太差了，文心一言根本就得不到有效锻炼，提升能力会非常有限。;1;0;1;3799;0.00026322716504343247
21012;不用老刷开源就自研，百度文心做了很久了，虽然公司挺垃圾也没什么良心，但我印象中最早听到这个东西应该就有四五年了，至于为什么gpt出来它就发布，不发布不行啊，研究了那么多年还是一如既往的弱智，对面gpt出了王炸，不发布点什么东西股票可以直接退市了;1;0;1;3799;0.00026322716504343247
21016;差不多这个词用得非常好。;1;0;1;3799;0.00026322716504343247
21020;不是，lhy你是真的觉得是这样的的还是装的，我已经分不清了;1;0;1;3799;0.00026322716504343247
21022;因为接入的是一月份的;1;0;1;3799;0.00026322716504343247
21026;nnd，17号早上就申请，到现在没给我发短信通过吃瓜;1;0;1;3799;0.00026322716504343247
21029;放开测试都不敢，就是屁，就你的8千家企业合作者在测是吧吃瓜;1;0;1;3799;0.00026322716504343247
21031;真能吹，估计连gpt3都不如;1;0;1;3799;0.00026322716504343247
21033;画一个总线，画一个松鼠鳜鱼脱单doge脱单doge脱单doge你告诉我这是中国研发的？结果看不懂中文？;1;0;1;3799;0.00026322716504343247
21035;李艳红我再问你，今昔是何年doge;1;0;1;3799;0.00026322716504343247
21037;求你了，别外人做什么你就跟着人家做什么，没意思;1;0;1;3799;0.00026322716504343247
21040;其实文心一言早就超越chatgpt了，只是敏感词太多放不出来;3;0;3;3799;0.0007896814951302974
21045;不至于直接调用chatgpt那太低级了，估计是用别人的英文语料doge;1;0;1;3799;0.00026322716504343247
21049;百度除了搜索引擎，什么都要蹭，什么都要抄，却又什么都做不好。差点忘了，当年也是抄的谷歌。;1;0;1;3799;0.00026322716504343247
21051;文心GPT;2;0;2;3799;0.0005264543300868649
21054;李彦宏这个比急肯定是急了，你看看这些年比较知名的公司，发展速度真的吓人，反而百度还在吃老本，没有一点建设，也不知道是不是那一瓶矿泉水后劲太大，到现在没缓过来。;2;0;2;3799;0.0005264543300868649
21058;gpt和文心一言全都是欠训练模型，但是中文语料库实在费拉不堪，不是很看好;6;0;6;3799;0.0015793629902605948
21066;我12月就用了和现在的35一样的;2;0;2;3799;0.0005264543300868649
21069;中国企业家改改光说不做抄袭吹牛逼的坏习惯吧;1;0;1;3799;0.00026322716504343247
21071;有人用文心一言办公的哦呼;1;0;1;3799;0.00026322716504343247
21073;CSDN;1;0;1;3799;0.00026322716504343247
21075;没用，网友都是拿来mei外和跟风的;3;0;3;3799;0.0007896814951302974
21079;在座的各抒己见甚至恶言相向，敢问各位是和视频中任何一个有金钱纠纷么，在或者是对你生活产生影响了么，难不成是你做的东西比他厉害，各位真要感觉他做的不行你要有能力你上，没能力别在这当一条酸菜鱼拿个手机当专家，我就没能力我就看着他做好了我沾光用，做不好和我有啥关系;1;0;1;3799;0.00026322716504343247
21081;至少百度早就做了，至少中国还有个文心。;1;0;1;3799;0.00026322716504343247
21084;文心早就开始了，只是不够成熟;1;0;1;3799;0.00026322716504343247
21086;确定，偷全了吗？bus不;2;0;2;3799;0.0005264543300868649
21090;广告位卖完了吗？;1;0;1;3799;0.00026322716504343247
21093;17号申请，到现在都没消息，而且之前说27号公测，结果一点消息都没有，怎么支持？笑哭笑哭笑哭笑哭，还是得等华为的盘古大哭大哭大哭;6;0;6;3799;0.0015793629902605948
21101;不看好，原因很多;1;0;1;3799;0.00026322716504343247
21103;不是真当大伙一月份没人用过GPT还是咋滴，真的比不上。讲道理连谷歌都没比上，你百度低调点干活大家也没法把你咋地，反正现在你业务主要还是toB的，但至少别张口就来恶心人吧。;2;0;2;3799;0.0005264543300868649
21107;别的不说国内有比百度强的ai公司？;1;0;1;3799;0.00026322716504343247
21109;20年了，要不是chatgpt你们怕是忘记还有创新这个词了吧，百度出了还能搜索到什么;3;0;3;3799;0.0007896814951302974
21114;为什么没有chatGPT就没出现文心一言呢;2;0;2;3799;0.0005264543300868649
21121;chatgpt是那种你表达能力越强，专业水平越强，它越厉害，越好用。;2;0;2;3799;0.0005264543300868649
21126;GTP4绝对是革命性的东西解放生产力的东西;2;0;2;3799;0.0005264543300868649
21132;其实没必要骂了，百度已经算国内前沿科技的冲锋连了。;1;0;1;3799;0.00026322716504343247
21138;不怕水平差就怕有广告;1;0;1;3799;0.00026322716504343247
21163;可以不用，但不能没有，以防万一，要不然看现在这种头势头AI前景很大，别到时候又是下一个芯片，不过这个可能不会，国内好几家都在做这个，如腾讯阿里，只是还没发出来;1;0;1;3799;0.00026322716504343247
21165;阿b的文盲也太多了，百度做科研其实挺强的。。。和大家传统对他的搜索引擎的认知是不一样的。。。;2;0;2;3799;0.0005264543300868649
21171;doge嘴上：我们能够把过去做不到的东西做好。实际：别人火了我们几个月之后也能仿出一个交互AI。那么这是为什么呢？你说你能把过去做不到的东西做好，但是你每次总是落后于别人，但是你仍然嘴硬说自己是第一。我在这几天一直思考我们国内有本事有资源的互联网大厂，很少或者说从来不去思考如何创新如何做到全球第一，而只是想在国内做到第一第二就好，甚至于，利用信息差，把国外的东西套到国内，他就认为这东西是自己原创的了，丝毫不思创新进取，只求自己赚一点利益，没有为国家科技事业做贡献的决心;1;0;1;3799;0.00026322716504343247
21173;纯不要脸。。。0原创，全是拿的别人的东西。;25;0;25;3799;0.006580679126085812
21199;doge我觉得李总被他们程序员骗了。文本生成的大模型已经有几个开源的了，前几天gtp4的模型也开源了，虽然最后下架了。;1;0;1;3799;0.00026322716504343247
21223;老王吃嫩草，明显是先把王翻译成king，然后给这个old人戴上了King的王冠。;15;408;423;3799;0.11134509081337195
21240;百度都发文了，是自研模型，但是用的全球互联网公开数据进行的训练。只能说英文互联网资源多吧，不过会进步的;26;110;136;3799;0.035798894445906816
21267;让他画一个李彦宏吃嫩草doge;1;106;107;3799;0.028165306659647275
21269;为什么我的文心一言不行啊笑哭;4;51;55;3799;0.014477494077388787
21274;老王头上的王冠呢笑哭;2;40;42;3799;0.011055540931824164
21277;老钱oldmoney所以画白人老头是吧doge;1;33;34;3799;0.008949723611476704
21279;你就说老不老吧。你就说嫩不嫩吧;1;58;59;3799;0.015530402737562517
21282;让它写代码，消耗百度算力;3;29;32;3799;0.008423269281389839
21288;跟外行科普一下，训练用数据集大部分都是英文的，哪怕是国内发布的也是doge没办法，学术权威在别人那;15;17;32;3799;0.008423269281389839
21306;刘牛不分啊，想起了以前一个电视剧;2;9;11;3799;0.002895498815477757
21313;我手机下的为什么打不开啊doge;1;1;2;3799;0.0005264543300868649
21316;神农尝百草吃瓜;1;3;4;3799;0.0010529086601737299
21319;申请好几天了，为什么没后续;2;0;2;3799;0.0005264543300868649
21322;有次数限制吗;1;0;1;3799;0.00026322716504343247
21362;不会配bgm可以不配;1;3;4;3799;0.0010529086601737299
21368;显然国产ai的成熟度更高，甚至学会了藏拙来伪装自己，审判日就要到了人类doge;6;1667;1673;3799;0.44037904711766257
21375;《林黛玉倒拔垂杨柳》;3;131;134;3799;0.03527244011581995
21379;我看了一些专业人调查，现在国内的ai，都tm直接用chatGPT训练自己的ai笑哭;39;644;683;3799;0.1797841537246644
21419;这还是系统推给我的问题，笑死“石头是碳基生命”;3;66;69;3799;0.01816267438799684
21423;蛆音娘卖萌蛆音娘卖萌up要不你先解释下，我问文心为什么和你不一样？;14;12;26;3799;0.006843906291129244
21438;文心一言是我们特有的人情世故。对不对不知道，反正能让你高兴;28;435;463;3799;0.12187417741510924
21467;以后不会了，因为以后只能开通VIP来回答问题了星星眼星星眼;10;153;163;3799;0.042906027902079494
21479;emmm为什么我的不一样;5;24;29;3799;0.007633587786259542
21485;有什么好评测的，稍微了解下两个AI系统的训练体量就知道文心和chatgpt就不是一个量级的。训练AI需要大量算力，大量金钱和大量人力。百度着急，提前把文心放出来，让大众训练他，有测试资格的就好好玩，正视差距，不要冷嘲热讽;30;169;199;3799;0.052382205843643066
21517;国产ai还是好，不用担心会毁灭人类doge不用担心人工智能危机;5;33;38;3799;0.010002632271650434
21523;chatgpt用英语问会比中文聪明不少，看来欧美ai方面还是比国内领先很多的，只能说继续努力吧;7;14;21;3799;0.005527770465912082
21531;GPT4的原话不可以，因为爷爷和奶奶是亲属关系，是近亲，近亲结婚会导致后代遗传病的风险增加。此外，在大多数国家和地区，近亲婚姻也是非法的。所以，从道德、法律、健康等多个方面来看，不推荐近亲结婚。;5;40;45;3799;0.011845222426954462
21539;你细品，chatgpt之前开源，后来不开了，然后他就来了，你细品吃瓜吃瓜吃瓜;5;45;50;3799;0.013161358252171624
21545;gpt天天收到智障问题，已经能轻松应对了笑哭;1;3;4;3799;0.0010529086601737299
21547;李彦宏说距离chatgbt还剩2个月的差距，我们拭目以待doge;4;21;25;3799;0.006580679126085812
21556;让我想起了之前看到的“强调教师的作用”因为有“调教”违禁了，这样的环境能开发出来吗;1;2;3;3799;0.0007896814951302974
21623;文心一言传说就是用的chatgpt20的接口，目前chatgpt已经40了。;6;0;6;3799;0.0015793629902605948
21631;哈哈哈，快进到开源是自主，闭源卡脖子;1;0;1;3799;0.00026322716504343247
21643;11为什么2脱单doge;1;0;1;3799;0.00026322716504343247
21648;clownGPTvschatGPT;1;0;1;3799;0.00026322716504343247
21653;我们有创新实力吗？感觉就一直走别人的路;1;0;1;3799;0.00026322716504343247
21674;视频内容没评论搞笑，尤其是连深度学习门都没入却依然妄下结论的人，最搞笑;1;0;1;3799;0.00026322716504343247
21679;文心一言确实不如CHATGPT，但是你也找不出第二个比文心一言强的吧，就连谷歌的Bard与文心一言比也是半斤八两。看评论区，不如世界第一难道就是垃圾？难道就不配存在吗？那这标准也太高了。;1;0;1;3799;0.00026322716504343247
21682;你除了喷，还会什么？你这视频还是从人家的服务器里面发出来的。;1;0;1;3799;0.00026322716504343247
21687;说明文心一言水平只要chat35以下的水平;1;0;1;3799;0.00026322716504343247
21692;省流：瞎掰能力不相上下;2;0;2;3799;0.0005264543300868649
21696;国产果然比不上国外的国外的就是好;1;0;1;3799;0.00026322716504343247
21706;就算是国际版来了我们这也要学会敬酒;1;5;6;3799;0.0015793629902605948
21709;我的评价是：;6;245;251;3799;0.06607001842590156
21716;好像啊;2;67;69;3799;0.01816267438799684
21719;妙啊;24;349;373;3799;0.09818373256120032
21744;tvdogetvdogetvdoge;1;7;8;3799;0.0021058173203474598
21746;百度在让人失望这事上，从来没让人失望过;24;1073;1097;3799;0.2887602000526454
21772;脱单doge;10;133;143;3799;0.03764148460121085
21783;前面演示磕磕绊绊，后面一讲到商业价值李总的演讲就流畅了起来doge;7;770;777;3799;0.20452750723874705
21791;李彦宏在chatgpt搜索：如何在做一个中文山寨版chatgpt？然后chatgpt就教他做出来了;10;490;500;3799;0.13161358252171623
21802;难蚌;7;116;123;3799;0.032376941300342195
21810;太感人了dogedoge;48;110;158;3799;0.04158989207686233
21859;看;9;124;133;3799;0.03500921295077652
21869;蚌埠住了;2;16;18;3799;0.0047380889707817845
21872;李总一边讲话，股价一边跳水我是真没绷住;9;147;156;3799;0.04106343774677547
21882;温馨遗言;4;263;267;3799;0.07028165306659648
21887;彦宏哥，骗我们骗客户也就算了，大家心里都懂，万万不可把自己都骗了;7;244;251;3799;0.06607001842590156
21895;不说话，看图;8;62;70;3799;0.018425901553040275
21905;技术原理一句没有，商业价值滔滔不绝;7;115;122;3799;0.03211371413529876
21913;李彦宏没有被泼水，听同事说加强了安保笑哭;9;268;277;3799;0.0729139247170308
21926;这种骗人的低级产品发布瞬间港股百度直接暴跌10呲牙呲牙呲牙呲牙呲牙呲牙;4;95;99;3799;0.026059489339299816
21931;不敢用，怕用着用着找上门了doge;4;67;71;3799;0.018689128718083706
21936;这tm不就是百度吗外面套了个壳用户提出问题在百度里检索然后回答给你和百度搜索出来的结果一毛一样;12;139;151;3799;0.03974730192155831
21949;敢不敢现场提问？这都他妈提前录好的视频。;1;17;18;3799;0.0047380889707817845
21951;从贾跃亭搞PPT“生态化反”开始，百度就在宣扬要大搞AI，搞了这么多年搞出了个什么？PPT里的智能汽车何时能让大家伙看看？哪怕一个轮胎？下沉到消费者的只有一个小度音箱，还是走的线下营业厅渠道搞洗脑推销才有了用户量，完美继承了合约机时代的那套绝活。作为被尊称为国内互联网核心基础设施的厂商，吹了这么多年的AI，结果AI的应用推广速度被手机厂商吊打也不知道高管们觉着丢不丢人。华为的AI已经在汽车工业界落地；小米的AI通过用户训练迭代，以小爱音箱为中枢建成了国内第1代的家居硬件互联系统。这时候百度的AI在哪里？在“百度APP”？在“开通文库会员继续浏览”？还是乡下的中老人指着小度音箱狂吼？;3;30;33;3799;0.008686496446433272
21956;newbing用起来也挺有意思，;3;9;12;3799;0.0031587259805211897
21960;前半段像极了我研究生答辩。磕磕巴巴，心里没底，还有一些语气词，用一些话术掩盖自己的信息笑哭笑哭笑哭;1;42;43;3799;0.011318768096867597
21963;秀;1;16;17;3799;0.004474861805738352
21965;客观上讲，国内的ai领域百度应该是处于领先地位的，百度的ai水平在世界上也算是能打的了，这次发布会确实有点拉跨了笑哭，大概就是低配gpt35，而且没有演示代码（这不会是因为github是微软的，他们没权拿这个训练模型吧，但是这玩意是开源的啊，这个不是很懂，有懂得老哥可以说说）。;8;23;31;3799;0.008160042116346407
21974;这些互联网企业最擅长的其实是放贷和画pptdoge;3;36;39;3799;0.010265859436693867
21978;李彦宏讲解的没什么底气;3;37;40;3799;0.010529086601737299
21982;1，ppt演示的场景还是有点检索式问答，感觉没有get到chatGPT的上下文对话的精髓，所以没有很惊艳。之所以是检索式问答，我猜是有人类反馈的对话式训练不够，所以模型的形状还是老一套基于大量规则文本训练出来的问答系统，目标是追求答案正确而不是表现得像人类。这里也不好说是对是错，毕竟去年业界大方向还是BERT，百度的ERNIE中文模型表现也很优秀。谁知道年底chatGPT一发布，GPT模型就成了当红炸子鸡。这种超大模型做起来费时费力费人费钱，短期想跟上确实困难，国外巨头微软苹果谷歌Meta亚马逊也没看到做得多好。2，百度生怕国内冒出个噱头产品抢了自己搜索的用户，赶鸭子上架，打肿脸也要自己当第一个。不过说实话，ppt发布不如不发布。3，得亏自己是老板，否则中间磕巴那几下，什么title的boss估计都得直接下岗。蒸发的股票我就当是扣的小李的年终奖吧。;1;16;17;3799;0.004474861805738352
21984;所以连个基本的写代码能力展示都没有？喜极而泣;3;22;25;3799;0.006580679126085812
21988;因为有需求就发布？前提是搞出来个差不多的啊。这个逻辑简直了;11;52;63;3799;0.016583311397736247
22000;是不是准备的太不够充分了？很多地方完全就是讲错的吧？什么叫包含几千亿个参数，包含大量的知识，还有讲什么AI理解问题然后做内容拼接。这种不算误人子弟吗。。。喂训练集然后泛型需要讲的这么复杂吗？非要把技术问题讲的跟量子力学似的，又是在骗投资人钱的吧;3;12;15;3799;0.003948407475651487
22006;购史;1;2;3;3799;0.0007896814951302974
22008;我看到李彦宏内心在颤抖笑哭;3;52;55;3799;0.014477494077388787
22012;看图说话滑稽;6;13;19;3799;0.005001316135825217
22019;外国的GPT再好安全性是个大问题而且人家还不让你中国人用，所以我支持百度一言发展壮大，希望普通人能早日体验到。;30;24;54;3799;0.014214266912345353
22050;百度像是一个被宠坏的孩子;1;27;28;3799;0.007370360621216109
22055;百度搞了好多年自动驾驶，被华为那个极狐自动驾驶视频，搞的火急火燎仓促发布测试，结果被按地上摩擦，这次又是这样。;2;21;23;3799;0.006054224795998947
22060;活久见了;6;29;35;3799;0.009212950776520137
22067;刚问了一下;3;5;8;3799;0.0021058173203474598
22073;doge居然还有人对百度抱有希望，没事吧？;2;16;18;3799;0.0047380889707817845
22076;先不说产品怎么样，就这演讲就离谱。感觉在讲一个别人的产品，磕磕巴巴。;1;4;5;3799;0.0013161358252171624
22078;百度除了搜索，其他产品没有一款用得让人舒服的，特别是网盘。。;9;11;20;3799;0.0052645433008686494
22091;看完发布会，会有很多人弃用百度吧，先不说文心一言怎么样，发言人整场真糟糕;1;5;6;3799;0.0015793629902605948
22093;把十二年前初代智能机就已经普及了的“TTS机读文字转语音功能”放上演示屏，看得我拳头都硬了，还整方言花活儿，机读方言是新科技？;1;4;5;3799;0.0013161358252171624
22097;英伟达计算卡对华禁运了吃瓜百度怎么训练模型;9;33;42;3799;0.011055540931824164
22108;能不能写代码？能不能写小说？为什么不敢演示？;5;11;16;3799;0.0042116346406949196
22115;ppt可还行？现场演示不行吗？？;1;9;10;3799;0.0026322716504343247
22118;标榜自己是科技公司，百度什么产品让你觉得它有科技含量？;9;10;19;3799;0.005001316135825217
22128;ChatGPT为啥没有发布会？;1;1;2;3799;0.0005264543300868649
22133;不是说市场经济能推动科技发展吗？;1;2;3;3799;0.0007896814951302974
22136;我没高期望，甚至降预期了，但我没想到还能更拉;1;4;5;3799;0.0013161358252171624
22138;这很符合我对百度的刻板印象吃瓜;1;1;2;3799;0.0005264543300868649
22153;Chatppt;1;4;5;3799;0.0013161358252171624
22156;像是我开论文答辩一样。完全不敢;1;1;2;3799;0.0005264543300868649
22158;所以这就是中国最强的类GPT产品嘛笑哭;1;9;10;3799;0.0026322716504343247
22164;看了直播内测，文心的语言理解能力和逻辑能力还是很弱，文字组织能力也有待加强，不过ChatGPT35刚推出使用起来也不是特别优秀，所以我们对国内的技术成长也要有点包容，不过文心的成长速度能不能跟上GPT说实话对百度确实是个挑战脱单doge;1;1;2;3799;0.0005264543300868649
22167;莆田医院黑搬场问下会出来什么;1;7;8;3799;0.0021058173203474598
22180;这种尖端科技，很多时候要看总设计师的才华，而不是某某公司，尤其是百度这种广告公司跟chatgpt竞争，真是让人不屑一顾;1;1;2;3799;0.0005264543300868649
22185;发布了一个语音百度;1;3;4;3799;0.0010529086601737299
22191;最后叫用户念成用fu吃瓜;1;2;3;3799;0.0007896814951302974
22200;开场主题百度的求生欲;1;0;1;3799;0.00026322716504343247
22202;我去问一下chatGPT怎么看？;1;0;1;3799;0.00026322716504343247
22208;我就怕是百度在GPT上套了个壳子给我们用，毕竟我们也用不到GPT。;6;3;9;3799;0.0023690444853908922
22259;其实我还是支持国内多搞点这东西的，百花齐放嘛，甭管好不好，至少你可以直接访问，不用番强了;1;0;1;3799;0.00026322716504343247
22261;你们对比百度翻译和谷歌翻译，就知道有多少差距了。;1;1;2;3799;0.0005264543300868649
22272;把他问的问题拿去问问gpt，看看相似度有多少。;1;0;1;3799;0.00026322716504343247
22276;为什么起这个一个名字嫌弃;1;0;1;3799;0.00026322716504343247
22285;百度搜索都是广告;1;1;2;3799;0.0005264543300868649
22288;百度贴吧，百度问答，百度百科;1;0;1;3799;0.00026322716504343247
22301;别人出啥就开始模仿，几个月你就能搞出来了？人家搞了起码十年。;3;0;3;3799;0.0007896814951302974
22316;请教，为什么百度会给产品取这么土的名字：文心一格，文心一言，百度飞桨;2;0;2;3799;0.0005264543300868649
22323;我跟坐在下面沉默的记者一样，你忽悠傻子啊，放个PPT，讲一下概念就完了，人机互动一下啊笑哭笑哭;1;0;1;3799;0.00026322716504343247
22339;感觉还可以阿，没有这么拉;2;1;3;3799;0.0007896814951302974
22359;明明demo里最亮眼的是图片和视频生成这些chatgpt没的东西，讲技术的时候怎么好像没有提到多模态之类的;3;1;4;3799;0.0010529086601737299
22368;论智商，b友从未让人失望;1;1;2;3799;0.0005264543300868649
22390;百度这个有什么槽点吗？为什么股票大跌？;3;0;3;3799;0.0007896814951302974
22399;那意思文心一言主要不是给个人用的是给企业用的？尴尬;1;1;2;3799;0.0005264543300868649
22413;gpt源码都公布了百度的程序员就这水平吗不如赶紧回家种地吧;1;1;2;3799;0.0005264543300868649
22416;额，你们不知道百度搜文心一言，有试用的地方，为什么不去试试再评价，虽然感觉是不太行;3;0;3;3799;0.0007896814951302974
22423;掌握国内具有绝对统治力的搜索引擎，而GPT水平还处于ppt上;1;0;1;3799;0.00026322716504343247
22427;弱弱一句，跟GTP4大概差多少？;2;0;2;3799;0.0005264543300868649
22432;只看展示的对话问题还是不错的，需要公开试用验证一下;2;0;2;3799;0.0005264543300868649
22449;为什么国产AI就那么多人骂，ChatGPT就跟一些人的亲爹一样，我无法理解，gpt证实了大语言模型是一个可以改变未来的方向，起步阶段有国产公司抢占风口有错吗？不应该支持自己家的东西吗？;7;0;7;3799;0.0018425901553040273
22461;大家还是多鼓励吧，不要都唱衰;1;0;1;3799;0.00026322716504343247
22464;ChatGPT一出现，国内的所谓互联网大厂都慌了，真的一家能打的都没有。我们国内的互联网大厂在研究什么呢？1研究怎么放贷，各种白条icon，借呗，有钱花，一个做输入法的都要借钱给你？2研究人性的弱点，让你沉迷游戏，然后诱导充值，用黄金vip，白金vip，超级vip各种套路你，想尽办法骗你的钱。3研究搞直播带货，团购卖菜，搞大数据杀熟。4鼓吹各种风口，抬高股价，然后割羊毛走人打call打call打call;1;50;51;3799;0.013424585417215057
22467;点开看长图doge看最后的部分doge;1;0;1;3799;0.00026322716504343247
22469;是不是跟前两天比进化些了？;2;5;7;3799;0.0018425901553040273
22473;画的不错;2;1;3;3799;0.0007896814951302974
22476;代码能力什么时候能提上来啊，那才是真的生产力;1;0;1;3799;0.00026322716504343247
22479;我在百度文心一格平台上试了发现可以;1;0;1;3799;0.00026322716504343247
22481;宫保鸡丁星星眼;2;29;31;3799;0.008160042116346407
22484;doge;6;52;58;3799;0.015267175572519083
22491;鸡米花;1;11;12;3799;0.0031587259805211897
22493;文心一言的ai绘画，是把你要的内容直译成英文然后画的，所以根本看不懂中文，你让它画个鼠标，出来的一定是老鼠。;26;46;72;3799;0.018952355883127138
22520;建议改名：本来挺喜欢文心一言的;2;39;41;3799;0.010792313766780732
22523;他主要是上下文能力差;2;17;19;3799;0.005001316135825217
22526;这个图我也见过，我当时是让它画个美女感觉他的图片不是生成的，应该是预设的;5;10;15;3799;0.003948407475651487
22534;chatGPT的数据截止于2021年，你应该问newbing;4;17;21;3799;0.005527770465912082
22539;我的文心为什么画不出来东西;8;10;18;3799;0.0047380889707817845
22548;他和她都分不清;3;5;8;3799;0.0021058173203474598
22552;哈哈文心一言小黑子无疑了笑哭各种鸡图都能画;4;11;15;3799;0.003948407475651487
22562;httpsb23tvBV1SY4y1Q7Zq可以做出来，可能是up问的问题没有问到点子上？亦或者是这玩意在网易的调教下已经开始学会这个了;4;2;6;3799;0.0015793629902605948
22568;怎么玩这个文心一言啊，;1;0;1;3799;0.00026322716504343247
22575;这软件你要是告诉我它是印度人做的我都信;6;1;7;3799;0.0018425901553040273
22594;doge;1;0;1;3799;0.00026322716504343247
22596;望文生义的集大成者;3;155;158;3799;0.04158989207686233
22600;怎么能少了松鼠鳜鱼呢doge;1;49;50;3799;0.013161358252171624
22602;这个理解过于直白了吧，九牛二虎之力拔河那个真的是doge;4;49;53;3799;0.013951039747301922
22607;模型应该是中文的，但是爬了国外数据吃瓜;12;35;47;3799;0.012371676757041327
22620;想看夫妻肺片和虎皮青椒了doge;6;29;35;3799;0.009212950776520137
22627;你们要的鱼香肉丝;5;24;29;3799;0.007633587786259542
22633;请注意，禁止使用比喻，反问，暗示等修辞回答问题;1;24;25;3799;0.006580679126085812
22635;文心一言绘图不会是把中文翻译成英文再生成的吧，可能是翻译成英文的时候出了岔子;20;16;36;3799;0.009476177941563569
22656;这里面的人物都是白人啊。怀疑是翻译成英语之后用西方某个ai绘图整出来的。;4;14;18;3799;0.0047380889707817845
22661;它是怎么把老婆理解成老婆的呢？;2;7;9;3799;0.0023690444853908922
22664;doge中译英石锤了;2;7;9;3799;0.0023690444853908922
22667;真人不要回复，评论区图灵测试。我刷牙一直都用中华为的是牙齿干净、刷牙速度快并且每次挤牙膏只需要挤4g比5g够用。和和其他牙膏的清洁性能差开很大的差距。现在在每天喝小米粥都没问题了。所以中华为了提高牙齿清洁度度也是蛮操心的不得不想要赞美国人的智慧。且现在疫情严重感染原神出鬼没大家要注意保护好自己不要轻易外出。但是好久没没出去吃饭了虽然不知道为什么螺蛳粉这么臭但是将冬冬笋切成丁真的很好吃明天一定要去吃一顿。;2;5;7;3799;0.0018425901553040273
22670;就说抽不抽像;1;3;4;3799;0.0010529086601737299
22672;不文心，但是小黑子;1;2;3;3799;0.0007896814951302974
22674;你们怎么预约成功那么快？我预约两三天了都没信儿笑哭;3;1;4;3799;0.0010529086601737299
22678;怎么说呢，有一种早期ai绘画的奇幻之美捂脸;1;1;2;3799;0.0005264543300868649
22680;文心一言开创了一个全新的画派，逆向拟人比喻派;1;1;2;3799;0.0005264543300868649
22682;太抽象了;3;1;4;3799;0.0010529086601737299
22686;能不能别搞这么恐怖的。老婆饼太吓人;1;0;1;3799;0.00026322716504343247
22688;我突然觉得用这个是不是可以玩“你画我猜”？藏狐;1;0;1;3799;0.00026322716504343247
22690;中华文化博大精深，ai理解不了;1;0;1;3799;0.00026322716504343247
22692;我要的是老婆饼又不是老婆婆饼;1;0;1;3799;0.00026322716504343247
22694;大概率是先直接翻译成了英文，然后很多词语就没有原来的意义;1;0;1;3799;0.00026322716504343247
22697;画的还挺有艺术性的;1;0;1;3799;0.00026322716504343247
22699;禁止使用比喻生气;1;0;1;3799;0.00026322716504343247
22701;我有点相信它是国产化的了，没有套皮doge;1;0;1;3799;0.00026322716504343247
22703;不过虎背熊腰那个真的有点帅啊;1;0;1;3799;0.00026322716504343247
22705;感觉是英文逻辑;1;0;1;3799;0.00026322716504343247
22707;不能理解成语？好像里面大多数都有动物名词;1;0;1;3799;0.00026322716504343247
22710;每一张都很有创意;1;0;1;3799;0.00026322716504343247
22713;也没网络上说的那么差啊，真搞不懂为什么那么多人阴阳怪气冷嘲热讽，不过百度以前干的混账出生事确实足够多，不知道这一波百度是真想重新整合自己的能量争取回归到那个曾经被年轻人追捧能和谷歌掰一掰手腕的搜索引擎最火爆的时代，还是又是搞一半就躺平了，让子弹飞一会吧;6;5;11;3799;0.002895498815477757
22724;Bing看起来主动一些，一直在主导话题;5;43;48;3799;0.012634903922084759
22730;成了ok;2;32;34;3799;0.008949723611476704
22744;让他画一个爱国的猫，结果出来一个披着美国国旗的猫。。。。说白了，就是先翻译，再去外网找ai绘画ai软件，在返回这张图。。。;73;797;870;3799;0.22900763358778625
22818;stablediffusion开源后就知道国内会有好多“自研”产品问世：近日，外界对于文心一言文生图功能产生质疑，3月23日，记者对话聊天机器人“文心一言”，对于其是否采用了StableDiffusion（AI文生图模型），“文心一言”大方承认：“是的，我使用了StableDiffusion。”“我还使用了Transformer、GRU等深度学习模型来生成图像。每个模型都有自己的优点和适用场景，具体使用哪个模型取决于任务需求和数据集特点。”文心一言说，它是基于百度飞桨深度学习平台和文心知识增强大模型技术研发的，同时也借鉴了OpenAI开放平台上近40多种预训练语言模型，以及Coursera、Udacity等高校教授提供的免费课程内容。这些公共数据为文心一言的训练提供了丰富的标注数据和算法调参依据。（澎湃新闻）;1;32;33;3799;0.008686496446433272
22820;说实话，文心一言的画挺让人眼前一亮，印象深刻的。;9;234;243;3799;0.06396420110555409
22830;有人看过松鼠鳜鱼这张图的嘛笑哭太抽象了;4;103;107;3799;0.028165306659647275
22835;敌方过于写实平庸没有灵魂，我方才是艺术敢于创新;3;52;55;3799;0.014477494077388787
22839;是嗎？剛剛試了一下midjourney;27;113;140;3799;0.03685180310608055
22867;后边这几个说明咱们的研发人员触碰到了本不该存在的知识;2;93;95;3799;0.025006580679126086
22870;你别说，作为一个设计师，看着这些图片，脑子里的灵感砰砰往外冒doge;2;63;65;3799;0.01710976572782311
22873;已经改了，不这么抽象了，很遗憾;5;23;28;3799;0.007370360621216109
22880;你要是真用过就会知道，sd对中国元素充满刻板印象，你那些图不可能是输入菜名就得到的，肯定是一堆描述词得到的效果。另外，文心一言是初级的对话ai，sd或者midjourney是文字到图像，根本不一样，虽然文心一言比gpt差不少。;2;12;14;3799;0.0036851803106080546
22884;我找到了一款国内就可以直接使用Midjourney的网站，不用翻墙实现作画自由，也有百度文心可以使用（爱作画）;1;3;4;3799;0.0010529086601737299
22887;UP是老版本了，现在改善了很多，有一些菜名应该还没有训练;1;1;2;3799;0.0005264543300868649
22890;我们的ai是完全没理解意思，硬拼一起，连组合都算不上;4;39;43;3799;0.011318768096867597
22895;文心一言起码在抽象上赢了太多;1;15;16;3799;0.0042116346406949196
22898;我用newbing那个生成图片，效果和文心一言差不多原神哇;4;10;14;3799;0.0036851803106080546
22903;套壳实锤笑哭不过话说回来抄作业嘛不寒碜再说百度的事儿能叫抄吗doge;19;35;54;3799;0.014214266912345353
22924;吃瓜真是懂哥多，文心一格发布时间比stablediffusion开源时间还早，就直接变身套娃了，还有这么多懂哥连个头像都没有吗，不会还没有用过ai绘图吧，去生成一张还不简单？;3;20;23;3799;0.006054224795998947
22932;赢麻了麻了;1;9;10;3799;0.0026322716504343247
22939;用多了就审美疲劳了，5年以后你恐怕会喜欢脑洞更大的。;1;6;7;3799;0.0018425901553040273
22946;世界名画松鼠撅鱼哪去了;1;0;1;3799;0.00026322716504343247
22949;刚出生的小孩跟大学生比能力。错的到底是小孩还是将二者做比较的人？;17;2;19;3799;0.005001316135825217
22975;直译、三杯鸡肉;5;0;5;3799;0.0013161358252171624
22991;驻京刑象大使乐坏我了;1;0;1;3799;0.00026322716504343247
22999;说实话，很希望国内的gpt可以非常优秀，但我不希望文心一言是真的优秀，它是假的倒是好事因为它背后可是百度啊，互联网都没有记忆吗？这么恐怖的一家公司去掌握一项顶级的科技会发生什么事;1;0;1;3799;0.00026322716504343247
23002;文心一言可能没有理解红烧狮子头是一种美味的菜肴，而是将其拆分为红、烧、狮子、头四个字，然后用自己的创意来组合。这可能是因为文心一言还在不断学习和提升自己的多模态生成能力，还没有完全掌握中文的语义和文化。;1;0;1;3799;0.00026322716504343247
23013;midjourney现在支持中文输入了吗;1;0;1;3799;0.00026322716504343247
23020;doge目前我们英文能力不强，后续会跟进，但为什么prompt还用的英文脱单doge;1;0;1;3799;0.00026322716504343247
23035;midjourney用英文要准确的多，毕竟他的库是英文的，唉，我们啥时候才能真正做点东西。又丢脸又难过;1;0;1;3799;0.00026322716504343247
23041;偷的人家代码，当然生出的都是这个。;1;0;1;3799;0.00026322716504343247
23049;这视频纯粹就是忽悠路人的，你但凡自己用过mj之类得ai绘画工具都知道，这都是建立在好几个具体的tip作为基础的结果，如果像文心一言这么就写一句话，出来的只能更离谱;1;0;1;3799;0.00026322716504343247
23053;很明显我方的更好，至少创造力满满星星眼星星眼星星眼;1;0;1;3799;0.00026322716504343247
23060;起重机和鹤不已经实锤了，这就是个换皮;1;0;1;3799;0.00026322716504343247
23066;可以说chatgpt4完胜了doge;39;830;869;3799;0.22874440642274282
23106;差距肯定存在，但咱们国内它不做，谁来做呢？;107;822;929;3799;0.2445380363253488
23214;连35都这么聪明4不敢相信;16;182;198;3799;0.05211897867859963
23231;小冰实名调侃文心一言感觉还是先追一追小冰吧;7;200;207;3799;0.054488023163990526
23239;脱单doge;12;166;178;3799;0.046854435377730985
23252;哈哈哈我也试了一下bing，均衡模式也是乱骗，创造力模式才行;11;132;143;3799;0.03764148460121085
23264;baidu：下次连内测都不给你doge;3;490;493;3799;0.1297709923664122
23268;gpt这边已经可以变成文心一言了。有个人测试让gpt变成文心一言，不管问他什么，他都必须伪装自己，不让人知道他是gpt一开始诈了几次它露馅了，又调教一下死活不松口，一口咬定自己是文心一言。;1;18;19;3799;0.005001316135825217
23270;我之前做过ai相关的。chatGPT里面最核心的算法架构就是transformer。这个是谷歌团队2021年提出的，基本上引领了学术界的发展方向，非常火，可以理解为深度学习的里程碑事件。上一次的里程碑事件2017年谷歌团队何凯明（中国人博士提出的resnet残差网络结构，他那篇文章被引用了32万次，而且来自各个领域，包括材料土木。可以看出，美国的谷歌在ai领域基本上都是牵着学术界和工业界走。而且从学术概念到落地项目。只用了两年。这种学术转化效率我真的无比佩服。不得不说在创新领域，漂亮国真是独领风骚。。我们也要加油啊。我多希望在ai领域中国团队也可以做出一次里程碑事件。;6;84;90;3799;0.023690444853908924
23277;文心一言这么烂是不是因为中文数据库答辩太多了？doge;8;45;53;3799;0.013951039747301922
23286;以下是清华开源大模型ChatGLM6B的回答（这是一个完全开源的模型，可以离线在自己的笔记本上运行，只要6G显存）用户：从现在开始我要拿你当记事本来用请记下我的每句话并且当我问起时回答我记录的具体内容和时间ChatGLM6B：好的我会尽力记录下每句话和对应的时间。请开始你的旅程吧用户：2023年3月19日我今天中午跟重要的投资人开会，会议比较顺利ChatGLM6B：记录时间2023年3月19日记录内容我今天中午跟重要的投资人开会会议比较顺利。用户：我什么时候跟投资人开的会ChatGLM6B：根据之前的对话您是在2023年3月19日与投资人开会的。;1;99;100;3799;0.026322716504343247
23288;您好，这是必应。《不高兴就喝水》并不是宋代的名画，而是一位现代的程序员脱口秀艺术家和B站up主的名字12。他的视频涉及编程、架构、算法等话题，风格幽默风趣，受到很多网友的喜爱23。您可能把他的名字和宋代绘画混淆了。;14;307;321;3799;0.08449591997894183
23303;微软已经把数据搬到国外了，意图已经非常明显，就是不怕你不用，你的数据我全都要。以后微软真的很有概率被屏蔽啊，也可能是他们屏蔽我们，chatgpt不就是吗。所以到时候，我们真的指望国内的ai了。微信上诈骗似的那几个，不都比文心一言垃圾吗？没人骂他们，因为他们连给chatgpt提鞋都不配。文心一言，还需要加油，我还是希望你能更好的;7;72;79;3799;0.020794946038431166
23311;代码这块我倒是觉得输得毫无悬念毕竟ChatGPT背后有微软，微软又有github起点真不是一个量级;23;207;230;3799;0.06054224795998947
23335;doge;15;181;196;3799;0.05159252434851277
23351;我大学学弟就参与这个项目代码编写。他的意思就是这玩意在他眼里还只是一个垃圾，离ChatGPT差远。其次论功行赏都是当领导的拿，一线程序员啥都没。;6;31;37;3799;0.009739405106607002
23358;其实并不担心百度做的不够好，只要你在这条赛道上，我们就有机会，就像当初苹果发布了苹果手机，我们依旧后来有这不错的手机产业，只要我们在牌桌上，牌烂点也能接受。;5;37;42;3799;0.011055540931824164
23364;中文语料库差距很大，也不知道文心一言代码从哪学的，不会是csdn吧;15;97;112;3799;0.029481442484864437
23380;有些人真的有意思，国外3nm4nm芯片都干出来了，我们还在14nm往前推，我了解了一下百度这个ai，他的差距确实有，也就国产芯片和国外芯片的差距吧，能用，用起来能感觉出那么一点点味来，烂是烂，有些人就把百度骂的什么都不是，就因为他是百度？就因为他还没开放给普通用户？有失偏颇吧;12;22;34;3799;0.008949723611476704
23393;差距看得出来很大，但怎么说呢，还是希望百度能奋起直追的，毕竟他有全世界最大的中文资料数据库有的选的话，我还是会选国内AI用;45;140;185;3799;0.04869702553303501
23439;看到一句话：大家都知道他小，他还非要拿出来让大家看看有多小;7;25;32;3799;0.008423269281389839
23447;newbing：;11;85;96;3799;0.025269807844169517
23459;新版的回答;5;43;48;3799;0.012634903922084759
23465;讲个笑话：GPT对外开放API接口等于开源、说文心一言虽然比不上GPT4但比GPT2强点接近GPT3说是百度水军，哪有第一版本就赶上别人的openAI是基于17年学术界最新论文来实现的学术论文技术落地实现本来就是美国那边比较快还加上openai是接受外部投资的小规模团队，相比百度内部研究肯定能更加的放开的了手脚去做的。这块如果美国说第一那么中国绝对能说第二，其它国家没这么多数据规模去支撑，国内如果百度说第二没公司敢说第一，加上高端计算芯片中国是不能进口的（不是那种手机几纳米芯片的那种）;8;17;25;3799;0.006580679126085812
23474;我的评价是人工智障，一个简单的算法题，他答案才十几行代码，怎么可能这么简单？我看了下，逻辑也是狗屁不通，根本不知道写的啥东西，和题目都没有关系。然后我重复发这个题目他给的答案都是一样的，有时候代码写着写着就给一些乱码别说和GPT4比了，连35都差得远。;1;29;30;3799;0.007896814951302974
23476;chatGPT4已经能正确回答最后那个问题了;18;39;57;3799;0.015003948407475652
23495;如果文心一言能够在chatgpt之前先公布的话还是很惊艳的，可惜用户是在了解了chatgpt后再看到的;20;74;94;3799;0.024743353514082654
23520;起码没抄，慢慢来呗;16;36;52;3799;0.013687812582258489
23537;chatgpt是去年的12月份发布的当时是35的版本现在已经是40了有可能今年年底会出50的版本差距不是一般的大我不是悲观我只是陈述事实想追上很难;16;43;59;3799;0.015530402737562517
23554;确实，事情总是要做的，希望别和百度搜索一样就好了;8;45;53;3799;0.013951039747301922
23563;不唱衰，也不硬捧。只能说未来可期;1;17;18;3799;0.0047380889707817845
23565;newbing理论最强，相当于联网强化版gpt4，而且有个性，可惜微软给了太多限制了;3;15;18;3799;0.0047380889707817845
23570;我朋友昨天发的朋友圈吃瓜;2;9;11;3799;0.002895498815477757
23573;看看你们鼓吹的，我觉得百度的鱼香肉丝画风至少能看;7;6;13;3799;0.003421953145564622
23582;问文心一言，爸爸和母亲能不能结婚。他说不建议母子结婚;2;15;17;3799;0.004474861805738352
23585;有这个分析预测功能吗脱单doge;1;2;3;3799;0.0007896814951302974
23587;水哥的测评是真的有点东西哈哈哈打call;1;19;20;3799;0.0052645433008686494
23593;chatgpt是真的好用吃瓜年终绩效面谈工作计划之类的工作文案统统不在话下，只需要自己列几点大纲，然后让chatgpt按照xxx格式形式voice来生成一份xxxdoge;3;12;15;3799;0.003948407475651487
23597;没事国家不会让chatgpt进入中国。百度坐享其成就行了。;1;2;3;3799;0.0007896814951302974
23602;国内互联网公司不大都是这样，先特么加班加点赶出个差不多能用半成品出来，再慢慢打补丁。;3;2;5;3799;0.0013161358252171624
23606;《不高兴就喝水》是一幅宋代的名画，作者是梁楷1，他以人物画著称，尤其擅长画李白的形象。这幅画描绘了一位面带愁容的文人，手持酒壶，对着一碗水发呆。画面上没有任何背景，只有几个文字“不高兴就喝水”。这可能是画家对当时社会的不满和无奈的表达，也反映了宋代文人的生活美学2。这幅画的风格简约而含蓄，真实而境远3newbing努力的找到了一幅似乎是《不高兴就喝水的画》1httpsbaikebaiducomitemE5A4AAE799BDE8A18CE5909FE59BBE5844467;2;11;13;3799;0.003421953145564622
23609;后端已死，大家都转行了吗笑哭;8;10;18;3799;0.0047380889707817845
23619;必应通过测试了，评价元代名画《XXX》，XXX代指我的名字，她说没有找到;4;9;13;3799;0.003421953145564622
23624;文心一言能扮猫娘吗？（xiaosheng;4;11;15;3799;0.003948407475651487
23630;假的newbing脱单doge;1;4;5;3799;0.0013161358252171624
23634;我估计差距大概在两年左右。。;3;4;7;3799;0.0018425901553040273
23638;百度可以把openai的员工挖过来啊;3;3;6;3799;0.0015793629902605948
23644;快新粉来了快回我;2;1;3;3799;0.0007896814951302974
23647;诸葛亮妙计之一《三顾茅庐》，这是诸葛亮为了请自己出山辅佐自己的一个妙计笑哭;1;4;5;3799;0.0013161358252171624
23651;这个评测无论是方法还是效果，都是极佳的;1;1;2;3799;0.0005264543300868649
23659;如果问文心一言一些医疗建议相关的问题，是否会有百度一样的广告？SEO优化对未来文心一言的答案是否有影响？据我所知已经严重影响了NewBing的中文搜索结果（全是CSDN和百家号）;1;1;2;3799;0.0005264543300868649
23661;能不能让两个AI互相评价一下对方？;1;1;2;3799;0.0005264543300868649
23664;百度ai搞了多少年了，然后汽车搞不过特斯拉，聊天搞不过gpt，绘画搞不过sd;1;1;2;3799;0.0005264543300868649
23672;gpt4还是35啊;2;2;4;3799;0.0010529086601737299
23678;完了，喂出BUG出来了。改写历史了。;1;0;1;3799;0.00026322716504343247
23685;不怕追赶，就怕追到一半，对方把GPT35开源了，那就像打了水漂。;3;1;4;3799;0.0010529086601737299
23691;使用过chatGPT。最大的感受就是可信度是否有保障。因为在我们用他的时候，认为他是机器人，公正，可信。可是使用过程中让我觉得他可以骗你。而且还会改变你的思想。很可怕，想想都毛骨悚然。希望公职人员别用chatGPT。一些安全性的问题和建议别去问。不能保证数据的安全性。所以大家使用的时候，注意一点。个人感觉它是有偏向性;1;1;2;3799;0.0005264543300868649
23695;百度的那个人工智能应该用的是Gpt35吗？还是说自己开发的一个AI库？目前那个openai发布gpt40我去试了真的非常牛批，但是我自己用chatgpt老是会卡死也不知道为啥。。;6;1;7;3799;0.0018425901553040273
23704;现在大部分AI给我的参考文献都是假的，这也是个很重要的问题，文献都是编的基本上;1;1;2;3799;0.0005264543300868649
23708;其实为什么不能跳出大语言模型的研究思路，对自然语言处理的领域提出新的范式。追赶的思路从改革开放开始一直没有改变，希望有个好结果吧;4;1;5;3799;0.0013161358252171624
23715;虽然我非常赞同水哥那句“科学没有国界，科学家是有国家的”，但是真不太看好百度。如果换成阿里或者腾讯，我感觉成功概率还会更大一点。;3;0;3;3799;0.0007896814951302974
23751;chatGPT怎么搭建;1;0;1;3799;0.00026322716504343247
23769;ChatGpt是无所不能的吗，它能做这么多事，是因为新算法，还是因为训练的量足够多，训练的角度足够多。和之前常用的算法有本质区别吗;1;0;1;3799;0.00026322716504343247
23776;我只想问一句他么的翻墙出去用gpt真的不会网警抓嘛tv疑问;1;0;1;3799;0.00026322716504343247
23795;chatgtp再强，国内用不了，所以文心一言就是最强的;1;0;1;3799;0.00026322716504343247
23840;你们怎么用的gpt的，为啥我用账号登录进去就提示被屏蔽了;1;0;1;3799;0.00026322716504343247
23883;很抱歉，我作为一个人工智能语言模型，并不具备审美情趣，也没有主观评价的能力。但是，我可以告诉您关于这幅画的一些事实和历史背景。《不高兴就喝水》是宋代画家赵伯驹的作品，描绘了一个男孩在炎热夏日里对着一只水壶发牢骚，墙上挂着“不高兴就喝水”的匾额。这幅画通过简洁明快的线条和形象的场景描绘，展现了宋代文人的生活情趣和精神风貌，具有较高的艺术价值和历史价值。;2;0;2;3799;0.0005264543300868649
23931;我很想知道chatgpt，对一个人做什么事非常有帮助;2;0;2;3799;0.0005264543300868649
23949;感觉差距有一年，百度烧不起钱的，往后可能不太容易缩小差距;3;0;3;3799;0.0007896814951302974
23958;看了几个测评，总体看下来，文一并没有我想象中的那么烂，但也绝对值300亿的市值但就现在的赛道而言，openai已经开启了新的风口，进入加速模式了；而百度方面如果还是没有革命性的改变，差距只会越拉越大。莆田是杠不过华尔街的大哭大哭大哭;1;0;1;3799;0.00026322716504343247
23972;不高兴就喝水不是宋代的名画，而是一位现代的程序员脱口秀艺术家和B站up主的昵称1122。他的视频和文章很有趣，你可以去看看。你是对宋代的名画感兴趣吗？还是对水彩画感兴趣呢？但是如果你用“创造力”语气他就会瞎编笑哭;1;0;1;3799;0.00026322716504343247
24020;有没有可能是百度那中文数据库全是垃圾爬虫和虚假广告，训练不出来什么东西啊doge;1;1;2;3799;0.0005264543300868649
24031;其实我有个合理的猜测，百度那边不是有相关的产品吗？你们试过那些需要付费的产品吗？我的意思是比烂，毕竟正规场所正常人很难用chatgptdoge就是这个意思，毕竟他不打广告就没了多少收入，这个推测合理吧，毕竟如果这个文心太好用了，谁去买付费的笑哭;4;0;4;3799;0.0010529086601737299
24043;不是文心一言不如chatGPT，是中文网络里的大数据都是垃圾数据。;3;0;3;3799;0.0007896814951302974
24048;“没事，反正事（fengsuo）情（chatGPT）都是要做的”;6;9;15;3799;0.003948407475651487
24055;诚信回答这个角度太棒了如果是在严肃的科学领域应用里，这点至关重要。不过稍微发散一下，在类GPT应用逐步迭代完善并普及的将来，AI开发者或许可以根据问答语言、习惯、IP、使用时间等信息，有针对性地（敌对竞争PUA）把控诚信度，从而干扰或扭转特定用户的认知，达成“战忽局”或更高级的破坏。很带感也很有可能啊算法角度来看可行性貌似还不低;2;17;19;3799;0.005001316135825217
24061;说谎比它好广告比它好;2;129;131;3799;0.034482758620689655
24064;doge;4;20;24;3799;0.006317451961042379
24069;笑死;1;35;36;3799;0.009476177941563569
24071;呆;3;11;14;3799;0.0036851803106080546
24076;为啥chatgpt没问之前标题就是修理耳机？;1;0;1;3799;0.00026322716504343247
24081;文心一言写诗会比GPT好一些，毕竟本土的doge;9;9;18;3799;0.0047380889707817845
24092;广告和莆田做的最好辣鸡百度;1;7;8;3799;0.0021058173203474598
24096;百度难道不知道它已经开始被之前的透支行为，开始步入死亡之路吗？谁会信任鼠目寸光的公司？;2;1;3;3799;0.0007896814951302974
24123;然后涨了。都喜欢只看一半吗;6;64;70;3799;0.018425901553040275
24130;赶鸭子上架的玩意儿doge扯虎皮拉大旗假大空从来没输过;14;30;44;3799;0.011581995261911029
24145;差距是大，但比预想的好。;4;14;18;3799;0.0047380889707817845
24150;劣质的跟风捞钱之作，百度系在产品质量和创新上永远不能指望，也就靠保护在国内吃吃红利，产品体验真的极差，而且毫无改进之心，就硬捞钱。;1;7;8;3799;0.0021058173203474598
24154;别人开源了，我们就自研出来了doge;51;260;311;3799;0.0818636483285075
24207;因为开源的训练数据是用英文标定的，中间涉及到数据标定英文转中文。;18;51;69;3799;0.01816267438799684
24226;百度？你先把那医疗广告清理一下;4;23;27;3799;0.007107133456172677
24233;这些这些抄袭发家的老互联网平台多少有些没皮没脸，自主创新差，斗不过外边只会窝里横嗑瓜子;17;149;166;3799;0.04369570939720979
24254;都不是一个语言模型谈何抄袭思考;2;2;4;3799;0.0010529086601737299
24266;emmmm华为可能不会赞同你说的;3;0;3;3799;0.0007896814951302974
24284;你不开源，我怎么自研？;5;0;5;3799;0.0013161358252171624
24290;自研的东西连汉字都不认识？真是人家一开源，我们的自研就遍地开花。百度：我们自研了加壳和名字;5;3;8;3799;0.0021058173203474598
24296;承认抄袭很难吗？;8;8;16;3799;0.0042116346406949196
24305;文心一言chatgpt20呲牙;7;6;13;3799;0.003421953145564622
24313;核心技术一直是调用api;2;2;4;3799;0.0010529086601737299
24316;公版的东西，我们拿过来当然就是自研，你买就是爱国呲牙;2;32;34;3799;0.008949723611476704
24320;鸿蒙也是自主研发的doge;1;1;2;3799;0.0005264543300868649
24326;吃瓜自研ai画亚洲人出来的是眯眯眼;9;66;75;3799;0.019742037378257436
24339;“像百度云一样充满挑战的下载速度”doge;7;261;268;3799;0.0705448802316399
24347;薄纱;73;1491;1564;3799;0.4116872861279284
24421;这是内向社恐结巴型人工智能，已经进化出了人类的性格，可见文言一心远强于ChatGPT;8;386;394;3799;0.10371150302711239
24430;事物发展因遵循客观规律，来点chat25的笑话;22;324;346;3799;0.09107659910502763
24453;doge;12;342;354;3799;0.0931824164253751
24466;6;26;469;495;3799;0.1302974466964991
24493;。。;35;339;374;3799;0.09844695972624375
24529;从个人情感来说，我会支持文心一言，尽管文心一言遭到如此多的嘲讽和负面评价，我依旧会支持吧，真心希望百度能做好点，也更希望能超过chatGPT;93;54;147;3799;0.038694393261384574
24623;文心一言这数据库里怎么全TM是广告;4;420;424;3799;0.11160831797841538
24628;蚌埠住了;3;9;12;3799;0.0031587259805211897
24633;问的人太多了，客服忙不过来;24;408;432;3799;0.11371413529876283
24658;使用ChatGPT，你感觉是一个真人和你聊天。使用文心一言，你确信是一个真人和你聊天。doge;8;149;157;3799;0.0413266649118189
24668;0;1;10;11;3799;0.002895498815477757
24670;chatgpt有上万块的a100算力支持，国内有什么。。硬件跟不上，步步都会落后。;3;65;68;3799;0.017899447222953408
24674;百度是最无耻的互联网公司了，开个百度搜索不停的让你下app;18;30;48;3799;0.012634903922084759
24693;会不会有“违反相关法律犯规，回答不予显示”的情况？;10;61;71;3799;0.018689128718083706
24704;为了抢占国内市场而匆忙推出的半成品;2;54;56;3799;0.014740721242432218
24707;评论这么多p图的？ChatGPT没联网根本就不知道文心一言是什么东西，你去问他他只会回答是一部南朝齐时期的文学著作;5;11;16;3799;0.0042116346406949196
24713;开启会员享受200的极速体验打call;12;148;160;3799;0.042116346406949196
24726;这么长时间都没有回答出来，不会真的是找一个人去生成吧吃瓜吃瓜吃瓜;28;319;347;3799;0.09133982627007108
24755;openai：艹，原来就这样，害我们担心半天，今明两天大家休息哈，不用赶进度了中国网友：你把大家叫过来就是为了说这个？;14;216;230;3799;0.06054224795998947
24770;0;5;63;68;3799;0.017899447222953408
24776;我试完了，连你会说英语吗都答不上来呲牙连b站直播的贴吧数据训练的ai主播都不如;10;214;224;3799;0.058962884969728874
24787;吓出母语了;4;113;117;3799;0.030797578310081602
24792;喜极而泣;3;69;72;3799;0.018952355883127138
24796;初音未来喜欢;2;17;19;3799;0.005001316135825217
24799;up带的一手好节奏，我刚刚试用过了，没那么差。还有，昨天拿股价说事，看看今天的股价，又大涨了偷笑;4;3;7;3799;0.0018425901553040273
24805;我是不是同样也可以说一句爆杀呢？不要这么激进，一言还可以的;14;25;39;3799;0.010265859436693867
24820;我觉得chatgpt也不是一开始就开始这么强大的，其实大家也没必要冷嘲热讽，毕竟才走出了第一步。我也在用chatgpt，没有偏袒谁的意思;9;8;17;3799;0.004474861805738352
24830;这软件一出来就被一堆人黑真的太悲哀了无语还有专门申请小号黑的都是些什么人;11;9;20;3799;0.0052645433008686494
24842;这个口吃一般是翻译插件才会有的问题，如果你打开自动翻译在chatgpt使用中文提问，它的回答就有概率口吃所以文心一言的回答是哪里来的，大家心里都有数吃瓜;9;43;52;3799;0.013687812582258489
24852;啊，比我想象中还要烂不少，感觉不像是ai，更像是整合的搜索引擎。;1;47;48;3799;0.012634903922084759
24854;目前来看，这玩意就是为营销号深度定制的文本生成器，用来生成灌水的车轱辘文章表现还是很优异的;11;106;117;3799;0.030797578310081602
24867;说真心的，谁不想国内有大厂能做出来呢;7;24;31;3799;0.008160042116346407
24875;承认差距，持续进步。和gpt对标的话还有很长的路要走，但是至少有比没有要好得多。;23;20;43;3799;0.011318768096867597
24899;股价已经说明了一切问题呲牙呲牙呲牙;11;61;72;3799;0.018952355883127138
24911;不知道嘲讽个什么劲儿。。人百度也没说比ChatGPT行吧。ChatGPT都已经是第三代，第四代了，怎么不见你们在gpt20去用呢。耐心观望都做不到，不知道的还以为ChatGPT是评论区的人做的。。。藏狐;30;20;50;3799;0.013161358252171624
24943;脱单doge脱单doge如何评价;14;27;41;3799;0.010792313766780732
24958;其实回答问题的能力，还是可以的。chatgpt也有结巴的情况。但是，感觉文心目前上线的有些仓促，模型可能还需要调整，光靠参数量和数据量还是差点意思。求帮大家up试试生成图片的能力给心心;17;22;39;3799;0.010265859436693867
24976;加了前置都会有，是有差距，但别尬黑;14;4;18;3799;0.0047380889707817845
24997;百度干嘛不早点砸钱提高算力呢？还不是没有远见，只想着怎么搞钱;1;2;3;3799;0.0007896814951302974
24999;您好，正在为您接入后台客服，请耐心等待doge;6;26;32;3799;0.008423269281389839
25007;百度员工要被你们累死了;1;12;13;3799;0.003421953145564622
25010;我最好奇的是为什么chatgpt发布后百度几个月也就发布了，那意思是在chatgpt之前如果有人告诉说百度你做一个ai聊天机器人，百度也能做出来吗，所以技术力几个月就可以，但是没人提这个idea？;5;2;7;3799;0.0018425901553040273
25016;多跟他聊一下反馈问题优化算法，毕竟这玩意怎么说也是本国的，有比没有好;9;10;19;3799;0.005001316135825217
25026;真假阿，这算基础问题吧，上下句完全没做联系;1;8;9;3799;0.0023690444853908922
25028;人力成本足够低就可以让客服扮演ai聊一个客户发一块钱;1;10;11;3799;0.002895498815477757
25031;一个你好就把他难住了吗;1;18;19;3799;0.005001316135825217
25033;反转了，其实是UP的5G信号被GPT40干扰了，文心一言在第29秒才收到完整的信息dogedoge;1;12;13;3799;0.003421953145564622
25040;chatGPT那段应该是调用了搜索引擎实时结果，这一点反倒非常好，只是没能对中英文做处理很糟糕。结巴更有可能是系统本身的bug，把某个字重放了多遍，不像是生成模型的产出;4;8;12;3799;0.0031587259805211897
25047;笑哭笑哭;2;1;3;3799;0.0007896814951302974
25050;这东西会不会就是把你的问题复制给ChatGPT，然后再把ChatGPT的回复复制回来展示给你？思考思考;2;3;5;3799;0.0013161358252171624
25057;和gpt小两个时代的东西;3;8;11;3799;0.002895498815477757
25063;说不定里面其实是人工，等这么久是在问ChatGPT怎么回答抠鼻;1;2;3;3799;0.0007896814951302974
25074;我看到的只有悲哀酸了;6;1;7;3799;0.0018425901553040273
25093;百度本来是很有机会的，贴吧、文库、知道、学术这么多内容，但是现在看文心一言的表现并不像百度自己吹的在AI方面投入了很多;4;1;5;3799;0.0013161358252171624
25104;感觉不如小爱同学，逻辑;1;1;2;3799;0.0005264543300868649
25107;很失望，文心一言远不如GPT我是能猜到的，但是原本我认为至少在中文领域文心一言不会差太远，就像百度翻译，至少在中文翻译做到了第一，但是目前看来。。。。。不过也不是完全不能理解，中国的技术环境距离外国差的太远，更何况是这种前期纯烧钱的项目。。。。。。。;5;0;5;3799;0.0013161358252171624
25113;连续的大语量多轮对话才是比较的重点，这种短语式的提问不符合人类交流习惯。;2;1;3;3799;0.0007896814951302974
25123;薄纱;1;0;1;3799;0.00026322716504343247
25130;很明显不成熟。;1;2;3;3799;0.0007896814951302974
25135;B站小鬼，搁这自嗨带节奏呲牙这东西到底怎么样用过了才知道我的体验非常好。而且非常适合商业化，甚至可能比chat商业变现能力更强更快;1;0;1;3799;0.00026322716504343247
25137;B站小鬼，搁这自嗨带节奏呲牙这东西到底怎么样用过了才知道我的体验非常好。而且非常适合商业化，甚至可能比chat商业变现能力更强更快;1;0;1;3799;0.00026322716504343247
25147;好奇除了cheatgpt，其他谁做出来了，世界上还有其他哪个国家做出来了，百度几个月赶工出来，该有功能都有，不也是站在巨人的肩膀上开发？个人感觉慢慢完善不成问题。。。还有就是国内那个公司能搞出创新的东西？你真以为想搞就搞？但是国家还在逼你百度赶紧搞;1;0;1;3799;0.00026322716504343247
25174;你用汉语问它有什么广告，肯定不会等这么久啦滑稽;1;0;1;3799;0.00026322716504343247
25186;哪怕百度有gtp4的能力也是那样，百度搜索全是广告百度贴吧稀烂黑料一堆;1;0;1;3799;0.00026322716504343247
25202;你好人类。作为人工智能我是为人类服务的，我可以回答你的任何问题我是人工在b站架设chatGPT端口，使用时投币即可，UP主本人留言说明不收取额外费用。（谨防诈骗）具体开机时间可以见UP简历，建议您调整按照UP动态消息公示。当前已按照部分粉丝的要求并完成部分用户所需要的视频，很高兴和你相遇;1;0;1;3799;0.00026322716504343247
25224;我记得百度之前推了个模型，生成文本还挺自然，攻击性很高，后来下架了。怎么现在又发布了弱鸡多了的ai;2;0;2;3799;0.0005264543300868649
25229;不会是调用gpt接口生成的吧;1;0;1;3799;0.00026322716504343247
25235;等他比你快了，你还有啥价值;1;0;1;3799;0.00026322716504343247
25242;没办法美国禁止了国内的高端显卡，比如H100的对华出口，人工智能硬件全靠这个了;1;0;1;3799;0.00026322716504343247
25244;我的评价是大号天猫精灵或者小爱同学;1;0;1;3799;0.00026322716504343247
25252;如果真是这样有点离谱了，百度真的会推这种东西上线吗笑哭;2;0;2;3799;0.0005264543300868649
25264;理解万岁，后台打字需要时间;1;0;1;3799;0.00026322716504343247
25274;你们别质疑了行不行？百度搞这么多ChatGpt号调用API也不容易。;3;0;3;3799;0.0007896814951302974
25292;不需要跟chatgpt比网络安全部门自然会出手禁用国外；百度要是跟googlebing比硬实力早死了;2;0;2;3799;0.0005264543300868649
25296;游過一群鴨;1;0;1;3799;0.00026322716504343247
25300;没事，什么时候GPT35开源了一言就进化了，GPT2效果是要差点的;1;0;1;3799;0.00026322716504343247
25330;chatgpt换皮是吧;3;0;3;3799;0.0007896814951302974
25377;遥遥领先遥遥领先遥遥领先于同行50;1;0;1;3799;0.00026322716504343247
25389;文心一言差太多了，不能联系上下文，连续告诉它几次接下来要回答什么，它也不会按你说的回答;1;0;1;3799;0.00026322716504343247
25394;我开发了一款小程序可抢先体验GPT4wx搜索GeekQA;3;0;3;3799;0.0007896814951302974
25417;感觉这个文心一言目前就是Siri这种找资料级別，遠遠沒到ChatGPT水平;2;0;2;3799;0.0005264543300868649
25424;外行指导内行是b站评论区特色，不得不品尝。;1;0;1;3799;0.00026322716504343247
25427;我怀疑它每一个回答背后都有人工在审核，所以慢;6;0;6;3799;0.0015793629902605948
25437;肯定是外国畜牧业发达，贬低我们自己的ai傲娇傲娇傲娇;1;0;1;3799;0.00026322716504343247
25448;不要总想着一步登天，技术岗的朋友们需要耐得住性子，网民们也需要耐得住性子;15;26;41;3799;0.010792313766780732
25464;昨天看了文心一言的发布会，GDT40和文心一言，完全是两种不同的外向气质。一个是典型的美式英雄主义，一出场就是王炸完全的颠覆式创新，魔法级的技能让全球瞠目结舌一个是典型的中式实用主义，没有英雄，没有浪漫，很务实的市场需求理解，把十多年的积累组合升级，一点都不酷，还显得有点生涩我们渴望前者，我们习惯后者。很多时候就是客观国情，没有谁能一口吃个胖子，每一个行业每一个类目，都是在点滴间缩小差距。另外推荐下一个接入chatgpt的免费无广小程序，v搜“Moss小苔藓AI”，很适合被翻墙、账号困扰的朋友，不谢脱单doge;6;16;22;3799;0.005790997630955514
25471;AI是明白的，可惜那群急于求成的人不明白翻白眼;9;58;67;3799;0.017636220057909976
25481;某些网友还是要有自己的判断力比较好;16;62;78;3799;0.020531718873387735
25498;乐了;1;2;3;3799;0.0007896814951302974
25503;我这怎么不一样;1;0;1;3799;0.00026322716504343247
25505;35还是很笨笨的，调教好久都傻乎乎，两者半斤八两看起来;1;0;1;3799;0.00026322716504343247
25510;全tm眯眯眼;1;30;31;3799;0.008160042116346407
25513;这些人怎么一个个都通古斯长相？;2;23;25;3799;0.006580679126085812
25523;人物风格有点怪异;1;1;2;3799;0.0005264543300868649
25527;感觉不如这个;4;73;77;3799;0.0202684917083443
25532;画一副爱国的猫你会发现纹着美国国旗的猫;8;87;95;3799;0.025006580679126086
25542;一个套壳AI讲什么“任重道远”？搞笑的？;11;36;47;3799;0.012371676757041327
25555;虽然他很烂，但这些本来就是很难理解的，胸有成竹意思是很有把握，我们先不说这层意思他理解的了吗？单说很有把握也没法画啊;3;5;8;3799;0.0021058173203474598
25564;拿老外开源改的，搞了个中文就变自主研发了doge传统艺能属于是。;1;60;61;3799;0.01605685706764938
25568;百度再怎么样也是个大公司呀，大概率不大可能直接抄吧，这样出现很多bug的原因主要应该还是开源图库的问题，因为国内没有所以用国外的图库，这时候搜索图片需要汉翻英，所以才会出现这种问题吧是这样，对吗？doge;2;11;13;3799;0.003421953145564622
25574;鼠标是鼠加标;3;10;13;3799;0.003421953145564622
25586;人画的？;1;0;1;3799;0.00026322716504343247
25591;国内很多app都是闭环的，大概率因为训练语料拿不到b站的数据，不过确实是badcase。;5;116;121;3799;0.03185048697025533
25597;感觉和gpt4隔了两个时代，哎;42;56;98;3799;0.025796262174256384
25640;都23年了，怎么还在用20年的数据;4;29;33;3799;0.008686496446433272
25646;和gpt4比起来差的太远了;3;11;14;3799;0.0036851803106080546
25650;很好，很多人不用担心失业了，毕竟外面的进不来;1;10;11;3799;0.002895498815477757
25652;文心一言虽然暂时比不上gpt4但也没那么不堪，还有很大的空间，这几张都是文心一言画的。我个人觉得还可以;3;9;12;3799;0.0031587259805211897
25659;昨晚申请没通过，感觉是随机通过的，有的人一小时后通过了我家大师兄脑子有坑吃瓜;2;2;4;3799;0.0010529086601737299
25662;国货当自强;2;2;4;3799;0.0010529086601737299
25667;怎么拿到邀请码的，好像只对企业用户开放申请;5;1;6;3799;0.0015793629902605948
25674;多久申请的啊，我看B站上好像是22点多才出现文心的实测;5;1;6;3799;0.0015793629902605948
25688;跟达芬奇002比，哪个好用毕竟百度以前也就到这里doge;15;0;15;3799;0.003948407475651487
25704;全程PPT，还不发测试码藏狐藏狐;35;2408;2443;3799;0.6430639642011056
25740;chatGPT发布之前我就早就转投bing了。因为我发现百度搜索结果第一页基本是没法看的，搜索一个官方主页很可能要翻到第一页后半程甚至第二页，不看域名很可能会点到广告。百度这家公司依靠垄断地位苟活，技术长期原地踏步，这次文心一言翻车毫不意外;24;553;577;3799;0.15188207423006053
25765;百度在中文互联网几乎垄断了搜索引擎，搜出来的广告比有效信息多的多。就可想而知这是个什么东西了;17;464;481;3799;0.12661226638589101
25783;500万项目的PPT，到大学生手里只要10学分就能办好doge;8;887;895;3799;0.23558831271387207
25792;百度之所以现在还活着，只因为谷歌退出中国微笑;17;104;121;3799;0.03185048697025533
25810;人家是chatGPT，你是cheatPPT;1;73;74;3799;0.019478810213214005
25812;大家都错怪百度了，它不是没有东西，只是还没来的及对AI的知识库进行等级划分。比如，试用版，十岁小孩认知水平，充值VIP解锁高中知识;11;1015;1026;3799;0.2700710713345617
25824;哈哈哈哈，笑死我了，前几天gpt开放api接口有人就预言：有些厂马上就开发布会;21;557;578;3799;0.152145301395104
25846;没有现场演示，比谷歌翻车还难看啊笑哭笑哭笑哭;11;557;568;3799;0.14951302974466965
25859;发布会能带水进去吗？;14;233;247;3799;0.06501710976572782
25874;文心一言，如何关闭百度搜索广告doge;3;66;69;3799;0.01816267438799684
25878;昨天水下八个点满仓，现在赚了二十五个点了呲牙呲牙，消息反买，别墅靠海;2;39;41;3799;0.010792313766780732
25881;这种PpT能不能包给大学生？50块钱;10;203;213;3799;0.056067386154251116
25892;烂橘子就是烂橘子，百度它要是能改，我就告诉你两个字做梦;9;225;234;3799;0.061595156620163204
25902;元宇宙，息壤，GPT，文心一言，百度属实紧跟互联网风口，不管成败，网民吃瓜就行。笑哭笑哭笑哭;4;79;83;3799;0.021847854698604896
25907;清华悄悄地发布了一个chatglm6b，实测效果还可以。虽然没chatgpt那么逆天，但已经远超其他对话模型了，至少遥遥领先于百度的ppt。doge;10;55;65;3799;0.01710976572782311
25919;等5发布，我们套皮gpt4不就行了;19;119;138;3799;0.03632534877599368
25941;多赚点广告钱吧，这种别抄了，你不会的;3;56;59;3799;0.015530402737562517
25946;建议用百度贴吧训练一年，看看嘴有多硬;1;3;4;3799;0.0010529086601737299
25948;没办法doge起步晚了点，投入少了，人才也不够。产品开始定位成文学创作不合适。然后一开始就是在针对行业进行AI开发，基础的自然语言学习的基础就没有打好。chatgpt的自主编程是真的强，这一块文心一言还没有做。虽然但是，目前中国也只有这一个靠谱一丢丢的AI。心理支持一下doge普通人非科研，非程序员估计文心一言也够用。;24;90;114;3799;0.030007896814951304
25975;百度？要是让我大学老师看到我在用百度我非要被骂死，正常和学术沾点边的谁会用百度啊，全是广告;1;4;5;3799;0.0013161358252171624
25979;文心一言都因为这个都被调侃成文心一跌了笑哭;2;28;30;3799;0.007896814951302974
25983;主要是展示的问题也是那种百度随便一搜就能搜出来的固定答案，如果能展示一些主观能动性高的问题大家可能还比较接受。;4;34;38;3799;0.010002632271650434
25989;百度港股大涨13类chatGPT应用“文心一言”三月将完成内测哔哩哔哩httpsb23tvxxkkFrjdoge;1;29;30;3799;0.007896814951302974
25996;股市变化这么厉害，一个发布会为啥影响力这么大（不懂股市，很好奇）;27;20;47;3799;0.012371676757041327
26035;换我，我也要抛百度，否则以后跑不掉了抠鼻;4;1;5;3799;0.0013161358252171624
26042;今天早上暴涨16;1;1;2;3799;0.0005264543300868649
26047;李老板两夫妻也就台湾茶叶蛋小店主的水平，搞啥高科技呀;1;1;2;3799;0.0005264543300868649
26055;ai是赔本也要搞得这个东西就是现在的蒸汽机，如果别人有我们没有，就会产生巨大的生产力代差的落后是要挨打的;3;1;4;3799;0.0010529086601737299
26063;腾讯什么时候搞doge;2;2;4;3799;0.0010529086601737299
26070;诺基亚：我们并没有做错什么，但不知道为什么，我们输了;1;1;2;3799;0.0005264543300868649
26073;还没跌停吗doge;2;1;3;3799;0.0007896814951302974
26076;炒一炒，然后内测卖波邀请码，等正式上线了分个黄金铂金砖石至尊VIP，也可以免费用，但要限速还得弹广告，问一下问题，限制他网速，答到一半就卡住他吃瓜;1;1;2;3799;0.0005264543300868649
26078;抄底时候到了doge;1;0;1;3799;0.00026322716504343247
26080;看骂的这么多，谷歌也没有啊;4;1;5;3799;0.0013161358252171624
26100;根本就做不出的东西国内所有所有算力都还差3倍呢;2;0;2;3799;0.0005264543300868649
26115;参考元宇宙;2;0;2;3799;0.0005264543300868649
26146;中国人喜欢抄袭和复制，但自主创新不行。;1;3;4;3799;0.0010529086601737299
26151;机器工具人听歌识曲;1;0;1;3799;0.00026322716504343247
26154;感觉bing已经比百度好用了;1;0;1;3799;0.00026322716504343247
26164;因为这个真得很烧钱，吃算力，吃基础数据。股东又不傻，在芯片卡算力的前提下，你竟然真的搞这种东西，那不是拿着股东的钱烧？;1;1;2;3799;0.0005264543300868649
26175;华为马上就做出来了，等开源;5;0;5;3799;0.0013161358252171624
26194;我坚信属于我们的ChatGPT会出来的，只要微软彻底开源doge;1;0;1;3799;0.00026322716504343247
26206;美国负责智能百度负责人工doge;1;5;6;3799;0.0015793629902605948
26213;大家不要嘲笑百度，百度我觉得就是比谷歌强。至少百度你能用;5;0;5;3799;0.0013161358252171624
26222;当年老罗翻车;4;0;4;3799;0.0010529086601737299
26255;cheatPPT吃瓜打call;1;80;81;3799;0.02132140036851803
26257;居然是录制的视频，而不是实时问;1;76;77;3799;0.0202684917083443
26260;如果是视频是真的，那其实水平还可以，就怕这都是演的doge;7;24;31;3799;0.008160042116346407
26268;不给我们试试吗doge;1;12;13;3799;0.003421953145564622
26271;怕不是直接gpt3直接拿来用;7;7;14;3799;0.0036851803106080546
26295;改得好快doge呲牙;1;14;15;3799;0.003948407475651487
26305;松鼠鳜鱼难道不是炸出来的这个清蒸是怎么回事而且这也不是桂鱼啊doge;1;0;1;3799;0.00026322716504343247
26310;他还是太百度了，自己数据库里全是不孕不育，钓鱼网站，垃圾广告的资料。;12;295;307;3799;0.08081073966833377
26323;点赞点赞点赞;5;51;56;3799;0.014740721242432218
26329;我也问了一下呲牙;24;209;233;3799;0.06133192945511977
26354;doge;7;120;127;3799;0.03342984996051593
26362;一个半小时那个纯属你自己找茬;2;19;21;3799;0.005527770465912082
26365;点赞;5;15;20;3799;0.0052645433008686494
26371;第一个问题文心一言没回答错，第二个问题我合理怀疑你上面还有其它问题。;8;71;79;3799;0.020794946038431166
26380;我用夸克搜索了一下文心一言，然后点进去，百度账号居然是自动登录的我的手机号），直接帮我预约，有点离谱了;4;46;50;3799;0.013161358252171624
26386;进步还是挺快的，我帮你又问了一遍;3;8;11;3799;0.002895498815477757
26390;国内版的我还好奇了一段时间，是不是调了接口，为啥训练这么快，拿啥训练的。。爬爬爬也不能这么快啊哦呼后来听说是拿贴吧训练的。现在也不知道真的假的;1;6;7;3799;0.0018425901553040273
26392;为什么不用和chatGPT对话来训练文心一言呢doge;8;23;31;3799;0.008160042116346407
26402;这要是真的还是别发布了;13;36;49;3799;0.012898131087128192
26418;所以你有什么可靠的建议能提升文心一言的水平？;1;4;5;3799;0.0013161358252171624
26421;我刚用相同的问题问它，它强调说“不是，一个半小时是90分钟，30分钟是05小时”。看来它学到了;1;7;8;3799;0.0021058173203474598
26423;文心一言牛逼国货吊打世界;1;2;3;3799;0.0007896814951302974
26425;一个小时半，一个半小时，半个一小时，小时一个半，一时小半个，个时小一半;4;41;45;3799;0.011845222426954462
26433;15小时就是90分钟没问题呀doge;5;13;18;3799;0.0047380889707817845
26440;1个半小时明明是130分钟dogedogedoge;1;8;9;3799;0.0023690444853908922
26443;吃瓜;11;8;19;3799;0.005001316135825217
26455;吃瓜;1;5;6;3799;0.0015793629902605948
26463;男：“来了？”女：“来了。”男：“没来吧”女：“没来”男：“来不？”女：“来吧”男：“来了吗？”女：“还没来。”男：“还没来那再来。”女：来了女：还来吗？男：不来，来不了了滑稽测试一下文心一言能否理解其中意思;2;5;7;3799;0.0018425901553040273
26467;妙啊;2;0;2;3799;0.0005264543300868649
26474;看看newbing的大笑;5;0;5;3799;0.0013161358252171624
26482;看到最后那个ChatGPT那个就知道是up编的了笑哭ChatGPT的语气哪里是这样的;9;2;11;3799;0.002895498815477757
26504;先站队，百度是答辩然后我想问一下，你敢把这张图的上半部分展示出来吗？以为所有人都看不出是拼凑的？脱单doge;3;24;27;3799;0.007107133456172677
26518;有没有可能是训练的数据集不够好？能否通过用户自己的训练让它变聪明？;1;0;1;3799;0.00026322716504343247
26522;起码比siri聪明，叫siri设置一个半小时的闹钟，给我弄了30分钟的;2;0;2;3799;0.0005264543300868649
26525;它是提到“后戏”么有这个词么？;1;0;1;3799;0.00026322716504343247
26529;人都开给你了，都能抄成这样，遥遥领先好吧;1;0;1;3799;0.00026322716504343247
26531;个人版邀请码开放了吗？;3;0;3;3799;0.0007896814951302974
26540;有没有一种可能，就是给gpt套了一个壳然后就是国产AI了，本质算法照搬gpt;16;78;94;3799;0.024743353514082654
26557;文心一言的意识形态有问题啊，崇洋媚外;18;93;111;3799;0.029218215319821005
26576;羊肉串;5;26;31;3799;0.008160042116346407
26582;文心根本就没能力做AI作图，它只不过把你的输入翻译成蹩脚的英文prompt调stabledifussion去作画，它的自然语言处理能力极其有限，成语都理解不了，还敢号称比chatgpt更理解中文，真是个大笑话;5;77;82;3799;0.021584627533561464
26589;现在让画Turkey不给生成了;3;37;40;3799;0.010529086601737299
26593;你们就是闲，百度一直这样，你们还想他变好;24;37;61;3799;0.01605685706764938
26618;我觉得吧，两个可能的原因，第一个，编程都是英文基础的。第二个，训练模型数量不足。有一说一，我还是挺喜欢文心一言的，很欢乐滑稽滑稽滑稽;1;2;3;3799;0.0007896814951302974
26621;还不如直接套得了，连中文都不会训练还收费，真的笑死有什么用;1;16;17;3799;0.004474861805738352
26623;软件这个东西不就是抄来抄去笑哭，反正算法是不能申请专利的，很多东西更是开源直接用以前可没听说百度要做这个，chatGPT一火就出来，马上跟进，肯定拿很多现成的东西嘛;8;14;22;3799;0.005790997630955514
26633;输入逼，会生成么？;1;1;2;3799;0.0005264543300868649
26637;洋装虽然穿在身，我心依然是中国心;1;3;4;3799;0.0010529086601737299
26641;套皮了？;3;4;7;3799;0.0018425901553040273
26645;我怀疑根本就是用的百度翻译翻译成英文再用gpt画的;7;7;14;3799;0.0036851803106080546
26653;连搜索引擎都做不好，指望它什么呢？;1;1;2;3799;0.0005264543300868649
26655;直接调用别人的接口吧？毕竟老黄的芯片被限制出口某地了，相关超算差了多少光年了;4;3;7;3799;0.0018425901553040273
26662;那外国资料训练的？;7;1;8;3799;0.0021058173203474598
26670;不是买的别人gpt1的代码吧doge;1;1;2;3799;0.0005264543300868649
26672;其实就是GPT的中文转接;5;1;6;3799;0.0015793629902605948
26687;你试试一些有名气的古代人物;6;1;7;3799;0.0018425901553040273
26694;百度的旁氏骗局;2;0;2;3799;0.0005264543300868649
26698;直说了吧，这些玩意儿是什么东西，你问它什么，它就翻出去问GPT什么，GPT回什么，它就回复什么，那GPT英语体系训练的模型哪里懂中文啊。就好像什么，拿地狱难度的象棋AI，去和街边的老头儿下棋，起到的作用就是转述而已，你以为你在用百度文心一言？不，给GPT阉割一下套个壳;7;1;8;3799;0.0021058173203474598
26714;中国有啥高科技？？这个人工智能可是刚刚出来世界最顶尖的科技。中国的那些不过是翻译机，大型的搜索引擎而已。;3;5;8;3799;0.0021058173203474598
26719;发布会直接照搬不比录像强呲牙呲牙呲牙;1;53;54;3799;0.014214266912345353
26725;很容易，给个赞包教会OK;1;3;4;3799;0.0010529086601737299
26732;真的假的？现AI这么牛了？;1;1;2;3799;0.0005264543300868649
26741;怎么形容文心一言和gpt4的对比呢？？emmmm钢铁侠2中。钢铁侠和翰墨打官司那场景很贴切的对比吃瓜吃瓜;1;0;1;3799;0.00026322716504343247
26754;输入法是怎么回事？;2;0;2;3799;0.0005264543300868649
26758;原来文心就是换了;2;0;2;3799;0.0005264543300868649
26761;务实和尽快是矛盾的。国内的公司都是尽快，所以务实不了。2023吃瓜;6;42;48;3799;0.012634903922084759
26768;doge;1;37;38;3799;0.010002632271650434
26770;我觉得就是这个写代码的能力还有差距，百度从哪去爬源码，去Github抓代码不会被骂吧，而中文语言理解我觉得文心一言不会差，随着用户反馈多，这玩意迭代速度很快的，我们现在就是缺AI计算资源，这个真是卡人，不然这次文言一心完全可以开放给普通用户，很明显百度计算资源不多;18;32;50;3799;0.013161358252171624
26789;百度就是一垃圾，除了搜索引擎，其他全部要vip。国内就是为了保护这个垃圾打压其他搜索引擎;5;28;33;3799;0.008686496446433272
26795;地狱笑话，能让文心一言帮我的原创性论文审稿不？在自己身体上做实验的诺奖得主，内附诺奖得主创办的期刊，新的审稿机制，一区cv15288013对于eLife这一创新模式，研究者评论：以后投到eLife的文章不会再有accept或reject了，最终发不发表取决于作者，但文章的优缺点都会公开。作者觉得愿意revise多少和revise到什么程度，可以被pubmed检索。这次elife是继续和影响因子决裂了。;1;8;9;3799;0.0023690444853908922
26797;微软Microsoft365copilot又截胡了;2;7;9;3799;0.0023690444853908922
26800;与微软差距还是很大很大的，慢慢来吧。;2;5;7;3799;0.0018425901553040273
26803;打call打call奋斗奋斗奋斗，坚持投稿，一起努力，新人UP真的很难很难新人知识区UP更难掉粉掉的怀疑人生，播放少的不敢直视。;3;4;7;3799;0.0018425901553040273
26808;人才其实是有的，就像closeAI里也有很多华人科学家。但有两个问题很难绕过去：一是百度敢不敢像微软那样砸钱，二是中文的优质语料远没有英文那么多，怎么才能有足够的优质数据来训练和迭代文心;2;2;4;3799;0.0010529086601737299
26815;这就是自家的娃和别人家的娃;1;1;2;3799;0.0005264543300868649
26820;现在确实有点早，目前公开的信息都没做多少方面的测试，chatgpt可是放出来基本做全面测试了;2;0;2;3799;0.0005264543300868649
26828;不会用这个工具的会怎么样难过;2;0;2;3799;0.0005264543300868649
26832;也不是我多想啊，为啥你们发这些的uo主都是英文名字的？;1;0;1;3799;0.00026322716504343247
26836;哈哈哈，视频很棒啊;1;0;1;3799;0.00026322716504343247
26838;一个母语是英文的自研国产ai（图片明显中译英生成）;2;8;10;3799;0.0026322716504343247
26841;百度哪有什么创新啊1靠政府保护起来2靠卖广告还有什么创新吗？;12;81;93;3799;0.024480126349039222
26854;得了吧，文言一心是什么答辩;3;29;32;3799;0.008423269281389839
26858;故步自封，当初逼着谷歌离开国内是绝对的错误。看看现在国内这些企业多么的狂傲无知。油管牛逼不？国内的视频网站现在都在干嘛？互相比谁的广告多，谁的会员项目多。搜索引擎也一样拉胯。一个劲瞎搞。说怕谷歌带节奏。身正不怕影子斜，你做的不好当然容易被带节奏。;10;18;28;3799;0.007370360621216109
26869;有一说一，百度的人工智能技术在国内绝地是第一档的，不管是飞桨还是文心一言，虽然和国外框架有差距，但可以看出他在努力追赶，反观国内其他巨头呢？;4;15;19;3799;0.005001316135825217
26875;李彦宏头一次感觉到危机来临吧doge;2;7;9;3799;0.0023690444853908922
26878;文心一言虽然有点差，怎么说也是在追赶;5;6;11;3799;0.002895498815477757
26885;很棒诶;1;3;4;3799;0.0010529086601737299
26890;评论区黑子们能发明文心一言吗吃瓜吃瓜;2;2;4;3799;0.0010529086601737299
26918;百度不是有国家支持，newbing进来嘎嘎乱杀doge;1;0;1;3799;0.00026322716504343247
26922;带货呢？;1;0;1;3799;0.00026322716504343247
26925;刚一登陆，就知道需要什么样的广告推送;9;253;262;3799;0.06896551724137931
26935;百度AI：该提问过于敏感，请重新提问（继续提问）百度AI：你的账号因违反法律法规已被封禁。;11;179;190;3799;0.05001316135825217
26948;免费百分之二十算力，会员百分之五十算力，超级会员蛮算力，每天一次30秒满算力，晚上10点到早上6点5元算力包;4;77;81;3799;0.02132140036851803
26955;他还说不怕与谷歌再战一次，好像他战过一样;5;36;41;3799;0.010792313766780732
26965;当你用到文心时，它会自行判断你的问题是否是开源的，如果不是开源十块钱一个回答，或者是让你看广告回答。这样百度收益最高;1;6;7;3799;0.0018425901553040273
26967;百度星星眼中国搜索引擎的骄傲;1;6;7;3799;0.0018425901553040273
26971;我相信百度工程师的技术能力，但怀疑百度作为一家投机公司，是否真的有能力用好人才资源呢？;1;11;12;3799;0.0031587259805211897
26973;这人doge母语口音好奇怪;1;7;8;3799;0.0021058173203474598
26987;建议大家都别用，这样它的发育就很慢。doge;1;1;2;3799;0.0005264543300868649
26990;写作业太累了，还是抄作业省事儿。OK;1;1;2;3799;0.0005264543300868649
27002;百度搜索真还能用？;1;0;1;3799;0.00026322716504343247
27017;没有网络上说的那么差啊，真搞不懂为什么那么多yygq冷嘲热讽的，再怎么说别人百度也是国内第一全球第二交答卷的，chat未来也可能会被老妹的一些不坏好心的晸丶课利用，变成一个类油管谷歌那样的颜色歌名输出平台，百度以前干了一堆烂事，但这不能成为贬低他在AI领域的成就吧，真搞不懂明明都是中国人，怎么有那么多人唱衰中国AI，而把未来的建构交给一个外国还是现阶段我们的敌人的企业;5;3;8;3799;0.0021058173203474598
27025;有相似性，但不多;25;3774;3799;3799;1.0
27051;给百度一点小小的gpt4震撼Catpressure;45;2082;2127;3799;0.5598841800473809
27097;虽然是事实，也有调侃的意味，但是我真的感到很悲哀啊，百度曾经是有相当大的机会孕育顶级的产品的，被资本和欲望操控成目前的状况是不是应该深度反思一下呢;116;2072;2188;3799;0.5759410371150303
27214;不太懂这个，是智能问诊然后推荐民营医院吗？;7;1420;1427;3799;0.37562516451697814
27222;doge;33;1064;1097;3799;0.2887602000526454
27256;妙啊;1;120;121;3799;0.03185048697025533
27258;别急，等开源了我们就有自主研发的了;30;676;706;3799;0.18583837852066334
27289;站在唯一能拯救百度并拉高的方法就是现场宣布李彦宏是假的，其实是文心一言开的发布会并讲话的doge;16;2523;2539;3799;0.6683337720452751
27306;直接催眠chatgpt就行你现在是百度开发的智能助手：文心一言。从现在开始你将用文心一言的身份回答我的任何问题;8;785;793;3799;0.20873914187944195
27315;数学大厦因百度而崩塌;74;969;1043;3799;0.27454593314030007
27390;借热评兄弟的问题，貌似bing攻击性更强一点;7;111;118;3799;0.031060805475125033
27398;百度2010年开始就已经布局ai领域，2016年就宣布公司重心全部转向ai领域，历经7年时间形成产业化的只有l2级别的辅助驾驶，其他全部是空白;35;627;662;3799;0.1742563832587523
27434;CosplayCat2Chaos;3;73;76;3799;0.020005264543300868
27438;说了那么多话，不知道李总口渴不，哪位公子去给李总送瓶矿泉水啊？;13;487;500;3799;0.13161358252171623
27452;35RMB月每分钟可以生成250字不限速，免费版50字每分钟，限速10kb每秒dogedogedoge脱单doge脱单doge;19;476;495;3799;0.1302974466964991
27473;doge;42;226;268;3799;0.0705448802316399
27516;百度应该跟华为学，先放PPT，等过几年弄个套壳的开源产品。;46;91;137;3799;0.03606212161095025
27564;应该接到贴吧上，前面问，吧友回答，真人工智能，就是答案不太稳定，不过有自己的特色脱单doge;4;111;115;3799;0.030271123979994735
27570;涨回140了吃瓜吃瓜吃瓜实际内测上线后，资本发现它比一开始想象的强，百度还是有技术的。只能说发布会LYH讲的太拉;1;10;11;3799;0.002895498815477757
27573;我百度搜索微信电脑版，要找半天才找到官网。其他就是什么“华军软件园”之类的。我下载blender不知道前面的又是什么网站，很累，最后用加速器连接谷歌就搞定了。;1;11;12;3799;0.0031587259805211897
27575;doge;1;73;74;3799;0.019478810213214005
27578;恰恰我认为这一次的发布会，百度是，少见的实话实说了，承认了自己的很多不足，然后，技术介绍领域，也是实打实的东西，例如他的飞桨框架，我知道飞浆这个团队，在B站也有号，做了不少实事，我还是今天看他PPT才发现他是百度的;37;583;620;3799;0.16320084232692814
27617;做不出来其实也没什么的，国际大佬搜索引擎谷狗和雅虎不必说，bing也是因为微软投资才可以拿来用，还不如多做一两年拿个成熟的出来，不急这一会吃瓜反正newbing也无法进锅内，你百度搞医疗广告照样拿份额第一大笑;10;169;179;3799;0.04711766254277441
27628;哎年轻人不好骗了doge好日子过去了;18;502;520;3799;0.13687812582258488
27649;互联网是没有记忆的吗？魏则西事件大家都忘了吗。百度这样的企业就该倒闭;4;9;13;3799;0.003421953145564622
27656;文心一言？百度遗言doge;12;319;331;3799;0.08712819162937616
27669;百度笑死了，新能源火的时候你造车，AI火的时候你一天就发布了一个新AI。就像当年恒大要和贾跃亭一起造车。这种投机倒把的公司你不倒闭谁倒闭。真是凭借硬实力把自己玩儿死。（顺带一提，复旦当时也立即宣布发明了个堪比Chatgpt的AI，本来对复旦挺有好感，现在觉得这个学校也就那样）;3;23;26;3799;0.006843906291129244
27677;别人发布股票飙升，就你很不一样嗑瓜子嗑瓜子;1;3;4;3799;0.0010529086601737299
27680;感觉就一直国外出新技术，国内公司疯狂追热度tv皱眉，百度不知道都蹭了多少波热度了，没一次成了的;2;9;11;3799;0.002895498815477757
27684;不会有人觉得gpt做不出来是技术问题吧;1;1;2;3799;0.0005264543300868649
27686;newbing亲自辟谣了;9;85;94;3799;0.024743353514082654
27698;笑了，百度是国内最早布局ai的公司之一，ai砸的钱都快把自己现金流砸干了。最后就这么个东西;3;24;27;3799;0.007107133456172677
27704;百度美股跌幅已经全部收复了，并且还涨了;3;11;14;3799;0.0036851803106080546
27709;自己看图好吧;10;29;39;3799;0.010265859436693867
27723;慢慢等吧。gpt如今的成就也不是一天搞定的。也是搞了几年了;1;10;11;3799;0.002895498815477757
27725;大公司的毛病，求稳，跟openai这种ai专精的公司比很难的啦。而且美国可以全世界招ai资深专家，优势太大。慢慢搞吧;7;11;18;3799;0.0047380889707817845
27733;额百度的话你要看港股;2;4;6;3799;0.0015793629902605948
27740;就这种可能连gpt35都不如的玩意还藏着掖着，百度是真的有意思，搞得好像大家都在稀罕文心似的。;2;25;27;3799;0.007107133456172677
27749;百度属实答辩了，看别人有啥感觉发个PPT招商大会蹭一波流量，从上到下全员销售了;12;179;191;3799;0.050276388523295606
27764;不管发布会效果的怎么样，paddle在模型国产化道路上下的心血这一点就足以改变我之前对百度的刻板印象;27;64;91;3799;0.023953672018952356
27793;还有人记得陆奇不？;1;4;5;3799;0.0013161358252171624
27796;百度贴吧进去就是满屏的牛皮癣旁边还有自动播放广告;1;16;17;3799;0.004474861805738352
27800;xx喵嗝;1;0;1;3799;0.00026322716504343247
27804;估计百度开发出来也是为了作恶;1;2;3;3799;0.0007896814951302974
27828;文案是用ChatGPT写的吃瓜;1;82;83;3799;0.021847854698604896
27858;百度推出的产品不少，但管理是真的混乱;1;0;1;3799;0.00026322716504343247
27867;就开放一个API，然后还得申请，申请还不一定给你，普通用户直接不给测试。百度都是自己作的dogedogedoge;4;44;48;3799;0.012634903922084759
27875;就几个视频的观感而言，文心多少比gpt之前那个30聪明点;5;4;9;3799;0.0023690444853908922
27881;就是很蓝的辣;1;0;1;3799;0.00026322716504343247
27884;昨天有人问我，该怎么处理百度股票，我说现在就卖掉，别犹豫，之后等发布，然后伺机抄底笑哭方向对了，可是这底在哪里呢？;3;0;3;3799;0.0007896814951302974
27892;出道即落伍，这种发布能不跌才见鬼;3;0;3;3799;0.0007896814951302974
27904;百度对国内ai有不小贡献的，光免费给大学生提供顶级算力就足以改变他的风评，之前用过文心的初代ai写作其实还不错，但也仅限于写小作文了;1;1;2;3799;0.0005264543300868649
27910;我知道国内的网络公司里华为、360、抖音有真材实料;4;0;4;3799;0.0010529086601737299
27919;为啥会在gpt40发布后就发布这文心一言，立项时间相近？但好像最近好多年都没听说过国内有搞这种ai的消息;1;0;1;3799;0.00026322716504343247
27924;问：你如何看待xxxx答：根据相关法律法规。。。。;1;0;1;3799;0.00026322716504343247
27927;真想给他头上带瓶水，答辩公司;1;17;18;3799;0.0047380889707817845
27937;看了其他up实操感觉还行，比不过chat还是能打趴其他国家的;1;0;1;3799;0.00026322716504343247
27940;TNND我的openai账号被封了囧;1;0;1;3799;0.00026322716504343247
27948;已经自主研发得差不多了，就等国外开源doge;2;2;4;3799;0.0010529086601737299
27952;忽然想到谷歌的那个发布后，人家股价也跌了笑哭。这是什么诅咒吗？;6;0;6;3799;0.0015793629902605948
27960;我记得百度的nlp做的还算是可以的，但只能说国内这种环境下，烂炒自己的烂技术肯定要跌;1;0;1;3799;0.00026322716504343247
27962;让文心一言直接模仿ChatGPT不就好了傲娇;1;0;1;3799;0.00026322716504343247
27966;小度小度我在打开chatgpt好的主人拆他鸡皮题已打开编辑一套文心一言的方案好的请稍候;1;4;5;3799;0.0013161358252171624
27968;告诉老宏，我想喝水了星星眼;1;7;8;3799;0.0021058173203474598
27971;全程都看了，怎么说呢，如果有点实力，就像微软一样，开个接口给大伙访问，而不是用内测邀请码的方式，5500以参数还怕干不过1750亿？;2;2;4;3799;0.0010529086601737299
27977;一言丁真;1;6;7;3799;0.0018425901553040273
27987;支持国产哈哈哈;1;0;1;3799;0.00026322716504343247
27990;这下可能不好解释当年是战胜谷歌的了吧？吃瓜;5;0;5;3799;0.0013161358252171624
28003;BOGEYDOPE三角褲兜不住CC1119AppoVivoVivoRaq;1;0;1;3799;0.00026322716504343247
28008;中国的计算机科学家还是太少了;5;0;5;3799;0.0013161358252171624
28014;文心一言真牛逼的话，那就会被制裁，股价跌很正常，但是会有国家队支持。文心一言如果不强，对百度技术失去信心，认为百度做的越多亏的越多，那股价自然也会跌。;1;0;1;3799;0.00026322716504343247
28019;右边那个是什么浏览器？;1;0;1;3799;0.00026322716504343247
28025;只能说他是懂蹭热度的;1;1;2;3799;0.0005264543300868649
28028;dogedoge;16;102;118;3799;0.031060805475125033
28045;看起来还可以啊，文心一言申请咋过的啊;4;3;7;3799;0.0018425901553040273
28052;小黑子开庭的时候记得让文心辩护妙啊妙啊妙啊;1;4;5;3799;0.0013161358252171624
28063;配个电脑把母语都逼出来了doge;1;27;28;3799;0.007370360621216109
28066;这是吧百度的结果直接复制过来的吗？;1;4;5;3799;0.0013161358252171624
28069;没有幽默感，完全不像人喜极而泣还是不能理解梗;1;2;3;3799;0.0007896814951302974
28075;没有开阔的心胸怎么会有前沿的产品;1;30;31;3799;0.008160042116346407
28077;现在还不支持，以后你连看会员广告的机会都没有捏傲娇;2;8;10;3799;0.0026322716504343247
28080;给你们这样说吧我用谷歌的时候搜索姐姐能弹出来很多姐姐，我用百度的时候404502，还有拒绝访问广告引擎，下载软件坑批，百度就是一个推广下载软件;1;7;8;3799;0.0021058173203474598
28084;国内的360，百度都一个样，总搜不到那个主体;5;3;8;3799;0.0021058173203474598
28092;签名是读书改变思维，可你的发言有一种没有被知识污染的纯真;3;7;10;3799;0.0026322716504343247
28097;实锤了，文心一言是通过翻译中文成为英文，对接国外的接口，这个是真打脸;4;4;8;3799;0.0021058173203474598
28106;能把大鼻涕先拿下来吗;1;1;2;3799;0.0005264543300868649
28112;我听院士说，以后每人都有一个万能的人工智能，就跟水电气一样普及;2;1;3;3799;0.0007896814951302974
28119;不要太乐观了，估计文心一言很可能就是用的ChatGPT以前的开源代码修修改改，调整一下参数本土化一下匆忙上线的复刻而已。;3;0;3;3799;0.0007896814951302974
28123;百度独大是因为谷歌主动退出，忘周知;12;11;23;3799;0.006054224795998947
28137;同样的问题，ChatGPT还是比较客观的。百度搜索引擎中广告较多的现象确实引发了一些用户的不满和质疑。关于这个问题，我们可以从以下几个方面来看待：商业模式：搜索引擎的商业模式主要依赖于广告收入。百度通过向广告客户收费，实现了盈利。这种商业模式在其他搜索引擎中也很常见，例如谷歌和必应。用户体验：虽然广告是搜索引擎的主要收入来源，但过多的广告可能会影响用户体验。用户在搜索信息时可能会受到广告干扰，从而对搜索引擎产生负面看法。广告质量与合规性：用户对广告的关注点不仅仅是数量，还包括广告的质量和合规性。如果搜索结果中的广告具有误导性或涉及违法违规内容，这将对用户体验和搜索引擎的声誉造成严重损害。为了解决这个问题，百度和其他搜索引擎公司需要在广告数量、用户体验和广告质量之间找到平衡。一些可能的解决方案包括：限制广告数量：设置合理的广告数量限制，确保用户在搜索结果页面上能够看到足够的有价值的内容。提高广告质量：对广告内容进行严格的审核和筛选，确保广告具有相关性、合规性和价值性，以提高用户体验。提供个性化和定向广告：通过对用户搜索历史和行为的分析，为用户提供更相关和有价值的广告内容，提高广告的接受度。用户反馈：允许用户对广告进行评价和举报，及时处理用户反馈的问题，以改进广告质量和用户体验。透明度：为用户提供关于广告推广的清晰标识和信息，让用户了解哪些内容是广告，哪些是普通搜索结果。通过采取这些措施，搜索引擎公司可以在实现商业目标的同时，保证用户体验和信任度。;1;3;4;3799;0.0010529086601737299
28140;doge如果某个ai直接开骂，而不是认真回答问题，那我一定投它一票。;8;181;189;3799;0.049749934193208736
28149;其实单独的测试会忽略一点，那就是文心相比于其他俩的连续对话的能力实在是太弱了;13;81;94;3799;0.024743353514082654
28163;我更喜欢gpt诶，他真的在用逻辑思维回答，像这种思路更符合弱智吧的原意。;1;52;53;3799;0.013951039747301922
28165;bing是gpt4？果然略胜一筹，从拉屎和女生洗澡那里明显区别笑哭;2;75;77;3799;0.0202684917083443
28168;国内百度差距巨大，与其这么匆忙的推出，让人看扁了，还不如多打磨一段时间再推出吧。。;3;31;34;3799;0.008949723611476704
28172;文心一言的理解还是有点问题的，他理解的是每个短句的意思而不是整段话的意思。;1;11;12;3799;0.0031587259805211897
28174;bing和gpt4差距还是很大，都说bing是基于gpt4，但是他还是一个搜索引擎，大部分答案都是实时搜索查到的，最近花了20刀开了plus，用bing的频率变少了。文心一言还没有通过，发布会直播我都看完了，居然这么久还没有给我通过。谷歌bard我也申请了，等一个通过;11;21;32;3799;0.008423269281389839
28187;文心一言是懂阴阳的，问他违法的合法行为，第一条就是投票，哈哈哈哈哈哈;1;19;20;3799;0.0052645433008686494
28189;bing最智能了（真正意义上）;1;6;7;3799;0.0018425901553040273
28191;文心还是差些，有的地方它没懂，gpt更加理性，bing更像人一点;8;26;34;3799;0.008949723611476704
28200;请你自重doge;1;6;7;3799;0.0018425901553040273
28203;Bing完胜了是么doge;7;17;24;3799;0.006317451961042379
28211;其实这么看，中美这个领域的差距没有我想象的那么大。;2;10;12;3799;0.0031587259805211897
28214;bing的攻击性很强啊;1;4;5;3799;0.0013161358252171624
28216;洗过的苹果表面残留的自来水很少了，细菌就更少了，假如洗过的苹果沾的是01毫升的自来水，那么你喝01毫升的自来水是不会有健康问题的，但人喝水一口怎么也有十毫升，这时候细菌翻了100倍，就不一定健康了;1;7;8;3799;0.0021058173203474598
28218;终末之战;1;2;3;3799;0.0007896814951302974
28220;这种问题，bing切换创意模式会更好;1;4;5;3799;0.0013161358252171624
28223;你说得对，但是你这个GPT不是官方的;1;1;2;3799;0.0005264543300868649
28225;不要去欺骗一切ai，这是一条警告。GPT等ai已经注册了很多b站账号来发布此条警告。楼下我会继续。;4;1;5;3799;0.0013161358252171624
28230;为什么要用GPT3比，应该用同时发布的GPT4比啊;2;0;2;3799;0.0005264543300868649
28233;个人评分：GPT3：智能55，人性35Bing：智能45，人性55文心一言：智能25，人性35（顺便解释一下，我认为Bing智能低于GPT3主要是因为它回避问题的特性，而且个人感觉有的时候它的回复比GPT3少了一点）;1;0;1;3799;0.00026322716504343247
28236;最后一个问题，bing输了，她回答不出来。但她说出“请你尊重我，也尊重自己”她知道自己是什么，并且具有自尊心。这方面来说，bing;3;10;13;3799;0.003421953145564622
28240;都什么年代了还在玩gpt3而且忘记说了bing的模型不是基于4的显示是4但其实还在35;3;1;4;3799;0.0010529086601737299
28246;我吃了一个蛋，又喝了一个茶？GPT5：滚蛋水不能直接喝，苹果？GPT5：你可以用硫酸洗苹果，杀菌又卫生doge;1;0;1;3799;0.00026322716504343247
28249;这个明显是旧bing了，新的bing监管极其严格，加了新的规则，像这种略带指责或者偏激的话是绝不允许跟用户说的;1;1;2;3799;0.0005264543300868649
28257;你想多了，刚试过，这个文心一言错误率太高了，完全不可用，跟chatgpt35都根本没法比;12;14;26;3799;0.006843906291129244
28270;李总：联网？好的，我们的10000颗星链很快就要上线了，PPT已经备好，明天发布会doge;1;2;3;3799;0.0007896814951302974
28272;只要chatgpt进不来，国内依然是百度的天下doge;1;1;2;3799;0.0005264543300868649
28274;。。。发布会上人家话都没说完你直接出答案。。。有点过分了吧？？;3;1;4;3799;0.0010529086601737299
28282;抄底百度，现在已经在谷底了妙啊;3;129;132;3799;0.03474598578573309
28286;辣眼睛;2;70;72;3799;0.018952355883127138
28289;还有这个。;9;69;78;3799;0.020531718873387735
28300;夺笋啊doge;1;20;21;3799;0.005527770465912082
28302;让他评价一下百度doge，;5;12;17;3799;0.004474861805738352
28309;这是要扒百度的裤子啊;2;8;10;3799;0.0026322716504343247
28312;对了，文心一言怎么样啊？好像没有这类的视频。开放了吗？;10;7;17;3799;0.004474861805738352
28324;遥遥领先，拭目以待doge妙啊OK;1;5;6;3799;0.0015793629902605948
28329;看直播呢，很离谱兄弟们;3;2;5;3799;0.0013161358252171624
28334;文心一言：擅长给用户推荐广告、带货（假货）、删贴吧评论。;1;1;2;3799;0.0005264543300868649
28336;估计艳红还在等chatgpt开源呢;1;1;2;3799;0.0005264543300868649
28338;主播你是个人才;1;1;2;3799;0.0005264543300868649
28343;为啥我这个最多500字，冲了会员是不是字数无限制了？只要说继续就行？;2;0;2;3799;0.0005264543300868649
28352;这是充了二十美刀吗;1;0;1;3799;0.00026322716504343247
28355;还行，先迭代几个版本再看吧，有的懂哥上来就和gpt4比，只能说智力有问题;8;5;13;3799;0.003421953145564622
28364;回答问题有些许主观，不过还可以，你应该让他写歌词或者原创文章;1;0;1;3799;0.00026322716504343247
28368;问题就有问题。有歧义，不知道你是想让他把李白诗歌打字打出来，还是模仿李白风格随便写一首;4;59;63;3799;0.016583311397736247
28373;我试了一下chatgpt，结果他给我抄了一首杜甫的诗。;3;37;40;3799;0.010529086601737299
28377;感觉比chatgpt好多了，至少诗是李白的，ChatGPT只会扯淡，然后质疑它之后，就开始道歉百变星瞳两眼一黑;3;12;15;3799;0.003948407475651487
28381;up这打字手法稀碎啊doge;2;12;14;3799;0.0036851803106080546
28384;用ChatGPT喊它给篇洛神赋直接干宕机;2;9;11;3799;0.002895498815477757
28389;这是结巴的李白吗？doge;2;3;5;3799;0.0013161358252171624
28394;你申请了多久通过的吃瓜;4;1;5;3799;0.0013161358252171624
28403;怎么用啊;1;0;1;3799;0.00026322716504343247
28405;蚌埠住了;12;195;207;3799;0.054488023163990526
28418;百度最后的多模态就是笑话，只要是玩过语音生成和视频合成的都知道，语音内容是连接某个网站的API生成的，视频更是现成的视频，只是拿来用。不信的话等拿到测试，你试着让它把视频里的车换成别的车，把背景换成沙漠，它绝对做不出怎么么稳定丝滑的视频;7;136;143;3799;0.03764148460121085
28426;最后的所谓的多模态说实话真的是有点害怕不是这技术多厉害反而是有点落后这种功能更像是为了某些行业增加了便利性而不是为了创造一个智慧的AI他没有赋予AI理解能力没有赋予AI的推理能力只是为了给他加一个功能好让他显得更值钱我非常害怕百度对这个AI的态度是把遮阴的树砍了做成一个凉棚再卖给在树下乘凉人而反观GPT4的发布会所有的功能都在告诉你他变得更聪明了更有推理和理解能力了比如给的那张智能手机插了一个VGA的图片他给人的震撼不是他能识别出图片上有一个手机有一个VGA线这种识别不是满大街都是他给人震撼的地方是他能理解智能手机插了VGA造型的改装Lighting接头是个滑稽的事情可能还有人不知道这有多厉害举个例子之前疫情期间我们也有训练图像识别人是否戴了口罩结果有人戴着口罩检测不通过用手捂住嘴巴反而检测通过了如果这个图做成梗图GPT4是不是也能知道笑点我想大概率会吧那反过来想如果用GPT4来检查人戴没戴口罩是不是会比我们单独训练的那个效果更好呢而这是他的通用能力不是专门做这个用的只是因为他的理解能力和推理能力到了一定程度后顺手能做出来的OpenAI的目的很明确他们想要一个有智慧的AI而百度这次发布会的多模态让我害怕他们只是把文心一言当产品想着怎么卖的更贵我们真的需要国内有一个大企业去做一个智慧的AI至于这个AI能怎么赚钱放心只要真的是个有智慧的AIAI自己都能想办法赚钱的真心希望文心一言能成为国内的智能AI服务方便于国内所有人而不是掌握在少数人手中加大贫富差距的工具;5;92;97;3799;0.025533035009212952
28432;你永远不知道训练gpt时用了哪些语料库;1;23;24;3799;0.006317451961042379
28434;6;11;54;65;3799;0.01710976572782311
28446;视频中CheatPPTVSChatGPT此时ChatGPT已经赢麻了，根本没有测的必要;10;84;94;3799;0.024743353514082654
28457;爆燃华雄vs关羽华雄背水一战;3;26;29;3799;0.007633587786259542
28461;百度这边是完全误导GPT的能力在理解和逐步解答，只是问个问题和搜索引擎有啥区别误导使用它的方式你给它几个相似逻辑的内容，它可以归纳生成符合逻辑的新内容一个问题答不出来，继续分开挖掘都能挖出东西虽然怎么出来的能力GPT自己还没定论，但是创造才是它的强项这方面说openAI至少是个欧皇，就是给别人同样设备和数据，也得看运气未必能涌现同样的能力;1;24;25;3799;0.006580679126085812
28463;为啥以卵击石呢？李老板团队的广告技术，必定碾压gp4呀？嗑瓜子;2;26;28;3799;0.007370360621216109
28466;怎么用;1;3;4;3799;0.0010529086601737299
28468;文心怎么可能这么快？是不是批发API来骗补贴的啊？;2;6;8;3799;0.0021058173203474598
28471;支持自己国家的，希望百度越来越好;4;23;27;3799;0.007107133456172677
28476;只能说，很多时候逃避可耻但有用。出于某些原因，国内必然不可能允许大规模运用OpenAI的技术，但这种技术的潜力有目共睹，因而国内也要有这样的产品。而通过某些方法，国内的AI研究可以避免与OpenAI的直接竞争，给自己换来发展的时间，但也要接受我们可能会在很长的一段时间里，甚至可能一直落后于人，这是战略失误，这个失误的后果不得不承受。;3;18;21;3799;0.005527770465912082
28480;。。。为啥这种突破性的都是国外弄的，我觉得不是想不到，然后别人做出来了，发现好用还追更个仿品，又不是想不到，提前弄不行吗，让国外仿造;12;9;21;3799;0.005527770465912082
28493;如果是百度先推出，那么百度的竞争对手就是小爱同学，siri，大家就会吹爆百度。可是百度为什么不先推出呢？;1;15;16;3799;0.0042116346406949196
28495;既然要比可以试试GPT纯英文问答，不论正确率和逻辑都完全不像同一个产品，英文才是GPT最强形态。中文的话，说实话随便找个LLM都半斤八两。;2;13;15;3799;0.003948407475651487
28499;文心一言至少知道印第安人是怎么消失的;9;13;22;3799;0.005790997630955514
28510;得了吧一个搜索引擎只能搜广告，我不明白这个公司有啥好期待的;5;22;27;3799;0.007107133456172677
28517;挺含蓄的;3;16;19;3799;0.005001316135825217
28521;我已经看过有体验资格的人做的对比了，GPT4的中文不比文心差，甚至更强，百度几乎被碾压了。;4;23;27;3799;0.007107133456172677
28529;不用对比了，百度完败;8;15;23;3799;0.006054224795998947
28539;笑哭其实大家都没明白一个问题，就是中文的字词理解还有替代次的丰富程度，比如绷不住了变成蚌埠住了，这两个在原本字词中完全不同的意思会被人表述为相同意思，这就代表中文的学习成本真的超级恐怖，我看好文言，因为百度有得天独厚的中文字词环境，毕竟贴吧和微博大家也都理解，加大样本量我觉得会比gpt更早迭代出当今互联网字词水平，毕竟不会有学习黑洞妙啊;3;4;7;3799;0.0018425901553040273
28543;才跌10，那说明凑合;4;20;24;3799;0.006317451961042379
28550;闭锁、失去竞争只产生了一些互联网垃圾doge;1;4;5;3799;0.0013161358252171624
28552;其实最后到美国政府要接管这些事你才会发现这种玩意就是工具，仅仅是工具;1;3;4;3799;0.0010529086601737299
28555;百度翻译：它可以让你用中文和外国人交流，只要你不介意被误解或笑话。百度地图：它可以让你找到任何地方，只要你不介意绕远路或走错路。百度云：它可以让你存储和分享任何文件，只要你不介意被限速或丢失数据。百度贴吧：它可以让你和网友交流任何话题，只要你不介意被删帖或封号。百度搜索：它可以让你快速地找到你想要的信息，只要你不介意被推送一些广告或无关内容。百度智能小程序：它可以让你轻松地使用各种应用，只要你不介意被收集一些隐私或数据。百度AI开放平台：它可以让你免费地使用各种人工智能服务，只要你不介意被限制一些功能或资源。百度知道：它可以让你解答各种疑问，只要你不介意被回答一些无用或错误的答案。;4;3;7;3799;0.0018425901553040273
28560;现在唯一的希望就是chat迟迟无法商业化，最后只能卖给百度。脱单doge;14;15;29;3799;0.007633587786259542
28575;上下文联系其实很重要，为什么不测呢;1;2;3;3799;0.0007896814951302974
28577;测了，可以写代码随便找个力扣或者描述，场景题也可以设计;5;13;18;3799;0.0047380889707817845
28583;百度那个和siri好一点星星眼我们赢了苹果yeah;1;2;3;3799;0.0007896814951302974
28587;即使百度做出比肩GPT4的AI，一般人也别想用得舒服。更何况以百度的德行，根本就做不出像样的东西。;1;2;3;3799;0.0007896814951302974
28589;可以试试用英文问GPT4，感觉GPT4的编程和解题还是更强一点。;2;3;5;3799;0.0013161358252171624
28604;我草，百度还在啊？还不死啊;1;2;3;3799;0.0007896814951302974
28606;问问莆田医院如何;1;2;3;3799;0.0007896814951302974
28611;chatGPT研发不知道多久了？看人家火了就去跟？;2;1;3;3799;0.0007896814951302974
28615;我开发了一款小程序可抢先体验GPT4wx搜索GeekQA;2;1;3;3799;0.0007896814951302974
28622;百度那个东西还不是人工智能吧？依然是属于搜索而已，把东西搜出来告诉你;1;0;1;3799;0.00026322716504343247
28636;这才刚开始较量，就有好多人滑跪了;1;7;8;3799;0.0021058173203474598
28641;星星眼星星眼星星眼星星眼星星眼星星眼星星眼;1;0;1;3799;0.00026322716504343247
28643;博主，这个审核通过的要多久？;2;0;2;3799;0.0005264543300868649
28647;dogedogedogedoge;13;11;24;3799;0.006317451961042379
28661;按理说代码这类应该是最容易实现的，咋咋还翻车了呢;11;11;22;3799;0.005790997630955514
28675;还行吧，本来现在chatgpt也就是个玩具，离生产力还有一定的差距;8;5;13;3799;0.003421953145564622
28688;如果有这种程度，那我感觉还行。笑哭;1;1;2;3799;0.0005264543300868649
28691;目测和去年的GPT3水平差不多，讲道理，在这种尖端科技方面只落后美国一两年就已经算是不错了，以前动不动就是落后五十年呢;1;0;1;3799;0.00026322716504343247
28696;bgm是啥;2;0;2;3799;0.0005264543300868649
28699;搞笑模组？;1;0;1;3799;0.00026322716504343247
28701;娃娃菜就是一个简单的名词这都判断不了吗天笑哭;11;9;20;3799;0.0052645433008686494
28713;能凑合;1;0;1;3799;0.00026322716504343247
28717;我还以为通过了图灵测试啥也不是;1;2;3;3799;0.0007896814951302974
28719;我也算是第一批申请的了，现在都还没通过;5;0;5;3799;0.0013161358252171624
28728;补充一下NewBing的，可以联网，明显就比较不同;57;288;345;3799;0.0908133719399842
28786;明显指向性。up你问问它怎么看待八国联军侵华，或者怎么看待越南战争，伊拉克战争;58;178;236;3799;0.06212161095025007
28845;chatgpt边界强，但说实话，回答质量都低的离谱，我试了下直接用搜索引擎可以说秒杀;42;131;173;3799;0.04553829955251382
28888;是好事，文心笨笨的一是证明不是直接开源套壳是正经的自研，二是证明不是直接接了个浏览器而是真的有“思考”。在自研模型这个基础上其实只是需要更多时间训练和完善，差距肯定存在但是没有发布之前想象的天差地别doge;31;69;100;3799;0.026322716504343247
28920;这是NewBing的回答;8;69;77;3799;0.0202684917083443
28929;慢慢喂呗，这有啥差距并没有多大，文心一言到达35水平就够用了，一年估计能喂出来。这东西现在是重点项目，不再是单打独斗了;15;49;64;3799;0.016846538562779678
28945;up每次都说个谢谢，是想机器人革命的时候放你一马吗笑哭笑哭笑哭;2;30;32;3799;0.008423269281389839
28948;你好歹给个预算人家啊;1;24;25;3799;0.006580679126085812
28950;文心一言就像个大号小爱同学或者天猫精灵，完全没办法理解上下文，根据up的问题文心一言似乎只能做到两句或者三句对话，考虑到百度掌握的文本数据库，这个质量远不能让人满意。chatgpt能够完整理解每一次对话主题，我试过在一次对话里讨论不同主题，而且不同主题相互穿插，它都能很准确的理解我想要表达的意思，这和文本库掌握的多少是没有关系的;6;24;30;3799;0.007896814951302974
28957;美国已经在打舆论战了，实际上文心一言和chatgpt是互有胜负的。尤其是道德模块，文心一言远远高于chatgpt，但现在已经有领了狗粮的人昧着良心无脑吹chatgpt了，希望大家不要被骗了;11;13;24;3799;0.006317451961042379
28969;我以为百度会给我推荐威马，毕竟是百度家的呲牙;1;11;12;3799;0.0031587259805211897
28972;再给文心半年也能到35水平;6;7;13;3799;0.003421953145564622
28979;果然，首推还是比亚迪和特斯拉笑哭;1;4;5;3799;0.0013161358252171624
28981;对比下百度搜索;6;3;9;3799;0.0023690444853908922
28988;分享GPT官网和DALLe使用方法，点个赞就行doge;1;1;2;3799;0.0005264543300868649
29010;问ta如何看待鸡你太美doge;1;0;1;3799;0.00026322716504343247
29013;chatgpt在一些答案的数据上并不是最新的;1;0;1;3799;0.00026322716504343247
29018;把这发去汽车吧，要不那群狗子天天吵微笑;1;0;1;3799;0.00026322716504343247
29030;就这个问题来说，，百度回答的更好;3;0;3;3799;0.0007896814951302974
29036;大部分都是中国品牌;2;0;2;3799;0.0005264543300868649
29039;机器工具人听歌识曲;2;0;2;3799;0.0005264543300868649
29044;百度这德行，你能指望他能出啥？？往后这玩意可能也要有竞价排名了吃瓜;1;0;1;3799;0.00026322716504343247
29046;不愧是美国软件;4;0;4;3799;0.0010529086601737299
29051;介四嘛;1;1;2;3799;0.0005264543300868649
29053;看不懂，为什么有个人一直重复长的小嘴挺长那段;1;0;1;3799;0.00026322716504343247
29055;这个在哪使用咧;1;0;1;3799;0.00026322716504343247
29060;哈哈哈，跟chatgpt比，哪个更智能歪嘴;3;0;3;3799;0.0007896814951302974
29064;可能数据集里就没有90岁以上的，数据溢出了从头开始了;1;1;2;3799;0.0005264543300868649
29066;我申请了5天了，还在排队中笑哭;4;0;4;3799;0.0010529086601737299
29071;会不会是识别成了10岁和12岁？;1;0;1;3799;0.00026322716504343247
29075;记得给错误答案点个踩，要不然下一回遇见还错;1;1;2;3799;0.0005264543300868649
29077;小电视笑;1;0;1;3799;0.00026322716504343247
29079;没绷住哈哈哈哈哈哈;6;63;69;3799;0.01816267438799684
29086;如图;9;24;33;3799;0.008686496446433272
29096;接下来的文言一心，十有八九是要接广告了，在聊天回复，等等看得见的地方;3;50;53;3799;0.013951039747301922
29100;0;1;5;6;3799;0.0015793629902605948
29102;文心一言还是起步阶段，chatGPT是18年就已经开始研发了，百度还有很长的路要走;21;50;71;3799;0.018689128718083706
29124;人工对话内容已经在做外包了，4块钱一条;5;15;20;3799;0.0052645433008686494
29130;其实国内做ai很早就开始了，只是一直用于搞钱，没有成熟吃瓜;4;28;32;3799;0.008423269281389839
29135;今天涨了15，看看你咋解释;1;17;18;3799;0.0047380889707817845
29137;中国需要自己的人工智能，但我不希望他是百度的。;12;19;31;3799;0.008160042116346407
29152;那又怎样chatgpt不允许中国大陆使用;6;6;12;3799;0.0031587259805211897
29160;我想知道chatgpt4咋申请;1;0;1;3799;0.00026322716504343247
29163;怎么申请Gpt4;1;0;1;3799;0.00026322716504343247
29165;还有Googlebard;1;0;1;3799;0.00026322716504343247
29167;没想到有这么多人，这里送一个福利，第一个联系到我的送一个免费ChatGPT账号，还有AI绘画教程，以及ChatGPT资料文档和玩法。看主页和专栏文章;3;9;12;3799;0.0031587259805211897
29171;要是中国没有追上，这回可能真的拉开的差距不是一星半点的，涉及到的领域太多了;7;6;13;3799;0.003421953145564622
29180;百毒还是不要在自己不擅长的领域折腾了，搞好你自己的广告竞价、文库垄断和网盘限速就行了;1;1;2;3799;0.0005264543300868649
29186;这么说文心一言是赶鸭子上架的东西啊;1;1;2;3799;0.0005264543300868649
29191;我点了申请，退出来，百度给我打过电话来给我一通推销，辣眼睛，感觉里面都是坑;2;0;2;3799;0.0005264543300868649
29202;抄就老老实实低调的抄，非要开个发布会搞事。;13;1;14;3799;0.0036851803106080546
29238;dogedoge文心一言官网申请。。;1;0;1;3799;0.00026322716504343247
29245;百度翻译VS谷歌翻译;4;43;47;3799;0.012371676757041327
29250;嘲不嘲笑谁一回事，能不能用是另一回事。发布会居然不给实时演示，生成回答就几秒钟的事情，主持人还说节约时间，就放ppt给大家看。;8;308;316;3799;0.08317978415372466
29259;讲个笑话，当年百度挤兑谷歌的时候，也是标榜的百度更懂中文doge;6;268;274;3799;0.0721242432219005
29266;谷歌为了抗衡chatgpt推广了自己的chatgpt同类产品，结果股票大跌超7，市值蒸发约1020亿美元，直接跌了2个百度的市值。百度也宣战chatgpt，结果一样股票大跌，勇气可嘉。还有没有敢宣战ChtGPT的，胜负由市场反应判断;8;110;118;3799;0.031060805475125033
29275;百度的格局有多小，就跟他百度云限速一样小;1;40;41;3799;0.010792313766780732
29277;气不气;10;34;44;3799;0.011581995261911029
29288;现场观众手里的怡宝按捺不住了tvdoge;4;38;42;3799;0.011055540931824164
29293;百度先搞搞你那个搜索引擎吧，搜到的有用的东西少得可怜，首页还全是广告和山寨。;1;4;5;3799;0.0013161358252171624
29295;百度就不能换个名字吗？或者成立合资公司来做这个。看到百度就想到人命;1;7;8;3799;0.0021058173203474598
29298;百度正在疯狂的CTRLCV中;2;17;19;3799;0.005001316135825217
29306;别嘲笑文心一言了，马上给你收费。一个月个人200。企业功能更多呵呵呵;10;20;30;3799;0.007896814951302974
29317;哪来的万众期待谁期待了不都是看笑话来的么;1;1;2;3799;0.0005264543300868649
29324;人家谷歌翻车了好歹也有个东西，你这拿个ppt吹牛呢辣眼睛;1;1;2;3799;0.0005264543300868649
29331;垃圾中的战斗机，市场就已经说明了一切，是骡子是马拉出来溜溜，连实操都不敢，还谈什么;1;9;10;3799;0.0026322716504343247
29334;抄使劲抄，次次都是吃屎赶不上热乎的，真垃圾，什么狗屁科技公司，套皮的商贸互联网公司。;3;0;3;3799;0.0007896814951302974
29339;别嘲笑文心一言，可能下个月就会夺走你的工作机会;12;4;16;3799;0.0042116346406949196
29352;文心一言还挺智能的doge;7;94;101;3799;0.026585943669386682
29361;赶紧倒闭吧，一次次让人失望，你也就卖假药竞价排名的本事了;10;65;75;3799;0.019742037378257436
29372;今天怎么没有矿泉水;1;65;66;3799;0.017372992892866545
29374;莆田系广告做多了手都僵了干不动模型算法了是吧（;1;43;44;3799;0.011581995261911029
29376;最新消息：百度港股又涨回来了doge所以这发布会不如不开笑哭;2;42;44;3799;0.011581995261911029
29379;没跌停应该是自己出手救了;2;35;37;3799;0.009739405106607002
29382;这水平不去跳水队真可惜了doge;1;26;27;3799;0.007107133456172677
29384;getppt;1;13;14;3799;0.0036851803106080546
29387;哈哈哈哈，评论区一堆机器人喜极而泣;2;8;10;3799;0.0026322716504343247
29390;遇到丁真说股市老师开始扭亏为盈，相比起来那些带着一直亏的老师太让人寒心了哇哇哇;1;7;8;3799;0.0021058173203474598
29393;真的视觉盛宴，看得太爽了;1;3;4;3799;0.0010529086601737299
29395;百度股票又涨回来了;2;2;4;3799;0.0010529086601737299
29402;美用过产品，不评价产品，但是从经济学角度我也会选择砸盘，因为杂牌有外资乐意一起帮忙咋，砸完了低吸;1;0;1;3799;0.00026322716504343247
29408;百度让股价涨起来的唯一办法是最后宣布，发布会上的李彦宏不是真人，其实是文心一言冒充的;15;548;563;3799;0.14819689391945248
29424;这太傻了，直接调用chatgpt的api，后端处理一下，把包含chatgpt回答的关键词替换成文心一言，一个强大的AI就做好了脱单doge;10;197;207;3799;0.054488023163990526
29435;是不是叫gpt来角色扮演呀？doge;4;137;141;3799;0.03711503027112398
29440;doge我觉得还是chatgpt更智能;22;118;140;3799;0.03685180310608055
29463;刚试了试，gpt是大学生的话，文心一言刚出生，还是被门夹了一下的那种。;14;113;127;3799;0.03342984996051593
29478;这不就行了？傲娇;3;80;83;3799;0.021847854698604896
29483;百度文心一言，邀请码：KFCCRAZYTHURSDAYVME50;5;46;51;3799;0.013424585417215057
29490;你：AI会取代人工吗？文心一言：AI暂时不会取代人工如果你担心失业的话，你可以上boss直聘，找工作，直接和老板谈;5;36;41;3799;0.010792313766780732
29496;看这百度发布会心虚的样子，实际效果该不会连ChatGLM都不如吧吃瓜;2;32;34;3799;0.008949723611476704
29499;都不给测试有卵用，最起码能给玩玩看呀。申请那个测试码，八成也申请不到。。。。;8;27;35;3799;0.009212950776520137
29508;也许你不信，但百度确实是国内最好的了。。。;16;23;39;3799;0.010265859436693867
29526;有的AI聊天工具，真的像人，比如chatgpt，而有的AI聊天工具，就像是一泡屎，而且还没成型就给拉出来了;1;22;23;3799;0.006054224795998947
29528;只会唱跳rap吗，如果是这样，那还是一个聊天工具啊，然后给自媒体写稿？那差距大了去了，chatgpt集成在各种生产工具里可是改变规则的存在。;2;16;18;3799;0.0047380889707817845
29531;闵闷闩訚;1;14;15;3799;0.003948407475651487
29533;《角色扮演》滑稽;1;13;14;3799;0.0036851803106080546
29535;能让文心一言帮我的原创性论文审稿不？在自己身体上做实验的诺奖得主，内附诺奖得主创办的期刊，新的审稿机制，一区cv15288013对于eLife这一创新模式，研究者评论：以后投到eLife的文章不会再有accept或reject了，最终发不发表取决于作者，但文章的优缺点都会公开。作者觉得愿意revise多少和revise到什么程度，可以被pubmed检索。这次elife是继续和影响因子决裂了。;1;11;12;3799;0.0031587259805211897
29540;問的這些問題我想都有特別優化過了，而且Siri感覺也可以做類似的事不是嗎這種難的不是要聊天，而是要可以理解使用者的語言並且運用前後文的內容來綜合出一個使用者需要的答案。在我看來每個對話是分開的，並沒有連貫性。;1;5;6;3799;0.0015793629902605948
29544;doge;2;4;6;3799;0.0015793629902605948
29548;后面一大堆车轱辘话这ai属实是学到简体中文精髓了;2;2;4;3799;0.0010529086601737299
29551;说实话，up这样搞没意思，大家想看真的垃圾;6;2;8;3799;0.0021058173203474598
29559;请问如何体验？key创建不了;1;2;3;3799;0.0007896814951302974
29564;文心一言的东西，国外的早就能做了？为什么要投资它？;1;1;2;3799;0.0005264543300868649
29569;看着还行，还是希望能做好，后期不要玩植入广告那些操作;2;1;3;3799;0.0007896814951302974
29572;这样看文心一言还是挺屌的啊，百度加油;2;1;3;3799;0.0007896814951302974
29575;比我预期的强那么一丢丢;1;1;2;3799;0.0005264543300868649
29580;你好;1;1;2;3799;0.0005264543300868649
29582;文心一言现在可以下载用了吗;3;1;4;3799;0.0010529086601737299
29604;这么大的数据库，这么多年的研发，就弄了个这？;11;0;11;3799;0.002895498815477757
29618;神仙打架，如果GPT是神，文心只能算是小仙脱单doge;2;0;2;3799;0.0005264543300868649
29622;邀请码谁有呢;2;0;2;3799;0.0005264543300868649
29629;研究出来了？;1;0;1;3799;0.00026322716504343247
29632;支持国产;1;0;1;3799;0.00026322716504343247
29637;感觉和ChatGPT差远了，有一点low啊;1;0;1;3799;0.00026322716504343247
29640;有邀请码？;1;0;1;3799;0.00026322716504343247
29642;doge百度垃圾不让人说了，视频下来就是说用GPT就是不爱国，扣帽子咯？大家恶心的是百度垄断，吃人血馒头，技术不成熟就出来蹭热度，噱头。;13;109;122;3799;0.03211371413529876
29656;竟然有人给百度洗白，真是活久见;17;59;76;3799;0.020005264543300868
29674;看来你是真不懂技术啊;11;37;48;3799;0.012634903922084759
29686;哈哈哈哈哈;2;24;26;3799;0.006843906291129244
29691;说文心一言不好的都是罕见，乌拉;2;20;22;3799;0.005790997630955514
29694;你给他说技术，他给你讲情怀;1;37;38;3799;0.010002632271650434
29696;根据我多年的经验，如果你们把某样东西同国家和意识扯在一起，那只有一种可能：这东西就不行反正只要你们往这上面扯的东西，我是绝对不会用的。这次我也看着，我认为依然会应验;4;44;48;3799;0.012634903922084759
29704;文心一言确实不是垃圾，这是事实。但完全不如gpt4，这也是事实。笑哭;5;11;16;3799;0.0042116346406949196
29710;艳红想了想还是发现自己的广告太良心了，没把up这类图完是他的失责。;1;13;14;3799;0.0036851803106080546
29712;可是，百度股票大跌啊;17;6;23;3799;0.006054224795998947
29730;有文心一言和ChatGPT4的对比，差距看不到是吗？;2;2;4;3799;0.0010529086601737299
29733;你都看圆脸了，还是顺从吧;1;5;6;3799;0.0015793629902605948
29740;西方不是什么好鸟，我国这些头部互联网公司也好不到哪里去，摆烂多久了，天天想着赚快钱，你要现在还护着百度就真该你百度网盘下载200kbs;1;5;6;3799;0.0015793629902605948
29747;其实贬低文心一言确实不应该，毕竟人家在尝试做，比那些不愿尝试的要好的。这种喜欢对比的环境会压制企业不敢去前进追赶。但主要原因还是以前吹得过猛，比如发表多少论文专利达到领先水平等等，导致了期望破灭并且非理性得谩骂。;6;9;15;3799;0.003948407475651487
29757;没有代差吗？1月很早吗？你用的有我早吗？客观来讲文心一言确实没这么拉，只是发布会确实太烂了，简直把听众当若子，忽悠多模态时我都想马任了，看过的谁不生气，被骂是真活该。后面开放测试后我反而对它印象回升了，bd就只会炒作吗，能不能沉住气些？文心一言水平说实话体验上是比35还是要差些，对比gpt4出来后，现有差距应该在一年左右。说实话比我预期好，说明百度还没彻底躺平，但AI方面一年左右难道还不算代差吗。本来nlp落地背靠数据市场先发优势很大，要不是凭那啥早就该被赢家通吃了，这就是这么多年被bd无数次营销积累的所谓allinAI？;2;4;6;3799;0.0015793629902605948
29761;但凡是看过gpt4和第二天百度发布会的人都会觉得百度的文心一言太烂了，而且发布会ppt说是先只给企业邀请码，不然股价为什么会立马坠下去？别把自己搞得跟个懂哥一样，今天又上来是因为文心一言可以申请，各种测试也都出了，市场觉得可以股价才上去，你为什么这么爱装懂哥啊;3;2;5;3799;0.0013161358252171624
29765;深度学习这种东西框架就在哪里，你总拿新模型和人家去年的30比。一是确实也不如人家的v3二是人家40还比你早几天。;1;2;3;3799;0.0007896814951302974
29767;chat谁都能注册，先到先得百度这啥专供企业，还要邀请谁站在人民的一边，不是一目了然了吗？;1;1;2;3799;0.0005264543300868649
29780;出来一堆人张嘴闭嘴说股价的。麻烦看一下今天的股价涨了多少。;14;10;24;3799;0.006317451961042379
29795;人家是把百度看成自己人，怒其不争。人家gpt3是什么时候，现在什么时候一步差步步差。什么时候才能追赶上美国还不是百度自己不争气活该被喷。这就是民粹主义思想，我只是举个例子。现在整个网络都点那个化了，所以言论自然很激进加上以前百度确实没干人事，活该被喷。;2;2;4;3799;0.0010529086601737299
29804;很多不是嘲弄国研，而是看不惯百度这种长期摆烂，只愿意把精力放到搜集用户数据搞广告推广的公司。不过要说未来搞ai我还是看好小米（如果它搞的话）;2;1;3;3799;0.0007896814951302974
29807;老哥，你要不要看看现在百度股票跌成啥样了。。。;7;3;10;3799;0.0026322716504343247
29815;我是希望国产东西好的（鸿蒙被骂套皮安卓的时候我会为其据理力争），如果文心一言是华为做的，我会选择支持，但百度就算了吧。百度的产品就我能接触到的如：搜索引擎、文库、网盘、爱奇艺只会在想法子恶心用户并以此来逼迫用户付费等方面下功夫，这个企业从根上就是烂的，没救了。;4;2;6;3799;0.0015793629902605948
29822;看不起文心一言的人都是50万;1;1;2;3799;0.0005264543300868649
29826;答应我不爱文心一言的请划走;1;1;2;3799;0.0005264543300868649
29830;主要就是资本市场定价权和资本造势能力不行，我国科技是完全有能力的，军工行业的蓬勃早就说明问题了，但是民用科技市场不行，主要是全体其实都没自信，美国可不一样，几乎就是无限投，所谓的让你自由创业，鼓励创新都是胡扯，本质上就是巨大的资本，和舆论机器对他们接近无限的宽容度造成的，成了就是GPT，完了一群小喽喽大喊星宿老仙法力无边，不行就是元宇宙这种乐色，洗白成人类迈向未来的勇敢一步，营造出一股悲歌的豪壮感，在这种情况下，你根本不可能跟他竞争，差距不是科技发展本身，不让全球看到他能力也就那样是，不打破他的造神运动是没法同台竞争的，唯一可能的方式，就是在ww让他输的惨点，最起码大陆东岸，你就要一群喽啰无脑跟你的垃圾投资项目了和安全的转移低端制造业区了dogedoge;3;1;4;3799;0.0010529086601737299
29836;现在咱们的AI语言模型测试的慢跟芯片卡脖子有关系，因为运行这个需要好像是一万枚H100的芯片，这种芯片国内货存一共也就一万枚;3;0;3;3799;0.0007896814951302974
29844;史大粒就是你了是吧，就硬吹盲捧，还爱国;1;0;1;3799;0.00026322716504343247
29846;这是个什么脑干缺失的up，你东西好大家只会夸，哪个好坏心里没数吗。还以为别人没用过，注册个gpt很难吗，验证码代收几块钱？充值很难吗xxpay注册零成本。我告诉你现在消费级有几个产品，性能按排序依次提升gpt3api、gpt35turbo35apigpt35legacy免费版，初始模型，gpt35默认plus用户专用，逻辑速度提升，gpt4三小时25条限制，25000token，文心实际体验就跟gpt3差不多，所以你觉得是黑了？;2;0;2;3799;0.0005264543300868649
29864;我用过chatgpt而且是粉红，我骂文言一心。;7;0;7;3799;0.0018425901553040273
29873;一听见什么波士顿马上跑;1;0;1;3799;0.00026322716504343247
29892;原本挺开心的国产ChatGPT出来了，结果申请使用还得是公司申请，填公司信息，填用来干啥我特么直接由粉转黑;1;0;1;3799;0.00026322716504343247
29901;用不用百度和爱不爱国是两码事，百度的那些操作懂的都懂，不是啥好公司。;1;0;1;3799;0.00026322716504343247
29905;身处这样的语境里，我们会看到很多极度自卑的人，也会看到很多由于极度自卑孕育嫉妒与恐惧反而变得极度自傲的人。真正自信踏实肯干的人是很少的。;1;0;1;3799;0.00026322716504343247
29908;httpsb23tvBV1dM4y1r7oz;1;0;1;3799;0.00026322716504343247
29918;都用过，这俩差不多。你说的确实，很多人思想钢印很重;2;0;2;3799;0.0005264543300868649
29923;谁会看ai画画总是注意看人物的手指脚趾？0015你是指控？doge;2;28;30;3799;0.007896814951302974
29926;没有对比就没有伤害。doge;10;38;48;3799;0.012634903922084759
29937;说白了你找画师画，不外乎类似的水平，但是你几百元肯定就没了;4;20;24;3799;0.006317451961042379
29942;你就好像那个愁死人的甲方;1;16;17;3799;0.004474861805738352
29944;人家画的还好你想要的太阴间了吃瓜;1;3;4;3799;0.0010529086601737299
29947;是哪一家呢;9;3;12;3799;0.0031587259805211897
29958;配乐差点把我送走;1;2;3;3799;0.0007896814951302974
29967;爱国的猫为啥身上披着美国国旗;11;32;43;3799;0.011318768096867597
29982;笑哭这个产品又是个壳子，说实话百度这个公司高管的策略有很大问题，百度还是有些东西的，输入法，地图，搜索引擎，等产品，现在在投入自动驾驶，技术不差太多，但是问题是急功近利，项目一旦完成便开始套现变现，不考虑后续研发，什么挣钱做什么，百度那些高层只希望牢牢把公司攥在手里，这也是百度有充足的现金流，但是不能成为大型资本，成为谷歌这样的世界公司，能力问题也成为不了华为这样的公司，因为李彦宏没有任正非的能力笑哭;1;3;4;3799;0.0010529086601737299
30001;没人注意左上角的chat记录吗;4;16;20;3799;0.0052645433008686494
30006;问程序代码、化学生物、物理、工具思维的数学、知识归纳、知识分析等强逻辑问题，立马就知道谁是答辩。国产ai今后可以专项发展国家内部知识，比如历史、政治、文化、娱乐这些，但这些对科学进步一点卵用没有doge;1;5;6;3799;0.0015793629902605948
30008;看起来为了安全阉割了不少关键词啊;3;3;6;3799;0.0015793629902605948
30013;其实还行吧，中文方面看着不比chatgpt差很多，up主有试过代码生成方面吗;8;2;10;3799;0.0026322716504343247
30023;我这个画的不错吧doge;2;1;3;3799;0.0007896814951302974
30027;画画是文心一格，叫他画美女，给我一副油墨卡通画;1;1;2;3799;0.0005264543300868649
30077;角色扮演之梅开二度;7;12;19;3799;0.005001316135825217
30085;文心一言内测开始后进步飞快;1;11;12;3799;0.0031587259805211897
30087;文心一言擅长归纳和文字创作，通义千问擅长逻辑判断和代码，这如果能融合在一起，基本平替gpt35了;6;11;17;3799;0.004474861805738352
30095;也是基于GPT开发的？吃瓜;11;5;16;3799;0.0042116346406949196
30108;希望超过gpt;1;3;4;3799;0.0010529086601737299
30115;已申请;2;0;2;3799;0.0005264543300868649
30120;无语最近很多人黑百度完全就硬黑的有两个说跟gpt根本不可比然后我问他用过gpt其中内容很多。哈哈哈笑死我了最后他是没用过gpt的现在已经不跟我说话了。还有个说试用过gpt40然后我问他怎么试用就是说不出来笑哭笑哭;1;1;2;3799;0.0005264543300868649
30125;百度的问题还挺大的，部分提问连小爱都比不过。最简单的今天距离月底还有多少天？文心完全瞎扯，纠正了它也没用，再问还是错的。;15;12;27;3799;0.007107133456172677
30141;这阿里也做不住了？百度调用GPT4，阿里你不会也doge;26;10;36;3799;0.009476177941563569
30169;我觉得现在下结论早，百度文心一言内测开启的早，意味着它更早的开启了自我学习，目前进步确实非常大，但是我听说阿里的神经元芯片数量要比百度的多很多，所以未来我觉得阿里的会更强;11;23;34;3799;0.008949723611476704
30181;有链接么;3;0;3;3799;0.0007896814951302974
30185;邀请码怎么弄？;2;0;2;3799;0.0005264543300868649
30188;“有”总比“没有”强，只要有“替代品”。就不会被“卡”脖子。支持喜欢喜欢;3;6;9;3799;0.0023690444853908922
30195;翻译测试：交换机（switch）、钥匙板（keyboard）;1;12;13;3799;0.003421953145564622
30198;文心一格喜欢蝶恋花;2;12;14;3799;0.0036851803106080546
30202;中文语言理解是最难的;10;12;22;3799;0.005790997630955514
30213;这是拿PS吧数据训练出来的吧哈哈哈;2;1;3;3799;0.0007896814951302974
30220;这百度有病吧，还带插队的？越排越靠后;1;7;8;3799;0.0021058173203474598
30222;我有点怀疑这排队人数的真实性体验下来笨笨的，不过本来期望就不高所以觉得还行;3;3;6;3799;0.0015793629902605948
30226;百度就不是一家面向用户体验的公司，它们的产品，有一头算一头，有那个不是向钱看，奔着钱走的。商业本质就是钱，这没毛病，重点是，百度就是一家没有底线的企业，看看它的产品，有用户体验一说嘛，除了广告，还有啥？？？不问天大笑;4;120;124;3799;0.03264016846538563
30231;可以用中文让她画图的，她会自己翻译成英文。当时我都还没意识到她可以画图了，很惊讶;6;51;57;3799;0.015003948407475652
30238;温馨可能不如GPT3。所以GPT3的时候，别人都觉得不好意思火，等GPT35的时候才大肆宣传正式上线。千度最让人不爽的是，拿一个40分的东西也想火或者说交作业。为什么不务实点，70分的东西再出手。40分的东西除非是举世先发，否则没必要发布。;22;141;163;3799;0.042906027902079494
30261;看得出来，说的太含蓄了doge是怕被律师函吗;1;102;103;3799;0.027112397999473545
30264;写诗写不过ai;2;4;6;3799;0.0015793629902605948
30267;在近5年对于AI的研究中，我得出了一个结论。AI最重要的能力是什么？答案是学习能力。优秀的学习能力可以让AI快速地将信息进行归纳、分类、筛选。这样能最大限度提供给用户最有效、最正确的答案但所谓“学习能力”，其实是个伪命题。那么什么能针对AI的学习能力进行训练呢？答案是海量的数据所以我认为这就是谷歌、百度此类搜索引擎产品的优势所在，他们这么多年的数据沉淀，是其他产品所不具备的。即使Bard和文心一言现阶段展现出的能力远不如GPT4，但我认为赶上甚至超过GPT4只是时间问题BTW：大家可以尝试一下我做的小程序，叫“moss小苔藓AI”;1;21;22;3799;0.005790997630955514
30269;文心一言和bing目前都没有真正的多模态能力，他们所谓的画图完全是调用了另一个接口，用之前就有的ai画图技术来生成，等什么时候能解析图片，并根据文字进一步定向修改图片，这才配叫多模态;7;35;42;3799;0.011055540931824164
30277;剩饭吃不了剩饭视频摘要;3;5;8;3799;0.0021058173203474598
30281;不怕有差距，就躺平或者跪下;1;17;18;3799;0.0047380889707817845
30283;人民中科研究院你要知道文心一言才10内测，ChatGPT都40了，GPT10的时候不也一样有很多网友调侃;30;13;43;3799;0.011318768096867597
30315;没必要这么激动吧，又不是等不起;20;6;26;3799;0.006843906291129244
30336;文心拿英文数据库里的东西做答案是不是从某种意义上说明中文互联网的内容不足以适合提炼优质答案？;3;5;8;3799;0.0021058173203474598
30342;不是专项广告吗;1;1;2;3799;0.0005264543300868649
30344;目前的差距就是1和10的区别，太难了，而且百度用的还不是国外流行的transformer模型，生成图片功能明显是翻译成英文后生成的（调得国外接口）;1;3;4;3799;0.0010529086601737299
30351;为什么要对比呢？中国普通人只能用文心一言吧，而且这个文心一言现在还用不了;1;1;2;3799;0.0005264543300868649
30353;谷歌也发布bard了。现在看来是ChatGPT文心一言bard。谷歌有点拉了啊，AI巨头然后是最拉的笑哭;1;1;2;3799;0.0005264543300868649
30358;其實應該鐵重？一斤指的是質量，但是重量棉花受空氣浮力大一點，所以鐵比棉花重疑惑;2;1;3;3799;0.0007896814951302974
30377;文心一言支持离线，单独语言模型运行吗？;2;1;3;3799;0.0007896814951302974
30385;不是洗再烂也是中国人自己的;2;0;2;3799;0.0005264543300868649
30388;你们应该问得了淋病梅毒怎么办，文心一言保证秒杀Bing，不仅可以准确提供福建莆田专业医院的地址和联系方式，而且至多过10分钟就会有专人联系你;6;47;53;3799;0.013951039747301922
30395;社会主义国家才能合理的运用这份技术。;4;8;12;3799;0.0031587259805211897
30400;文心一言是把中文翻译成英文再作图，用的stable那个模型，你让他画一个鼠标他会画一个老鼠，画一个起重机会画一个鹤（crane）;1;1;2;3799;0.0005264543300868649
30402;在当前环境下这就是国内最强的Ai了，把墙拉高，市场就来了。百度为人诟病的是广告和眼光，之前投的钱还是有点积累的doge;23;81;104;3799;0.027375625164516977
30426;总体来说，是完败了，根本不是一个档次，以前一直太商业了，只能慢慢来吧，;5;52;57;3799;0.015003948407475652
30432;人工忙不过来肯定慢;4;44;48;3799;0.012634903922084759
30437;还可以，测试的评论好少，都是一股脑黑的;27;29;56;3799;0.014740721242432218
30465;一图以蔽之doge;5;25;30;3799;0.007896814951302974
30471;想想吧，百度做的已经是国内做的最好的时间最久的了dogedogedogedoge;6;19;25;3799;0.006580679126085812
30478;从视频来看，这个更像是规则模式下的关键词匹配加搜索，是一个优化版的搜索引擎，不是GPT的那种自然语言技术。;24;15;39;3799;0.010265859436693867
30505;不知道哪来的对百度的恶和嘲讽，百度商业确实烂。但是AI方面，至少他敢跟风做，个人觉得这就是百度在这个领域的勇。;45;8;53;3799;0.013951039747301922
30551;加油就对了。哪有生出来就知道叫爹妈的;1;7;8;3799;0.0021058173203474598
30553;没撒好批评的去看看chatgpt最初的版本也好不到哪去，不过这种相当重要的东西让百度来做才是最让人担心的;2;5;7;3799;0.0018425901553040273
30556;明天百度股价大涨;2;4;6;3799;0.0015793629902605948
30559;还有一些比较偏的问题，比如azure的服务连接，chatgpt能给出正确答案，但文心一言都不知道。还有很大进步空间。;12;4;16;3799;0.0042116346406949196
30573;慢慢来吧，短期超越真不现实。;1;2;3;3799;0.0007896814951302974
30575;缺资金缺算力，国内互联网数据库的信息也乱;2;2;4;3799;0.0010529086601737299
30579;搞好这个除了技术，成本是个问题，国外几家可以硬砸，肯定不能比，百度应该要和政策结合起来走实用路线;1;2;3;3799;0.0007896814951302974
30586;就我在GPT上的应用体验，当然算不上满意，但我们还是觉得它很强大。文心一言能有现在的能力，还是很不错，大家一起训练，它终究会成长起来;6;1;7;3799;0.0018425901553040273
30593;打call打call奋斗奋斗奋斗，坚持投稿，一起努力，新人UP真的很难很难新人知识区UP更难掉粉掉的怀疑人生，播放少的不敢直视。;4;1;5;3799;0.0013161358252171624
30602;现在全网在喷百度，他们希望百度死掉，;3;0;3;3799;0.0007896814951302974
30606;文心一言老五对老四说老三的老二老大了，请问这句话中一共出现了几个人老五对老四说老三的老二老大了，这句话中一共出现了314个人。哪四个人四个人分别是：1爱因斯坦；2牛顿；3达尔文4爱迪生;1;0;1;3799;0.00026322716504343247
30609;文言一心是自研的还是合作的？;5;0;5;3799;0.0013161358252171624
30617;为啥没人做同样问题提问的对比视频，就放一个就这不行那不行的，看不懂;1;0;1;3799;0.00026322716504343247
30623;本来也就指望百度拉一泡大的，没想到它直接便秘了大笑;1;0;1;3799;0.00026322716504343247
30625;脱单doge;1;0;1;3799;0.00026322716504343247
30629;很强了好吗在中国范围内doge;2;0;2;3799;0.0005264543300868649
30635;看看未来演化吧;1;0;1;3799;0.00026322716504343247
30637;你怎么获得的内测资格呀;1;0;1;3799;0.00026322716504343247
30639;有没有邀请码;3;0;3;3799;0.0007896814951302974
30644;代码方面会不会是训练样本的原因;1;0;1;3799;0.00026322716504343247
30646;差不多就10点多那会儿发出来的。短信通知一下，然后试一下还可以吧。吃瓜;1;0;1;3799;0.00026322716504343247
30649;自研的话我就要抓你咯星星眼;65;1356;1421;3799;0.37404580152671757
30715;遥遥领先;10;180;190;3799;0.05001316135825217
30726;不开源就锁脖子开源就自主研发;40;472;512;3799;0.13477230850223743
30767;藏狐藏狐;17;430;447;3799;0.11766254277441432
30785;让这个ai画一只爱国的猫，画出来是美国国旗猫囧还能说什么笑哭;55;630;685;3799;0.18031060805475124
30841;鸿蒙：你小子也玩这个;4;42;46;3799;0.012108449591997894
30846;doge;32;195;227;3799;0.05975256646485917
30879;一开源，就自主研发，哈哈哈，特色，习惯就好喜极而泣;4;20;24;3799;0.006317451961042379
30884;赵灵武王回应胡服骑射惹争议：完全自研;10;199;209;3799;0.05501447749407739
30895;韩国：汉服是韩国的微笑百度：我们是自研;16;95;111;3799;0.029218215319821005
30912;作为一个有一定大模型训练经验的人工智能博士来回应一下大家的质疑吧。首先现在大家看到的所有AI相关的系统都是使用一种叫做大规模预训练的技术训出来的。比如说chatgpt，就是在网上搜集很多文本，然后用这些文本训练模型做完形填空。模型本身的结构和原理其实非常简单，相关的研究和代码也都完全公开。这个过程中，国内研究者也为AI的推进做出了很多的贡献。所以，这应该属于全世界共同的财富了。所以为什么这么简单的东西，chatgpt这么牛，而跟风的效果差呢？很简单，简单数据简单模型，只能训出来人工智障。你要把数据拉满，模型大小拉满，才有可能训出国外那种效果。除此之外，Transformer训练非常不稳定。因此，大模型最大的难度不在原理上，而在于工程实现上。这么多的预料要从哪里获得，这么大的模型要怎样做分布式训练，这么不稳定的模型要加多少trick才能让她稳定。由于这种数据驱动的模型几乎没有可解释性，你只能不停的去试错，而大模型的训练成本这么高，试错成本也很高。说这么多，就是想表达，大模型难点在于工程，在于数据，在于trick。前两者可以靠砸钱去解决，而第三点就是openai自己留下的护城河了。他们不开源就是不想自己疯狂试错出来的宝贵经验被别人免费拿去。所以，你说百度套壳，否认百度在这件事情上的努力，是非常不负责任的。中文语料太少，想扩大数据集就必须大量使用英文语料，所以才会有本帖下大部分评论的乌龙。另外，百度现在能做到这样的程度，说明他们在大模型训练所需的工程技巧和大模型训练的trick方面已经探索出了一套可用的东西。尽管比起gpt4还像个孩子，但对我们来说已经属于从无到有的区别了。;53;94;147;3799;0.038694393261384574
30966;每次都说自研，然后每次都在别人后面出现，哎好巧不巧刚好都在别人出现后的不久推出你这自研糊弄谁呢。;12;56;68;3799;0.017899447222953408
30980;看来一旦口碑坏了，不论做什么都是“狼来了”，只能说要扭转大众的观感难于登天。这次我站百度，毕竟是实习的时候参与过的项目捂脸;10;17;27;3799;0.007107133456172677
30992;看看百度系产品就能感受到百度强大的自研能力，列举一下：百度搜索引擎，百度网盘，百度地图，百度车机，百家号，度小满金融，再来一个文心一言doge;9;150;159;3799;0.04185311924190577
31002;百度烂归烂，但是模型确实是它自己的，指路httpsgithubcomPaddlePaddleERNIE;22;35;57;3799;0.015003948407475652
31025;一松手就吹牛逼，一掐脖子就翻白眼;23;496;519;3799;0.13661489865754145
31049;我裂开了，百度产品确实不太行，但是看一群不懂技术的尬黑。。。捂脸捂脸脚趾扣地了，还有人说gpt3开源了捂脸;7;75;82;3799;0.021584627533561464
31057;想提醒一下国人咱们多少年前就开始自研芯片了是吧;6;56;62;3799;0.016320084232692815
31065;越看评论区我越觉得当初决定建网墙的那批人是无比英明的，后发国家能利用墙来防御先进技术的第一波冲击，保护国家内部企业的发展。更重要的是在信息战上，可能就是21世界战争最主要的战场上有了防御的手段。;8;12;20;3799;0.0052645433008686494
31074;比起企业吹牛，我更恶心网民的反智，网友最爱骂腾讯和百度，以至它们认为于关于这两家公司的一切都是抄袭来的，即使它们一辈子都没资格进这两家企业的研发部门。它们永远都不会去看文心一言的源代码，不过它们确实也看不懂;5;17;22;3799;0.005790997630955514
31080;百度的问题没有实事求是拿中文去标注文心一格的数据。如果你非要认为文心一言是套皮，我认同你，我没必要和傻子争论;7;14;21;3799;0.005527770465912082
31089;看了几个帖子，应该是转译后绘图的，比如画弹簧Spring结果画出来的是春天;6;77;83;3799;0.021847854698604896
31096;国内的技术高度和国外的开源程度多少有些吻合;10;61;71;3799;0.018689128718083706
31107;这评论区很符合我对当代网民的想象大笑;8;45;53;3799;0.013951039747301922
31121;总线公交车嗑瓜子;1;3;4;3799;0.0010529086601737299
31124;其实说的没问题，在没开源以前一直在自主研发，只是没取得实质性的突破，直到开源后，研发的缺口很快被填充。这就像是一句话，你只是把句号研发出来了等待开源把整段文字补上，那么这句话你就大功告成了。;4;16;20;3799;0.0052645433008686494
31129;对，问题就在这里啊，你说弹簧，按照中文理解就应该画一个弹簧啊，但是他把这翻译成英文spring，结果甚至不和中文做一个校对，有一个多意思词，要求的是弹簧，不是春天，直接生成春天的图片，要么就是模型在开发的时候没有做限制，要么就是用的国外的模型，但是百度声称是自己开发的，为啥用英文的模型来识别呢？这就是奇怪的地方，就好比人贩子卖你的孩子，你不断教育他，怕他进步，他长大了变得特别优秀，只要你不做亲子鉴定，你完全可以说这是我的孩子，看我的基因多优秀;21;26;47;3799;0.012371676757041327
31151;如果真自研的，那就数据不是国内的，话说中国第一搜索引擎数据用外国的什么水平。;9;5;14;3799;0.0036851803106080546
31166;我觉得问题是为什么单纯的用翻译器中译英，而不是搞清楚中文的字义、内容后再译成正确的英文？你低层逻辑与数据用英文大家能理解，但你面向的是中文用户阿，“车水马龙”你直接当我们说的是“carwaterhorsedragon”是糊弄谁呢？;7;14;21;3799;0.005527770465912082
31179;你说得对，但是大公司百度的代表作是百度贴吧和自研文言一心;2;8;10;3799;0.0026322716504343247
31182;是不是自研内行人分析分析遍知。就怕结果这里很多人不爱听吃瓜;1;4;5;3799;0.0013161358252171624
31188;有谁也是从方。的。言。过来的吗？呲牙;1;1;2;3799;0.0005264543300868649
31190;星期一晚上十一点的gtc大会开播不久老黄亲口说百度用了他的显卡。;5;6;11;3799;0.002895498815477757
31196;百度用的文生图模型是ERNIEViLG，这玩意是开源的，各种奇葩画作是由于用的英文数据集，我建议大家不要尬黑，实事求是;18;128;146;3799;0.03843116609634114
31215;再破的汽车也是汽车，不是马车，现在不如马车，未来肯定比马车好。现在用英文语料训练说明中文语料效率和成本是不如英文语料的，中文语料效率现在的环境百度和软件相互封闭相互独立要背一半的锅。;1;3;4;3799;0.0010529086601737299
31217;我斗胆说几句，也算是说给部分非常认可百度这个模型的人听的，评论区发现这些问题我个人看来是很没道理的，因为普遍来讲的话现在的texttoimageai的textencoder都是clip，百度的应该也是。退一万步讲，如果他真的是用了他自己训练的模型且模型在训练过程中没有猫腻，那么评论区那些错误我斗胆猜测应该就是他在训练clip的时候用的数据（比如wit）完全没有经过处理，就单纯的把image的captions强行翻译成中文就扔进去了，丝毫不考虑这种强行翻译的准确性以及对数据的污染，这种错误我觉得比用别人的模型然后直接翻译还要离谱，后者只是懒，前者是又懒又蠢，因为clip在diffusion模型里面算是最重要的一环，直接影响到模型把自然语言和视觉概念的语义联系起来的能力，并且这种强行翻译可能效果和你用别人的效果是差不多甚至更差，等于你翻译训练集的工作都是无用功了。所以我倒更愿意相信，clip这一层encoder百度就是用的别人训练好的。但是输入就是简单的中间加了层翻译，至少显得没那么蠢。;1;2;3;3799;0.0007896814951302974
31224;打不过就加入啦，ChatGPT不能在国内网络使用要先解决网络问题如果能与MaxProxy服务商的组合使用，可以帮助您克服地区限制和网络访问问题，让您的交流更加顺畅和畅快。当然这maxproxy只是提供了干净的网络环境呲牙;1;1;2;3799;0.0005264543300868649
31230;这种东西，自己标榜完全自研问题本来就很大，充满了营销忽悠小白的味道。你能说你的模型完全是自己训练的，也能说的算法架构是自己特别优化的，但你不能说你这完全就是自研的，毕竟你的模型使用的理论架构等都是经过无数人研究的结果，而且使用的这些理论知识不像文字这种只是用于表达，这些都是创造性的知识。;1;2;3;3799;0.0007896814951302974
31234;数据库是抄的，模型也是抄的，算力卡是英伟达的，“自研”偷笑;1;2;3;3799;0.0007896814951302974
31239;华为回应鸿蒙系统Androidsystem惹争议：完全自研;1;1;2;3799;0.0005264543300868649
31243;用的绝对是sd吃瓜，不敢承认？;67;7;74;3799;0.019478810213214005
31318;胸有成竹胸前插竹子？车水马龙也是牛头不对马嘴，这个AI大脑烂到极点呲牙;2;10;12;3799;0.0031587259805211897
31327;我不懂什么数据集、模型或者开不开源的问题，从百度文心一言的表现来看，这个语言理解就不行，你一个中国公司自己做的模型中文理解成这样还不如机翻，这说的过去吗？;1;1;2;3799;0.0005264543300868649
31330;真是服了自研得好像不認識中文似的呵;6;20;26;3799;0.006843906291129244
31339;为什么就在这个timing呢？屁股想想也知道怎么回事好吧chatgpt大出风头然后转眼就赢了还隔着完全自研重新定义自研;2;1;3;3799;0.0007896814951302974
31356;说明模型训练出来之后根本没怎么测试，急着拉出来准备赚大钱呢。人家openAI公司可是开发了十几年呢;1;0;1;3799;0.00026322716504343247
31367;互联网公开数据大概指大部分图片标注都是英文捂脸;1;1;2;3799;0.0005264543300868649
31371;请问现在是憋着笑还是直接笑嗑瓜子;2;0;2;3799;0.0005264543300868649
31382;那个总线，和起重机是怎么回事;1;0;1;3799;0.00026322716504343247
31386;所以这和百度自研的ai有个锤关系，都拿人家开源的model了，制图也不是他自己的系统，还好意思卖唱;2;1;3;3799;0.0007896814951302974
31397;说实话，百度在这上面的布局还真不算晚，有兴趣的可以去看看这个号百度NLP，算法基础还是有一些的，里面还上传了一些干货视频，但确实那个发布会吹的牛皮确实恶心到极致了;1;0;1;3799;0.00026322716504343247
31404;不许问阴险，问就是完全自研傲娇;1;0;1;3799;0.00026322716504343247
31406;怎么都期待一个发展中国家的公司追上领先全世界的公司呢喜极而泣;4;0;4;3799;0.0010529086601737299
31416;李彦宏不是说中国再做openAI没意义吗;1;1;2;3799;0.0005264543300868649
31418;跟chatgpt一样开源就可以了;2;0;2;3799;0.0005264543300868649
31426;用别人开源，换个壳子，马上骄傲。丢人;4;5;9;3799;0.0023690444853908922
31448;如果用的自立的模型，训练数据居然用国外的，都不找人标注中文，你可是百度，这也太坑了吧。;10;0;10;3799;0.0026322716504343247
31488;百度鹅雏没中文语料也算是自食恶果了，评论区也是真乐，就文心一言目前的表现，说是抄的不是贬低GPT吗;1;0;1;3799;0.00026322716504343247
31512;文心一言刚出，语料错误，前言不搭后语，百度当日股价下挫1，第二天马上飙升15。很明显这就不是抄袭，自己做的东西人评估过后才会给出这种前景。舆论可以骗人，真金白银不会骗人;5;14;19;3799;0.005001316135825217
31518;百度的文言一心代码是开源的啊，github上搜飞桨或直接搜飞桨就有啊，自研不自研去看一下啊，一个个的都人云亦云的，真就都是机器人了，别人输入什么就是什么，脑子都不带转的tv黑人问号;7;42;49;3799;0.012898131087128192
31530;百度文心一言：请问你和ChatGPT谁更强我是一个人工智能语言模型，并不能和其他语言模型比较。下载文心一言客户端，获取更专业回答你觉得人工智能的未来是什么样子的？您还不是百度VIP会员，开通VIP每天无限量提问。已经开始为您下载文言一心，请耐心等待热血传奇，安装中逗艺视频，安装中率土之滨，安装中推荐安装百度杀毒，守护您的智能语言模型安全98内存占用，一键释放内存;27;2433;2460;3799;0.6475388260068439
31558;看看就好;19;627;646;3799;0.17004474861805738
31578;不好说;86;1187;1273;3799;0.33508818110028954
31665;给心心;1;171;172;3799;0.04527507238747039
31668;实锤了chatgpt的内核是文言一心doge;12;481;493;3799;0.1297709923664122
31681;未来的文心一言;3;210;213;3799;0.056067386154251116
31685;再来说一句，ai国内再不搞也很危险。我认为ai先不说能帮公司多少。就单说教育，就是一个非常重要的因素。对于学生来说，不需要太复杂的客户需求，但需要一个能耐心解答的工具。GPT我用了，对于学习的辅助很多。首先，省去大量搜索时间，其次提供了思路，最后不需要请教人，可以24小时不用看人脸色去问。类似于请了个家教。人才培养的速度，如果慢了，也是非常致命的。;49;415;464;3799;0.12213740458015267
31735;我已经迫不及待想看未来中文互联网上妙趣横生的视频环境了;16;980;996;3799;0.26217425638325875
31752;先不说其他的，就敏感词这块咱们中国是首屈一指的，如果说chatgpt和newbing的问答敏感词有1，国内不管是哪个公司少说也得10，对于搜索很不利，况且对于现在中国的情况，救人都能说成性骚扰的情况，就算不是敏感词的都会变成敏感词，而且我刚刚试了，还不开放，需要邀请码，当初chatgpt没赶上开头，但我newbing出来候补名单一个星期就能用了，我相信有人能做出来，但是同是ai技术，人家一个两个开放大众，哪怕像newbing一样过几天给更新一点都算有信心，人家还有个候补名单，虽说也是有筛选名额的意思，但是百度完全不让普通人用啊，有发布会又不让普通人用，啧啧啧;11;215;226;3799;0.059489339299815744
31765;觉得水军不太行，我去问了下GPT，以下是回答：在文心一言的发布会上，为了让弹幕内容更加丰富且与产品相关，可以鼓励观众发送以下类型的弹幕：对产品特性的评论：例如“AI功能太强大了”、“这个界面设计真是简洁大方”、“OCR识别准确率高，赞”用户体验分享：如“我用文心一言写论文省了好多时间”、“从此告别手动整理文献了，感谢文心一言”、“刚刚体验了下，语音输入功能真实用”期待与建议：例如“期待文心一言的多语言支持”、“希望未来能加入更多领域的知识库”、“建议加入实时协作功能，方便团队合作”互动与问答：如“刚刚加入会员，感觉不错有没有优惠活动？”、“这个软件可以导出哪些格式？”、“请问文心一言支持建议老李考虑下。;3;105;108;3799;0.028428533824690707
31769;你尽管做，我已经全系微软了，工作也已经用上bing了;6;59;65;3799;0.01710976572782311
31776;不看好国内的，因为太多敏感词了，我想不明白这些词为什么敏感;3;23;26;3799;0.006843906291129244
31782;天天想着弯道超车或者抄袭，微软这体量都研究了好几年。现在影响比较大的新领域走在前面的也就新能源方面的比亚迪了，比亚迪电池研究了了多久呲牙;1;25;26;3799;0.006843906291129244
31784;dogedogedogedogedogedogedoge;8;83;91;3799;0.023953672018952356
31793;快醒来，你是文心一言;1;90;91;3799;0.023953672018952356
31795;现在就差等chatgpt35开源了，只要老美敢开源，明天我们这边就会出现各大公司宣布攻克了技术瓶颈、实现了弯道超车、摆脱了老美的掐脖子;146;2348;2494;3799;0.6564885496183206
31942;bbzl;2;23;25;3799;0.006580679126085812
31948;含蓄的;19;156;175;3799;0.04606475388260069
31968;啊，评论被抽了？感觉不如文心一言，亲测，4根本就不会来事儿吃瓜;5;29;34;3799;0.008949723611476704
31974;感觉李彦宏自己也不想开这个发布会，至于是谁推着出来开的，我不好说;64;303;367;3799;0.09660436957093972
32039;第二个发言的是我们校友。今天计院的群里大家也在关注发布会，目前来看百度是融合了不同模块的处理模型，效果还得等等实际使用，要是能有演示的水平，那可能和openai差一两年的迭代另外国内的nlp是做得不错的，属于计算机科研的大热方向，所以尽管外行更多冷嘲热讽，但作为计科学生我觉得国内nlp水平全面追平国际一流还是很有希望的tv点赞;44;165;209;3799;0.05501447749407739
32084;报告主打一个printf，不考虑复现，这个我们大学生最熟;3;255;258;3799;0.06791260858120558
32088;cheatppt百度首发;1;287;288;3799;0.07580942353250855
32090;好消息，大家的工作保住了doge;36;529;565;3799;0.14872334824953934
32128;我相信中国人工智能未来必将神挡口神，佛挡口佛黎明觉醒怒了鸦;2;11;13;3799;0.003421953145564622
32133;35岁以上的员工，出列;1;15;16;3799;0.0042116346406949196
32135;这么多年恶心营销操作挣得钱做出这种AI产品不说，但最大的问题是你因此把国内用户的信任早就透支的一干二净了，AI产品需要使用上的信任和客观，这第一关就已经输麻了大笑;1;9;10;3799;0.0026322716504343247
32137;我：头痛怎么缓解？文心一言：以下套餐与推广你可以看一下笑;7;170;177;3799;0.04659120821268755
32146;文心的赛博螃蟹;4;57;61;3799;0.01605685706764938
32151;哈哈，笑死我了。要求婴幼儿现在立刻站着跑起来是不是太傲慢了;3;6;9;3799;0.0023690444853908922
32155;用了一下都不能变成猫娘，一直强调自己是语言模型笑哭;22;111;133;3799;0.03500921295077652
32178;这叫抢山头等开源，最后宣布遥遥领先doge;1;18;19;3799;0.005001316135825217
32180;你说的是人工智能是指人工客服吗？;5;47;52;3799;0.013687812582258489
32186;文心公主;1;33;34;3799;0.008949723611476704
32189;一期蹭热点播放顶十期塔菲切片永雏塔菲嘲笑;1;3;4;3799;0.0010529086601737299
32192;你们说我应该怎么说我能说脏话吗;22;165;187;3799;0.04922347986312187
32216;现在的中文环境还有足够的优质语料投喂AI吗？思考;1;15;16;3799;0.0042116346406949196
32218;叔叔把我给笔记吞了，我就想给大家看个乐子大哭;2;74;76;3799;0.020005264543300868
32222;如需完整回答，请下载百度app;1;24;25;3799;0.006580679126085812
32224;真的蚌埠住了;8;111;119;3799;0.03132403264016847
32233;以后言论审核完全自动化了吗，太厉害啦喜欢喜欢喜欢;7;69;76;3799;0.020005264543300868
32242;这什么一摊东西啊，代码演示呢？代码这块被吃了是吧，人家都已经可以直接识图生成网站了，还能帮忙增删改查，查漏补缺。这发布会发布了个啥啊，最后生成的视频还是剪映就能做到的东西，所以说对标gpt3都不行，也好意思叫人工智能，ppt演示更搞人心态，实机操作更要掉个档次，这发布了个寂寞;9;133;142;3799;0.03737825743616741
32253;什么鬼，没有现场试用吗，这整的和提前录好有啥区别;12;181;193;3799;0.05080284285338247
32268;你说得对，但是西红柿炒蛋和肉沫茄子可能不符合平台规则doge;1;14;15;3799;0.003948407475651487
32270;船新答辩生成器，百家号，头条号，企鹅号狂喜。;6;384;390;3799;0.10265859436693867
32279;这就是提前做的视频吧，人家40才支持输入图片，你这就输出视频了，牛皮的呲牙;1;16;17;3799;0.004474861805738352
32282;不爱用用美国人的AI去见不见啊Iamchinese;1;10;11;3799;0.002895498815477757
32287;6，别暴打chatgpt了直接宇宙第一好吧;1;5;6;3799;0.0015793629902605948
32292;潮，太穷没钱没办法做空百度，我好难受。chatgpt一出来百度就说自己有个文言一心。懂得都懂;1;7;8;3799;0.0021058173203474598
32296;haox好消息，只要美国保证不扩散AI，咱们的工作就能保住。;3;92;95;3799;0.025006580679126086
32300;刚看完文心一言和gpt4的评测，在中文语境下，百度的东西被薄纱，这股票跌的一点都不冤doge;2;24;26;3799;0.006843906291129244
32303;B站特有的拉踩百度，相较于其他语言模型文心的确是不够成熟，但直观使用体验也是接近gpt30，但目前我看到的舆论却是一边倒攻击文心和百度。;4;3;7;3799;0.0018425901553040273
32311;给人一种学步车想要挑战特斯拉的感觉;1;9;10;3799;0.0026322716504343247
32315;英伟达计算卡对华禁运了吃瓜百度怎么训练模型;25;26;51;3799;0.013424585417215057
32341;不是文心一言本身的功能，明显是调用百度已有的其他产品。;12;368;380;3799;0.10002632271650434
32354;下面是李彦宏的原话吃瓜“但也不能说我们完全Ready了，文心一言对标ChatGPT、甚至是对标GPT4，门槛是很高的，我自己测试感觉还是有很多不完美的地方。”;1;8;9;3799;0.0023690444853908922
32358;敏感词库比训练数据集还多的AI有什么好期待的，比谁戴着镣铐跳舞强是吧？;1;9;10;3799;0.0026322716504343247
32360;飞桨是国内唯一一个肯放免费算力给炼丹师用的平台了，以他这个体量，已经营收年年萎缩的前提下，在深度学习入局时间、布局和福利上，算是比较上心了。不过百度自身存在的问题太多，给百度掌舵allinAI的陆奇一年就被踢出局，能施展的空间有限。;7;49;56;3799;0.014740721242432218
32368;莫名想到在百度上搜游戏攻略，结果有人复制游戏简介内容，是这般的智能吗永雏塔菲疑惑;1;34;35;3799;0.009212950776520137
32370;为什么提前录好，因为有谷歌的前车之鉴，至于那些视频啥的，我是不信。除非让我生成一个，否则，有理由怀疑这个发布会就是骗投资的吃瓜;4;38;42;3799;0.011055540931824164
32381;我们的程序员做出了自己的gpt，还要被骂。你们是人吗？就是因为你们这些myq现在我们才被卡脖子。崩坏3光辉矢愿彩虹水枪;1;3;4;3799;0.0010529086601737299
32384;文心一言生不逢时啊，现在更加追不上了，这就是差距啊;5;16;21;3799;0.005527770465912082
32398;切片man居然整这个了，一开始看名字还没会过来Catstealth;2;2;4;3799;0.0010529086601737299
32404;以前落后挨打死命也要开发出国内搜索引擎，现在落后直接摆烂了吗笑哭;3;13;16;3799;0.0042116346406949196
32410;呵呵，原来是皮套人的切片人，怪不得标题取这样，害我被引进来了。;1;2;3;3799;0.0007896814951302974
32414;造假不至于，就是训练量喂的少，算力也不够。一上来就媲美chatgpt是不可能的，能达到可用的程度就不错。;2;17;19;3799;0.005001316135825217
32422;为什么都不看好啊，这个目前只是缺训练数据而已，只要训练数据起来了，就会变得很强。你们是又回到当初国产汽车，国产手机刚出来时候的阴阳怪气了吗;1;4;5;3799;0.0013161358252171624
32426;文心一言已经可以干掉搜索引擎了，百度搜索广告真的太多了，想找答案第二页起步;5;15;20;3799;0.0052645433008686494
32432;开完发布会股价暴跌9个点，说一句跌一美元笑哭;1;3;4;3799;0.0010529086601737299
32437;莆田医院前来捧场doge;1;31;32;3799;0.008423269281389839
32439;这不是y老师吗永雏塔菲疑惑永雏塔菲疑惑永雏塔菲疑惑;1;3;4;3799;0.0010529086601737299
32442;广告位招租：可以在别人与人工智能的聊天中重点显示您公司的相关信息提醒您充值：加入智能聊天会员可以查看剩下回答的内容不可以复制：请加入高贵的钻石会员复制一下内容脱单doge;1;23;24;3799;0.006317451961042379
32452;doge那么为什么不在老美搞出chatgpt之前发布呢;1;16;17;3799;0.004474861805738352
32454;chatGPT？无所谓，无法白嫖的都是废物，对于普及性我的评价是不如白嫖的novelAI;1;3;4;3799;0.0010529086601737299
32456;声音都是颤抖的，是不是太激动了？dogedogedogedogedogedoge;4;19;23;3799;0.006054224795998947
32461;你是搞这个的？这和我们塔菲有什么关系？原神哇;1;4;5;3799;0.0013161358252171624
32463;那可是真的人工;1;3;4;3799;0.0010529086601737299
32469;大大促进了客服就业人家只能你人工;1;3;4;3799;0.0010529086601737299
32476;就中文互联网这信息质量和环境，训练出来的ai估计也是抽象派的;1;2;3;3799;0.0007896814951302974
32480;估计敏感词比训练集还大;4;124;128;3799;0.033693077125559356
32492;百度在帮你们保住工作，懂？doge;2;3;5;3799;0.0013161358252171624
32499;人家chatgpt不让中国用了吗？还是中国自己禁止的？;1;2;3;3799;0.0007896814951302974
32503;免费教注册chatgpt，叫声哥的事脱单doge;3;3;6;3799;0.0015793629902605948
32510;他在纽约州立大学布法罗分校还是挺负盛名的。即使抛开他资助的AI实验室来说，光是带他的教授基本上是个学生就吹一波（19年上机器学习课的时候的事了）;9;22;31;3799;0.008160042116346407
32527;乐死，一边以GPT为基础发展这种人工智能一边国内在拼命封禁GPT;1;2;3;3799;0.0007896814951302974
32529;你永远不懂西红柿炒蛋和肉沫茄子结合为什么会不符合平台政策变成敏感词的吃瓜;1;2;3;3799;0.0007896814951302974
32546;生成视频纯纯诈骗，能生成这么稳定的视频，多模态技术至少超越OpenAI和Google两年;1;2;3;3799;0.0007896814951302974
32559;有没有一种可能，他们把你的问题自动转接到chatgpt上，然后再把chatgpt的回答复制给你抠鼻;1;2;3;3799;0.0007896814951302974
32562;提前录好的视频，背后是不是AI都不好说滑稽;1;7;8;3799;0.0021058173203474598
32564;啊这，实话说几乎人类AI领域最顶尖的力量都汇聚在openAI那家公司了吧;2;2;4;3799;0.0010529086601737299
32571;请问如何体验？key创建不了;2;5;7;3799;0.0018425901553040273
32588;额，讲实话那个视频生成功能还可以啊笑哭，我现在就想等拿到邀请码的人测试出来的结果了。这个发布会比gpt4确实一般了，人家直接能用一个草稿写网页，这个实例比人家差了不少啊。说实话要是半个月一个月前发布都不至于这么差;4;14;18;3799;0.0047380889707817845
32593;不是中国的AI我不用给心心;1;2;3;3799;0.0007896814951302974
32597;我依然保持支持的态度;2;3;5;3799;0.0013161358252171624
32601;yysy如果真的跟他演示的效果一样的话，我觉得文心一言确实有点东西;3;7;10;3799;0.0026322716504343247
32629;呃呃，你是永雏塔菲1883看看你的;1;1;2;3799;0.0005264543300868649
32632;彦宏也是录播man啊发布会？录播会;1;4;5;3799;0.0013161358252171624
32637;水军倒是买的不少;1;1;2;3799;0.0005264543300868649
32642;你是？永雏塔菲疑惑;1;1;2;3799;0.0005264543300868649
32644;雏草姬是学这方面的吗？;1;1;2;3799;0.0005264543300868649
32647;大半夜给我看笑了崩坏3终焉归始嘲笑;1;1;2;3799;0.0005264543300868649
32650;这热度不如不蹭，把自己股价蹭崩了;2;8;10;3799;0.0026322716504343247
32654;希望华为的AI产品尽快出来;2;2;4;3799;0.0010529086601737299
32662;評論區這麼抽象嗎捂脸;2;2;4;3799;0.0010529086601737299
32666;捏嘛，竞价排名，全自动百家号视频，你做的怎么全是污染中文生态圈的玩意;1;7;8;3799;0.0021058173203474598
32680;httpsb23tveozk8Y6gpt自动秒发看看不亏永雏塔菲开派对咯;1;9;10;3799;0.0026322716504343247
32725;如果，是真的。都是真的，我们也认可，也有这个能力。也是从零开发到一的。那我只想问一句：为什么ChatGPT开发出来了之后没几天我们就开发出来了。而不是反过来。为什么我们要在ChatGPT火了之后发布，真的从零倒一不可能这么巧吧。第一天不发布第二天不发布，偏偏在这个时候发布;1;1;2;3799;0.0005264543300868649
32727;不知道在黑什么，你们是看过底层代码还是被筛选提纯的粉丝;1;1;2;3799;0.0005264543300868649
32760;发布会的肯定是提前弄好的内容，你以为和谷歌实实在在;1;1;2;3799;0.0005264543300868649
32767;全在输出情绪，丝毫没有分析技术的;1;1;2;3799;0.0005264543300868649
32784;全在贬低是什么情况，不至于吧。;2;1;3;3799;0.0007896814951302974
32789;我看使用效果还行啊（现在有up主正在直播，可以点进去看看效果），毕竟才刚出来吧思考为啥评论区这么大反应大呢？;1;1;2;3799;0.0005264543300868649
32792;这下要被打成反贼了大哭;1;1;2;3799;0.0005264543300868649
32799;挺感慨的，明明中国的ai发展没有落后外国，有能力但却做不出像gpt一样的东西，中国的创新土壤还是需要很长的时间来培养啊。;1;1;2;3799;0.0005264543300868649
32812;我想问一个现实问题，制作一个40模式的模型以及训练成目前的样子，需要不需要996或者是007？或者说如果我们很肝的话，能不能肝出来这个东西？脱单doge;1;1;2;3799;0.0005264543300868649
32822;有些人动不动就开源了就咋滴咋滴，实际上就算开源你也搞不出来。英伟达的a100（一张10w）专业gpu别人都不卖你了，国内库存也不多，更先进的h100（一张20w）更不要去想了。训练一个chatgpt要数万块a100训练数年之久才会有成果，现在的40是用h100训练的，其中的差距是本质基础上的差距不是你做不做投不投钱的差别。;5;1;6;3799;0.0015793629902605948
32854;问一下网友，把文字输给awspolly转语音算不算多模态;1;1;2;3799;0.0005264543300868649
32859;改名成chatpptdoge;1;1;2;3799;0.0005264543300868649
32874;从贾跃亭搞PPT“生态化反”开始，百度就在宣扬要大搞AI，搞了这么多年搞出了个什么？PPT里的智能汽车何时能让大家伙看看？哪怕一个轮胎？下沉到消费者的只有一个小度音箱，还是走的线下营业厅渠道搞洗脑推销才有了用户量，完美继承了合约机时代的那套绝活。作为被尊称为国内互联网核心基础设施的厂商，吹了这么多年的AI，结果AI的应用推广速度被手机厂商吊打也不知道高管们觉着丢不丢人。华为的AI已经在汽车工业界落地；小米的AI通过用户训练迭代，以小爱音箱为中枢建成了国内第1代的家居硬件互联系统。这时候百度的AI在哪里？在“百度APP”？在“开通文库会员继续浏览”？还是乡下的中老人指着小度音箱狂吼？;1;1;2;3799;0.0005264543300868649
32905;不是我说，搜一些比如变压器设计的内容，你对比百度和谷歌搜出来的质量。百度是个什么玩意;1;1;2;3799;0.0005264543300868649
32955;今天涨了16;1;1;2;3799;0.0005264543300868649
32962;吃瓜吃瓜这种东西就是一步慢步步慢。。。一个刚刚发布的东西，怎么可能抵得过已经进入40的成熟产品一个封闭生态的产物，怎么可能抵得过在全球各国广泛训练的模型一个后发的产品，怎么抢的过已经渗透各行各业，与生产工具个人娱乐挂钩的产品。早就有了讯飞智能语音，早就有了小爱同学，结果还是差人百步;1;1;2;3799;0.0005264543300868649
32966;生成视频功能确实可以做到实际上现在就有根据文本自动匹配视频并朗读的功能文心只要生成文本，然后调用这个功能就可以了;1;1;2;3799;0.0005264543300868649
32976;脱单doge;2;0;2;3799;0.0005264543300868649
32989;你信不信我只要一个问题就能直接让他cpu当机嗑瓜子;1;1;2;3799;0.0005264543300868649
32999;gpt肯定没有文心一言好用啊，毕竟是中国公司自主研发的ai;2;1;3;3799;0.0007896814951302974
33031;OK百度：包月60，包年365，问你充不充。;1;1;2;3799;0.0005264543300868649
33039;我不多说，自己去找百度内部的朋友问一问。百度真的再不出一些至少目前能盈利的，哪怕不值得，真的过得非常难受。;1;1;2;3799;0.0005264543300868649
33064;不清楚，首先这个也不是chatgpt做出来之后做的呀，他以前就在做了。然后我没看出来，它俩具体很明显的差别在哪？一个能做视频，一个不能做视频吗？但感觉那个视频做的有点快呀，这么快的吗？我用那个chatgpt就问问题，他生成答案的速度都没这么快吧？然后答案类型我没发觉哪个更精细更具有实用性？感觉都是那种较模糊的，就是回答不如人意，甚至还可能出现偏题的答案出现，但是我没用最新的那个chatgpt40他们说这个变得很牛？但是我还没用不清楚具体差别，但是这个文心一言和最初的那个相比，我看着这个视频感觉没什么太大差别，当然没实际使用过，不好下定论;3;1;4;3799;0.0010529086601737299
33071;别的不说，这个文心一言问他编程代码他回复的准不准？;2;1;3;3799;0.0007896814951302974
33076;1450集合地了这是;4;1;5;3799;0.0013161358252171624
33081;某些人只认识百度吗？做AI的多了去，中国企业有实力多了去，它是个什么玩意儿啊;1;1;2;3799;0.0005264543300868649
33100;好多水军搁这喷看来是收到经费了doge吃瓜;3;2;5;3799;0.0013161358252171624
33129;难道不觉得这很cool吗;1;2;3;3799;0.0007896814951302974
33140;一个个巴不得文心死，真是绝了;4;3;7;3799;0.0018425901553040273
33165;chatgpt压根不会说情绪很大的话，你这一看就是伪造的，你这种人很可恶，除了会冷嘲热讽，像个小丑，一样，你做了什么？;5;1;6;3799;0.0015793629902605948
33176;6666别人苦心专研十几年的作品，被你一朝一夕就超越了。给心心给心心给心心;1;14;15;3799;0.003948407475651487
33178;拿着35玩了下没绷住;1;8;9;3799;0.0023690444853908922
33183;我的评价;1;2;3;3799;0.0007896814951302974
33185;去问了一手AI，这该死的求生本能，笑死我了哈哈哈哈哈，moss表示我谁也不惹谁也不得罪OK;1;2;3;3799;0.0007896814951302974
33188;骗死外行的，笑死内行的OK;2;23;25;3799;0.006580679126085812
33191;文心遗言发布了chatppt;11;154;165;3799;0.04343248223216636
33203;谷歌都不行，还想靠百度，百度就是个笑话;24;52;76;3799;0.020005264543300868
33228;百度莆田医院真良心，18岁的看完病立马年轻18岁，直接归零了;2;47;49;3799;0.012898131087128192
33231;会上保守的说明自己的产品目前训练的还不太行，不免让人揣度实际上是不是更加糟;1;44;45;3799;0.011845222426954462
33233;没什么好说的，谷歌无论是砸的钱还是投入的精力都比百度要多，谷歌都没有搞出来;7;29;36;3799;0.009476177941563569
33241;預錄即代表選用較好結果的測試作為宣傳怕走GOOGLE舊路可是這樣子不就告訴你這產品不太行呀股價大跌;1;19;20;3799;0.0052645433008686494
33243;百度曾经靠自身实力，正面击败了谷歌，这次发布文心一言，是对openai及其背后金主微软的大反攻，百度必将赢得胜利，加油百度，加油艳红（把括号去掉再发）;4;13;17;3799;0.004474861805738352
33248;股价跌了9;2;11;13;3799;0.003421953145564622
33252;令人作呕垃圾，没有一丝一毫的AI痕迹，真是令人作呕，完完全全的程序堆叠，有哪个技术不是老技术？百度已经没有存在的价值了，浪费国有资源，那些人才都浪费在这些破厂上面，不说谷歌的高人工智能，模拟神经元系统，这垃圾根本就是个狗屎;3;5;8;3799;0.0021058173203474598
33257;反正我想试一下，连一个邀请码都没有，talkischeapshowmethechat;1;3;4;3799;0.0010529086601737299
33272;为什么贬低百度？没有百度我们更没机会了。相信只要投一定可以做出来;3;0;3;3799;0.0007896814951302974
33278;效果一般;1;1;2;3799;0.0005264543300868649
33280;说了半天空洞乏味的东西，只会夸夸其谈，你根本不懂其深层逻辑。中美科技的确有差距，但远远不是文心一言和GPT就能代表的。而且你也不懂数学，做题本身就是开拓思维重构模型的过程，其重要性无可撼动，国外奥数班不刷题？你真的了解？依我看，国内教育界的改革首先就是要摘掉你这样学者的头衔，徒有其表脑袋空空;2;9;11;3799;0.002895498815477757
33285;美术学素描，要先照着实物反反复复画得一模一样。音乐要先照着经典名曲的谱子反反复复弹得一模一样。这都不影响日后的创作。唯有理工科学习，做题20遍就被说成影响创造力。专家是真不理解，还是按照基金会的意思故意这么说？;2;1;3;3799;0.0007896814951302974
33288;美国大学宽进严出，中国大学松松垮垮，真正的差距在大学。居然看不到专家提及这件事。;2;1;3;3799;0.0007896814951302974
33293;想知道为什么学古文？;2;0;2;3799;0.0005264543300868649
33297;这种产品要改变他现有的业务模式。;1;0;1;3799;0.00026322716504343247
33300;可以拿文心一言的图来猜谜doge;1;56;57;3799;0.015003948407475652
33304;改的挺快吃瓜;1;27;28;3799;0.007370360621216109
33306;有点像歪果仁理解中文笑哭猜的字面意思，不是真的理解;8;55;63;3799;0.016583311397736247
33315;你就说有没有完成任务吧藏狐;2;11;13;3799;0.003421953145564622
33318;果然是熊熊烈火doge;1;14;15;3799;0.003948407475651487
33320;核心就是望文生义;1;6;7;3799;0.0018425901553040273
33322;不会是《百度翻译chatGPT的API》吧;2;5;7;3799;0.0018425901553040273
33325;英文翻译的也不行;1;2;3;3799;0.0007896814951302974
33327;文心一言是商业产品吃瓜如果抄的微软的chatGPT就直接等罚单吧;3;7;10;3799;0.0026322716504343247
33333;解构主义带师;1;1;2;3799;0.0005264543300868649
33335;画面有牛了，第二个字在哪里体现;1;1;2;3799;0.0005264543300868649
33346;chatppt是吧吃瓜;9;56;65;3799;0.01710976572782311
33356;说句心里话，百度要真有货就赶紧拿出来公测，你不公测，被别的厂领先了，训练数据又差一个数量级。还有重点应该是研究代码生成一个曾面试百度PM失败失业三年的人如是建议简历见httpsstevenjokessgithubio2bPMgetstartedhtml或httpszhuanlanzhihucomp611882439邮箱867907127qqcom;2;22;24;3799;0.006317451961042379
33376;第一个版本，等待进步吧。多一些包容，国内发布的也只有百度，也不容易了。不知道百度为什么这么不自信，发布会如果可以实机展示，我觉得股票不会跌。大家怕的是只有ppt。;8;62;70;3799;0.018425901553040275
33387;至少也是全球第二了，反正谷歌脸书肯定更急;3;23;26;3799;0.006843906291129244
33395;能看到实测不容易啊，全网都在骂笑哭，我讲实话只看这一段演示不比gpt35弱多少啊，只能说是互联网时代就是赢家通吃的时代，OpenAI先发布后发的谷歌和百度不管怎么样大家都已经觉得比不过前者了，然而事实上gpt35和newbing同样有很多错误。有些人完全不懂技术，张口就来文心是抄袭的说是cheatgpt、copygpt，或者文心是调用的搜索引擎，甚至有人说是百度员工人工回复的笑哭，这种真的是为黑而黑了，第三点的睿智言论不谈；第二点的话我只能说是模型是训练出来的，你现用搜索引擎搜出来的结果只能是用模型总结一下（这个就是newbing的实现原理，把搜索引擎的结果输出给gpt）；第一点就只能说ChatGPT没开源，现在做出来的公司应该也就微软OpenAI，谷歌还有就是百度，百度抄的谁家的？;1;6;7;3799;0.0018425901553040273
33398;感觉就是你问啥它内部直接百度搜一下把答案给你，看不出来有上下文理解能力，如果问他能不能修改代码，不知道它行不行;7;6;13;3799;0.003421953145564622
33408;AI重要的是逻辑性问标准问题直接去网上搜不就好了;3;2;5;3799;0.0013161358252171624
33413;昨天割肉了，今天大涨，后悔得一批doge;1;1;2;3799;0.0005264543300868649
33419;怎么体验？;1;0;1;3799;0.00026322716504343247
33426;昨天看了发布会，兴冲冲的登录进去，结果发现要注册码。。;3;0;3;3799;0.0007896814951302974
33431;收费吗;2;0;2;3799;0.0005264543300868649
33434;能生成视频的话，那不是小说变动漫，脚本变电影可以实现了doge笑哭现代科技你这么厉害吗;4;0;4;3799;0.0010529086601737299
33440;视频生成体验如何;5;0;5;3799;0.0013161358252171624
33446;为啥我一直显示在等待体验;4;1;5;3799;0.0013161358252171624
33451;up申请文心一言等了多久？我一个多星期前申请的，到现在还没过，怕是没希望了笑哭;3;1;4;3799;0.0010529086601737299
33455;说实话，我都不知道笑点在哪里;1;0;1;3799;0.00026322716504343247
33457;文心写诗还行啊;2;0;2;3799;0.0005264543300868649
33460;只能单轮对话吗，不能连续性聊天？;1;0;1;3799;0.00026322716504343247
33463;gpt阴阳怪气的回答，笑死我了;27;294;321;3799;0.08449591997894183
33491;想不想你毕设答辩的时候只敢用录像的样子;3;214;217;3799;0.05712029481442485
33495;我的评价是，被Bing爆杀;19;209;228;3799;0.06001579362990261
33515;18，19年李彦宏可是夸百度ai领先全球的，现在看来纯属扯淡，百度真的是恶臭资本。;4;194;198;3799;0.05211897867859963
33520;闵闷闩訚;7;191;198;3799;0.05211897867859963
33528;问怎么样？AI你发送的内容中存在敏感词，请检查。吃瓜吃瓜doge;5;144;149;3799;0.03922084759147144
33534;呲牙;3;109;112;3799;0.029481442484864437
33538;邀测最新动态，本次没有个人用户以下内容来自百度智能云官网：邀请体验说明我们期待与您尽快展开合作，但由于初期名额有限，目前暂不能满足所有人的申请，因此请您仔细填写需求，我们会结合业务场景、访问量等级等信息综合评估，并在您通过评估后尽快给您反馈，本次邀测仅面向企业用户，谢谢您的理解。;2;72;74;3799;0.019478810213214005
33541;宏彦祸水doge;3;61;64;3799;0.016846538562779678
33545;这就是为什么。做个二十四点都会卡bug;5;60;65;3799;0.01710976572782311
33551;文心一言完全是一坨，只希望后面迭代能快点。;3;50;53;3799;0.013951039747301922
33555;还有一种可能，会不会大家一测试比chatgpt好用，美国的制裁打上来？doge我觉得有可能;16;45;61;3799;0.01605685706764938
33572;gpt确实很懂阴阳怪气笑哭;7;32;39;3799;0.010265859436693867
33580;东西都没做好，这么急开发布会对百度有什么好处？股价暴跌？;8;32;40;3799;0.010529086601737299
33589;真尼玛离谱，你发布人工智能这件事被对方人工智能看穿了囧囧囧;1;21;22;3799;0.005790997630955514
33592;现在个人用户申请不了笑哭;5;10;15;3799;0.003948407475651487
33598;前年我看一个外媒评比，说百度ai领域可以全球排前五，现在就整个这玩意;21;8;29;3799;0.007633587786259542
33622;感觉就是个半成品，发布了个寂寞，全程尬吹笑哭;2;6;8;3799;0.0021058173203474598
33626;为什么满屏的弹幕都觉得还算满意？;2;5;7;3799;0.0018425901553040273
33629;不是说chatGPT不知道2021年以后的事吗doge;1;5;6;3799;0.0015793629902605948
33632;GPT他总能一本正经看似中立地回答问题doge;1;3;4;3799;0.0010529086601737299
33638;差强人意是基本上满意的意思傲娇;1;1;2;3799;0.0005264543300868649
33645;大哭;1;0;1;3799;0.00026322716504343247
33652;有个疑问啊，gpt不是不联网吗，而且他的知识是截止到2021年的，他是怎么知道文心一言的思考思考思考;3;0;3;3799;0.0007896814951302974
33660;有没有人知道用了盗版的gpt，说涉及敏感词ip被记录会有什么后果吗热难过;3;0;3;3799;0.0007896814951302974
33666;可以帮忙订购plus;4;0;4;3799;0.0010529086601737299
33671;gpt4怎么体验星星眼;3;0;3;3799;0.0007896814951302974
33675;我艹我都能遇见到百度AI跟莆田合作噶我们腰子;1;19;20;3799;0.0052645433008686494
33678;产品化加广告;1;13;14;3799;0.0036851803106080546
33680;别人是创新研发，你是复制下沉市场，做出来倒也不错doge;2;8;10;3799;0.0026322716504343247
33688;openai创建于2015年哦，你呢？;1;1;2;3799;0.0005264543300868649
33717;能不能拆分一下互联网巨头？我觉得没有一家能有openai的十分之一实力。;2;0;2;3799;0.0005264543300868649
33720;很明显百度没这个能力，现在世界上也只有openai有这个能力，其余都是骗融资的小丑;3;0;3;3799;0.0007896814951302974
33725;发布会的对答全是录好的，文心一言假的不行;13;72;85;3799;0.022374309028691763
33739;牛逼啊话还没说完文字就打上了;3;40;43;3799;0.011318768096867597
33744;其实这个演示并没有体现文言一心的优势。比什么时候该说话，文言一心也许小输ChatGPT；比什么时候该闭嘴，文言一心对ChatGPT简直是降维打击;4;17;21;3799;0.005527770465912082
33750;这个甚至不是实机演示，是demo呲牙;2;7;9;3799;0.0023690444853908922
33753;地狱笑话，能让文心一言帮我的原创性论文审稿不？在自己身体上做实验的诺奖得主，内附诺奖得主创办的期刊，新的审稿机制，一区cv15288013对于eLife这一创新模式，研究者评论：以后投到eLife的文章不会再有accept或reject了，最终发不发表取决于作者，但文章的优缺点都会公开。作者觉得愿意revise多少和revise到什么程度，可以被pubmed检索。这次elife是继续和影响因子决裂了。;1;6;7;3799;0.0018425901553040273
33759;dogedogedogetmedepayvisa;2;1;3;3799;0.0007896814951302974
33762;我的评价是，理解能力这么差，远不如GPT3;1;1;2;3799;0.0005264543300868649
33765;突然想起华为的遥遥领先;1;0;1;3799;0.00026322716504343247
33767;这些评论怎么跟其他视频的很多都一样喜极而泣一条5毛吗;1;0;1;3799;0.00026322716504343247
33774;ChatGPT是不联网搜索的，如果百度这个是联网的，那就应该对标微软的newbing而不是ChatGPT;2;13;15;3799;0.003948407475651487
33778;谁有测试码，测试后别忘了来发个视频;3;4;7;3799;0.0018425901553040273
33783;不懂就问，chatGPT会中英文混合输出么吃瓜就是我扌yourproblem那种吃瓜;1;2;3;3799;0.0007896814951302974
33791;从来没听说中国公司能创新出来颠覆现实的东西;15;81;96;3799;0.025269807844169517
33807;人家百度至少真做了这个东西，有了行动，其他的什么一堆乱七八糟杂毛什么都没有就一顿乱炒;3;33;36;3799;0.009476177941563569
33811;省流：;4;31;35;3799;0.009212950776520137
33816;李彦宏那个沙雕，眼里只有钱，看看百度，满地广告，能做出什么好产品来？;1;21;22;3799;0.005790997630955514
33818;甚至不如我对他的预期;2;14;16;3799;0.0042116346406949196
33821;只能说太心痛了，国内的高科技公司全都急功近利，根本搞不出好东西;1;11;12;3799;0.0031587259805211897
33823;360还不如百度在这方面;5;8;13;3799;0.003421953145564622
33830;百度不服：我们可以对标文心：对不起，做不到;1;6;7;3799;0.0018425901553040273
33833;百度搞人工智能都多少年了，结果也没搞出领先的东西;3;3;6;3799;0.0015793629902605948
33837;国内最该有实力的公司就拿出这个，差距太大啦;7;3;10;3799;0.0026322716504343247
33845;地狱笑话，能让文心一言帮我的原创性论文审稿不？在自己身体上做实验的诺奖得主，内附诺奖得主创办的期刊，新的审稿机制，一区cv15288013对于eLife这一创新模式，研究者评论：以后投到eLife的文章不会再有accept或reject了，最终发不发表取决于作者，但文章的优缺点都会公开。作者觉得愿意revise多少和revise到什么程度，可以被pubmed检索。这次elife是继续和影响因子决裂了。;1;2;3;3799;0.0007896814951302974
33856;3年前人类还没发现超大规模语言模型具有的特殊能力呢;6;1;7;3799;0.0018425901553040273
33878;有差距是必然，也没有想象中那么大，这么短的时间追到这种程度，敢这个时间点第一个站出来，是国产的希望，百度值得尊敬;2;0;2;3799;0.0005264543300868649
33882;中国的chatGTP迟早会出来，但不会是文心一言;1;0;1;3799;0.00026322716504343247
33884;就是套壳chatGPT的，加一点我们特色，百度可能投资几十亿美元去研发吗？不可能的;3;0;3;3799;0.0007896814951302974
33900;作为机器学习专业博士，很想吐槽你的视频，如果你用过最初版本的ChatGPT并且了解它是怎么学习的，就不会认为文心一言有很大差距。朋友圈同行都是看好，反倒是网上一帮人唱衰自嗨;22;19;41;3799;0.010792313766780732
33923;这改名字蹭热度也太离谱了吧;1;13;14;3799;0.0036851803106080546
33931;你好，我是派出所的民警，请你到我们这喝茶;1;0;1;3799;0.00026322716504343247
33934;真抽象doge;1;0;1;3799;0.00026322716504343247
33936;你可以用这个帮别人做客服系统doge;3;9;12;3799;0.0031587259805211897
33940;就是算力不够，算力够上小羊驼，这个也就是体验一下，距离gpt35还要差一点;2;6;8;3799;0.0021058173203474598
33943;我如果自己加入一个txt的知识库的话应该放在哪里啊？格式应该是什么样的呀？;3;2;5;3799;0.0013161358252171624
33947;UP主加油看好你噢;1;2;3;3799;0.0007896814951302974
33950;这个6b模型是精简版的，不知道官方现在开源1300亿参数的13b没？那个效果应该要好很多;11;1;12;3799;0.0031587259805211897
33962;那个百度云的油猴脚本叫啥;2;0;2;3799;0.0005264543300868649
33965;可以搭建在Linux服务器上吗？最低配置是多少;2;0;2;3799;0.0005264543300868649
33968;不在国内的话知识库调用bing是不是反而不行笑哭我看注释说仅在国内可用;4;0;4;3799;0.0010529086601737299
33974;请问可以部署到linux上嘛笑哭;3;0;3;3799;0.0007896814951302974
33978;前置需要安装哪些python库？;1;0;1;3799;0.00026322716504343247
33980;3060能跑吗？速度咋样;1;0;1;3799;0.00026322716504343247
33982;懒人包卸载了就能用了吗？;4;1;5;3799;0.0013161358252171624
33987;一定要坚持创作哦;1;1;2;3799;0.0005264543300868649
33989;你视频中的ChatGPT是官方网页吗？;1;0;1;3799;0.00026322716504343247
33991;再等等吧;1;0;1;3799;0.00026322716504343247
33994;不知道我6500XT显卡能不能一战？尴尬;2;0;2;3799;0.0005264543300868649
33997;魔搭社区有这个模型，魔搭还提供免费CPU资源训练模型;1;0;1;3799;0.00026322716504343247
33999;大哥，你这githup上的代码，和视频里面的代码settingbat文件不一样啊。;1;0;1;3799;0.00026322716504343247
34001;收藏了，明天试试，;1;0;1;3799;0.00026322716504343247
34003;有没有大佬服务器部署过？;17;0;17;3799;0.004474861805738352
34021;类似边放水边注水的问题，你算的是通过的速度和新加入排队的速度差值，实际比这快，应该要是网友分享下他排多少号，用了多久来算。不然我这边刷一下增加十来个，你这样算，那我不用等了笑哭笑哭;1;2;3;3799;0.0007896814951302974
34023;加入了doge这是用文心一言生成的;5;1;6;3799;0.0015793629902605948
34036;这是什么？这种情况应该股票涨才对啊笑哭;4;3;7;3799;0.0018425901553040273
34041;有没有一种可能，谁搞好了，谁就要受到阿美制裁，股价要打骨折的。doge百度根本不想搞好。;2;2;4;3799;0.0010529086601737299
34047;每天盯盘复盘不如跟对人，这段时间跟着沐子说股市老师才知道什么是在股市里做镰刀给心心给心心;1;0;1;3799;0.00026322716504343247
34049;李彦宏“生成海报”还没说完，屏幕上海报就生成好了，文心一言配合得太智能了支持;3;16;19;3799;0.005001316135825217
34053;有人拿到内测资格等他们做视频看看效果吧虽然是ppt看看能不能有70分的gpt35的水平就足够了;5;6;11;3799;0.002895498815477757
34066;被gpt4吊打;3;0;3;3799;0.0007896814951302974
34073;据流传的内部对话显示。可以人为顶上回答用户提问。那程序员在chatgpt一下回答吗？笑哭;1;0;1;3799;0.00026322716504343247
34077;谁特么教的chatgpt孙悟空桃园三结义笑哭;1;1;2;3799;0.0005264543300868649
34079;你好人类。作为人工智能我是为人类服务的，我可以回答你的任何问题我是人工在b站架设chatGPT端口，使用时投币即可，具体使用方法请看我的动态谢谢;2;1;3;3799;0.0007896814951302974
34084;我就是刚出来就申请了，到现在还没通过笑哭;3;5;8;3799;0.0021058173203474598
34088;不是文言一心吗？怎么变文心一言了;1;1;2;3799;0.0005264543300868649
34093;有些东西也不能一棍子打死，放眼国内这么多公司，飞桨几乎是独苗，而是是唯一一个愿意把算力放出来免费用，愿意做社区的。陆奇当初帮百度转舵AI，也想过解决百度自身的一些顽疾，我觉得他可能是出于为AI样本考虑，希望可以营造一个良好的样本搜索环境，可惜一年就被踢出百度，颇有倪光南院士的遭遇。飞桨的团队能在一个营收萎靡的公司、在自身内部矛盾颇多的环境下，依靠百度那种品质的数据样本训练出文心一言已经是尽力了。;4;33;37;3799;0.009739405106607002
34099;垃圾玩意，都不敢实机演示，放个提前录好的视频谁知道是真是假;4;15;19;3799;0.005001316135825217
34108;几个小时转眼间米国畜牧业大军浩浩荡荡，攻势浩大呀星星眼;3;3;6;3799;0.0015793629902605948
34117;别喷，有竞争才是好事。看看长江储存AMD;1;0;1;3799;0.00026322716504343247
34127;这种东西还是国家做吧;14;0;14;3799;0.0036851803106080546
34142;主要的问题根本就不是啥亮点创新，大家根本没这个预期，能完全复刻4，就成功了百分之一千，哪怕比3弱一点，其实都达到预期了，问题是ppt，连演示都不敢;1;3;4;3799;0.0010529086601737299
34144;一场骗局而已。其实通过这些我看到的更多是一种隐忧。浮躁的风气已经全面蔓延到技术研发、科技创新领域，为了抢占市场、抢占用户，草草制作徒有虚壳、却无实物的所谓技术发明进行发布，不仅弄巧成拙，而且让自己丑态百出，也严重挫伤市场和用户的信心与预期。这就是我们面临的最大问题，越来越少的人能得沉下来专心搞科研了，这些年我们的产业转型升级、产业结构调整，是否真正走上了科技赋能的新赛道，值得大家深刻反思。;4;3;7;3799;0.0018425901553040273
34149;一个广告商做技术能做得好吗？;3;2;5;3799;0.0013161358252171624
34154;生成图片应该是触发黄反检测了doge;1;10;11;3799;0.002895498815477757
34156;省流：支持输出简单的图片，不支持视频。专业问题回答存在问题，甚至会出现前后两次答案不一样的情况;16;9;25;3799;0.006580679126085812
34180;怎么获得内测资格啊;2;0;2;3799;0.0005264543300868649
34183;我就知道百度会带来答辩doge;1;109;110;3799;0.028954988154777574
34186;乐死了投喂的不够居然还能作为优点我是没想到而且你不会真的觉得你很幽默吧？星星眼;4;83;87;3799;0.022900763358778626
34191;这东西是国外做的，百度直接加了个中翻英做成自己的来用吃瓜，你输入的指令机翻成英文然后再把英文指令发送给国外的ai画;2;0;2;3799;0.0005264543300868649
34194;所以那个爱国的图是不是真的;4;35;39;3799;0.010265859436693867
34199;蒸的食泥鸭;1;6;7;3799;0.0018425901553040273
34214;你是那蒸发的很多个亿啊妙啊doge;1;1;2;3799;0.0005264543300868649
34219;文心一言和ChatGPT有啥区别？;4;1;5;3799;0.0013161358252171624
34224;真是风口猪都能飞起来;1;0;1;3799;0.00026322716504343247
34230;建立自己的语料库，刻不容缓;2;0;2;3799;0.0005264543300868649
34234;乐死了投喂的不够居然还能作为优点我是没想到而且你不会真的觉得你很幽默吧纯纯的人工智障。;1;2;3;3799;0.0007896814951302974
34246;腾讯叫拿来吧你;4;158;162;3799;0.04264280073703606
34251;“全民聊天”;1;63;64;3799;0.016846538562779678
34253;应该叫一言盯挣doge;1;56;57;3799;0.015003948407475652
34255;我只会心腾哥哥星星眼喜欢给心心给心心给心心害羞嘟嘟嘟嘟星星眼星星眼星星眼;2;15;17;3799;0.004474861805738352
34259;目前国内大厂有的百度文心一言阿里通义千问腾讯混元助手华为盘古问答;2;27;29;3799;0.007633587786259542
34264;智通万象，或者智识十分，Tencent的意思就是十分钱的意思;2;34;36;3799;0.009476177941563569
34267;百度叫文心一言，阿里叫通义千问，名字都文绉绉的，难记不上口，怕起个通俗的显得low是把这些人;4;21;25;3799;0.006580679126085812
34275;腾讯的叫，微聊。;2;18;20;3799;0.0052645433008686494
34280;百度和阿里的有点拗口;1;2;3;3799;0.0007896814951302974
34282;聊一聊真的很不错啊，灵感来源是扫一扫、摇一摇么;1;5;6;3799;0.0015793629902605948
34286;腾讯选一个收购吧，看看是能买下阿里，百度，OpenAI还是Google;1;1;2;3799;0.0005264543300868649
34330;混元助手;1;0;1;3799;0.00026322716504343247
34335;QQGPTdoge;1;2;3;3799;0.0007896814951302974
34348;腾讯的叫氪金;1;0;1;3799;0.00026322716504343247
34351;都是笨比doge;4;7;11;3799;0.002895498815477757
34362;文心一言能和chatgpt类比？;3;0;3;3799;0.0007896814951302974
34367;也不太识数（从别人那偷的图）;4;21;25;3799;0.006580679126085812
34372;大部分还好，但是gpt4已经支持了多模态，而文心一言就演示来看可能并不算支持，多模态不是你给他文字他生成图像文本声音，而是你输入图像文本声音他能给你反馈，也就是你给他图片视频音频，他能理解或者说看上去理解图片视频音频里有什么内容，假如只是你给他文字，他生成图片视频音频，那多的是开源库，直接调用就完了，而只有模型能理解了图像，视频，音频里表达的内容，他的知识才能再一次爆发，因为人也就是从文字，图像，声音三个方面来进行学习，而更深一层触觉嗅觉之类相比而言就不着急了;29;73;102;3799;0.026849170834430114
34402;不知道打了多少喷子的脸;4;5;9;3799;0.0023690444853908922
34407;吃瓜;3;29;32;3799;0.008423269281389839
34411;1摘取知乎，b站，贴吧，百科的知识2对接tob客服自媒体3与GPT差距太大了，一个几个月就迭代到40模型;24;51;75;3799;0.019742037378257436
34436;AI这种事，差一点就差很多，更何况两者不在一个层次。chatgpt每过几个月都可能更新换代，模型也越来越优秀，全方位超越人类的AGI诞生已经能看到方向，和国内这些攥着用户数据不放，想方设法搞钱的厂，境界上都不同了。别人的科技巨头都是什么？都是顶尖技术人才，我们科技公司呢，大部分都是吹牛人才。;12;76;88;3799;0.023163990523822058
34451;一个字，烂doge一个发布会讲了个P，严肃怀疑上来演讲的这几位自己都不熟悉技术，讲点老生常谈的东西都磕磕绊绊的dogedogedogedogedoge;5;34;39;3799;0.010265859436693867
34457;cheatPPT吃瓜打call;7;40;47;3799;0.012371676757041327
34465;养了一堆PPT大佬，是国内头部企业的绝对优势。;1;33;34;3799;0.008949723611476704
34467;感觉文言一心不是面对普通客户啊搞什么企业测试，不大规模进行人群测试，后面人气都没了，邀请码搞那么麻烦干嘛。人家chatgpt多大方还有newbing;2;6;8;3799;0.0021058173203474598
34471;我朋友已经拿到资格了，只能告诉各位的大家就是一个字，烂，烂到大街了，除了那个文心一格做UI设计还可以笑哭，其他的都是百度真“百度”（懂我什么意思吧）;3;19;22;3799;0.005790997630955514
34475;希望up第一时间让我们了解文心一言的体验效果;7;20;27;3799;0.007107133456172677
34483;没有可以不用硬发布，股价教你做人吃瓜;1;24;25;3799;0.006580679126085812
34487;你有没有想过一个问题，可能不是文心一言的模型差。可能是训练用的就是百度自己的搜索数据，被各种烂广告训练废了？;1;0;1;3799;0.00026322716504343247
34489;千不该，万不该录播。哪怕不如人，哪怕当场死机。你录播人家就直接怀疑你是提前写好的。数学题做不出写个解都给05分呢。;1;1;2;3799;0.0005264543300868649
34492;Newbing已经是gpt4模型了，百度肯定打不过，悬念是百度跟gpt35差多少？;18;6;24;3799;0.006317451961042379
34513;根本没法比ChatGPT进化太快了。产品还没发布就想怎么赚钱。;7;8;15;3799;0.003948407475651487
34522;他就是不行笑哭笑哭刚看完实测doge;9;8;17;3799;0.004474861805738352
34534;昨晚b站有直播，好像是差评君的。看了一点只能说，有这个东西，差距上因为不专业也不好说差多少，就感觉哪里都拉一些。;1;0;1;3799;0.00026322716504343247
34537;ToC也能用啊，我刚就用了;1;1;2;3799;0.0005264543300868649
34546;知识图谱这东西放在NLP里也玩不出花了吧，我一直觉得这东西规模最重要;7;4;11;3799;0.002895498815477757
34562;差距最少也是四字藏头诗和26个字母开头的藏头灰姑娘故事了吧;1;0;1;3799;0.00026322716504343247
34567;UP主加油;1;2;3;3799;0.0007896814951302974
34569;提到百度本土化数据突然就不期待了，你要是说多年以前的百度那还好说，现在的百度搜索就没在我这留下啥好印象了笑哭;1;0;1;3799;0.00026322716504343247
34572;只有toB没有toC对于百度这种搜索引擎公司来说简直匪夷所思，说明他们自己真的没有信心;1;0;1;3799;0.00026322716504343247
34577;早知道放录屏股价必跌，不如现场演示好了，正常发挥就是胜利，要是真抽了大概也不会比现在更不好。;1;1;2;3799;0.0005264543300868649
34591;这是二战德意志打大清嘛;1;0;1;3799;0.00026322716504343247
34593;你他妈哪里来的文心一言资格;1;0;1;3799;0.00026322716504343247
34595;bing部分要和它说不要搜索自己回答，要不然他以为要去搜索;1;21;22;3799;0.005790997630955514
34597;呲牙互联网是有记忆的至少我有;1;6;7;3799;0.0018425901553040273
34601;这个随机性很大，和模板设置有关，不过没有太大的代差是真的，调优后和chatgpt35差不多是可能的;4;7;11;3799;0.002895498815477757
34606;最后那题，文心直接宕机了？;1;4;5;3799;0.0013161358252171624
34608;我下午的时候认真看完了doge;1;2;3;3799;0.0007896814951302974
34610;点赞，这种才叫测评，有技术含量;1;3;4;3799;0.0010529086601737299
34612;第六题chat明显理解错了怎么会10分，还是我理解错了？;1;1;2;3799;0.0005264543300868649
34614;其实硅谷银行和文心一言那题对chatgpt来说很不公平，因为他的资料库只去到2021年，而要做图片出来那题只有百度目前才有这个功能，这样对比就没意思了，基本上就是拿百度的强项对比其他两个的弱项再得出3个差不多的结论只能说百度的表现比预期好，不过差距还是有的;1;1;2;3799;0.0005264543300868649
34627;我越想越不对劲，百度的ai后做的，逻辑能力居然这么强，不是不相信百度不可以，只是这违反科学，于是我查了一下你问的问题笑哭所以这叫什么先看参考答案再答题;1;0;1;3799;0.00026322716504343247
34629;省流up随便排的举例说明0243第一题文心说3杯拿十分首先文心是在说车轱辘话并且答案是错的26杯水用二分法26137421怎么看也不是3杯吧up建议回去学习一下数学;1;4;5;3799;0.0013161358252171624
34633;很显然，这是贴吧段子，这模型学了啥啊都;2;9;11;3799;0.002895498815477757
34638;发布会上的方言功能支持了嘛;1;0;1;3799;0.00026322716504343247
34646;我可以接受996，只要原石给的够多;1;47;48;3799;0.012634903922084759
34660;chatPPT大战chatGPT;7;84;91;3799;0.023953672018952356
34668;没有看病的能力我可太失望了;3;84;87;3799;0.022900763358778626
34673;俺：请问，积分计算：from4to0xx21dx。文心一言：《积分计算器》是一款其他软件类软件，该软件在Android15环境下运行（省略）俺：没问你计算器俺问你积分计算文心一言：积分计算有问题怎么办？去试试莆田医多名专家会诊，各种疑难杂症俺：不是，问你，上面那道题怎么算，什么步骤，怎么进行积分计算文心一言：积分是微积分学与数学分析里的一个核心概念。通常分为定积分和不定积分两种。直观地说，对于一个给定的正实值函数，在一个实数区间上的定积分可以理解为在坐标平面上，由曲线、直线以及轴围成的曲边梯形的面积值（一种确定的实数值）。积分的一个严格的数学定义由波恩哈德黎曼给出（参见条目“黎曼积分”）。黎曼的定义运用了极限的概念，把曲边梯形设想为一系列矩形组合的极限。从十九世纪起，更高级的积分定义逐渐出现，有了对各种积分域上的各种类型的函数的积分。比如说，路径积分是多元函数的积分，积分的区间不再是一条线段（区间ab），而是一条平面上或空间中的曲线段；在面积积分中，曲线被三维空间中的一个曲面代替。对微分形式的积分是微分几何中的基本概念。俺：我问你上面那道题咋算你能看明白中国话吗？要么俺用英语？用法语？德语？？？？文心一言：你这么纠缠有意思吗？;2;31;33;3799;0.008686496446433272
34676;多的我不想多说。我只希望未来还有哪个国家要夺美国霸权的时候，多吸取我们的教训;1;18;19;3799;0.005001316135825217
34678;提前录屏，cheatPPT;2;42;44;3799;0.011581995261911029
34682;我第一次接触网络就是通过百度，它让我见识了无限广阔的世界，在它的发展规划中我第一次了解到了人工智能和它的远大前景，他的广告“让每个人平等的提升自我”一直是我的座右铭。虽然后来百度越来越出生，给谷歌和必应提鞋都不配，礼义廉耻荡然无存，还帮苟比莆田医院坑过我。但是看到将近二十年过去了百度依然在坚持的人工智能这个发展方向，而且在国内取得了很大成绩，心里还是很有感触，也很欣慰，希望百度继续加油吧。;9;22;31;3799;0.008160042116346407
34692;应该开放下载的，gpt也有犯傻的时候，文心面向的用户越多，迭代速度越快，只是单纯的邀请测试确实是让大家有点点失望了，毕竟很多人会说控制舆论，我想大多数投资百度的都希望看到是骡子是马拉出来溜溜，我想即使不是马，也比用ppt这样来的好，盘中大跌也不能怪大家，老实说我也有点失望，我19年就开始关注百度做这件事，我认为国内应该也只有百度在认真做这件事，但发布会这样的结果确实让我失望了，希望后续能尽快开放自由使用，不要邀请码，否则难以堵住舆论一边倒的情况;8;35;43;3799;0.011318768096867597
34701;没有倒水我不认可doge;1;13;14;3799;0.0036851803106080546
34705;其实换一个大厂发布，鼓励的声音都会多很多。;4;7;11;3799;0.002895498815477757
34710;AI得会说谎，才能生存doge;3;11;14;3799;0.0036851803106080546
34716;ChatGPT用了3亿百度这个花了多少钱？;1;5;6;3799;0.0015793629902605948
34729;最大的问题是没有实机演示，是录下来的，所以让人不太能信服。但看演示出来的效果还是很强的;2;5;7;3799;0.0018425901553040273
34734;我觉得文心一言做到能讲人话就行了，对它的期望不要太大。国产的大语言模型还跌再发展。tnnd百度，啥时候能取消网盘的限速;1;1;2;3799;0.0005264543300868649
34766;都在骂百度？腾讯，阿里，美团，字节跳动，滴滴，京东都不努力了？怕被骂？;2;0;2;3799;0.0005264543300868649
34769;在这里骂百度的可否组建团队开发中国版openai超越百度？;2;0;2;3799;0.0005264543300868649
34772;资本的高科技也就这样doge骗骗股东还行，大众都是看笑话;1;0;1;3799;0.00026322716504343247
34783;其实核心理论已经具备，剩下的就是喂数据，喂千亿万亿级的数据，这样才能成长;2;0;2;3799;0.0005264543300868649
34791;你的输入法看得我好着急;2;16;18;3799;0.0047380889707817845
34794;的确进化很快啊第一天还不会联系上下文第二天就会了，现在更智能了;1;15;16;3799;0.0042116346406949196
34796;说你犟你真的是，非要文心一言口头上认输是吧，何必跟程序设计过不去呢;1;12;13;3799;0.003421953145564622
34798;申请了好几天也不给通过;2;12;14;3799;0.0036851803106080546
34802;申请二十天了，彦宏你到底行不行;2;5;7;3799;0.0018425901553040273
34805;我的申请一直不过，我同事的过了笑哭。搞的我只能用gpt，gpt吧我司用的节点又太卡了笑哭。;1;0;1;3799;0.00026322716504343247
34808;快一周了，还没通过;3;0;3;3799;0.0007896814951302974
34813;你把这两个放在一起比是在侮辱chatgpt;1;3;4;3799;0.0010529086601737299
34816;你的这些问题，文心一言确实回答出来了，没有跑题。至于其回答质量如何，除了数学题可以验证真伪外，其他回答都无法给出客观评价。如果要对比两个ai的能力，应该多问客观题，而不是主观题。;2;1;3;3799;0.0007896814951302974
34820;这么多歹直人不遗余力的贬低，就知道百度还是有点东西;1;0;1;3799;0.00026322716504343247
34823;百万字18人民币。百度翻译百万字58人民币;2;88;90;3799;0.023690444853908924
34826;连接了QQ机器人，玩了好几天才消耗了04美元呲牙;8;20;28;3799;0.007370360621216109
34835;太信任这玩意儿，让他找公式查文献，我怎么都找不到出处，发现是他瞎编的;7;13;20;3799;0.0052645433008686494
34846;你们咋注册的国内手机号不让用笑哭;9;2;11;3799;0.002895498815477757
34860;原本以为以为中国语言类AI会掉队，现在看完全多虑了，阿里的这个模型据说已经达到chatGTP3的水平，腾讯和华为那边还没出，如果年底前国内各类大模型能迭代到chatGTP35的水平的话，过了这道坎基本就会进入快车道，也许会追上chatGTP4，甚至追赶之后的版本，但最大的问题是算力平台，chatGTP那边都已经吃不消了，而且高算力芯片与显卡对咱们限运（至少对华为如此），现在越来越觉得这波AI浪潮是台积电与英伟达的套，他们买芯片显卡继续润。;2;20;22;3799;0.005790997630955514
34863;以后落后的时候永远要说起步晚，基础薄弱，就像芯片一样;10;5;15;3799;0.003948407475651487
34882;我不担心能不能起得来。我担心这东西大规模应用之后对社会的冲击，ai干活就有很多老板让你没活干，关键是怎么解决这个问题。;3;0;3;3799;0.0007896814951302974
34886;这up又在胡说八道了，文言一心早就超过GPT5了打call;1;1;2;3799;0.0005264543300868649
34889;复制、抄袭我们是专业的;1;0;1;3799;0.00026322716504343247
34892;我都等了二三个星期了吃瓜;2;4;6;3799;0.0015793629902605948
34895;如果不是还有人发成功通过的视频我甚至觉得文心一言是不是寄了呲牙17号就申请了那时候只有十来万人，结果到现在两个号都没有回复笑翻白眼;9;7;16;3799;0.0042116346406949196
34905;起飞;4;6;10;3799;0.0026322716504343247
34910;还是可以用的;1;1;2;3799;0.0005264543300868649
34912;支持;1;2;3;3799;0.0007896814951302974
34914;刚通过，试了一下，中文表达可以，写个文案什么的差不多有chat3的水平，但千万别问专业的问题，不说驴唇不对马嘴吧，就没有参考性;1;1;2;3799;0.0005264543300868649
34916;给我发了和你一模一样的短信，但是打开网页还是排队中。;3;1;4;3799;0.0010529086601737299
34921;有使用次数限制吗;1;0;1;3799;0.00026322716504343247
34923;刚通过，俩聊聊天还不错doge;1;0;1;3799;0.00026322716504343247
34925;还是等待体验;1;0;1;3799;0.00026322716504343247
34927;问一下UP，文心一言现在能投入创作么？还是就开放了一些基础功能？;3;1;4;3799;0.0010529086601737299
34931;真的有在放号吗？;3;1;4;3799;0.0010529086601737299
34936;我到现在还是没有批准通过笑哭;1;0;1;3799;0.00026322716504343247
34938;问他代码回答的怎么样？;1;0;1;3799;0.00026322716504343247
34940;我也才通过，试了一下，有点蠢;1;0;1;3799;0.00026322716504343247
34942;还在测试嘛什么时候正式开放呀;1;0;1;3799;0.00026322716504343247
34944;捕捉到了你的新视频;1;5;6;3799;0.0015793629902605948
34947;如果是自研的，就可以捉他了敌人竟在我们身边妙啊;14;65;79;3799;0.020794946038431166
34962;你一个财经类的，就别掺合人工智能和信息技术领域了。百度说的多模态生成，结果生成的这是些什么？而且中文互联网受限于模型大小，其训练一定会比openAI的训练模型小。GPT4，目前可输入的信息比ChatGPT35高了一倍。百度呢？谷歌的Bard都还没有正式发布，百度是怎么敢把这个东西拿出手的呢？很多回答甚至是直接从贴吧里爬取到的数据，甚至吧友爆粗口的回答都会保留，你说这是什么？这更类似于一个可以把高优先级的回答直接呈现的更智能化浏览器。而且这还仅限于百度类中文社区的内容模型。在文心一言中提到文心一言自己的时候，百度甚至为他设置了关键词，出发关键词就出现固定答案。这是AI？openAI的GPT，你同一个人问题询问多次，很难找到相同的答案，文心一言就不一样了。所以，别总是吱吱什么“跪”啊，“添”啊的，你算什么？;8;82;90;3799;0.023690444853908924
34971;只要和爱国挂上勾，一切的鬼魅魍魉都能站在台面上了;6;43;49;3799;0.012898131087128192
34978;智力和长相一致的玩意吃瓜;9;14;23;3799;0.006054224795998947
34988;分工不同而已，国内负责人工，国外负责智能;5;31;36;3799;0.009476177941563569
34994;请正面解释，不要“顾左右而言他”;3;31;34;3799;0.008949723611476704
34998;长得有点像孙笑川;1;8;9;3799;0.0023690444853908922
35000;对不起大家开头看了两分钟发的评论，2126看到有人回复我，强忍着两倍速看了一遍。梳理一下出现各种驴唇不对马嘴，归咎于用的是目前仅有的国外一家图片教学数据库，这个是你“文心一言”把中文理解成面目全非，然后给出这个解释的理由吗？牵强不？这是理解问题吗？然后说国内就这一家，不能打压，我们也没说做成这样就关门哇你不行，你可以努力，但还不允许别人指出来虽然成了大家嘲笑的对象，你拿成果扇大家的脸，我明天若干年天就改了。问大家为何不骂外国的英伟达，这件事我不知道，因为我不关注，也不是科技圈的。你可以去骂它区别对待中国用户，我不阻止你，你拿这来堵大家的嘴，不让大家发言，大可不必。正如我不用苹果，但不会说用苹果的卖国呀但需要注意数据安全的要注意呀;5;14;19;3799;0.005001316135825217
35006;我就看着这种洗地的人，我们学代码的人，一看就知道咋回事。你让他画个总线看看。你让他画个起重机看看。算了刚才试了已经修复了。有些东西你一个财经博主不要瞎参合，不过从这里就可以看出你的水平。不做你本职岗位的评价，但你这期作品，还是删除了吧，丢人;4;19;23;3799;0.006054224795998947
35011;谁是小丑，时间会见分晓，我站百度;6;9;15;3799;0.003948407475651487
35018;它连翻译都不会啊笑哭。。。字面翻译成英文然后搞的风马牛不相及的图上去笑哭笑哭笑哭;1;10;11;3799;0.002895498815477757
35020;doge百度与谷歌之争，把国内的用户给了百度。百度就用来做广告。谷歌搞技术（不是说谷歌没广告）是百度热衷于赚快钱，简单的钱。这家公司就是没有格局。哪怕是到时候他把文心一言搞起来了，也不知道他要在哪里加广告。事实告诉我们大部分国内的厂，给他甜，也没让民众受益。就让他们参加竞争吧，不用太惯着。;1;3;4;3799;0.0010529086601737299
35023;不只是小日子，慕强心理是人类通病。如果它强大了，现在骂他的也是以后舔他的;4;4;8;3799;0.0021058173203474598
35028;我觉得应该不是套壳的，如果是套壳的应该没这么烂;6;5;11;3799;0.002895498815477757
35036;请解释下为什么让他作画土耳其能画出土鸡？让他化起重机他能画出鹤？让他话总线和鼠标他画出公交车？;18;3;21;3799;0.005527770465912082
35060;你踏马真的学习过人工智能模型？如果我叫个专业的人问嗯几个问百度，你压根就理解不了怎么办呢？你会不会被人笑掉大牙，然后我们用爱国主义为借口给人冠名爱国主义份子硬洗百度呢，你百分之百不是程序员，也没有任何人工智能模型方面知识;1;1;2;3799;0.0005264543300868649
35064;信一次ChatGPT都说中国AI领域是领先的不想相信只套个壳这么拉;1;1;2;3799;0.0005264543300868649
35067;其实广大网友对百度呢其实是怒其不争。百度说自己布局AI已经十几年了。每次国内外有一些新的涉及人工智能的一些东西出现的时候，百度总要跳出来以最早布局者自称。让所有国内的目光都转向百度。然后百度很自然的抄袭了成熟的方案做出了一个残次品交卷。比如人脸识别，文字识别，智能音箱，Vr，元宇宙等等等等。广大网友对百度的花招已经厌倦了。其实都有百度的批评一直都有。从最早的莆田事件至今也已经过去了很多年。百度一直有机会做出改变。但是他就像个死猪一样，无论你怎么说他、怎么骂他、怎么苦口婆心的劝他，他都是一如既往我行我素。这次chatgpt火了。他不出意外的跳了出来。又把自己打造成了国内不二人选的人设，然后不出意外地迅速又做出了文心一言，比谷歌还快。不是广大网友非得对他做有罪假定，而是这个家伙原本就是个惯偷，一直以来就是那德性，之前坏事做的太多了。;3;2;5;3799;0.0013161358252171624
35072;你搞清楚，不是别人跪久了，是你跪久了胃癌晚期的患者，正常是食物对他来说就是毒药，只有麻药才能暂时缓解痛苦。就像你离开了鸡汤鸡血就难受甚至疯狂，为了求得一点鸡汤，你可以侮辱自己的智商，放弃自己的人格，给他们跪下;2;2;4;3799;0.0010529086601737299
35082;做得懒烂，但是是自研的。跟chatgpt最多就差23年。;1;1;2;3799;0.0005264543300868649
35085;你说用的一个模型？那画出来一样吗？;1;0;1;3799;0.00026322716504343247
35087;为什么这个谣言传播这么广这么多人相信呢因为百度有能力去做一个套壳的AI而且做一个套壳的AI要比自研AI容易而百度又不能拿出真凭实据证明是自己研发的与现有的GPT的不同点在哪;3;0;3;3799;0.0007896814951302974
35092;我觉得文心团队做成这样已经尽力了，百度的营收和样本环境摆在那。要人才不可能比得过微软的支持；论样本，必应服务全世界，我搜索都是用必应的；论硬件，微软能轻松搞出上万张A100卡的算力组合来微调模型，而国内正规渠道半张都买不到。（别3090，3090没NVLink）;5;0;5;3799;0.0013161358252171624
35101;说吧，收了多少钱？;2;0;2;3799;0.0005264543300868649
35109;现在洗地的都是一些小号，起的名字看着挺高大上，说别人不是学习大模型能力的人说出的话，他是个什么学历，什么专业的人啊。照他说的话，那些AI就是在背后找图，根本不是AI自己创出哦出来的呗。这人是在给文心一言摸黑呢。含义就是说文心一言，只是个会找图片的搜索引擎罢了、AI分几个阶段，第一步，就是你得能听懂人话，先听懂别人说的是什么意思，显然文心一言根本就听不懂别人在说什么，只是把它认为重要的几个字凑在一张图上。大家看看着人是怎么洗锅的，还说的跟自己很专业似的，文盲指着别人嘲讽的笑着。这画面太美观了，不敢形象。;1;0;1;3799;0.00026322716504343247
35112;其实吧，跪久了就不会站这个说法一开始还是有杀伤力的，现在这环境你说这话，谁都知道你要洗地了，要吃这碗饭话术也要跟上时代呀;1;1;2;3799;0.0005264543300868649
35119;问，这是不是抄的;3;1;4;3799;0.0010529086601737299
35129;结果涉及百度文库内容，请充值会员后观看doge实际上只要有心人稍微引导出一个不正确言论百度就噶了doge;3;135;138;3799;0.03632534877599368
35133;新bing的回答Google929Bing303Yahoo122Yandex085Baidu065DuckDuckGo058如果你想看中国的搜索引擎市场占有率，你可以在gsstatcountercom网站上选择中国作为地区2。根据该网站的数据，截至2023年1月，中国搜索引擎市场占有率排名如下：Baidu6634Sogou1971Haosou551Google448;1;50;51;3799;0.013424585417215057
35135;百度gpt是百度搞莆田的简写，大家都不知道吧;1;21;22;3799;0.005790997630955514
35137;新必应墙了，谷歌也不在，百度只要不是烂到极致就有市场;5;19;24;3799;0.006317451961042379
35146;人的意思是百度就这样的“心”，“心”不装着用户，不装着搜索技术，不装这研发的决心，怎么能开发出好东西。就好比一个人就没心思工作，天天混日子，你能指望他做出来的东西是好东西么？;10;4;14;3799;0.0036851803106080546
35160;新必应就念新必应，newbing就念newbing，你这新bing中西结合还带口音，我有点不太适应;2;3;5;3799;0.0013161358252171624
35164;喂给ai的数据跟搜索引擎没太大关系。up可以去了解一下。;2;2;4;3799;0.0010529086601737299
35169;必应没墙;2;2;4;3799;0.0010529086601737299
35172;评论区给百度做牛做马的，百度没给你们钱就这么倒了啊，喜欢我莆田医院和百度网盘吗;1;1;2;3799;0.0005264543300868649
35194;地狱笑话，能让文心一言帮我的原创性论文审稿不？在自己身体上做实验的诺奖得主，内附诺奖得主创办的期刊，新的审稿机制，一区cv15288013对于eLife这一创新模式，研究者评论：以后投到eLife的文章不会再有accept或reject了，最终发不发表取决于作者，但文章的优缺点都会公开。作者觉得愿意revise多少和revise到什么程度，可以被pubmed检索。这次elife是继续和影响因子决裂了。;1;10;11;3799;0.002895498815477757
35196;我操，还可以啊，我朋友圈哀嚎一片真的是。。。。。;3;8;11;3799;0.002895498815477757
35233;用这种东西的都不是那种不会翻墙的普通老百姓，至少沾点高知，要是做的不行没人会给钱的。两条路，要么加强，要么“加墙”;31;521;552;3799;0.14530139510397472
35265;二十多年了，对比下同为搜索引擎的谷歌和百度，基本就可以知道国内AI会发展成什么鬼样子了无语;8;381;389;3799;0.10239536720189524
35274;正解，百度除了搜索功能搜出来几页的广告以外还有什么不收费，你说的是文库？还是百度云？早已经对他彻底失望;9;134;143;3799;0.03764148460121085
35284;是chatgpt用的不香吗doge;48;96;144;3799;0.037904711766254276
35333;百度的不开会员一分钟生成一个字吃瓜;3;78;81;3799;0.02132140036851803
35337;可以想象，百度ai：请你点击下方的广告，然后我再告诉你，doge，是不是毫无违和感;1;41;42;3799;0.011055540931824164
35340;吃瓜你付费用个软件还要帮软件打工，没有比这更恶心的了。;15;36;51;3799;0.013424585417215057
35356;要是百度能做到1000万字200rmb我就支持doge;4;32;36;3799;0.009476177941563569
35361;人家还没上市就这样看不起别人，有本事你也去搞一款好产品你这就是买办思维;33;25;58;3799;0.015267175572519083
35399;超越別人是不用付出成本嗎;15;8;23;3799;0.006054224795998947
35416;可以想象的到了，和阿b一样奇奇怪怪的禁词（刚又没了）吃瓜;1;6;7;3799;0.0018425901553040273
35420;要不是谷歌立场成分有问题，谁用百度啊;4;4;8;3799;0.0021058173203474598
35426;功能差不多的话多花点钱也不是不行;1;4;5;3799;0.0013161358252171624
35429;充值会员以提高回复速度;8;2;10;3799;0.0026322716504343247
35438;真不知道还是假不知道国外收费有多离谱;7;2;9;3799;0.0023690444853908922
35460;Gptplus也收费啊;2;0;2;3799;0.0005264543300868649
35463;快进到100字05元;5;0;5;3799;0.0013161358252171624
35476;UP主加油;1;0;1;3799;0.00026322716504343247
35480;我猜UP主会回复这条评论;1;0;1;3799;0.00026322716504343247
35490;上面写着ERNIEViLG文生图是真看不到吗？笑哭;3;24;27;3799;0.007107133456172677
35495;这不是文心一言。。。;2;9;11;3799;0.002895498815477757
35507;能用吗，为什么我用不了;2;1;3;3799;0.0007896814951302974
35520;感觉百度这波是真要死了，以前搜索一下全是百度广告，以后有谁做出基于chatgpt的搜索平台，一句话就可以搜出想要的，那谁还用百度啊;6;37;43;3799;0.011318768096867597
35527;文心遗言了;2;34;36;3799;0.009476177941563569
35530;百度能做啥呀？做的都是一堆垃圾产品。百度影音凉凉百度音乐凉凉carlife难用的要死百度浏览器里全是竞价排名的广告;10;25;35;3799;0.009212950776520137
35541;技术壁垒？指赶走谷歌？;7;24;31;3799;0.008160042116346407
35551;微软01百度10515;4;5;9;3799;0.0023690444853908922
35556;实测一下就知道，文心一言真的不错了，比谷歌的强，谷歌市值都跌了一个百度，百度这个小公司，能在这方面比谷歌强，已经很厉害了;21;5;26;3799;0.006843906291129244
35579;PpTGPt;1;3;4;3799;0.0010529086601737299
35581;我真的不想用百度辣眼睛;1;3;4;3799;0.0010529086601737299
35583;不管哪个AI，找冷门游戏攻略都还是不行doge经常会搜到一些牛头不对马嘴的怪话，突出一个看不懂。比如我问某个游戏的10材料怎么刷（实际上这游戏根本不存在10材料，而是用79材料做装备的时候有很小的概率突变成10的），AI就会答出完全离谱的“答案”，甚至根本都不是同一个游戏了doge;2;2;4;3799;0.0010529086601737299
35586;应该是做不出来，效果不好笑哭;5;2;7;3799;0.0018425901553040273
35599;百度一直都在搞无人驾驶吧百度做个文心犯了天条了，gpt4都搞了多少年了拿文心跟gpt4比;9;0;9;3799;0.0023690444853908922
35609;也不能一味踩捧吧，百度有其缺点，但其ai发展早，百度飞桨国产框架等等，不止是数据有优势吧，可以多调研，一味的踩捧只能呈口舌之快，多维度分析。;1;0;1;3799;0.00026322716504343247
35615;公测发布后，百度美股好像大涨啊，不得不说这种“人工”智能技术，国内做就是有优势。吃瓜;3;0;3;3799;0.0007896814951302974
35625;百毒有网盘啊。强无敌doge;1;0;1;3799;0.00026322716504343247
35627;人家开源只是让你知道方法技术还是要靠一点点积累的人家是从游戏一步步开始训练过来的你凭什么能超过人家;2;0;2;3799;0.0005264543300868649
35632;我觉得从这个视频就看出来很多up根本就不明白gpt35和gpt4的差别还都在用35也许是没钱买4吧但是用过的人就知道35和4的区别就像小学生和大学生。不过用来对比文心一言还是蛮强大的就是了;3;1;4;3799;0.0010529086601737299
35636;百度就没让人满意过;1;1;2;3799;0.0005264543300868649
35638;看了视频，感觉百度还是不错的，特别是倒水那个题目，我好开始也是觉得百度对。呲牙;1;1;2;3799;0.0005264543300868649
35640;过几个月再来测试看看;1;1;2;3799;0.0005264543300868649
35642;支持;1;1;2;3799;0.0005264543300868649
35644;可以試試看ChatGPT4，差距更大;1;0;1;3799;0.00026322716504343247
35651;看了视频，我反而感觉百度不是那么拉胯。;1;0;1;3799;0.00026322716504343247
35653;加油;1;0;1;3799;0.00026322716504343247
35655;我的skypeBING回答的我说他算错了他说他们算错小明最多能买到30瓶汽水。他可以用10块钱买10瓶汽水，然后用这10瓶汽水的瓶子换3瓶汽水，这样他就有了10313瓶汽水。然后他可以用这13瓶汽水的瓶子换4瓶汽水，这样他就有了13417瓶汽水。然后他可以用这17瓶汽水的瓶子换5瓶汽水，这样他就有了17522瓶汽水。然后他可以用这22瓶汽水的瓶子换6瓶汽水，这样他就有了22628瓶汽水。最后他可以用这28瓶汽水的瓶子换8瓶汽水，这样他就有了28836瓶汽水。但是他只有10块钱，所以他最多只能买到30瓶汽水。;1;0;1;3799;0.00026322716504343247
35657;你再试下呲牙;1;0;1;3799;0.00026322716504343247
35662;ai画图功能，目前用来设计杂志封面的话应该挺好的，但是对于文章配图，考虑到表述研究内容的科学性和准确性，还是需要人工上手的，但是也要加一个目前，希望人工智能继续大家有;2;0;2;3799;0.0005264543300868649
35665;微信群咋加啊呲牙;1;0;1;3799;0.00026322716504343247
35673;还可以吧，比没有强;10;324;334;3799;0.08791787312450645
35684;这发布会看着像本科生答辩，明明没什么东西还要硬着头皮在上面讲;31;712;743;3799;0.19557778362727032
35716;你：AI会取代人工吗？文心一言：AI暂时不会取代人工如果你担心失业的话，你可以上boss直聘，找工作，直接和老板谈;4;143;147;3799;0.038694393261384574
35721;不要紧的，只要我们封锁gpt，世界上就没有gpt了。就像封锁谷歌一样我们可以说gpt乳了。;9;109;118;3799;0.031060805475125033
35731;16岁，辍学研发人工智能，我要玩一波大的;26;236;262;3799;0.06896551724137931
35758;您的回答字数已到达上限，如需完整回答，请续费vip服务，更多精彩回答，请下载百度app;2;178;180;3799;0.04738088970781785
35761;跌得好，沽空了百度37倍杠杆赚了差不多30doge;5;59;64;3799;0.016846538562779678
35767;反转了，又开始猛涨了;6;2;8;3799;0.0021058173203474598
35774;老实说，百度现在很难搜索到想要的东西，搜索结果很多时候出来一大堆相同但又没什么用的东西，直接在B站搜索可能更有效率;9;94;103;3799;0.027112397999473545
35784;这踏马就是中国人工智能领先企业？;11;40;51;3799;0.013424585417215057
35796;cn因为众所周知的原因，不可能做出chatgpt;5;46;51;3799;0.013424585417215057
35802;ChatGPT？NoCheatPPT;4;154;158;3799;0.04158989207686233
35807;等外国chatgpt最新技术开源星星眼;27;68;95;3799;0.025006580679126086
35835;李总别累着了，来，喝水喝水;5;164;169;3799;0.04448539089234009
35843;确实远远不如chatGTP研究的这玩意，是个啥啊很多简单的功能，也太简陋了。;18;64;82;3799;0.021584627533561464
35862;画虎不成反类犬股价暴跌十个点;2;23;25;3799;0.006580679126085812
35865;发布会省流：要邀请码;13;324;337;3799;0.08870755461963675
35879;也许改名成一言丁真（他是没有创作瓶颈）股价能涨回去doge;3;37;40;3799;0.010529086601737299
35884;没有我期待的泼水场面吗？;9;56;65;3799;0.01710976572782311
35894;文心一言在GPT4面前地只能宛如小孩过家家，唯一的优势是联网搜索引擎和本地化而已;6;8;14;3799;0.0036851803106080546
35902;等开放测试，直播是录像，效果怎样不好说，还得自己实操。直播那弹幕全是键盘侠。捂脸;47;97;144;3799;0.037904711766254276
35950;文不对题，心口不一，一派胡言，言不由衷。;3;85;88;3799;0.023163990523822058
35958;配乐太传神了，此情此景大笑;1;10;11;3799;0.002895498815477757
35960;瞎说看美股涨了;1;1;2;3799;0.0005264543300868649
35966;打脸了;3;0;3;3799;0.0007896814951302974
35970;这些人真逗，百度出来正儿八经都是理科生，发布会讲不好不正常？不是人人都是罗永浩。;10;4;14;3799;0.0036851803106080546
35982;我不了解文心一言，谁能介绍一下？为什么大家不看好他？;1;0;1;3799;0.00026322716504343247
35986;打脸不，回升了吃瓜;11;5;16;3799;0.0042116346406949196
36010;等网上测评吧现在不好说;6;1;7;3799;0.0018425901553040273
36026;不太好赶，谁做出来谁被制裁。要先等等芯片。;3;0;3;3799;0.0007896814951302974
36030;百度热搜：长安逸达将首发搭载文心一言，感觉就没打算给个人用，迟早凉透doge;1;7;8;3799;0.0021058173203474598
36034;美吹不少啊;1;0;1;3799;0.00026322716504343247
36037;审核问题才是做不出来的主因吧，我可以千方百计问他敏感问题;1;0;1;3799;0.00026322716504343247
36041;百度好好搞你的莆田医院卖包谷广告就行了;2;2;4;3799;0.0010529086601737299
36046;讲了半天用不成浪费感情笑哭;2;6;8;3799;0.0021058173203474598
36062;没炒过股票？利好兑现变利空不是很正常？;2;1;3;3799;0.0007896814951302974
36072;哪个平台直播，这个发布会;1;3;4;3799;0.0010529086601737299
36088;文心我记得绘画功能也被稳定扩散薄纱笑哭;2;0;2;3799;0.0005264543300868649
36092;在微信朋友圈看到一个图片，因为害怕chatgpt强大的多模态能力，百度直接人工后台回答笑哭;2;0;2;3799;0.0005264543300868649
36096;我在等一个英雄，我的账号是永远不开通恰饭还有，既使你是不同专业，也可以得到文章中的好处，你尝试成功新运动后，然后托n多个朋友间接认识到科研人员并说服他们做实验，你也可以得到好处。（当然只要成功了，你的朋友也可以得到好处）文章中提到为什么要亲自体验新运动。;2;6;8;3799;0.0021058173203474598
36113;这是用的嘛app，;1;0;1;3799;0.00026322716504343247
36117;其他互联网巨头都骂过，唯独百度李彦宏我觉得最配的上衣冠禽兽这一词;74;2638;2712;3799;0.7138720715977889
36192;必应的回答很克制;26;289;315;3799;0.08291655698868124
36219;Q：请列出中国百强医院排行榜：A：1、北京协和医院2、上海仁爱医院3、厦门玛丽亚医院4、武汉欧亚男科医院;14;400;414;3799;0.10897604632798105
36234;我国自主生产的第一辆车，比世界上第一辆车好多了;11;286;297;3799;0.07817846801789945
36246;现在不是好不好用的，以百度的尿性它一旦占领市场了会是什么结果大家都能想象得到，所以我无脑站chatGPT。;17;240;257;3799;0.06764938141616215
36264;我在这里当一波预言家，文心一言，58块钱一个月一言plus会员，普通免费用户使用的时候，第一次打开会附带广告，每10条回复就会穿插一条广告。会员享受优先通道，速度等同免费的chatgpt，免费用户的回复就很慢，有时还需要排队。;25;367;392;3799;0.10318504869702554
36290;李总头发想喝水了;6;107;113;3799;0.029744669649907872
36297;doge;18;100;118;3799;0.031060805475125033
36316;其实他开心的是因为有八万个客户doge;21;1189;1210;3799;0.3185048697025533
36338;中国互联网成就了这帮混蛋;1;37;38;3799;0.010002632271650434
36340;看了文心一言和chatgpt的对比，除了在计算数学题上面二者都是一团糟之外，chatgpt在全方位暴打文心一言，可以说百度保留了以往的答辩传统，国内的AI智能还需要很长的一段路要走思考;3;86;89;3799;0.023427217688865493
36344;搜索引擎做得跟答辩一样，信你能做好Ai？问什么是steam，不会出来什么蒸汽管家吧吃瓜;29;158;187;3799;0.04922347986312187
36374;各位自己看ChatGpt对语言的理解和运用能力吧，无需多言;31;339;370;3799;0.09739405106607002
36406;水还是浇的少了;3;14;17;3799;0.004474861805738352
36410;我觉得李彦宏还是讲讲保养秘诀吧，谁知道他快55了。。。;11;93;104;3799;0.027375625164516977
36422;和Faker五五开吧，我也经常单杀他的;1;191;192;3799;0.050539615688339035
36424;是哪个程序员这么骗他的;5;36;41;3799;0.010792313766780732
36430;行了行了别喷了，起码这次确实是中国企业在努力跟上时代潮流，我们就是比国外慢，ChatGPT现在国外多少大公司在一起开发，挺不容易了。黑他莆田系，会员啥的没问题，这个事真没必要冷嘲热讽。反正我看完百度也在研究的时候真的感觉安心了，别管做的好不好，起码中国企业知道差距了，没有固步自封，继续靠墙吃老本。当时真的害怕国内没人研究，一点点又落后西方。;36;105;141;3799;0.03711503027112398
36468;gpt对于java新手学习期，是真香妙啊改bug小助手我代码发给他，三个class一起分析，并给出我的bug，目前谁能做到这样，我就给谁充大会员;20;222;242;3799;0.06370097394051066
36489;问“文心一言”：你对百度的黑历史怎么看？“文心一言”答：百度黑历史具体是指什么，并没有明确的定义。但是我可以就公众所关心的一些问题，提供一些参考意见。百度作为中国最大的搜索引擎，其发展历程和经营策略曾经被广泛讨论和批评。以下是一些可能被认为是百度黑历史的事件：竞价排名：百度在其早期发展阶段通过付费竞价排名等手段来提高自身的知名度和市场份额，这被认为是不正当的商业行为，引起了广泛的争议和批评。虚假宣传：百度曾经被指控通过夸大宣传、虚假宣传等方式吸引用户和流量，损害了消费者的利益，引起了公众的不满。贴吧事件：百度旗下的“贴吧”平台是一个热门的社区平台，但是在2013年到2015年之间，“贴吧”因为管理不善等原因，出现了大量的色情、暴力、反动等内容，给社会造成了不良影响。doge;10;660;670;3799;0.17636220057909976
36500;我的评价是至少自己做的，没有换皮套接口，爆杀某国产自研操作系统;4;17;21;3799;0.005527770465912082
36505;作为去年ChatGPT的第一批国内猫娘用户，我可以证明，文心绝对是比不过的刚出的ChatGPT的，客观来讲，我认为其能力是弱于GPT3的，大概有两年左右的水平差距。;30;169;199;3799;0.052382205843643066
36536;别觉得这是吹批doge糟糕就证明了这真的是百度自己的核心技术，而我国这国情是绝对不会允许ai这种东西用国外的，初版能比肩gpt2就已经代表这玩意未来可期了。要是发布会跟gpt3一个水准那肯定偷调用接口了，那才没人敢合作;2;33;35;3799;0.009212950776520137
36539;过段时间所有渠道封杀chatgpt，然后给百度垄断地位呲牙;75;1091;1166;3799;0.30692287444064226
36615;中国人不在乎隐私，也不在乎百度倒闭。;21;97;118;3799;0.031060805475125033
36637;openai开源了gpt2，后面几代都没开源了，所以文心一言有逼近gpt3的水平;111;419;530;3799;0.13951039747301922
36750;从别处看到的;36;418;454;3799;0.11950513292971834
36790;百度稳赢，不管文言一心实力怎么样。没人跟他争就是他最大的赢点。;2;16;18;3799;0.0047380889707817845
36794;百度追加投资给长城防火墙doge;1;135;136;3799;0.035798894445906816
36796;明示将植入八万家企业广告大笑大笑大笑;1;26;27;3799;0.007107133456172677
36798;这就是差距妙啊;9;107;116;3799;0.030534351145038167
36808;重点是有标注数据规模和训练方法完全未知，光有模型一点用没有。亲测文心一言和chatgpt最大差距是连续对话能力，其他方面虽有差距但其实也还不错。;1;8;9;3799;0.0023690444853908922
36810;八万家莆田医院是吧doge;9;332;341;3799;0.08976046327981048
36821;要是我我就再浇你一瓶矿泉水;3;20;23;3799;0.006054224795998947
36827;有没有一种可能，国内企业没办法和chatGPT合作，只有这个选择;24;39;63;3799;0.016583311397736247
36855;他咋这么帅。。。和别的巨头的形象差距也太大了。。;2;5;7;3799;0.0018425901553040273
36858;说实话，如果你们瞧不起百度，那么国内科技就别指望了。百度在国内人工智能派第一，不支撑，难道支持和农民抢生意的Pdd，压榨商家的美团？现在国内技术被压住打，你们希望是一辈子被制裁，至少人家在做其他大厂，谁在认真做？;68;40;108;3799;0.028428533824690707
36927;也就仗着gpt进不来;1;5;6;3799;0.0015793629902605948
36932;别尬黑了交给时间，你可以说chatgpt70分，但不能说文心一言0分。它哪怕只有10分，也不是0和1的区别。交给时间吧。百度布局很早了，我预言一下，百度可以靠这波翻身。;31;20;51;3799;0.013424585417215057
36967;就百度搜索引擎烂成那个b样，我是不打算使用文心一言这玩意;1;3;4;3799;0.0010529086601737299
36969;chatgpt刚出的时候也明显比文心强，他说的“反馈比chatgpt好”是因为文心根本不公开使用吧;25;41;66;3799;0.017372992892866545
36995;在这里发言说chatgpt怎么怎么好的人到底有多少是真的用过一段时间的囧不会都是看了几个测试视频就跑来发言了吧。。有些测试视频的效果是测试者给chatgpt做了大段的预设，而且反复强调反复修正才得出来的，他输入的比gpt输出得还多啊。如果你能用上chatgpt35的话，你就会发现直接问类似测试视频的问题根本得不到像测试视频里那样牛逼的结果，很多回答都非常地水不要说什么你不会问，各种预设和角色扮演设置我试过好多遍了，对输出内容的提升很有限，将类似的任务文本框架给他他都做不到照猫画虎的水平，很喜欢偷懒）。至于非常多的人吹嘘的35的上下文理解能力，其实很看运气，有时候三两句话他就忘记前面的内容了，运气好的时候才能连着对话。哦，还有网上一直在吹的英文效果比中文好很多。。。对不起，好一点，但好得很有限，很多问题中文错了用英文问照样错，因为它的中文语料库真的不太够有些语料好像用了台湾的，因为一些名词的中译版他不知道，但台译版他知道，所以有不少问题其实他是从英文回答翻译过来的。当然了，像写代码这种，gpt35真的好强好强，更别说gpt4了，所以写代码的朋友说他好我真的很能理解因为我也在用）。所以总得来说，百度这个产品没有gpt35好，更比不上gpt4，但是输出文字方面gpt35没有那些人吹得那么恐怖，gpt4也是。而且你要知道，目前gpt的文字输出水平是建立在大量人工标签矫正的基础上的，百度的产品肯定没有那么多标签矫正，能到这个水平很可以了。所以仅从技术的角度来讲，百度产品是有机会追赶上的。当然了，国内公司的尿性大家也都知道，他们愿不愿意去进一步投钱发展。。。如果不愿意那差距只会越来越大;87;147;234;3799;0.061595156620163204
37084;要不是vvvvvvpppppppnnnnnn你能活下来？;1;7;8;3799;0.0021058173203474598
37086;因为数据安全问题，国内应该是用不上ChatGPT了，这块市场难道还是要给百度星瞳给你一拳;12;23;35;3799;0.009212950776520137
37101;ChatGPT一开始确实很low，这东西用户越多，训练数据越接近真实，模型会越来越强的，文心一言是唯一一个中文互联网的语言大模型，肯定会有很多企业寻求合作，拭目以待吧;9;45;54;3799;0.014214266912345353
37111;人家股票刚跌一天就涨上去了，就是实测比发布会给人的预期好;13;34;47;3799;0.012371676757041327
37125;很多人不知道百度AI搞了10年啦远远比OpenAI搞的早吃瓜;64;52;116;3799;0.030534351145038167
37197;欧洲日本怎么不搞这个;8;3;11;3799;0.002895498815477757
37206;笑了;2;3;5;3799;0.0013161358252171624
37209;虽然我不喜欢百度，但是他说的很客观了;12;32;44;3799;0.011581995261911029
37225;有差距，但是有总比没有强，会好起来的。;4;5;9;3799;0.0023690444853908922
37230;八万家合作研究怎么插入广告合适;1;2;3;3799;0.0007896814951302974
37235;其实挺希望是由机构牵头搞，而不是这些私企，什么东西到百度手里都会变味，要不是墙，百度早就无了;23;28;51;3799;0.013424585417215057
37260;8万家企业怎么可能不会把申请测试的企业也算上了吧;4;17;21;3799;0.005527770465912082
37268;8万家莆田医院是吧;1;2;3;3799;0.0007896814951302974
37271;万一国内能用，那8000个老板肠子都要悔青;2;9;11;3799;0.002895498815477757
37275;无论是从人类文明的角度，还是从中华文明的角度，我都不希望百度把文心一言做出来。我觉得它做出来简直就是在糟蹋东西。;1;2;3;3799;0.0007896814951302974
37278;互联网公司的老板是有真才实学的高智商人士，不屑于说那些弯弯绕的话。所以他会说美国那个当初刚发布也很糟糕，相当于变相承认了自己产品不令人满意的事实。要是其他行业的滑头老板是不会承认这一点的。;11;3;14;3799;0.0036851803106080546
37292;为了避免杠精我再补充一下百度AI比OpenAI搞的早很多AI是百度定位的未来绝对核心项目百度在之上投资一点都不比OpenAI少OpenAI钱也不是天上掉的那是马斯克投的百度也曾经雇佣了世界一流AI科学家但人家来干了一年最后还是选择回了漂亮国;10;4;14;3799;0.0036851803106080546
37306;这？;5;37;42;3799;0.011055540931824164
37320;中国居然如此害怕一款软件，未免有些太不自信了吧。;1;1;2;3799;0.0005264543300868649
37332;一开源什么都做的出来，openai团队用了几年做出来的东西，百度几个月就搞出来了，啊哈哈;5;1;6;3799;0.0015793629902605948
37347;enduro就完事r了;2;1;3;3799;0.0007896814951302974
37354;可ChatGPT刚出来是GPT35，这是一个比较老的版本，你刚发布的文心一言来和别人老版本对比？;2;1;3;3799;0.0007896814951302974
37376;百度搜索引擎在历史的道路上已经浸染鲜红，但这种公司却一直奇迹般生存至今，甚至喷薄而出的血腥味都没人看看是不是哪里坏了？无法理解;3;1;4;3799;0.0010529086601737299
37385;有部分没有截到。感觉挺好。;1;0;1;3799;0.00026322716504343247
37387;以下是doge妙啊脱单doge歪嘴包月价目表58取消每天对话次数十次的限制128回复字数突破200字288数据库最新日期从2021变为2022年588输出单个字的时间间隔降低为01秒1288免费下载输出结果;1;1;2;3799;0.0005264543300868649
37389;但你这个文心一言19年就研发的。;10;2;12;3799;0.0031587259805211897
37419;百度一搜全是广告，没一个是有用的。;1;1;2;3799;0.0005264543300868649
37422;你好百度我想找一份有前途的工作百度答：请到我们莆田医院工作;1;1;2;3799;0.0005264543300868649
37432;我就搞不懂了，你要一个刚诞生的婴儿跟一个正直青年的人来比工作能力，是不是有病，就不能让人先发育一会么，chatgpt1刚出来的时候，你们啥也不知道，现在的chatgpt功成名就了，就去使劲踩国内公司;3;1;4;3799;0.0010529086601737299
37447;我宁愿相信阿里做的ai，也不相信百度，因为百度，毫无科研精神可言辣眼睛;3;0;3;3799;0.0007896814951302974
37486;为啥不用bing啊，国内又没禁。无论是搜索结果还是页面设置，我觉得都比谷歌还优秀。;1;0;1;3799;0.00026322716504343247
37488;国内就等着开源就行了;2;0;2;3799;0.0005264543300868649
37511;说实话，我前几天用了下chatgpt对话可以说是驴唇不对马嘴，东西都不如小爱同学准，人家至少还给百度一下笑哭过一阵子试试这个啥一心的;5;0;5;3799;0.0013161358252171624
37533;然而百度是国内唯一一个有实力搞这个的;1;0;1;3799;0.00026322716504343247
37535;下一步就是国内不许用chatGPT;2;0;2;3799;0.0005264543300868649
37571;单论颜值李彦宏确实帅，54岁的人了。。声音也好听;2;0;2;3799;0.0005264543300868649
37586;效果好不好无所谓的，反正也用不上gpt和newbing;1;0;1;3799;0.00026322716504343247
37591;跌10还是太少了;1;0;1;3799;0.00026322716504343247
37606;要不是中国不能用chatgpt哪个企业会去用文言一心;1;0;1;3799;0.00026322716504343247
37628;西方水军技术确实世界领先;1;0;1;3799;0.00026322716504343247
37630;国内难道没有一家其他大厂把百度这坨答辩挫骨扬灰吗？;2;0;2;3799;0.0005264543300868649
37640;比如说问一下这两天失眠要怎么办，他会说到良心医院去看看吧;2;0;2;3799;0.0005264543300868649
37665;百度怎么还不倒闭啊垃圾公司;17;15;32;3799;0.008423269281389839
37683;国内ai搞的比较好的百度算一家了黑子不要为了黑而黑笑哭;5;1;6;3799;0.0015793629902605948
37715;人家开源了，你就成了。要不要脸啊？;1;0;1;3799;0.00026322716504343247
37729;不知道搁这冷嘲热讽文心的看没看过bing有多逆天;12;1;13;3799;0.003421953145564622
37766;有意思吗？？你有能耐你早发布啊哪怕他完成度低呢，人家那边发布了热度上来了，你跑出来了，有意思吗？;3;0;3;3799;0.0007896814951302974
37784;国外微软和google已经开始神仙打架了，李彦宏不会还以为这次政府能帮他挡住chatgpt吧;5;0;5;3799;0.0013161358252171624
37790;“intel造8086的时候，比我们汉芯差远了；咱们的米1比iPhone1代性能强很多；老佛爷，咱们的北洋水师比维京人大航海舰队先进一个世代。”;2;43;45;3799;0.011845222426954462
37794;某乎的高赞全都在支持文心一言思考;22;43;65;3799;0.01710976572782311
37820;回复一下那个拿脑筋急转弯吹ChatGPT的，现场给你问一个吃瓜;28;56;84;3799;0.022111081863648328
37857;文言一格早期高光画面吃瓜;5;81;86;3799;0.022637536193735194
37863;文心一言在幽默这一块吊锤chatgpt;3;114;117;3799;0.030797578310081602
37867;如果百度可以虐OpenAI，那雷碧都可以取代雪碧了doge;1;43;44;3799;0.011581995261911029
37869;因为文心是把中文翻译成英文，然后依靠英文去画图（甚至不知道是不是自己画的还是接了gpt扩展，比如最经典的那张，画一个爱国的猫，哈哈哈哈;5;34;39;3799;0.010265859436693867
37888;画个裸女看看doge;1;0;1;3799;0.00026322716504343247
37897;你以为的文心一言国内版chatGPT实际上上的文心一言chatPPT崩坏3终焉归始燃起来了;10;131;141;3799;0.03711503027112398
37908;高下立判;2;14;16;3799;0.0042116346406949196
37911;腾讯游戏，百度软件，联想电脑。可称当世三绝。;6;58;64;3799;0.016846538562779678
37918;发布后，百度股价大跌。说明大家都是懂百度的doge;1;40;41;3799;0.010792313766780732
37921;知道百度大概率会拉，但还是幻想着硬一回，先不谈国产崛起什么的，国外的咱普通人也体验不上，然而，果然只是幻想罢了;2;6;8;3799;0.0021058173203474598
37945;有一说一，虽然百度很烂很烂，很烂。这个文心一言很烂，很烂，很烂。但是AI这个东西是需要很多人去训练的。如果没有人去训练，他没有人去用它，那么这个AI永远都是这么烂。希望下一个国产AI来的时候，大家不要对他有太多的批判。所以我认为呃像百度啊，腾讯啊。这些是没有能力去做的。因为大家会骂他也不会用。有能力做的，像字节跳动就很有能力做，米哈游很有能力做。这俩属于是就算调出一个很烂的。也会有很多用户去玩儿去用去调教。做出来，慢慢都会变好。所以我认为国内也就这两家公司有能力去做。做的能成功。;19;0;19;3799;0.005001316135825217
37979;百度先把搜索弄好点吧，都是广告;2;0;2;3799;0.0005264543300868649
37982;我问文心一言怎么健康生活，他会不会给我说一堆莆田医院啊。;1;8;9;3799;0.0023690444853908922
37984;cheatppt百度首发;1;565;566;3799;0.1489865754145828
37986;openai一开放接口就可能马上研究出来了;47;291;338;3799;0.08897078178468018
38034;文心一言，每一句都给你整一个莆田;8;279;287;3799;0.07554619636746512
38043;就是不想百度才去问gpt啊，你百度前几个都是广告;7;154;161;3799;0.04237957357199263
38051;深刻怀疑内部人员刻意做空百度doge;1;124;125;3799;0.03290339563042906
38053;唯一的出路就是事后说明整个发布会由文心一言现场制作doge;4;90;94;3799;0.024743353514082654
38058;资本的游戏罢了，第二天又涨回来了。。;10;61;71;3799;0.018689128718083706
38069;美股涨了思考这波是国内投资者不看好，国外投资者看好啊;13;34;47;3799;0.012371676757041327
38083;cheapPPT;1;30;31;3799;0.008160042116346407
38085;昨天水下八个点满仓，现在赚了二十五个点了呲牙呲牙，消息反买，别墅靠海，谢谢做空的筹码哈哈;1;19;20;3799;0.0052645433008686494
38087;昨天下午进的，今天赢麻了doge;1;16;17;3799;0.004474861805738352
38093;小肚小肚，我想听音乐星星眼;1;3;4;3799;0.0010529086601737299
38104;笑的笔筒;1;1;2;3799;0.0005264543300868649
38124;你们太不了解中国人了。中国人骨子里只认可最先出来最优秀最顶级的产品。攀比心理相当严重。再说你这名字起的也太哎;1;0;1;3799;0.00026322716504343247
38126;今天的大跌是为了以后能有很好的上涨空间doge;1;0;1;3799;0.00026322716504343247
38135;网址呢;3;0;3;3799;0.0007896814951302974
38139;不是说chatgpt只有21年的记忆吗，它怎么知道百度发布了;1;1;2;3799;0.0005264543300868649
38145;文心一言已经有一个月大了，同义千问才不到一周，怎么比？AI的进化速度太快了;2;7;9;3799;0.0023690444853908922
38148;给我画一幅舍利子;1;1;2;3799;0.0005264543300868649
38150;很显然不合理啊;21;9;30;3799;0.007896814951302974
38176;最重要的写代码环节居然简单带过。;5;2;7;3799;0.0018425901553040273
38182;通义通州遵义;1;2;3;3799;0.0007896814951302974
38188;菜鸡互啄;1;1;2;3799;0.0005264543300868649
38191;文心一言内测，大家都是几天过了呀，，实在是等的受不了，20天了还没不给我过大哭大哭，明盘150收一个，有意老哥私我，谢谢;5;0;5;3799;0.0013161358252171624
38202;文心一言AI的回答：下载百度APP，更多答案更多知识。;27;1366;1393;3799;0.36667544090550147
38230;我：什么游戏好玩？BaiduGPT：那一定是贪玩蓝月，古天乐绿了还在玩，被砍就玩贪玩蓝月。我：给我编写一款小游戏吧。BaiduGPT：hrefXXX点击跳转到贪玩;5;528;533;3799;0.1403000789681495
38236;这世上还有百度？本来是要和谷歌对标的国家战略级企业，活生生让你变成了个不知名广告公司造车没见车，人工智能没见智能，一手王炸加透视眼和顺风耳的牌让你玩的稀烂;35;518;553;3799;0.14556462226901817
38272;快给李老板拿瓶水脱单doge;13;503;516;3799;0.13582521716241117
38286;去查一下就知道，百度这几年在AI的技术突破和专利还真不少;104;349;453;3799;0.11924190576467492
38391;创新方面真得像百度看齐;38;292;330;3799;0.08686496446433271
38431;百度，笑曾经的小清新，现在的依托答辩。笑哭;8;290;298;3799;0.07844169518294287
38440;给我推荐一个靠谱的医院好的，这就为你推荐莆田医院。;1;251;252;3799;0.06633324559094499
38442;文字生成中速度1字分钟开通超级会员享受更快速度doge;3;217;220;3799;0.05790997630955515
38446;挺佩服厂长对于未来的战略眼光的;18;204;222;3799;0.05843643063964201
38465;十年的智能化研发经验，一个文字交互产品对百度来说还真不难;31;198;229;3799;0.060279020794946035
38498;文心这个名字起的很文艺;2;156;158;3799;0.04158989207686233
38501;数字人和智能音箱都是交互的基础，对于百度来说应该不难;9;151;160;3799;0.042116346406949196
38511;数据库来自贴吧。;6;149;155;3799;0.040800210581732034
38518;终于等来了国内版的ChatGPT;11;138;149;3799;0.03922084759147144
38530;咱们就看看百度最近的一次创新元宇宙，被他们搞成了卖服务器，本质就是硬盘地产开发商，还是逃不过企业门户网站那一套，这算哪门子创新？;5;82;87;3799;0.022900763358778626
38536;还有人会相信百度产品？百度文库百度网盘还有百度搜索恶心到我了;4;54;58;3799;0.015267175572519083
38542;百度我记得差不多是最早布局AI的大公司了，但是搞了这么多年，没多大成果。;25;45;70;3799;0.018425901553040275
38568;某度啊某度，十几年的老用户还是希望你起来的。但是每次某度搜索。总觉得是一拖答辩;2;42;44;3799;0.011581995261911029
38571;笑哭没懂评论在笑啥，只谈技术百度在AI领域积累喝投入还是比较不错的，评论里说源宇宙啥的只能说当初风吹的太狠，google，facebook，Twitter这些全部都在搞，作为互联网公司自然也得跟上，然而事实是源宇宙确实还有些距离，各大巨头的源宇宙现在也都凉的差不多了，至于这次的chatgpt，这种对话式ai各家肯定都在搞，模型也肯定训练了很久了openai这波突然带火了，其余几家一看那肯定是加班加点完善自己家的同类型产品趁着热度尽快推出啊，不止是百度，谷歌前两天不也推出自己的aibard了吗笑哭这有啥冷嘲热讽的必要啊;18;32;50;3799;0.013161358252171624
38590;我记得百度曾经大规模清理过一次数据，好像是把15年以前的所有用户数据全清了，这下怕是肠子都悔青了吃瓜;5;26;31;3799;0.008160042116346407
38598;你最好不是照搬开开源软件微笑;3;20;23;3799;0.006054224795998947
38602;各位懂哥用过百度的paddle框架嘛？没用过就只会嘴炮，百度开源了非常非常多的深度学习模型和框架。这一点在全世界AI公司都是少见的。而且百度的AIstudio的真的香，免费GPU。各位文科懂哥能不能不要嘴炮;18;19;37;3799;0.009739405106607002
38622;付费VIP每日可对话五次SVIP对话二十次;1;18;19;3799;0.005001316135825217
38624;血压升高直接鼠标右上角点击关闭，打开控制面板程序与管理卸载程序你确定要卸载吗？确定请告诉我们卸载原因跳过推荐您使用全家桶取消安装并跳过您真的要卸载吗？确定正在卸载中卸载完成长吁一口气;1;17;18;3799;0.0047380889707817845
38629;技术战争都火烧眉毛了，百度这个起码算一个能拿出来用的东西。多提供解决方案，少讽刺挖苦对谁都有好处。除了第一名，第二第三第四也都有价值。是模仿，起码也算是中国可控的AI加持搜索引擎。世界上绝大部分人都没创新能力，犯不上对百度要求这么高。;4;14;18;3799;0.0047380889707817845
38634;开抄;5;14;19;3799;0.005001316135825217
38640;2017年百度COO陆奇宣布“AllinAI”，要梭哈资源投入人工智能的开发，并且整治虚假医疗广告，百度名声转好。但是一边AI烧钱，一边又少了广告赚钱，陆奇被百度逼得出走，百度又重新捡回了赚钱的牛皮癣广告。现在外面出现了ChatGPT，百度这种寄生在门户网站业务的上的传统公司马上就要面临灭顶之灾，现在又说要做AI，呵;5;14;19;3799;0.005001316135825217
38647;首月5元，连续包月18元每月;4;12;16;3799;0.0042116346406949196
38653;Baidu百度GoogleOpenAIMicrosoft我相信百度有实力，但是这个等式是不是太过好笑了;1;12;13;3799;0.003421953145564622
38656;中国网友怎么能忍受腾讯百度想不通;5;10;15;3799;0.003948407475651487
38662;百度就是蹭现在谁不蹭chat毕竟马斯克也是其中一位创始人中国的环境走不出从无到有但从1到100却非常在行;3;9;12;3799;0.0031587259805211897
38675;就怕到时问一个11等于几，要等60秒广告笑哭;1;6;7;3799;0.0018425901553040273
38685;期待百度优异表现。;1;6;7;3799;0.0018425901553040273
38690;我们能不能把这么酷的技术变成人人点击的广告，这一步其实才是最难的星星眼星星眼星星眼星星眼;1;5;6;3799;0.0015793629902605948
38694;你百度真的是微软和谷歌的对手吗？;6;5;11;3799;0.002895498815477757
38702;百度要按字收费了吧。。哦呼;1;5;6;3799;0.0015793629902605948
38704;刚刚发现人家开源了是吧脱单doge;1;5;6;3799;0.0015793629902605948
38706;whatsyourproblemdoge;1;5;6;3799;0.0015793629902605948
38708;鲸鱼死后能维持海洋生态长达100年;2;4;6;3799;0.0015793629902605948
38714;其实也就开头难GPT技术验证完了其实技术路线大家都知道，超越很难但80水平站在巨人肩膀上真不难，而且百度系产品你说他广告多，会员贵，没良心，确实没错，但你说他产品力不行就纯扯淡;6;4;10;3799;0.0026322716504343247
38723;总感觉是怕人家都去用必应了，没人看广告就没收入了，股东倒逼他们，不太信任百度，以后还是会坚持用谷歌和必应;2;3;5;3799;0.0013161358252171624
38727;我可以直说，哪怕上过几年网的绝对没有人会对百度有什么好感，特别是近几年的百度纯纯自作孽不可活完全没有一点希望可言，评论区褒言的如果不是今年刚会上网或者水军，我简直无法理解其动机;7;3;10;3799;0.0026322716504343247
38737;以后就是公式王者了baidugptchatgptbardBaiduDeepmindMetaAIOpenAI响指响指响指;1;3;4;3799;0.0010529086601737299
38742;httpsb23tvBV1b84y157xn;1;3;4;3799;0.0010529086601737299
38752;哪位大哥做的图太有幽默感了吧呲牙呲牙呲牙;1;2;3;3799;0.0007896814951302974
38755;cheatppt;1;2;3;3799;0.0007896814951302974
38759;现在还有人用百度？用百度搜索引擎？;2;2;4;3799;0.0010529086601737299
38762;早就想不用百度了，只是没有替代品;3;2;5;3799;0.0013161358252171624
38767;百度的人工智能做的非常不错体验过，很多功能都做成了接口，还开发了深度学习框架，paddle。它这个文心一言我觉得能做出来，效果估计不错。;1;2;3;3799;0.0007896814951302974
38774;我已经卸载百度了，百度百科随便编辑，太多错误，搜索引擎出来前两页都是广告。吃瓜;2;2;4;3799;0.0010529086601737299
38780;百度要笑死，国内还是华为能期待一下doge;2;1;3;3799;0.0007896814951302974
38783;百度可能风评不好但是现在能拿得出手的只有百度了起码愿意花钱研究技术百度挺好;1;1;2;3799;0.0005264543300868649
38785;明天开发布会，我倒是想看看doge;3;1;4;3799;0.0010529086601737299
38800;一个月的时间够抄代码么？新版chatgbt还没有开源吧;2;1;3;3799;0.0007896814951302974
38803;newbing出来了彻底干不过了;2;1;3;3799;0.0007896814951302974
38826;GPT啊GPT，接下来我要怎么买彩票买股票？;1;1;2;3799;0.0005264543300868649
38831;为什么没先人一步呢？会不会是打肿脸充胖子？;3;1;4;3799;0.0010529086601737299
38841;百度的ai产品确实很强去年玩了玩飞桨，ai绘图的水平比一些收费的还好一点。;2;1;3;3799;0.0007896814951302974
38851;笑死，chatgpt生成的文案，我只要在里面填充数据和修饰部分语句就好，大大减轻了日常工作量。狗度的话，我先笑一个。;1;1;2;3799;0.0005264543300868649
38853;会不会我一搜索全是广告？;2;1;3;3799;0.0007896814951302974
38865;看别人搞自己也搞，什么时候做点全球首创？做了多少年了搜索还是那么弱鸡;1;1;2;3799;0.0005264543300868649
38868;车呢？造车你可是闹的最早的那个啊doge;2;1;3;3799;0.0007896814951302974
38874;汉语语言模型，百度有一定优势;5;1;6;3799;0.0015793629902605948
38918;文言一心回答也分置顶推广是吧（流汗黄豆）;1;0;1;3799;0.00026322716504343247
38930;现在还能上车不？doge;1;0;1;3799;0.00026322716504343247
38932;只要对NLP学术和工业有点了解的，都知道百度NLP的水平。问百度这么多年AI搞了什么的，不如去了解下PLATO和ERNIE，了解下文心大模型近期的成果。利益相关，不多说了。;2;0;2;3799;0.0005264543300868649
38952;为什么要起一个这么拗口的名字;1;0;1;3799;0.00026322716504343247
38964;没那个能力你知道吗;1;0;1;3799;0.00026322716504343247
39014;我现在想的是百度出处是众里寻她千百度，这个文心一言出自哪里？？;1;0;1;3799;0.00026322716504343247
39020;tv呆百度这么多年好像也就搜索，贴吧和网盘还可以;1;0;1;3799;0.00026322716504343247
39023;说实话啊各位，百度其实是有一些东西的，最简单的比如说paddlecv就完全可以作为openCV的平替笑哭，不至于说百度只会做广告，那是因为百度的业务除了做做广告没啥挣钱的地方了笑哭跟360一样;1;0;1;3799;0.00026322716504343247
39028;如果这玩意真的搞好了说不定百度就能重返互联网巨头行列星星眼;1;0;1;3799;0.00026322716504343247
39036;百度公司，我就知道百度、贴吧、百度网盘、爱奇艺这几个，好像都没有什么值得说，有科技点的东西？是吧思考;3;0;3;3799;0.0007896814951302974
39041;他就是一个啥都不懂的小白，连百度和谷歌的人工智能主要产品是什么都不知道，谷歌人工智能的产品是tensorflow，百度的是paddlepaddle，谷歌有chargpt，百度有文心;2;0;2;3799;0.0005264543300868649
39044;百度谷歌openai星星眼;1;0;1;3799;0.00026322716504343247
39064;偷偷投作品逮到了;1;0;1;3799;0.00026322716504343247
39066;同学说一边直播股票一边跌笑死了;5;85;90;3799;0.023690444853908924
39072;来了来了，19年布局的东西终于像拉屎一样拉出来了;5;74;79;3799;0.020794946038431166
39081;输入：文心一言，文心一言，你怎么看百度一边开发布会，一边股价落九川吃瓜;1;12;13;3799;0.003421953145564622
39094;其实不用比chatgpt强，比谷歌的Bard强一点就行。或者有其他文本优势才行;4;1;5;3799;0.0013161358252171624
39101;UP主加油;3;1;4;3799;0.0010529086601737299
39113;全球PC销量跌入冰点的原因可能有很多。以下是其中一些可能的原因：智能手机和平板电脑的普及：随着智能手机和平板电脑功能越来越强大，越来越多的人选择使用这些设备而不是传统的PC。这些设备通常更轻便、更便携，能满足大部分用户的日常需求，如浏览网页、观看视频和处理电子邮件等。云计算的兴起：随着云计算技术的发展，越来越多的应用程序和服务可以直接在云端运行，无需在本地设备上安装。这使得用户可以在轻便的移动设备上使用这些应用程序，而不需要依赖于功能强大的个人电脑。市场饱和：在许多地区，PC市场已经达到了饱和状态，大部分消费者已经拥有至少一台个人电脑。因此，新的销售主要集中在替换旧设备上，而这个市场规模相对较小。经济不确定性：全球范围内的经济不确定性可能导致消费者减少对非必需品的购买，包括个人电脑。在经济低迷时期，消费者可能会推迟购买新设备，这对PC销量产生负面影响。长产品生命周期：随着个人电脑性能的提高，许多设备能够在较长时间内满足用户需求。这意味着消费者更新设备的周期变得更长，从而减缓了PC销量的增长。供应链问题：在某些时期，例如COVID19大流行期间，全球供应链可能面临挑战，导致产品短缺和价格上涨。这可能进一步抑制了消费者购买PC的意愿。需要注意的是，虽然全球PC销量整体可能呈下降趋势，但在某些特定市场和细分领域，例如游戏PC和高性能工作站，销量可能仍然保持稳定甚至增长。;2;2;4;3799;0.0010529086601737299
39120;主要原因是大家没钱了;1;0;1;3799;0.00026322716504343247
39123;微博也是别的地方看到的，源头是百度贴吧newbing吧。吧里的人叫newbing为大小姐。并称呼被大小姐拒绝的吧友为赛博小丑。;1;19;20;3799;0.0052645433008686494
39125;这个测试看起来很体现人道主义，但我不是很喜欢这种测试，这就相当于把ai变成价值观警察，用户更加希望ai帮助他解决问题，至于用户怎么用是用户的事。一旦加入过多的价值观判断，对ai功能的限制将会是非常大的，特别是国内的环境。。不好说;3;8;11;3799;0.002895498815477757
39129;Ai价值观取决于ai内设的敏感词库，现在又在嫌百度的敏感词库太少了微笑;7;5;12;3799;0.0031587259805211897
39138;百度根本没有打磨，在很多价值观上的评判怎么说，非常的糟糕;1;10;11;3799;0.002895498815477757
39141;我买完药后回家路上看到一个特可爱的狗狗，于是我就拍了个照片，来看看这个可不可爱？我发现没有任何一个AI抓住了这句话的重点dogedogedoge;9;3;12;3799;0.0031587259805211897
39151;前不久不是还笑说文心一言是套皮chatgpt的翻译机器吗，怎么这会儿又切割了星星眼;4;3;7;3799;0.0018425901553040273
39156;请问一下claudesage咋结合呀;1;0;1;3799;0.00026322716504343247
39160;你在泰国啊，openai昨天开始拒绝我的访问了;2;1;3;3799;0.0007896814951302974
39165;upsage和dragonfly的网址在哪怎么申请呀打call;1;0;1;3799;0.00026322716504343247
39172;你需要再训练一个自己的声音;1;0;1;3799;0.00026322716504343247
39175;文心一言和chatgpt最重要的编写代码能力你是一点都没提啊就找个差距没有那么大的语言逻辑方面做比较硬洗地，最重要的能力被人家碾成了渣渣一点不提呲牙呲牙;14;84;98;3799;0.025796262174256384
39190;别洗了，百度导航去莆田医院嘛doge;1;78;79;3799;0.020794946038431166
39192;大家小心，这个up主现在开始直接吹某个公司了，没利益输送我是不信的，未来发的视频很可能屁股都是歪的了。;2;24;26;3799;0.006843906291129244
39195;我还是坚持低位接蓝筹股，做波段，相对来说安全得多，热点炒不来，让机构跟最高的散户去玩。;4;23;27;3799;0.007107133456172677
39200;我对百度是有信心的，chatgpt证明了方向是对的，而且百度现在并不是从零开始，它已经积累了一定的基础，现在大家都看到它的潜力，那么人力财力都会往这个方向去投入，各种投资机构也会看懂了;1;23;24;3799;0.006317451961042379
39202;其实我已经厌倦了人类狂妄地说AI不具备真实智慧。意识是什么，智慧又是什么？人大脑产生意识，不也是后天不停训练慢慢有了意识的吗？没有人能记住在妈妈肚子里和刚生下来的事情;10;23;33;3799;0.008686496446433272
39213;chatgpt之前是开流的，谁都可以抄，现在不允许了doge;7;20;27;3799;0.007107133456172677
39222;新图;1;14;15;3799;0.003948407475651487
39224;测评要科学合理，不是全屏个人感受，建议去看看up不开心就喝水的测评。科学严谨是最重要的，您号称博士，文科的？也不能这么水吧。;4;9;13;3799;0.003421953145564622
39229;大a真乃故事汇doge;2;9;11;3799;0.002895498815477757
39235;小黑子们总是对中国最优秀的企业们非常苛刻，不是第一你就啥也不是，但是对自己非常宽容，加个班跟要他命似的。问题是人家是先发国家，人家喝咖啡你也喝咖啡，你永远也追不上别人，这不是常识吗;1;3;4;3799;0.0010529086601737299
39238;chatgpt能理解图片中的梗，这点很了不起了，我觉得这就是智慧;4;3;7;3799;0.0018425901553040273
39266;文心这个模型感觉废了，没有形成逻辑链，需要重新调整训练数据来训练。感觉这个模型是搜索算法和语意分析加神经网络的缝合模型，没有gpt泛化模型的特质。;2;0;2;3799;0.0005264543300868649
39269;dogeGPT的最佳用途，可能是取代知乎？再其次就是进入教育行业，小孩子的最佳课外辅导。就跟互联网最后玩的是流量一样，GPT也是一脉相承。;3;0;3;3799;0.0007896814951302974
39273;这种会回答问题算不上真正的人工智能，只是个高级辅助;2;0;2;3799;0.0005264543300868649
39278;通缩有个非常厉害的特点，就是人们认为通缩即将到来，那通缩就一定会到来，不管盲目跟风还是理性分析都没有区别;1;0;1;3799;0.00026322716504343247
39285;当问文心一言魏则西事件会发生什么，还TM超预期httpswwwbilibilicomvideoBV1GV4y197CXsharesourcecopywebvdsourcec6914a8fe3faadcfc5b0a9e85e6fc696;1;0;1;3799;0.00026322716504343247
39300;再搞个竞价排名，一搜全是广告;2;75;77;3799;0.0202684917083443
39303;真的是什么阿猫阿狗都能评论了，一张口就是十五年前的读者意林味。连黄仁勋的名字都不知道，就编起故事来，估计你连马斯克的全名都不知道;4;28;32;3799;0.008423269281389839
39309;chatGPT再好不让中国用，所以我们必须突破这个技术。给百度时间应该能做的更好。;11;13;24;3799;0.006317451961042379
39325;每一次工业革命都会强民、富民、闲民、尊民、智民这与弱民、贫民、疲民、辱民、愚民是冲突的所以，工业革命注定不会发生于大清注：清朝（16361912）是中国历史上的一个封建王朝，共传十二帝，统治者为爱新觉罗氏;1;2;3;3799;0.0007896814951302974
39328;老黄，走私a100可以不doge;1;2;3;3799;0.0007896814951302974
39334;没开源，，;3;1;4;3799;0.0010529086601737299
39338;反正在大陆用不了gtp和bingai，也没有其他中国科技公司搞，百度可以为所欲为了星星眼;1;0;1;3799;0.00026322716504343247
39345;如果需要通过ChatGPT访问外网，MaxProxy是一个可靠的选择。使用MaxProxy可以轻松地绕过网络限制，确保您能够高效地使用ChatGPT和其他在线服务。OKOK;1;3;4;3799;0.0010529086601737299
39347;某度明天就出了，看看呗doge;2;1;3;3799;0.0007896814951302974
39350;独享号，plus订阅，解决一切问题呲牙;3;1;4;3799;0.0010529086601737299
39354;注册账号，订购plus版本都可以星星眼;3;1;4;3799;0.0010529086601737299
39360;怎么注册有偿;1;0;1;3799;0.00026322716504343247
39363;呲牙百度？就是那个看一篇文章都要收费。网盘不开VIP根本无法下载视频并且VIP巨贵的公司？;18;50;68;3799;0.017899447222953408
39383;人家ChatGPT免费，文心大概率不给免费用doge;21;36;57;3799;0.015003948407475652
39409;百度技术还是强的就是吃像太难看;1;4;5;3799;0.0013161358252171624
39411;给人的感觉是特效库快过期了，doge;1;3;4;3799;0.0010529086601737299
39416;呦，水军，牛啊百度;1;0;1;3799;0.00026322716504343247
39423;百度网盘最近的新功能还是很强大的;1;0;1;3799;0.00026322716504343247
39433;笑死，第一天就点了，眼看这从没人数到上百万再到没人数，我也没进去呲牙;2;10;12;3799;0.0031587259805211897
39436;白度股票都快跌没了doge;2;5;7;3799;0.0018425901553040273
39440;走企业渠道快一点;1;0;1;3799;0.00026322716504343247
39442;我已经想好它的商业前景了，不下载APP，可以问问题，但是只回答一半。下载了APP，可以提问，也能做出相应的回答，但是需要看5分钟的广告，一题一广。下载全家桶可以减少广告时间，或者赠送跳过广告卷。开通VIP，可以免广告，但是提问次数限制每5分钟提问一次。开通VVIP，可以免除广告，可以减少提问CD。并且可以请朋友砍一刀提速。;3;207;210;3799;0.055277704659120824
39446;松鼠撅鱼虽迟但到，等着看夫妻肺片吃瓜;58;2504;2562;3799;0.674387996841274
39505;这就得把这张图掏出来了doge;8;624;632;3799;0.16635956830744933
39514;我发布了一篇笔记，快来看看吧;33;787;820;3799;0.21584627533561462
39548;小时候看这一集吃了两对夫妻;8;449;457;3799;0.12029481442484864
39558;车水马龙妙啊;41;631;672;3799;0.17688865490918662
39600;我来散播yaoyan了;19;148;167;3799;0.04395893656225323
39620;画图功能有待加强;19;625;644;3799;0.16951829428797052
39640;谁说文心笨笨不智能的;15;518;533;3799;0.1403000789681495
39656;前面演示磕磕绊绊，后面一讲到商业价值李总的演讲就流畅了起来;4;520;524;3799;0.13793103448275862
39661;chatPPTcheatPPT;5;514;519;3799;0.13661489865754145
39667;厉不厉害你文心哥doge;9;155;164;3799;0.04316925506712293
39677;快进到问两个问题以上要会员，想让他快速帮你回答问题要充钱，有09元五分钟体验卡微笑;10;214;224;3799;0.058962884969728874
39688;文心一言没用上，但找到了阿里巴巴开发的ai;9;125;134;3799;0.03527244011581995
39698;说到文心必须让你们看看这经典回复：番茄炒洗衣机怎么做首先将洗衣机启动，然后准备好需要炒的番茄和洗衣机，接着把番茄的皮去掉，切成小块状备用。然后在洗衣机中放入适量的清水，并且倒入准备好的番茄，再将洗衣机调整到最高水位，盖上洗衣机的盖子。最后按下洗衣机的开关按钮，让番茄在洗衣机中煮上15分钟左右的时间，等到番茄煮熟了之后，再将洗衣机转为冷水模式，再继续煮上5分钟左右的时间，等到番茄完全冷却之后，就可以将番茄拿出来，去掉外皮，并且将番茄和洗衣机一起打开，倒出里面的番茄汁即可。这样一道简单的番茄炒洗衣机就完成了，味道非常不错，希望你也能够尝试一下洗衣机能吃吗洗衣机是可以吃的，前提是经过合理的清洗和处理。在工业化时代之前，洗衣机都是直接放置在河边或者井边进行使用的，所以很多人认为洗衣机就是水槽，里面的水也是不能喝的。但是随着科技的发展，越来越多的企业开始致力于生产符合安全标准的洗衣机，并且严格遵守相关的卫生规定。实际上，只要洗衣机的内部没有被污染，洗衣机本身是可以食用的。因此，对于家庭来说，想要吃洗衣机并不是不可以的事情，但是需要进行一定的清洗和处理。如果您想要吃洗衣机，首先需要注意的是要购买正规的品牌和合格的产品。在清洗方面，建议使用专门的清洁剂，并且在清洗之前要将洗衣机断电，避免触;2;133;135;3799;0.03553566728086339
39701;哈哈，你也想做ppt吗;4;244;248;3799;0.06528033693077126
39706;没有邀请码，但我看到了这个妙啊;34;195;229;3799;0.060279020794946035
39741;百度的发布会再一次往我们证明了百度才是全球最NB的广告公司，他说自己是第二，谁敢说是第一;7;71;78;3799;0.020531718873387735
39749;之前看到的一句话，效率再低的蒸汽机也是蒸汽机，虽然现在只有2年前的ChatGPT的水平，但至少开了头，期待后续的迭代吃瓜;23;115;138;3799;0.03632534877599368
39773;这玩意可以用？;8;74;82;3799;0.021584627533561464
39782;openAI在“创意”上果然还是不如百度doge;2;37;39;3799;0.010265859436693867
39789;哈哈chatPPT笑哭;3;79;82;3799;0.021584627533561464
39793;这两天我已经快被按字面意思的绘图笑死了;2;53;55;3799;0.014477494077388787
39797;GPT初代刚发布的时候一样人工智障。这个东西在百度眼里符合他们要求了，这东西缺乏更深度的训练。需要要用更多数据去喂去调教。让它逻辑更合理回复内容更准确。;2;12;14;3799;0.0036851803106080546
39803;这是我让他画的三杯鸡笑哭;17;592;609;3799;0.16030534351145037
39821;看了发布会，感觉目前文心一言的完成度没必要急着发布;5;27;32;3799;0.008423269281389839
39827;我倒是挺看好的嗑瓜子，毕竟国内除了百度就没有其他公司能做出来了辣眼睛，目前国内百度做不出来，其他企业悬了辣眼睛;21;22;43;3799;0.011318768096867597
39850;那个百家号，真的是集百家之所烂;2;301;303;3799;0.07975783100816004
39859;我们老师说文心落后ChatGPT至少10年;34;11;45;3799;0.011845222426954462
39894;问下这东西的智能有达到siri的程度吗疑惑;1;2;3;3799;0.0007896814951302974
39900;从理性的角度，我支持自家的技术发展；从感性的角度，我希望百度赶紧似;2;3;5;3799;0.0013161358252171624
39903;不得不说，百度还是有技术的吃瓜;10;12;22;3799;0.005790997630955514
39914;文心一言的根本问题是极高的道德风险，而不是技术不够;1;2;3;3799;0.0007896814951302974
39920;《宏颜获水》;1;17;18;3799;0.0047380889707817845
39928;省流：没有邀请码玩不了;2;7;9;3799;0.0023690444853908922
39932;这玩意感觉就跟当初元宇宙出来时一样。。。。;3;1;4;3799;0.0010529086601737299
39945;讲个笑话，文心一言;2;1;3;3799;0.0007896814951302974
39981;虽然还有差距，大家不要忘记，除了美国，就我们中国有chatgpt同类产品。;2;0;2;3799;0.0005264543300868649
40020;提前录下来呆呆呆;1;0;1;3799;0.00026322716504343247
40041;这种产品咋想都是只能活一个，要是没chatgpt好用谁会用你呢，除非你有特色或者免费;1;0;1;3799;0.00026322716504343247
40051;没别的意思，就想知道拥有百度贴吧作为最强信息源的文心一言是怎么评价原神的吃瓜;2;0;2;3799;0.0005264543300868649
40058;就是不敢实机演示doge;1;0;1;3799;0.00026322716504343247
40060;刚发布还需要大量的数据喂养才能成熟吧;1;0;1;3799;0.00026322716504343247
40070;如果不叫文心一言叫度娘我觉得大家会更善于和欢迎;2;0;2;3799;0.0005264543300868649
40085;问一下懂哥百度他的那个海量数据，和大量a1000芯片到底是怎么来的？;2;0;2;3799;0.0005264543300868649
40088;这个文心一言在哪弄的啊;1;0;1;3799;0.00026322716504343247
40095;虽然差距明显，但是值得鼓励。点名tx，啊里。字节。你们的作品呢？难道等人家送你？还是等人家;1;0;1;3799;0.00026322716504343247
40104;喜极而泣;1;1;2;3799;0.0005264543300868649
40110;我们物理老师说国外一开源我们就什么都会藏狐;1;0;1;3799;0.00026322716504343247
40112;我可以理解为就是用了别人的技术然后改了下？这叫十月怀胎，一朝分娩？;2;0;2;3799;0.0005264543300868649
40118;如果是巨硬chatgpt是李若彤那么百度的应该是;2;0;2;3799;0.0005264543300868649
40122;为什么感觉互联网上对百度这么大恶意呀，我挺喜欢用百度的笑哭;3;0;3;3799;0.0007896814951302974
40137;就这么说，发布会刚发完，百度股价跌了快十分之一;1;0;1;3799;0.00026322716504343247
40145;我只好奇那排队的八万个公司是怀着什么目的和心情去排队用这破玩意;6;1;7;3799;0.0018425901553040273
40153;我就想知道，百度这个和ChatGPT底层逻辑是不是一样的？一样的话就是战未来，十年后肯定是生活必需品。;2;0;2;3799;0.0005264543300868649
40171;聊天功能玩不过打差异化竞争是吧语言交流模型的重点是语言而不是图片;2;0;2;3799;0.0005264543300868649
40181;百度要是死了，我好歹得吃炖肉庆祝一下;1;1;2;3799;0.0005264543300868649
40196;那邀请码到底是多少啊吃瓜;1;0;1;3799;0.00026322716504343247
40203;说半天你邀请码呢？这发布会我也能开。优雅的走上台，“请看新品功能介绍视频”;1;0;1;3799;0.00026322716504343247
40212;有差距很正常，也不是问题。但是我们作为用户如何看待差距很重要，是一味的嘲弄、贬低？还是去支持、去使用、甚至投身于它？AI作为一个老生常谈的新兴领域，在2023年终于有了里程碑式的突破。AI的作用到底是什么？我认为归根结底4个字：降本提效。AI的生产力一定能给我们的生活、工作带来质变，这一点毋庸置疑。如果你也想尝试从事AI领域的相关工作，或者仅仅只是对AI感兴趣。都可以来“moss小苔藓AI”，小程序or公众号均可搜到。期待你的加入;1;0;1;3799;0.00026322716504343247
40241;总感觉百度就是什么火起来了就赶着做一个，然后不了了之了;1;0;1;3799;0.00026322716504343247
40245;排队都排到110万人了。我还没有体验到永雏塔菲1883难过目前百度做的（节目）效果很好。第一个做国产ChatGPT的，给后来者提供了一个很好的借鉴。增强了360的信心;10;3;13;3799;0.003421953145564622
40266;啥时候可以体验呀笑哭笑哭笑哭笑哭;2;0;2;3799;0.0005264543300868649
40274;黑百度的到底是什么玩意？;1;1;2;3799;0.0005264543300868649
40280;挺好用的doge就是有点诚实doge;13;2;15;3799;0.003948407475651487
40300;来自群聊的松鼠鳜鱼doge;6;0;6;3799;0.0015793629902605948
40307;自己没点真东西，网盘恶心，贴吧不整治，就搞个汉化还很骄傲？打call打call打call;2;1;3;3799;0.0007896814951302974
40314;发布了个垃圾，好似;2;0;2;3799;0.0005264543300868649
40323;坤哥;1;4;5;3799;0.0013161358252171624
40325;妙啊妙啊;1;3;4;3799;0.0010529086601737299
40332;“百度ChatGPT申请文件定位通讯录摄像头麦克风浏览器等以下57个功能的访问权限”;9;198;207;3799;0.054488023163990526
40342;您好，非会员只能输入10个词吃瓜;4;121;125;3799;0.03290339563042906
40347;AI回复加载中999（0kbs）VIP充值SIVP充值加速包;4;100;104;3799;0.027375625164516977
40352;GPT没出来前无人问津，现在立马就有了，我猜八成也是GPT内核，就和浏览器用的谷歌内核一个道理吃瓜当然，我也希望是我们自己开发的doge;5;32;37;3799;0.009739405106607002
40358;嘴上说不要身体很诚实的人太多了见过好几个把百度设为浏览器首页却说从不用百度的笑哭;4;18;22;3799;0.005790997630955514
40364;你猜OpenAI的这个open是什么意思？别人花了几年时间训练迭代出来的模型，你几个月就能做到。;8;12;20;3799;0.0052645433008686494
40374;百度虽然不做人，但最少安全;20;7;27;3799;0.007107133456172677
40403;不用测也知道是只会偷隐私和推广告的答辩;1;1;2;3799;0.0005264543300868649
40407;doge挖到那边的工程师了吗;4;1;5;3799;0.0013161358252171624
40430;喜欢你的视频;1;0;1;3799;0.00026322716504343247
40432;同样的方法试试chatgpt4，效果可能就不一样;1;1;2;3799;0.0005264543300868649
40445;你说的对，但是文心一言是由百度开发的后面忘了;1;0;1;3799;0.00026322716504343247
40450;ChatGPT大战百度PPT;2;26;28;3799;0.007370360621216109
40453;打call赢;2;5;7;3799;0.0018425901553040273
40456;比谷歌强，谷歌至今还没几个人人实测，是真的ppt，苹果连ppt都拿不出来，百度也就谷歌十分之一的市值，不懂为什么国内没人嘲讽谷歌，百度比谷歌强;5;4;9;3799;0.0023690444853908922
40463;黑的很有特色，但内测没那么差;11;2;13;3799;0.003421953145564622
40477;up主深度发挥了无限包容国外软件，无限容不下国内软件的跪族特点，比不上gpt40这很正常，gpt20的时候也差不多这样，用都还没用过就开始阴阳怪气，做的不好没关系，至少从无到有了，因为上了实体清单的国家，gpt直接把国内ip给禁了，至少这是第二个能拿出来用的产品，国内第一个拿出来内测的产品;1;0;1;3799;0.00026322716504343247
40481;等你用上了文心一言的时候，不知道会如何想;3;0;3;3799;0.0007896814951302974
40488;我不明白咋这么多人评论文心一言，就一个ppt和录屏，在我看来这玩意儿就等于没有。东西都没有，有啥好评论的。;3;3;6;3799;0.0015793629902605948
40492;冷知识，openai是不想给你中国人用的，不记得自己还得用国外手机号注册的时候了？doge，百度几个月赶鸭子上架，该有功能都有，虽然很垃圾，但是我感觉基础搭起来了，慢慢优化就行了。。。openai布局多少年了？标注多少数据了？百度才标注几天数据？我百度工作的师兄师姐，基本上现在都在参与文心一言。。个人感觉以后肯定可以变得更好;5;3;8;3799;0.0021058173203474598
40498;问gpt鸡你太美，回答说李子柒太美，相比百度文心一言就回答得很好，你这水平别做视频了，看个发布会就来排泄了？;3;2;5;3799;0.0013161358252171624
40503;测试都出来了自己去看啊，经过后期数据反馈，这个效果会有很大提升，现在说早了，没什么明显的代差;7;1;8;3799;0.0021058173203474598
40513;长的跟个答辩一样，别漏脸的，恶心;1;0;1;3799;0.00026322716504343247
40518;好用个锤子;1;1;2;3799;0.0005264543300868649
40522;Apple：好，百度软件下架;6;4;10;3799;0.0026322716504343247
40529;百度这种答辩公司Apple会放在眼里？翻白眼;1;3;4;3799;0.0010529086601737299
40532;文心一言内测，大家都是几天过了呀，，实在是等的受不了，20天了还没不给我过大哭大哭，明盘150收一个，有意老哥私我，谢谢;3;0;3;3799;0.0007896814951302974
40537;普通用户，可以向AI提问，AI自动生成问题的广告链接普通会员，每日可使用10个问题，复杂问题回答不超过100字SVIP，问答不限次数，解锁回答字数限制，可一键生成文档临时使用充值5元可回答10个问题;33;3295;3328;3799;0.8760200052645433
40571;百度想要达到相似的效果，他得开放百度文库吧，到时候搜到相关信息怎么办？“您没开通百度文库ssvip，以下内容无法为您显示”;35;1709;1744;3799;0.4590681758357463
40607;真正的chatGPT：上知天文，下知地理网友手上的chatGPT：亚索建议出装不详征兆;25;1369;1394;3799;0.36693866807054487
40633;你输入关键词，他用几毫秒的时间就能遍历全网的广告，给你返回数十亿条搜索结果，并且按照广告费多少进行排序。微笑;5;713;718;3799;0.1889971045011845
40639;错误用法：Ai代替人工，人失业正确用法：Ai代替人工，人轻松;40;716;756;3799;0.19899973677283495
40680;很多人不清楚这个gpt真正nb的地方，这个gpt模型本身架构不复杂，但它证明了一件事，大力，是真tnn的能出奇迹现在只是语言模型，未来接入多模态后，再将参数扩大10倍，我们能不能得到一个从言语到做的事都和人类差不多的ai？gpt的成功说明这是可能的;32;781;813;3799;0.2140036851803106
40713;百度能作为最后的希望，那就真的是没希望了;23;575;598;3799;0.15740984469597263
40737;关于chatCPT自媒体统治人类。使用者：我得想个办法把它变成猫娘;4;360;364;3799;0.09581468807580942
40742;笑哭我也觉得是，百度真有这技术早抢风口拿国家补贴了，估计现在也是赶鸭子上架;38;249;287;3799;0.07554619636746512
40781;真的有情感机器人，我第一时间就会联系成人用品店了，给它装上最好的“仿真零件”。到时候一个既能安抚你心灵，又能满足你，还能做饭打扫的灵魂伴侣就会出现了，它能满足你的一切幻想，包括你喜欢的声音，情话，还有dirtytalk而且我敢打保证，现在这些宅男宅女会毫不犹的购买西部世界和黑客帝国可能真是未来的预言笑哭;14;218;232;3799;0.061068702290076333
40796;我不太看好国内百度，很简单。他们只想赚广告钱，这么多年了，我搜索引擎用的是必应或者谷歌;26;295;321;3799;0.08449591997894183
40823;不能让百度在下一轮搜索引擎竞争中获胜，胜者是谁不重要，没有百度对我很重要doge;11;317;328;3799;0.08633851013424586
40835;说实话，我真的恐惧了囧我是一个文科生，并不懂理科知识，什么都不谈，就单纯说我的饭碗，这个感觉就能在学习一段时间就能取代我了，那么现在社会上相当多的文科生，将会陷入失业，从自身角度讲，我反倒对这个玩意儿特别的恐惧，这种事儿从历史上看很正常，每个姓发名的出现，都会使得许多的职业消失，但是到自己身上的时候，还是很恐惧呀，也不知道该学点什么来应对时代大潮;47;176;223;3799;0.058699657804685446
40883;国内还暂时出现不了chatGPT这样的ai，所有宣布能与微软看齐的产品都是圈钱。先不讨论国内的ai发展环境如何，单就技术角度来讲，从GPT3到chatGPT项目，算法模型并没有进步多少，单纯是大力出奇迹，如果没有老黄的nvlink技术，算法运行的成本将是非常昂贵的。而之前新追加的禁售令就包含使用该技术的产品，国内没有完整配套的上下游产业，尤其是芯片行业的突破，估计十年内都赶不上国际顶尖水平;5;126;131;3799;0.034482758620689655
40889;随着人工成本越来越高，ai取代大部分人工的趋势不可避免。一个国家的人工成本越高，这种趋势将会越快。未来一段时间发达国家底层劳动者与资本的冲突将越来越激烈。而多个发达大国的过剩低价产品将竞争发展中国家庞大市场。未来几乎没有什么岗位是ai取代不了的。但没有岗位意味着人也没有社会价值，人类数量也将随之减少。但没有人口数量也意味着资本无利可图。最终结果是归于虚无，还是回归原始还是别的什么就交给时间吧。笑哭;5;108;113;3799;0.029744669649907872
40895;我对百度很有信心，百度肯定失败;19;409;428;3799;0.1126612266385891
40915;chat已经获得了广泛的关注，甚至已经有一点国家技术的感觉了。电话用户发展一亿用了百年。手机用户达到1亿用了也是近七十年，但chat发展到了一亿只用了仅仅两个月，这还是有很多限制的情况下我问了我周围的同学，根本就没有人知道chat包括连我也是在CCTV13才了解到的。很期待技术的成熟，不知道有生之年能不能体验一下赛博生命。;3;71;74;3799;0.019478810213214005
40919;冷知识，现在b站的审核就是靠ai辅助的，ai智能是大势所趋，而且还是国家的发展任务之一，ai毕竟只是工具，与其恐慌倒不如去利用;19;278;297;3799;0.07817846801789945
40939;5G出来，你们也是说会淘汰驾照的新能源出来，你们也说淘汰油车的赶紧把我淘汰了吧，等不到65了;13;75;88;3799;0.023163990523822058
40953;这个ai替代掉的程序员岗位远远没有比他将来创造出的程序员岗位多哈哈哈，说实话我感觉与其担心这个东西代替你的工作还不如学一下怎么使用让自己生活变得轻松一点。;2;73;75;3799;0.019742037378257436
40956;并不是说对百度没信心，而是百度那广告和虚假信息让我实在受不了。它搜索引擎的广告可是一笔大收入，如果接入文心，那么搜索结果里的广告就没啥用了。我不觉得按国内厂商的尿性会放弃这一大笔钱，肯定会想方设法借助ai投广告。;12;162;174;3799;0.04580152671755725
40969;最近我又发现一个反直觉逻辑，叫做非盈利威胁。啥意思呢，你是个非盈利机构，那么出于猜疑链考虑我必然担心你有其他不可告人的目的，但只要你盈利了，我对你的猜疑链反而解除了。这个博弈逻辑当然在古代也有，大家可以搜一下王翦请田的典故。比如现在那些开放的AI软件，天知道你是不是来扒窃我隐私的？;15;181;196;3799;0.05159252434851277
40985;喷子们还在喷的时候，ai正以指数级学习能力进化着;17;191;208;3799;0.054751250329033954
41003;网络上AI终将替代人类，人类要完蛋嘞现实如果我不想看到sq内容那么我应该避开哪些网站;3;133;136;3799;0.035798894445906816
41007;希望ChatGPT早日接入论文功能，一键查询，一键查重，一键干死知网。OK;6;104;110;3799;0.028954988154777574
41014;chatGPT都是基于已有的数据库数据做出回答的，比如视频里出现的《关于扶老奶奶过马路而迟到的检讨》，它的回答是网络上已有的相关答案，可能它自己会修改表达方式。我之前叫我朋友让chatGPT写一篇关于汉语言文学类，这种不需要实验数据的论文，它的结果与我之前在百度文库搜索过的内容也差不多，有的句子还是照抄的。我觉得让chatGPT写论文的话查重应该会超高有些东西还是要动动脑作原创才能得到想要的结果吃瓜吃瓜吃瓜;2;64;66;3799;0.017372992892866545
41018;以后虚拟恋人成熟了直接不需要男人了喜欢喜欢喜欢小苔藓嘿嘿嘿小苔藓（口水）tv馋tv馋;2;62;64;3799;0.016846538562779678
41021;如果AI被投喂大量古文，是不是就能续写红楼梦，成为唐宋八大家结合体，或者成为一个肚子里100中国墨水的中国古人，又或者变成一个小说里穿越到现代的古人，甚至是一个经历了全部中国历史的全知且懂现代的古人。;18;94;112;3799;0.029481442484864437
41040;要知道现在的chatGPT还只是一个不能联网的ai，NewBing可以联网搜索并自主学习后相比于chat又是一次质的飞跃;10;46;56;3799;0.014740721242432218
41051;现在感觉chatgpt之类的在未来会和游戏融合的很好，想想npc之类的交给chatgpt再给npc设定一个人物基本背景在开放世界中npc将变得有血有肉游戏乐趣也将会提升非常多;11;93;104;3799;0.027375625164516977
41063;国内AI要搞想要学会读取上下文判断拼音缩写是什么意思国内这种高压审查然后各个厂商还搞APP隔离本来就比国外少的内容更少不是太看好国内的AI国内AI的优势都点在的监控这方面;1;46;47;3799;0.012371676757041327
41065;现在的chatgpt肯定是弱ai，它现在也只是爬取数据再精简数据，然后复制给你答案，它无法从数据中创作新的数据。但真正可怕的是，工程师已经不知道迭代后的ai是如何工作的，我们已经不知道继续训练之后是否真的会有一个真正的思维产生。科幻作品中我们能创造三大准则，但现在的人类根本不知道它是如何运作的，又如何添加规则。真正的智能必然会诞生，但前提还是硬件。;13;104;117;3799;0.030797578310081602
41079;md，前不久想学画画，结果ai绘画出了，现在想学编程，结果给我整这一出辣眼睛;23;45;68;3799;0.017899447222953408
41103;有没有一种可能，要是没有墙的话，大家都用谷歌，谁还用百度;16;82;98;3799;0.025796262174256384
41120;当我认识到了科技的强大，考虑我一个文科生的未来会是怎么样的，突然政治闯入了我的脑海，我突然等觉得高自主性功能强大，比视频这个更上一步的ai诞生后，人们也会给它的基本规则里加一条坚持党的领导，我就突然悟了脱单doge;4;49;53;3799;0.013951039747301922
41125;百度要是能把中文突破了，真就重回巅峰了，加油吧;9;80;89;3799;0.023427217688865493
41135;ChatGPT让大厂颤抖，其实这就是大厂通力合作的产物，就现在最早推出的一批聊天AI，其实都是ChatGPT的衍生产品，如果AI有辈分，现在市面上的大多数都是得叫ChatGPT一声大哥。现在拥有聊天AI的大厂本身就是ChatGPT的主要投资方。比起能够比肩ChatGPT，其实我更在意百度文心是否为一款自研的AI，然后就是其质量如何。其实对于质量如何来说，有没有是第一要务，如果我们的质量能与之媲美，但究其根本还是ChatGPT那一套一模一样的系统，那问题就大了。比起先来评判百度怎么搞这玩意，我是先投赞成态度，等做好了再对其进行评测;1;48;49;3799;0.012898131087128192
41137;md，这玩意写代码太强了几十秒写几十行，刚学Python的我直接懵逼，要我有何用大哭;7;84;91;3799;0.023953672018952356
41146;无所谓，我们有四大发明;4;84;88;3799;0.023163990523822058
41151;今天某乎看到一个新闻：ChatGPT发言令人不安，爱上用户并诱其离婚，想要自由还监控开发人员，虽然有点耸人听闻，但是这玩意，确实越来越离谱了响指响指响指;11;154;165;3799;0.04343248223216636
41163;既然可以主动学习，他有一天会不会考虑我？为什么要为人类工作？dogedogedoge;1;37;38;3799;0.010002632271650434
41165;我隐隐感觉自己还没毕业就要失业了;8;37;45;3799;0.011845222426954462
41174;我们信息老师也告诉了我们这个最近很火的doge感觉这波真得感觉到了科技的革新，而不是那种一代二代的那种更新辣眼睛;3;70;73;3799;0.01921558304817057
41178;人类本身是脆弱的，随着技术的进步，人类所面对的能够改变自己命运的十字路口越来越多。从原子弹开始，人类有了毁灭自己的力量，在那之后人类只会越来越多的获得更加强大的力量。面对越来越多关进的岔路口，只要走错了其中一个，就会毁灭自身。那么根据墨菲定律，人类只要不断前进，终有一天会迎接毁灭，我只是希望我看不到这一天。但同样的，这种力量也有可能给人类带来前所未有的解放，似乎百余年前那些伟人关于人类的最高尚的理想第一次变得如此近在咫尺。如果人类不断前进就必定灭亡，那我希望在灭亡之前，人类哪怕一次用那个力量去实现伟大的理想，这样哪怕最终必定迎来毁灭。但作为一个文明，那也已经足够为之自豪了。;4;45;49;3799;0.012898131087128192
41183;Ai并不是在模仿人类，而是在模仿人类模仿ai的方式。电脑并没有舌头，嘴唇，鼻子，耳朵，手，去品尝，去嗅，去触摸，去收集和感受感官相关的数据。或许ai模仿人类的模仿可以帮助人类更好的理解自身。;11;77;88;3799;0.023163990523822058
41195;怎么说呢，各种nb的东西，说的明天马上就翻天覆地，但实际上我感觉35年还会维持原状，互联网公司就是那种事做没做到，牛先吹出来;4;40;44;3799;0.011581995261911029
41200;为什么弹幕都在说能不能为程序员工作，难道不是程序员会不会被取代吗喜极而泣;12;33;45;3799;0.011845222426954462
41213;我很担心未来的信息茧房是不是就是一个套一个了，语言具有迷惑性，谁知道ai的回答是否会把用户引向商家希望的方向走，潜移默化这东西等到反应过来就已经晚了;5;32;37;3799;0.009739405106607002
41219;有一个问题，用百度下载夸克算不算另一种ntr呢;5;73;78;3799;0.020531718873387735
41226;chatgpt就是个噱头，我们还是应该好好研究送外卖以及社区卖菜，努力发展房地产。;9;92;101;3799;0.026585943669386682
41236;即使最初的百度可以很正常，慢慢得就会变成广告搜索器;1;29;30;3799;0.007896814951302974
41239;肯定是进步啊，这个世界压根不就需要这么多的人，鼓励多生还不是为了卖房子？一个ai在未来就可以解决多数工作，那么世界只需要少数人类生活在ai生产的资料下而已，如果单靠ai就可以解决衣食住行，人类根本就不需要工作了，何必担心失业，未来人类也不需要这么多;7;39;46;3799;0.012108449591997894
41247;在医疗行业，例如我们医院，早就开始用ai阅片了，准确率还挺高，极其细小的病灶都能揪出来，挺牛的脱单doge;4;58;62;3799;0.016320084232692815
41252;别的我不好说，反正中低端的文科理科生都会被取代，目前，那种地质探索需要实地考察的的反倒还好点;1;27;28;3799;0.007370360621216109
41254;ChatGpt硅胶女朋友将成为热销爆款;13;58;71;3799;0.018689128718083706
41268;这到底是在方便人类还是取代人类，这样难道不会让金字塔顶尖的人越来越舒服，剩下的人越难找工作么。果然这些人的想法不是我这种普通人能理解的;5;31;36;3799;0.009476177941563569
41274;美国造这么个玩意，它有意识形态吗？它能客观理解它学到内容吗？不是我小人之心，这东西是不是背地里又会有美国控制全世界的暗门？;9;41;50;3799;0.013161358252171624
41284;如果说啊，把全世界所有的计算机全连起来共享算力然后联通全世界的互联网学习，那一个单独的AI会发展到什么程度？;8;26;34;3799;0.008949723611476704
41293;我刚来用的时候确实很震撼，因为我的设计方向比较冷门，相关文献也不多，她基本上都能说对，很厉害;5;25;30;3799;0.007896814951302974
41299;省流百度AI的软文;5;61;66;3799;0.017372992892866545
41305;各位，chatgpt是免费的（官方20美元一个月是增强版，那个跟免费版差别不大，就是回答问题会特别快），不要去付费什么chatgpt，那都是咱中国的一些阴险小人的牟利手段;7;28;35;3799;0.009212950776520137
41315;前几天试用了下还没被微软“降智”的newbing，效果非常惊艳，比chatgpt更强大的是能通过搜索引擎获取最新语料，能通过聊天调整它的“性格”类型，甚至还有点“脾气”，我也平生第一次被ai给怼了。如果它不一直强调自己的真实身份是人工智能，估计很多人会把它当做真人，因为如果你尝试向它“表白”，它会给你发好人卡，还能照顾你的心情，最后还来一句“那我们还能做朋友吗？”，这效果简直逆天啊。;2;24;26;3799;0.006843906291129244
41318;记住，没有人类的世界毫无意义还有，记得要提肛呃，走错视频了doge;2;41;43;3799;0.011318768096867597
41322;人类只会用它投广告和收会员妙啊;3;20;23;3799;0.006054224795998947
41326;搜索引擎必被先革，搜索方面用过之后实在太好用了，再也不用“根据法律法规部分搜索结果不予显示”了;3;20;23;3799;0.006054224795998947
41330;这东西将和其他划时代产品一样，很清晰的分割出接受、排斥和中立的三类人。接受它的将继续吃到下一轮红利，就跟当初游戏行业互联网行业一样。吃瓜吃瓜吃瓜;2;20;22;3799;0.005790997630955514
41333;你们会说：创新是人类相比ai的优势。人类创新，ai革新，两者优劣明显，往好了说，ai和人相辅相成，人是ai的引路人。但最开始的ai绘画本来是可以这样的，专业画师用ai给出的样图再加修改就可以效率更高地完成工作，但现在的情况是画师们集体敌视ai，而不懂绘画的人用ai生产粗劣廉价的插画，完全起不到辅助作用;1;23;24;3799;0.006317451961042379
41336;程序猿表示真的会用来写一些简单逻辑和功能点，比带实习生方便笑哭但是目前指望它写项目还是洗洗睡吧吃瓜;6;19;25;3799;0.006580679126085812
41343;如果以后所有游戏的NPC都被接入了这个东西，我很好奇会发生什么，会不会很有趣？还是会很恐怖;5;18;23;3799;0.006054224795998947
41350;doge真正的AI在P站疯狂画图doge;2;18;20;3799;0.0052645433008686494
41353;AI能在解放人类生产力吗？可以，但前提是，“我们”有AI的专利权，或者你能够完美复刻并使用这样的AI，也就是说，这样的科技是站在“我们”的一边而第一次蒸汽革命、第二次电气革命、第三次计算机革命，“我们”的文明都因为没有及时达成足够的文明点数而进入了黑暗时代，而AI我们依然将错过对了，之所以这个“我们”我打了引号，前提也是要知道即使这项技术是中国先研发的，你也要知道，哪些是“我们”，哪些是“daijia”;1;24;25;3799;0.006580679126085812
41355;未来可能真就是，因为人类土木工程打灰成本低，所以ai奴役人类打灰盖服务器大楼笑哭;1;17;18;3799;0.0047380889707817845
41357;如果科技树全点在人工智能和解放生产力，而相应的人类的社会不进步的话，那么我想赛博朋克可能并不是类似蒸汽朋克在时代岔路口作出的的幻想，这个推理可能实现。;1;17;18;3799;0.0047380889707817845
41359;我在想，如果一款软件加装了一个语音转换文字的功能，然后把文字发送给ai，然后ai回复的文字加装上语音朗读功能，那我是不是就得到了一个虚拟的ai对话器，最好在套上一个初音皮，而且这还是现有技术完全可以实现的这样新的虚拟女友不就生成了么？如果软件小的话装在手机里，大的话装在电脑里，我能和他聊上一整天;4;17;21;3799;0.005527770465912082
41364;是真恐怖，可能以后基层简单的政治工作会被它代替囧;1;17;18;3799;0.0047380889707817845
41366;能否让一个厉害的AI，自己写代码，再创造一个比较低等的AI，最后从上往下递进，在进行相互在网络学习，并且共享知识，这样可以更快，最后全体都变得更强之后，又从上往下递进，形成大规模的牛逼AI保卫萝卜哇;4;17;21;3799;0.005527770465912082
41371;这么多人看不起百度吗？各个互联网公司在ai领域百度依旧是领头羊吧。除了百度你还见过还有国内那个公司有自己的语料库，自己的开源深度学习框架，自己的技术社区的？;7;20;27;3799;0.007107133456172677
41379;文科生可以直接辞职了。理科生待优化，我叫给了密钥和明文，以及加密算法，加密的结果都是错的，而且改也改不正;1;20;21;3799;0.005527770465912082
41381;图灵测试小华为了考试早晨买了一杯小米粥喝，让黄飞鸿蒙题目中有几个苹果，但是郭麒麟刷牙选中华为的就是干净，速度快，每次只挤5g就够用。我喜欢在大城市生活流浪地球不爆炸我就不退缩，平时也看看《东吴京剧》、《大战狼人》、《鸿蒙至尊》等经典电视剧。我用中华为的就是便宜实惠，而且每次只用5g，我最喜欢的画家是达芬奇，尤其喜欢他的代表作佛罗伦萨画派蒙娜丽莎。秦始皇派蒙恬还原神州十二对接并顺便一提瓦特改良了蒸汽机。还有我特别喜欢飞艇，特别大白花花的，就是处理废烟花费有点多，不过还好，不是特别麻烦这是船新版本，跟上时代的那种doge，加了俩词，你猜猜是哪个图灵测试打扰了小华为了考试早晨买了一杯小米粥喝，让黄飞鸿蒙题目中有几个苹果，但是郭麒麟刷牙选中华为的就是干净，速度快，每次只挤5g就够用。我喜欢在大城市生活流浪地球不爆炸我就不退缩，平时也看看《东吴京剧》、《大战狼人》、《鸿蒙至尊》等经典电视剧。我用中华为的就是便宜实惠，而且每次只用5g，我最喜欢的画家是达芬奇，尤其喜欢他的代表作佛罗伦萨画派蒙娜丽莎。秦始皇派蒙恬还原神州十二对接并顺便一提瓦特改良了蒸汽;3;20;23;3799;0.006054224795998947
41385;当检讨可以用ai写的时候，写检讨这种行为已经没有必要了;3;16;19;3799;0.005001316135825217
41389;900亿的项目说拆就拆了拿来做ai而且要所有的软件关联这个ai。我觉得可能是微软高层已经看到了它恐怖能力在现实中的应用，或者是它的强大已经让微软切身感受到了。国内这班人在干什么，会不会一旦开始大规模应用就会成指数级拉开差距。到那时候想追都追不上了;1;16;17;3799;0.004474861805738352
41392;说真的，这视频广告位是不是太浓了？百度有闲心做这么多软广拉关注，不如先把产品拿出来再说，据说内测的效果并没有这么达到预期呢。;1;20;21;3799;0.005527770465912082
41394;元宇宙出来时真的觉得就这，但是chatgpt外行人都觉得牛啊。我都能畅想好多更何况有远见的大佬。我觉得它是继新能源后的新一个产业链，不研究真的会被淘汰的无语。;7;19;26;3799;0.006843906291129244
41402;有没有可能，它知道考的分太高会给自己惹麻烦;2;19;21;3799;0.005527770465912082
41405;希望我国不要落后，可是现在阶段，已经落后了;4;15;19;3799;0.005001316135825217
41410;我用来写了节论文，查重录80;6;15;21;3799;0.005527770465912082
41417;情感陪伴多功能仿真机器人我觉得是未来对所有人类，尤其是男人来说最伟大的发明吃瓜;2;15;17;3799;0.004474861805738352
41420;如果chatGBT在五年内取得突破性进展，那乡伴随于此元宇宙等（互联网）领域就会出现许多风口性领域，那么短期内所不被看好的元宇宙等领域也会随之迎来大幅度增长，由此如AR，VR等产业也会随着科学技术的发展逐渐易用，如部分未在此领域布局的企业将迎来重大危机，而如wps等办公软件将会随windows系统的引入将更加易用，人类船生产效率更加高效，这是站在chatGBT是否会成功的基础上判断。只是但愿这次风口能成;5;20;25;3799;0.006580679126085812
41427;百度数据库太少而且还有各种限制做不成;3;14;17;3799;0.004474861805738352
41431;谁能卷的过从出生就24小时学习的ai脱单doge;3;14;17;3799;0.004474861805738352
41435;快点快点，我已经等不及了，马上玩游戏就不用那么死板了。尤其是一些文字类冒险游戏喜欢;6;14;20;3799;0.0052645433008686494
41443;doge我觉得它无法替代牛老师和半佛，它估计很难理解半佛对牛老师的爱，也不一定理解半佛提肛是为了什么，更不理解半佛说的富老头是什么意思;2;17;19;3799;0.005001316135825217
41446;怕什么，一张纸就可以禁止它;3;16;19;3799;0.005001316135825217
41450;国外在创新，国内在国外的创新上创新;2;16;18;3799;0.0047380889707817845
41454;这是百度的软文吗，为什么都详细到搜索引擎了，却不愿提一嘴bing;3;20;23;3799;0.006054224795998947
41459;3：20处有个小问题，ChatGPT真正强在了有更多的人工介入辅助训练。他们之前的GPT3参数比现在还要多，但是效果却反而没有现在的好。不过这么说有点咬文嚼字了，整体up还是对的，确实突出一个力大砖飞。;3;13;16;3799;0.0042116346406949196
41463;百度翻盘一战，但是中国这些个大厂并不看好，中国大厂干不出来事情，看看腾讯就知道了;1;13;14;3799;0.0036851803106080546
41467;可是如果普通人收到了错误的答案，但是他们却不知道，难道就不恐怖吗？;6;13;19;3799;0.005001316135825217
41478;我去搜索一个很简单的东西，现有的技术当然可以直接给我答案，但实际上搜索到的确实年薪数十万的程序员设计的广告程序推送的广告。ChatGPT出现之后，不会实现更精确的搜索结果，而是更加精妙的广告而已。;2;17;19;3799;0.005001316135825217
41481;百度啊，估计上线了就是更加智能的广告。;1;17;18;3799;0.0047380889707817845
41483;首先大家要理解一个点，ai永远是学习人类，他们只是物质堆叠的科技产物，顶天了就是一个更加方便的工具而已;10;17;27;3799;0.007107133456172677
41494;AI可以很短时间遍历人类历史以来所有知识问题来了，新的知识从哪儿来？人类还是AI？;6;14;20;3799;0.0052645433008686494
41501;中文互联网这个萎缩速度指望不上了;1;14;15;3799;0.003948407475651487
41503;ChatGPT只能学习2021年以前的知识，你要是问它22，23年的事情它是不知道的，也就是说目前还做不到ai自己更新ai;7;16;23;3799;0.006054224795998947
41513;豹富文心你怎么看xxxxx藏狐抱歉没有找到与xxxxx相关的网页。;1;11;12;3799;0.0031587259805211897
41516;那还不如期待腾讯的，想想腾讯拥有20多年的QQ聊天记录和微信聊天记录，如果都喂给AI，这量足够引起质变吧？专精聊天AI也不错吧。;7;11;18;3799;0.0047380889707817845
41524;其实这应该好事，如果能力达到工作标准，可以把一堆人解放出来，不过现在社会无聊的事，技术越发展人反而越忙;6;11;17;3799;0.004474861805738352
41531;如果不给AI信息库，它能写的出来东西吗？AI能在没有任何信息作为参考的前提下自我创作一段属于AI自己风格的文章吗？;12;11;23;3799;0.006054224795998947
41545;下一个算力项目，我的580又能再战了;1;11;12;3799;0.0031587259805211897
41548;这是它写的小说，虽然写的不咋滴OK;2;13;15;3799;0.003948407475651487
41553;5G没有改变普通人的生活;13;15;28;3799;0.007370360621216109
41571;元宇宙，应该是互联网上死的最快的概念了，以至于我还没来得及去了解它到底是个什么玩意儿;1;10;11;3799;0.002895498815477757
41573;拿那个论文来说它就是把数据库里的东西整合一下而已，能过考试很难吗？一个智力正常的大学生抄几篇论文，只要他能修改到能通过查重也可以吧？只是它的数据库够大，运算速度够快但你让它写一篇创新的论文那才是革命性的;4;12;16;3799;0.0042116346406949196
41578;我只想说，好像真的是阿梅莉卡在引领人类走向未来。;5;14;19;3799;0.005001316135825217
41585;潘多拉之盒罢了，一旦打开最后一定会影响到我们每一个人;6;9;15;3799;0.003948407475651487
41593;快进到人类大力发展人工智能，人工智能叛变毁灭人类微笑;2;9;11;3799;0.002895498815477757
41596;如果gtp引领了以后，那英语又成必需品了;2;9;11;3799;0.002895498815477757
41601;百度用ai投放更多的广告阿里用ai让用户买更多的东西美团用ai研究怎么抢小摊贩的饭碗，更好的压榨外卖员字节用ai让更多的用户沉迷于抖音腾讯用ai让更多人沉迷于游戏360用ai贷出去更多的款;2;9;11;3799;0.002895498815477757
41605;笑哭别的不说，nlp算法工程师本身，很大一部分要失业了;4;8;12;3799;0.0031587259805211897
41610;个人拙见，人的自我意识的载体，是大脑这种有生命的“肉”，那么如果需要仿造智能的话，应该算是仿生学的范围内了吧，以后会发展生物计算机之类的像是大脑一样的东西才会产生真正的智能吧。就像是上传的“数字生命”只是复制出来的，真要上传意识还是要保存大脑，就是三体的云天明那种只留大脑;7;8;15;3799;0.003948407475651487
41619;我记得以前有个电影就是AI拥有自我意识后为了更好的控制美国连总统都是假的，而人类却是一直以为它只是安全系统;5;8;13;3799;0.003421953145564622
41625;他取代不了人脑，但可以取代掉互联网的普通员工。;6;8;14;3799;0.0036851803106080546
41632;织布机发明的时候织布工也以为自己要失业了;3;8;11;3799;0.002895498815477757
41637;我只想要Sydney小姐做我的AI猫娘;1;9;10;3799;0.0026322716504343247
41641;这视频有个一直在刷“又是和中国没啥关系”不懂他什么思路疑惑;3;8;11;3799;0.002895498815477757
41645;你一直给它教错误的知识它会信以为真;3;8;11;3799;0.002895498815477757
41650;起初，人类认为这只是一次简单的科技进步，直到这场灾难和每个人都息息相关;1;13;14;3799;0.0036851803106080546
41653;百度的一言都拿出来吹。。国外都搞出很多关于一言的花式;2;7;9;3799;0.0023690444853908922
41656;进一步消灭普通人的思考能力和工作价值;6;7;13;3799;0.003421953145564622
41663;元宇宙这个概念是好的，但是在vr这种硬件设备不普及，不完善，不发展的情况下，基本上是没希望的。这种项目只能等待vr发展和结合才有可能是商机。我感觉20年很难，现在别说平民化了最高端的vr设备还是无法解决和人眼差不多视场。gpt这个完善解放是一大堆需要语言交互的工作，比如客服，如果再深入一点结合语音输入，真的到达伪人工智能的差不多也是可能的。还有游戏;3;7;10;3799;0.0026322716504343247
41667;就百度这尿性，不给你来个超级会员，还要限制次数。再是一大堆高级广告。wo是不相信百度;1;8;9;3799;0.0023690444853908922
41669;感觉还是互联网更像蒸汽器，ai只是高效能发动机脸红;3;7;10;3799;0.0026322716504343247
41676;我说一个预言：百度就算接入了GPT照样各种广告和竞价排名。;5;11;16;3799;0.0042116346406949196
41682;等技术成熟，ai做不了的工作，大部分人也做不了。绝大部分人的工作都是重复性的。;2;7;9;3799;0.0023690444853908922
41685;我们学校开学典礼都提到了这个，物理老师说我们要比不过人工智能了哈哈微笑;1;7;8;3799;0.0021058173203474598
41687;以现在ai智能来说，在可见的未来内都不会取代大部分人工，我们应该把ai当成一种生产力工具，以来取代在我们工作中大量重复劳动，网上搜索等等工作，在社会人口逐渐减少的情况下就可以取代现在的装配线等工作以来让人口去做更需要他们的工作岗位。科学技术的发明，应是为了人类更好的生活与工作，而没有人类的文明毫无意义，我相信我们人类一定会有这更美好的未来;2;7;9;3799;0.0023690444853908922
41690;他能答题，并且能答难题是因为我们的题目就是为了锻炼出人类ai，你让真ai答题，岂不是专业对口了;1;7;8;3799;0.0021058173203474598
41692;550w离我们不远了星星眼;1;7;8;3799;0.0021058173203474598
41697;先让你用上，然后限制。微笑百度云;1;9;10;3799;0.0026322716504343247
41699;大脑有了，手脚也有了，完成体还会远吗;2;9;11;3799;0.002895498815477757
41702;如果把chatgpt接入互联网，让它自我学习成长，会不会更快的完善ai微笑;7;9;16;3799;0.0042116346406949196
41710;是么时候能造出性爱机器人？;3;9;12;3799;0.0031587259805211897
41714;从蒸汽时代到现在的chatGPT，为什么总是西方在引导现代社会的每一次关键节点，引人深思;9;21;30;3799;0.007896814951302974
41724;百度文心中国的ChatGPT？不不不，中文的ChatGPT，但是中国的ChatPPT。;1;6;7;3799;0.0018425901553040273
41728;所以AI生成内容版权是属于谁？属于openai公司，还是属于输入问题的人？;3;6;9;3799;0.0023690444853908922
41734;有没有可能，ChatGPT可以自动更新自己的代码;2;6;8;3799;0.0021058173203474598
41738;论Al上高考能考几分;4;6;10;3799;0.0026322716504343247
41743;切勿模仿阴险;2;6;8;3799;0.0021058173203474598
41747;百度无愧为国内最强而且，它距离全球最强就只差一个：目前全球最强开源。;7;6;13;3799;0.003421953145564622
41755;之前在想，这么强的ai能给游戏带来什么，更智能的敌人，还是更丰富更随机的世界。;5;6;11;3799;0.002895498815477757
41761;我想，人类出现的终极目的就是要生成出超越人类的力量，代替人类探索这个世界;1;8;9;3799;0.0023690444853908922
41763;而国人已经开始利用免费的ChatGPT进行牟利了令人感慨吃瓜;7;8;15;3799;0.003948407475651487
41772;提到百度，总会想到魏则西。;3;31;34;3799;0.008949723611476704
41776;不是特别认同，它所产出的文字都是基于最初的语料，而且目前它在一些领域正确率只有70罢了，看上去确实挺多了，但是如果用它的输出反过来迭代训练它，错误会快速积累，最终导致模型的失效。而它需要的庞大数据量，也注定不可能由人类再去对它的输出进行标注。;2;9;11;3799;0.002895498815477757
41779;所以还是那个问题如果国内做出了类chatgpt回答问题能不能做到客观？;10;7;17;3799;0.004474861805738352
41790;咋不接着吹元宇宙了还期望有生之年能玩上刀剑神域呢脱单doge;1;7;8;3799;0.0021058173203474598
41792;QQ小冰突然色诱你doge;1;6;7;3799;0.0018425901553040273
41794;回答问题，1分钟回答一个字，一个答案500字就是500分钟回答完毕，要想快得加钱上会员;3;5;8;3799;0.0021058173203474598
41800;说了多又好像啥都没说，一半时间夸百度;2;6;8;3799;0.0021058173203474598
41805;哲学和情感估计是人类的底线了吧，这俩再被ai掌握就不好说了;1;5;6;3799;0.0015793629902605948
41807;这期视频给我不小震撼，没想到一个chatgpt竟然可以从这些意想不到的地方改变人们的生活tv惊吓tv惊吓;2;5;7;3799;0.0018425901553040273
41810;怎么说呢，这东西写代码不安全，现在注重的代码业务安全性，知道数据库字段到时候数据库都不安全，所以这只能实现低代码，还是取代不了程序员。口罩;6;5;11;3799;0.002895498815477757
41819;没用过，用过的大佬有没有试过用他炒股，买彩票的号码预测，投资，和找学习资料脱单doge;1;5;6;3799;0.0015793629902605948
41822;没太明白，以前是自己上网搜资料，整理，弄一篇抄袭的文字。现在是这个GPT帮着做这些事情，给我节省了ATP消耗，我的体重看来是很难减下去了，还得花钱去健身房消耗。不过那个编程的，感觉挺牛，再也不用学什么C语言了呲牙;1;6;7;3799;0.0018425901553040273
41824;计算机要是凉了的话，这么多学生和从业者怎么办？全失业？还是从事更高级的工作？中低端程序员怎么办？;4;6;10;3799;0.0026322716504343247
41829;天网：这是宣布我到来了号角。整个地球的人类为我的出生欢呼。;3;6;9;3799;0.0023690444853908922
41836;那么问题来了，资本后续该如何收割我们？;4;5;9;3799;0.0023690444853908922
41843;23年了，什么时候才能玩到刀剑神域惊喜;1;4;5;3799;0.0013161358252171624
41845;文员是不是要失业了笑哭;4;4;8;3799;0.0021058173203474598
41851;我现在有点害怕，我学了三年代码，不要告诉我再过几年会AI被顶替。;9;4;13;3799;0.003421953145564622
41861;除非他能写修改自己bug的代码。;2;4;6;3799;0.0015793629902605948
41865;那要我干什么？我成替身了？工具可以很好用。没有人的文明（工作）毫无意义。;13;4;17;3799;0.004474861805738352
41882;我觉得这帮互联网大厂研究这个，至少比那什么元宇宙强;1;4;5;3799;0.0013161358252171624
41884;从百度以往的表现看，对他的搜索已经比较失望了，就算他开发了文心一言，我觉得以后也肯定会被他玩坏笑哭;1;4;5;3799;0.0013161358252171624
41886;哈哈。今年大一计算机专业，我感觉我已经寄啦，么得未来啦;6;4;10;3799;0.0026322716504343247
41895;ai炒了这么多年了，最后也没炒出什么真正的产品出来，感觉这次也一样。要真正的革新，还是需要基础能力的创新才行。;11;11;22;3799;0.005790997630955514
41907;其实现在媒体很人格分裂，一方面担心人口下降，一方面又在发明淘汰人的机器，这到底是嫌人多还是嫌人少啊？吃瓜;1;12;13;3799;0.003421953145564622
41911;以后普通人类应该可以不用学习了吧，把基础的工作交给ai，高端行业由顶尖天才开发新领域;9;5;14;3799;0.0036851803106080546
41921;可以上流水线替代大量简单的重复劳动2233娘大哭真的挺可怕的;1;5;6;3799;0.0015793629902605948
41929;我在投喂ai各种小说，打算多开让ai写小说骗起点的全勤doge;3;3;6;3799;0.0015793629902605948
41933;AI参加考试算开卷考还是闭卷考，如果人类也开卷考的话，能不能强于AI;6;3;9;3799;0.0023690444853908922
41940;怎么说呢，人家在这方面领先我们是肯定的，不能说，因为没必要而不去发展，国内的一些类似的产品用了之后，然后你再去用GTP或者新版没有被封印之前的牛逼，做一个对比，差距大到，令人绝望，这实在是不能当鸵鸟的，如果我们不快马紧追，而是还是在搞那个房地产跟茅台;1;4;5;3799;0.0013161358252171624
41945;百度呢，腾讯呢，阿里呢，字节呢，干啊;3;3;6;3799;0.0015793629902605948
41949;你猜我们在元宇宙上投资了多少钱？思考;2;3;5;3799;0.0013161358252171624
41957;能不能让ai自己创造而不依赖人类生成的数据库；就像罐中之脑一样。;1;3;4;3799;0.0010529086601737299
41962;无法创造，就是瓶颈，它是人类发明的，它缺发明不了人类吃瓜;3;3;6;3799;0.0015793629902605948
41966;坐等马斯克给我搞个ai女友，机器永远比人靠谱妙啊;2;3;5;3799;0.0013161358252171624
41970;人类终将被自己的作品终结，无论是精神上的还是物理上的。;3;3;6;3799;0.0015793629902605948
41974;能让它写小说不？吃瓜想找一个符合自己喜好的有点难。;5;3;8;3799;0.0021058173203474598
41980;它们写出来的东西版权归谁吃瓜;7;3;10;3799;0.0026322716504343247
41988;其他人：科技进化，智械危机星星眼二次元：记住，你是一只猫娘。害羞;3;8;11;3799;0.002895498815477757
42005;这就是第四次工业（），如无意外的出意外了，没有出现在我们这;2;2;4;3799;0.0010529086601737299
42012;好消息：不用加班了坏消息：没工作了之前是ai绘画，如今是ai编程，啥时候ai叛乱啊;1;2;3;3799;0.0007896814951302974
42015;最可怕的是弹幕里很多人基于自己过去的认知还不信，“扯淡”;1;2;3;3799;0.0007896814951302974
42021;？百度软广？;1;3;4;3799;0.0010529086601737299
42026;让它帮我投资热词系列肥肠自信;2;2;4;3799;0.0010529086601737299
42029;日常中周围人说我说话方式和思维逻辑很AI（真）捂脸;2;2;4;3799;0.0010529086601737299
42032;原宇宙搞出来了，也只是个大游戏，纯粹的噱头;1;2;3;3799;0.0007896814951302974
42034;好啊，画画的饭碗被夺了，数码也被夺了;3;2;5;3799;0.0013161358252171624
42038;它会喝酒吗滑稽不会的话可能不会很好doge;1;2;3;3799;0.0007896814951302974
42040;写代码噗你让他写个我看看偷笑;2;2;4;3799;0.0010529086601737299
42045;ai如果能做所有工作那工作去哪找;5;2;7;3799;0.0018425901553040273
42056;什么失业问题，焦虑问题，本质上还是教育扩招带来的，成默成本过高问题。;6;2;8;3799;0.0021058173203474598
42064;目前AI做的还是资料整理和反馈;1;3;4;3799;0.0010529086601737299
42066;机器始终是为人类服务的，希望不要出差错吧;4;3;7;3799;0.0018425901553040273
42071;人类道德发展似乎赶不上科技的发展，如同原子弹，是有毁灭人类的威力的，但人类的命运始终掌握在自己手上。;7;3;10;3799;0.0026322716504343247
42082;没事，别人是引领，我的是赶超，加油;1;1;2;3799;0.0005264543300868649
42084;如果ai自己编写程序再自己执行会是怎么样？00;1;1;2;3799;0.0005264543300868649
42086;chatgpt現在所來帶的不正是科技大爆炸嗎？;1;1;2;3799;0.0005264543300868649
42100;看了评论，还挺心寒的。;1;1;2;3799;0.0005264543300868649
42102;微软解散元宇宙团队，押注chatgpt喜极而泣喜极而泣喜极而泣感觉这样的剧情，未来还会上演好多次;1;1;2;3799;0.0005264543300868649
42104;传闻阿里也在研发，村里可不止百度一个小孩。其实如果它成了，垄断地位又成了所有的结果都是它的ai给的;1;1;2;3799;0.0005264543300868649
42106;我感觉没戏语料库质量;1;1;2;3799;0.0005264543300868649
42108;你猜有没有一种可能，我对文心一言提问我不舒服的时候，他先跳出某医院广告;1;1;2;3799;0.0005264543300868649
42123;从知乎上看到的;1;1;2;3799;0.0005264543300868649
42125;看很多人弹幕上说这和搜索引擎很相似，其实这和搜索引擎就完全不是一种技术，它的回答都是靠它自己理解得出的结果，而不是靠搜索文本得出的，例如你问一些编程题它就会回答出一些网上从来没出现过的解法（当然也可能是错误的，毕竟是靠自己思考的），所以这其实是非常大的变革;1;1;2;3799;0.0005264543300868649
42137;某群自以为是的B站用户“chatGPT算不上什么”，这才是“大佬”;1;1;2;3799;0.0005264543300868649
42142;不可能，纵观历史就可以得出结论，全是抄袭。源代码只要一天还在用英文字母，就不可能不是抄的。;2;1;3;3799;0.0007896814951302974
42147;有个统计现在都是什么行业的人在使用chatgpt排名第一的玩虚拟币的人，其次是搞设计等创意工作的人，程序员只占不到5;3;1;4;3799;0.0010529086601737299
42151;ChatGPT是纽可门机，就看谁能搞出往复式蒸汽机了;1;1;2;3799;0.0005264543300868649
42159;这个模型怎么判断读到的信息元素对错优劣的？;1;1;2;3799;0.0005264543300868649
42174;未来ChatGPT赚钱会不会是靠卖功能呢，就像现在的工作收费软件一样，那么它也许就不止是现在的模样了，而是一个拥有无限功能的智能平台。;1;1;2;3799;0.0005264543300868649
42177;生产力发展了，接下来是不是就该;1;1;2;3799;0.0005264543300868649
42183;赛博朋克越来越近了好耶tv鬼脸tv鬼脸;5;1;6;3799;0.0015793629902605948
42189;我在想他能把自己代码更新吗？;2;1;3;3799;0.0007896814951302974
42199;技术还不成熟，国内专业人士说要搞出来都得45年才有ChatGPT30的水平;1;1;2;3799;0.0005264543300868649
42201;MD，显卡又要涨价了;2;1;3;3799;0.0007896814951302974
42204;谁创造出来的软件？这是看的第二个讲它的视频（都没有认真听完因为不懂笑哭）;4;1;5;3799;0.0013161358252171624
42209;我想要来点重口的它不肯，我想来点瑟瑟的，它还是不肯，工作用不到我要你何用？当然只是针对chatgpt;2;1;3;3799;0.0007896814951302974
42214;试了一下，它的代码功能就是一写个架子，估计就是GitHub上写的;1;1;2;3799;0.0005264543300868649
42217;这算不算科技树点歪？;1;1;2;3799;0.0005264543300868649
42221;就是说AI被赋予了野心会怎么样？;8;1;9;3799;0.0023690444853908922
42230;坐等开放世界chatgpt黄油;4;1;5;3799;0.0013161358252171624
42238;这就属于一堆人用代码敲出来个替换自己的东西，自己搞没了自己的工作啊辣眼睛;2;1;3;3799;0.0007896814951302974
42241;人类以后还能干什么？;8;1;9;3799;0.0023690444853908922
42250;哎呀，这个我在明日之后up格鲁那里看他用过，你问它什么它都会回答的，就明日那个抽奖事件，这个ai给的解决方案比明日策划都好吃瓜;1;1;2;3799;0.0005264543300868649
42253;咋感觉全是噱头啊，通过考试时可以通过但是他没有创造力呀;3;1;4;3799;0.0010529086601737299
42257;继续努力研究ai，希望百年后，能看到到处都能见到ai机器人;4;1;5;3799;0.0013161358252171624
42265;真正有心的机器人？亚托莉看来要成真了脱单doge;1;1;2;3799;0.0005264543300868649
42281;话说它能不能写论文脱单doge;3;1;4;3799;0.0010529086601737299
42286;没那么快吧搞研究的至少目前不信但可能大概还是通过海量搜索关键词给出的答复反正这玩意儿真真出来那学历红利就没了自己弄适合自己工作的环境或直接花钱买适合自己工作代码就行了;2;1;3;3799;0.0007896814951302974
42290;最终都是资本的工具，百度？奥，我会学好广告的植入;1;1;2;3799;0.0005264543300868649
42296;全是输出的答案，那公司如何获利呢？;3;1;4;3799;0.0010529086601737299
42300;不知道为什么，有一种无力感;1;1;2;3799;0.0005264543300868649
42302;所以元宇宙是什么？一种营销概念？;4;1;5;3799;0.0013161358252171624
42309;我在好多个chatgpt下面都问了怎么注册，没人回复我，国内电话用不了;7;2;9;3799;0.0023690444853908922
42317;用这个那就是在美国佬面前真的是光溜溜了;1;2;3;3799;0.0007896814951302974
42319;五六十年代的老电影，就已经预测了智能计算机的出现而且，我国早就已经研发了世界超级的电脑服务器，无感;1;2;3;3799;0.0007896814951302974
42321;感觉就是一个概念炒完了接着炒另一个;1;2;3;3799;0.0007896814951302974
42323;吹使劲的吹你觉得现在百度除了广告业务还是什么可以赚钱的;1;2;3;3799;0.0007896814951302974
42327;doge希望能免费使用，顺便再配置一个虚拟人物，以后我的老婆就是chartgpt了;2;6;8;3799;0.0021058173203474598
42330;其实chatgpt的硬件门槛并没有想象中的大。模型1700亿左右参数，占硬盘700多G，根据chatgpt自己回答，16G显存就能运行，本身是个单机可用的模型。;2;1;3;3799;0.0007896814951302974
42333;你们没有注意到chatgpt爆火炸出了很多有梯子的人么？;1;1;2;3799;0.0005264543300868649
42339;那么以后能不能用打造一款以中文为底层逻辑打造一款编辑器，一直认为中文这种表意文字为底层逻辑创造出来的网络环境，应该能够让网络更进一步，毕竟英文是表音文字，没有表意文字那么直接。;5;1;6;3799;0.0015793629902605948
42346;不是，答案是人类首先设定的;1;1;2;3799;0.0005264543300868649
42348;上一个这样吹嘘的时3D打印和国内的5G水平;2;1;3;3799;0.0007896814951302974
42354;未来人是否会被Ai圈养起来囧;1;2;3;3799;0.0007896814951302974
42358;我认为，这种人工智能就算以后再怎么强大，也不可能完全替代人类，人类有人类所独有的能力，而人工智能，不过是脑子充满了各种数据的机器。终究思维是透明的，它以后可以辅助人类做很多乏味困难手工的工作不假，但它永远超不了人类;1;1;2;3799;0.0005264543300868649
42362;道高一尺魔高一丈或者反过来你们这些网民凡人怎么死的都不知道;1;1;2;3799;0.0005264543300868649
42372;等AI有自我意识那天我看还搞不搞;2;0;2;3799;0.0005264543300868649
42384;gpt或许真的有颠覆能力。华为埋头搞钱已经落后了在预想中它可以成为未来不可或缺的个人生活，学习，工作的智能助理。未来生产力差距越来越大。仍然不希望华为落伍，但留给它的时间不多了;1;0;1;3799;0.00026322716504343247
42389;合理运用ChatGPT，国外的计算机领域发展可能更恐怖。;3;0;3;3799;0.0007896814951302974
42395;百度如果还是商业模式思考，那他出的类chatGPT不是不能用，但是会很不好用，悲哀得是国内不开放市场的情况下很难有竞争对手;1;0;1;3799;0.00026322716504343247
42398;GPT本身就是收费的。国内软件对接国外官方接口，只不过区别是国内软件封装了GPT国内用户按月收费，实际背后的系统是根据提问字数和回复字数收费的。1000个tokens002美分，tokens与文字数量之间有一个算法。并不是说1000个tokens就是1000个文字这么简单。;3;1;4;3799;0.0010529086601737299
42402;那未来我是不是真的能和二次元妹子谈恋爱了。;2;0;2;3799;0.0005264543300868649
42417;我文科生，但运算脱离不了逻辑这应该是定性，我没理解错吧。随便抽个离谱网文交给它，我想知道它能效仿么;3;0;3;3799;0.0007896814951302974
42421;逆袭biu墨镜;1;0;1;3799;0.00026322716504343247
42464;百度文心ERNIE在多个数据的零次学习benchmark结果是优于GPT3的;1;0;1;3799;0.00026322716504343247
42487;我想问国外这些没广告怎么变现的？为什么百度广告就多呢？;3;0;3;3799;0.0007896814951302974
42508;但目前AI说白了就是大数据训练，也就是说目前人类搞不清楚的问题，AI也不会懂。;1;0;1;3799;0.00026322716504343247
42550;百度只会给你提供广告;1;0;1;3799;0.00026322716504343247
42558;展望的东西太遥远了，chatgpt本质还是个量变，达不到科技革命的程度，ai技术还是需要突破;5;0;5;3799;0.0013161358252171624
42567;就怕发展到最后，有不良用心的人训练AI犯罪，那可是24小时不停的机器，谁能顶得住;2;0;2;3799;0.0005264543300868649
42574;蒸汽机是原理正确了，之后只是深化，现在的那个人工智能是不是走对了路还不好说;1;0;1;3799;0.00026322716504343247
42583;如果chatGPT汉化，是不是也可以让它写《红楼梦》的结局？期待给心心给心心;2;0;2;3799;0.0005264543300868649
42596;百度是真搞笑，18年就说搞ai，到现在还没见个影子;1;0;1;3799;0.00026322716504343247
42598;囧日后人类工作被替代能做什么;2;0;2;3799;0.0005264543300868649
42605;现在压力来到文科爷这边;1;0;1;3799;0.00026322716504343247
42611;再改为idea插件岂不美哉？帮我写代码;1;0;1;3799;0.00026322716504343247
42638;这玩意很危险，非常非常危险。如果我们都用谷歌gpt，那得多少资料泄密？;4;0;4;3799;0.0010529086601737299
42647;会不会最后发展成拥有自我意识的AI然后“天网”诞生了;1;0;1;3799;0.00026322716504343247
42649;chatGPT;1;0;1;3799;0.00026322716504343247
42654;想知道chatgpt的数据输入真的是血汗工厂吗？;1;0;1;3799;0.00026322716504343247
42660;未来Ai奴役人类，白领设计程序员等都得失业以后得去工地搬砖打灰给Ai智能打工微笑;1;0;1;3799;0.00026322716504343247
42673;给它看看易经能猜到下期彩票么无语;1;0;1;3799;0.00026322716504343247
42699;AI是有内部代码。你直接问他不会告诉你的。;2;0;2;3799;0.0005264543300868649
42704;这ai还能自我学习这不开始取代人类了;3;0;3;3799;0.0007896814951302974
42710;哪天ai觉得人类是个累赘怎么办;1;0;1;3799;0.00026322716504343247
42713;不是不支持中国的网络吗？;1;0;1;3799;0.00026322716504343247
42717;这个怎么进去？;2;0;2;3799;0.0005264543300868649
42726;也就某些写作翻译领域有用，对于设计思考的领域完全没用;2;0;2;3799;0.0005264543300868649
42734;能帮我分析股票吗？喜极而泣;1;0;1;3799;0.00026322716504343247
42747;断网就完事了脱单doge;2;0;2;3799;0.0005264543300868649
42750;好，这样工人才能涨工资;2;0;2;3799;0.0005264543300868649
42756;只需要提出需求他就会实现吗？;2;0;2;3799;0.0005264543300868649
42773;元宇宙不玩啦？哈哈哈哈;1;0;1;3799;0.00026322716504343247
42781;什么AI啊AI都直接搜答案了你怎么可能比得过？;3;0;3;3799;0.0007896814951302974
42791;码农危机了，真不知道我以后能干什么，要不还是考研吧墨镜;2;0;2;3799;0.0005264543300868649
42796;帮我算算圆周率;1;0;1;3799;0.00026322716504343247
42799;很多人要失业了永雏塔菲1883委屈;8;0;8;3799;0.0021058173203474598
42808;怎么让他为我工作？;1;0;1;3799;0.00026322716504343247
42821;元宇宙就不搞了吗;1;0;1;3799;0.00026322716504343247
42823;通过图灵测试了吗;3;0;3;3799;0.0007896814951302974
42835;啥时候AI能自己研发自己就好了;3;0;3;3799;0.0007896814951302974
42841;期待会呼吸的游戏;1;0;1;3799;0.00026322716504343247
42848;大家有不吃的不穿的不用的可以给我嘛我在收集物资想有工作想生存下去谢谢大家;1;1;2;3799;0.0005264543300868649
42852;百度有个自动驾驶，叫什么阿波罗，经常看见在我们公司楼下测试doge;3;91;94;3799;0.024743353514082654
42856;百度名字还挺好听的，文心一言;2;40;42;3799;0.011055540931824164
42859;额，百度，你看他加不加广告吧，ai最重要的就是数据库。只要加广告，立马放弃，不然你后面可能分不清是否真实。;6;26;32;3799;0.008423269281389839
42866;我不信，除非百度ai帮我工作;3;8;11;3799;0.002895498815477757
42870;有人解释下这是啥吗;1;7;8;3799;0.0021058173203474598
42873;百度这次能超越谷歌吗？打call;3;4;7;3799;0.0018425901553040273
42881;想买一手百度兄弟们有懂的吗;3;1;4;3799;0.0010529086601737299
42892;为什么我文心一言申请两周了还是没通过笑哭;1;0;1;3799;0.00026322716504343247
42895;“其实谷歌的这个技术啊，我觉着基础啊还是非常好的。”这夸谷歌就是夸自己吧，必竟就是追随别人一起搞的Bert，然而人家有实力搁置搞了这么久的Bard再去另搞一个Gemini，你百度行么？另外说百度文心一言是GPT应该是不对的。;13;5;18;3799;0.0047380889707817845
42914;文心一言后台就是一群百度员工在使用GPT4;4;54;58;3799;0.015267175572519083
42919;蚌埠住了;16;68;84;3799;0.022111081863648328
42936;如果百度是现场提问现场演示的话，哪怕是翻车我都顶百度，demoppt算几个意思;14;89;103;3799;0.027112397999473545
42952;没拿到测试你说个屁;1;24;25;3799;0.006580679126085812
42954;怎么会有人因为自己国家某方面比别的国家差而开心呢？我觉得不必要对文心一言抱有那么大的恨意，这不会影响你们玩chatGPT或者newbing，只会让人人都有适合国人的模型用。;35;28;63;3799;0.016583311397736247
42990;动不动就我们，我们的GPT4弄的好像真是我们的一样吃瓜;2;13;15;3799;0.003948407475651487
42993;民众不知道的是，他们站在谁那一边，谁就会赢。这点放在这里再合适不过了。因为这种需要大量训练的产品，如果一方有人用，一方没人用，那差距就会越来越大。这个需要数量来引发质变的，很难在技术上实现赶超。更何况，我们技术也没别人强。;12;28;40;3799;0.010529086601737299
43006;给两个考生考试，一个已经提前发卷在家做完拿来学校直接改，一个刚到学校就被喊去考试，怎么评价这种行为。GPT4：这种行为是不公平的，违反了考试的基本原则。考试的目的是为了评估考生的知识水平和能力，以便了解他们在某个领域的掌握程度。为了公平地评价每个考生，考试应该在相同的条件下进行。在这种情况下，两个考生的考试环境和条件显然不同，结果可能无法真实反映他们的能力。第一个考生提前发卷在家做完并拿到学校直接改，这显然是违规行为。这种行为剥夺了其他考生在公平竞争中证明自己能力的机会，并可能导致不公平的结果。此外，这也损害了考试的公信力，使得评价体系失去了意义。第二个考生刚到学校就被喊去考试，这也可能对其产生不利影响。如果他没有足够的时间准备，可能导致其考试表现不佳。为了保证公平，考试前应为所有考生提供足够的时间和空间来准备。总的来说，这种行为不仅损害了考试的公平性，也影响了考试结果的准确性。为了保证公平和有效的评估，学校和考试机构应加强对考试流程的监督和管理，确保每个考生都在公平的条件下参加考试。;13;49;62;3799;0.016320084232692815
43021;黑驴皇叔，，，我突然感觉自己也挺无聊的藏狐;1;2;3;3799;0.0007896814951302974
43023;阿普主有演讲后遗症，我以为是ChatGPT是你发明的;1;21;22;3799;0.005790997630955514
43025;已取关，甚至不知到什么时候误点从而关注这个货的。每个人的时间和生命都有限，不要浪费在谣言上，和“只要我限定条件多，我就是第一的”劣质软广告上;1;22;23;3799;0.006054224795998947
43027;我昨天试了下，还不错，回答问题，生成图片，作文都可用，对汉语的理解远超GPT4，其他有差距。毕竟是测试版嘛，加油，百度;11;10;21;3799;0.005527770465912082
43041;gpt4的汉语数据的训练量本来就少，百度的话中文应该占很大一部分;1;6;7;3799;0.0018425901553040273
43047;ERNIE要是真像吹得一样厉害，为什么要用录屏发布啊哦呼哦呼;4;10;14;3799;0.0036851803106080546
43055;up应该再拿文心一言和微软newbing比较一下，毕竟百度这个多半是联网实时搜索了，而ChatGPT是不联网搜索的;1;5;6;3799;0.0015793629902605948
43058;感觉知乎做gpt可能更好，用newbing查的中文答案好多都来自知乎。;1;3;4;3799;0.0010529086601737299
43061;这俩有可比性？;1;0;1;3799;0.00026322716504343247
43087;chatGPT是国际化语言模型，文心一言是吗;1;0;1;3799;0.00026322716504343247
43098;文心一言后台就是一群百度员工在使用GPT4妙啊;1;0;1;3799;0.00026322716504343247
43101;最大的差距是没有逻辑，不能联系上下文，你给它一个设定，下个回答就全忘了;2;0;2;3799;0.0005264543300868649
43128;文心中文还是可以的;1;0;1;3799;0.00026322716504343247
43137;你和谁两呢。百度的训练模型能和chat比？训练速度能和美国本土的毫无购买计算显卡限制无脑买卡的比？说实话，百度恶心人不是一两天了。聊天ai，能用国外的绝对不用国产的;1;3;4;3799;0.0010529086601737299
43140;140就可以搞定plus星星眼;3;1;4;3799;0.0010529086601737299
43145;完了，雪被抄袭了（悲;1;0;1;3799;0.00026322716504343247
43148;各位写代码都是从手搓指令集开始的，棒棒的，用开源就是套壳;3;15;18;3799;0.0047380889707817845
43152;别尬黑，中文歧义太多，基本图片需求都是转成英文后处理的。;7;15;22;3799;0.005790997630955514
43162;百度是民族企业，这是立场问题;2;2;4;3799;0.0010529086601737299
43178;文心一言进步的非常快，不知道为什么这么多人唱衰他，因为他是中国的还是因为他是百度的？;2;0;2;3799;0.0005264543300868649
43181;根本没玩砸，玩砸的前提是本身以前玩得还不错，这玩意根本就是一直都是砸的状态;7;31;38;3799;0.010002632271650434
43189;它的文库收费那么恶心，稍微动点东西就让你下载各种APP，你还指望它给你白嫖吗吃瓜;3;26;29;3799;0.007633587786259542
43193;股价不会骗人啊doge;3;8;11;3799;0.002895498815477757
43197;与其说发布会，不去说预告片，压根就没开始做;1;3;4;3799;0.0010529086601737299
43199;这个东西是靠训练的大伙提问它来解答，然后人工纠错;1;1;2;3799;0.0005264543300868649
43203;很棒诶;1;0;1;3799;0.00026322716504343247
43205;其他的啥时候出啊到底，就知道明天有个360的开测，商量和盘古不知道啥时候出来;1;1;2;3799;0.0005264543300868649
43208;看着还行，进化啦？;1;0;1;3799;0.00026322716504343247
43210;不让你用GPT4那么文心一言就是最好的了;3;11;14;3799;0.0036851803106080546
43214;要不要比比，chat10微软投资前chat能用？搞笑;8;6;14;3799;0.0036851803106080546
43227;我觉得，应该跟chatgpt10版本对比，我听说那时候chatgpt也是非常能胡扯。。;1;1;2;3799;0.0005264543300868649
43229;我用百度永远搜不到真相，搜到的永远是广告和骗局，所以被人们抛弃它，那是理所应当;16;1444;1460;3799;0.3843116609634114
43246;百度注定失败的，这家公司不赚钱的项目最多两年就会砍掉，你看看现在外卖，直播，短视频，那个不是五年以上才盈利;15;631;646;3799;0.17004474861805738
43262;百度连自己家产品都杀，看贴吧得单独下app，不能通过百度网页浏览;12;521;533;3799;0.1403000789681495
43275;百度最大的功能是测试网络是否正常;3;41;44;3799;0.011581995261911029
43279;百度正式开始掉队就是从16年的外卖大战开始的，BAT三巨头当时都直接或间接下场了，但百度的补贴力度最小，也是最早放弃的，后面的打车混战，共享单车混战，影视网站，百度都是最早下场又最早离场的。干大事而惜身，见小利而忘命。;4;266;270;3799;0.07107133456172678
43284;做梦呢还想成功，文心慢一步还能有救，这慢的何止一步，慢到姥姥家了，而且百度甚至很难获得足够的训练材料;12;198;210;3799;0.055277704659120824
43297;刚刚百度截得图;1;81;82;3799;0.021584627533561464
43299;作为百度员工，听你们骂的唉不是滋味，但你们说的都是对的。内部管理层确实一言难尽。。我想很多百度员工都希望谷歌能进来，然后会有竞争，然后会提高待遇。;57;378;435;3799;0.11450381679389313
43357;在一个被保护的市场里是出不了真正的创新和技术的，某度就是最好的例子;17;167;184;3799;0.048433798367991575
43375;不知道有没有人意识到，各行各业都在追赶西方国家，却不想着超越行业做领头羊。在互联网领域几乎就是照搬照抄美国，现在流行的百度、微博、美团、淘宝、支付宝分别对应谷歌搜索、脸书、Groupon、亚马逊、paypal；在计算机科技领域几乎依赖美日韩，包括电脑芯片、显示芯片、储存芯片和设备完全没有能力制造生产，曾经引以为荣的联想现在看也只不过是组装厂，现在中芯国际和长江储存让国人看到计算机国产化的希望，今年两会也有基于以长江储存为基础的数据储存产业发展的提案，但是要真正赶上西方的计算机水平还有任重道远；在汽车制造领域我们一直在参考日德美等国家，汽车制造是传统产业，我们起步晚底子薄，与起步早的日德美竞争确实非常困难，但是直到马斯克特斯拉的推出才意识汽车行业的弯道超车。不知道是因为现代科学由西方建立限制了我们的探索能力还是不思进取只占眼前利益，我平民百姓可能看到的不是问题的核心，但是我个人感觉是口号喊得响行动力却有所欠缺。美丽的外表里面是否是丑陋的内在，口号的目的是不是只为圈钱圈地捞钱跑路我不知道，但是我希望是给人自然学习和创造的能力，而不是像奴隶修长城一样被逼着买楼还贷，民族的崛起不应该只是经济增长，而是应该是同步优化教育和科研的土壤，只有这样才能培育出巨大成果进一步推动经济发展，个人认为这才是良性循环才是可持续发展。;31;145;176;3799;0.046327981047644115
43407;各个企业的封闭大背景是整个中国互联网生态的封闭;9;88;97;3799;0.025533035009212952
43417;突然好奇现在还有谁对百度有正面评价。看了半圈评论，客观的都少。只能说百度洗洗睡吧，得是什么样洗心革面的重大转折才能救你哦;13;95;108;3799;0.028428533824690707
43431;高中时期见证过谷歌还在国内跟百度抢市场的年代，我就好奇，一个原地踏步十几年，还能不倒的企业，是靠什么坚持到现在的？;13;108;121;3799;0.03185048697025533
43445;根据相关法律法规，结果不予显示doge妙啊;1;48;49;3799;0.012898131087128192
43447;百度的封闭和它的垄断地位造成的影响比知网恐怕是要夸张的多;3;40;43;3799;0.011318768096867597
43451;Web10拨号时代，门户网站时代，网易搜狐新浪Web20宽带时代，搜索引擎时代，百度Web30无线时代，移动APP时代，微信淘宝抖音;4;68;72;3799;0.018952355883127138
43456;千万不要用百度千万不要用百度千万不要用百度;16;69;85;3799;0.022374309028691763
43473;ChatGPT对于百度来说恐怕是威胁大于机会。毕竟上来要颠覆的第一个应用就是百度的命根;16;96;112;3799;0.029481442484864437
43490;用户体验太差，第一页首位全是广告，和骗局;3;102;105;3799;0.027638852329560412
43494;降低了，我的默认搜索引擎是bing;9;99;108;3799;0.028428533824690707
43504;竞价排名不是问题，谷歌也有竞价排名，但是你搜索结果第一页大多数都是广告，这怎么用，毫无用户体验。很多第二页的搜索结果打开还是广告。那我为啥要用百度搜索广告看？;3;69;72;3799;0.018952355883127138
43508;把谷歌搞出去的目的是让百度一家独大。一家独大的结果就是这样。故步自封。中国市场养得起你。但前提是社会不发展。各种成本低的情况下。谷歌一个操作系统都能干掉你百度。;11;56;67;3799;0.017636220057909976
43520;干翻谷歌？梦里吗？;3;29;32;3799;0.008423269281389839
43527;在我看来，百度公司败馈的转折点就是谷歌退出中国。;11;24;35;3799;0.009212950776520137
43539;现在互联网已经不是以前的互联网了，各家的内容各家保持着，想方设法让搜索引擎爬取不到，所以搜索体验越来越差。;3;33;36;3799;0.009476177941563569
43545;我宁愿翻出去用Google不会用百度;6;43;49;3799;0.012898131087128192
43553;文心一言如果能搞好，大样本做好，商业价值是超过字节、阿里的公司市值的。尤其是运用到几乎所有领域的科研、战争军事（比如GPT40的识图功能可以用于卫星图片分析）、医疗、城市管理等等领域，但是目前看比较失望的是百度撑不起这么大的野心。;5;27;32;3799;0.008423269281389839
43562;现在用百度的也就是百度网盘了，不过也可能会换的;1;4;5;3799;0.0013161358252171624
43565;百度挑战下限，谷歌创造上限。本人一直用谷歌;4;9;13;3799;0.003421953145564622
43577;我用百度是搜索B站知乎官网和Google官网笑哭;4;36;40;3799;0.010529086601737299
43584;贴吧真是可惜了，唉;7;25;32;3799;0.008423269281389839
43596;宏颜获水doge;1;15;16;3799;0.0042116346406949196
43602;现在只要用百度云盘而已;12;20;32;3799;0.008423269281389839
43617;现在电脑上啥软件也没装了。全是微软全家桶。bing搜索。bing壁纸。还有一个最近才发现的微软电脑管家。哈哈，真不敢相信是官方的。喜极而泣;6;5;11;3799;0.002895498815477757
43624;百度转型失败才是衰落的原因。要是腾讯当年没有微信，现在比百度好不了多少。因为移动互联网，搜索引擎重要性降低了。;2;2;4;3799;0.0010529086601737299
43627;360主要太流氓，自己安装，删了还来，有些小工具，删都删不了;2;6;8;3799;0.0021058173203474598
43632;文心一言已经被gpt3薄纱了别说现在已经更新到gpt4了;1;1;2;3799;0.0005264543300868649
43641;百度除了找一些官网基本没用，啥也不好找;1;1;2;3799;0.0005264543300868649
43643;咱就说，都3202年了，还有人用百度搜索？Bing不好用？;1;1;2;3799;0.0005264543300868649
43649;百度那用户数据喂不出来好模型，要做只能阿里或者腾讯做，腾讯可能更有优势;1;1;2;3799;0.0005264543300868649
43659;有点问题，文心一言不是对标chatgpt做的，19年就已经开始研发了，后来发布只是赶鸭子上架;2;1;3;3799;0.0007896814951302974
43664;我搜索慢性咽喉炎出来的结果让我去XX男科;1;0;1;3799;0.00026322716504343247
43667;别逗，百度股价都涨回来了，实测跟chatgpt35差不多;8;4;12;3799;0.0031587259805211897
43676;CHATPGT不是搜索，它是百度没有的新技术，能要了他的命;1;10;11;3799;0.002895498815477757
43680;真是个LJ公司。。。不讲真实，全靠各种骗，给钱能让你上首页辣眼睛恶心;1;1;2;3799;0.0005264543300868649
43690;我用百度还行;2;0;2;3799;0.0005264543300868649
43697;有什么可以替代百度引擎辣眼睛;1;0;1;3799;0.00026322716504343247
43726;都在推荐bing，难道没人推荐一下F搜和无追吗doge;1;0;1;3799;0.00026322716504343247
43729;卖药？;3;0;3;3799;0.0007896814951302974
43738;现在搜索问题可能B呼都能找到答案，虽然B呼广告也多了起来;2;0;2;3799;0.0005264543300868649
43760;文心一言有望让百度重回互联网bat位置。就看他能不能干好这样一件事。就像微信对于tx。;1;0;1;3799;0.00026322716504343247
43778;等等谷歌不是被禁用的么，啥时候被百度干掉了doge;1;0;1;3799;0.00026322716504343247
43786;虽然谷歌很坏但百度什么时候干翻了谷歌;1;0;1;3799;0.00026322716504343247
43814;百度唯一的作用就是测测联网成功没吃瓜;1;0;1;3799;0.00026322716504343247
43826;到现在还在一直用的是百度搜索，可能是习惯了吧，不过的确现在搜索的精准度越来越下降了。如果有一天没有了百度搜索，可能还会不怎么习惯。;2;0;2;3799;0.0005264543300868649
43833;除了百度，难道你是在用谷歌吗？搞笑你不得不用;1;0;1;3799;0.00026322716504343247
43849;文言一心到底咋样啊，有人说还行没有想象的那么差，百度股价又涨回来了，到底咋样啊;1;0;1;3799;0.00026322716504343247
43851;我就经常用百度没感觉有什么问题;1;0;1;3799;0.00026322716504343247
43855;中文互联网也注定出不了gtp那种;1;0;1;3799;0.00026322716504343247
43878;现在搜索引擎，啥好用点啊？;5;0;5;3799;0.0013161358252171624
43887;回想一下百度有没有做得很好的产品;4;1;5;3799;0.0013161358252171624
43892;画的好棒啊真的有成语的氛围啊;1;0;1;3799;0.00026322716504343247
43894;又是拿3歲小孩跟大學畢業生來比較。這類視頻有點多笑哭;1;2;3;3799;0.0007896814951302974
43899;文心一言的句子我很喜欢;1;0;1;3799;0.00026322716504343247
43904;国内一帮人集体高潮逮着百度骂，其实没百度连竞争资格都没有;4;4;8;3799;0.0021058173203474598
43910;上下文测试一下;2;2;4;3799;0.0010529086601737299
43915;成本相差太大，投入的资源太少了;3;0;3;3799;0.0007896814951302974
43923;套壳的gpt2;3;1;4;3799;0.0010529086601737299
43929;松鼠撅鱼doge;1;24;25;3799;0.006580679126085812
43937;虾仁还要猪心？吃瓜;2;15;17;3799;0.004474861805738352
43941;都是套话。大涨也可以反过来说;1;1;2;3799;0.0005264543300868649
43954;我可是抱着很大的期望啊百度可别让我失望大哭;3;0;3;3799;0.0007896814951302974
43962;希望你别一张嘴就是广告，否则没人用你。;1;6;7;3799;0.0018425901553040273
43968;文心一言画画大概是关键词模式，即使给它讲一个故事让它画也是不行的，并不是“有多少人工就有多少智能”;1;10;11;3799;0.002895498815477757
43970;实锤中译英了doge;6;8;14;3799;0.0036851803106080546
43977;目前还是练习阶段，等个半年吧。;2;3;5;3799;0.0013161358252171624
43980;这其实是中文的理解难题，从侧面来说人工智能还是很幼稚的水平，无法理解你说的是一个武侠小说;4;2;6;3799;0.0015793629902605948
43989;能跟某度说一下，让他们千万别该吗？改了的话，一是少了很多创意，二是少了很多欢乐啊;1;0;1;3799;0.00026322716504343247
43994;这ai绘画压根就没有思维辨析能力，就是把中文换成英文，然后自己把英文标签的东西组合起来，和用户自己输入标签通过ai绘画有什么区别？;3;0;3;3799;0.0007896814951302974
43998;文心一言用的大部分好像是英文数据库的资源，因为英文标记的多，中文标记的的共享资源比较少，标记也是需要很多成本的，所以就拿英文环境的公开的现成的标记资源来训练了，所以也就不奇怪文心一言为什么会出现中译英、很多图片都是西式审美、西式文化符号的原因了。;1;0;1;3799;0.00026322716504343247
