发布者;真实一级评论数;真实点赞数;边数;最大边数;集群密度
彩云小梦Dream;5;16;21;21673;0.0009689475384118488
馋老师bot;3;11;14;21673;0.0006459650256078992
被遺忘腐爛的厨余垃圾33027;3;3;6;21673;0.0002768421538319568
混世窝窝头;2;3;5;21673;0.00023070179485996402
燃星击夜;7;649;656;21673;0.03026807548562728
·AstronNautes·;2;6;8;21673;0.0003691228717759424
紫霄时雨_;2;8;10;21673;0.00046140358971992804
Klara_And_the_Sun;1;3;4;21673;0.0001845614358879712
云南艺术学院文华学院新闻中心;1;1;2;21673;9.22807179439856e-05
装盐的瓶;8;6;14;21673;0.0006459650256078992
风过无痕dear;8;7;15;21673;0.0006921053845798921
栖息的月光光;23;36;59;21673;0.0027222811793475754
奶盐盐粒子;7;5;12;21673;0.0005536843076639136
_西红柿女孩_;1;4;5;21673;0.00023070179485996402
黑屏黑屏黑;2;14;16;21673;0.0007382457435518848
Q娜娜N;2;2;4;21673;0.0001845614358879712
商丘医专微校园;35;200;235;21673;0.010842984358418309
可爱的雅瑞宝贝;5;3;8;21673;0.0003691228717759424
长三角铁路;2;7;9;21673;0.0004152632307479352
水草的迷;2;1;3;21673;0.0001384210769159784
隐竹斋;3;7;10;21673;0.00046140358971992804
DeniseFanta;1;6;7;21673;0.0003229825128039496
YI曦-;12;266;278;21673;0.012827019794213999
中科大胡不归;2;23;25;21673;0.00115350897429982
一只饭cp的萝卜;4;130;134;21673;0.006182808102247035
瑞睿女王;1;1;2;21673;9.22807179439856e-05
Rabbitwool_梦比优斯出蓝光了么;2;4;6;21673;0.0002768421538319568
绿箭五糖薄荷糖;3;12;15;21673;0.0006921053845798921
北京众一公益基金会;-1;2;1;21673;4.61403589719928e-05
陳企鵝_Patty;7;3;10;21673;0.00046140358971992804
vitamin__C_;2;4;6;21673;0.0002768421538319568
问问夕夕姐姐;0;1;1;21673;4.61403589719928e-05
淇淇夬夬;1;1;2;21673;9.22807179439856e-05
盐式夏日;8;2;10;21673;0.00046140358971992804
付俊医生;1;1;2;21673;9.22807179439856e-05
yang_smile;0;3;3;21673;0.0001384210769159784
Fong110;3;18;21;21673;0.0009689475384118488
SUMMER旧梦安雪;10;46;56;21673;0.002583860102431597
水煮长江;1;1;2;21673;9.22807179439856e-05
岳盛斋的饲养员;1;12;13;21673;0.0005998246666359064
穆梓欣MZX;3;6;9;21673;0.0004152632307479352
单色光0517;6;6;12;21673;0.0005536843076639136
Libra_Iridescent;2;16;18;21673;0.0008305264614958704
又又想喝冰阔落;1;2;3;21673;0.0001384210769159784
augenstern_澄念;19;21;40;21673;0.0018456143588797122
霜予叙柒;20;2;22;21673;0.0010150878973838417
橙子茶Yi;0;5;5;21673;0.00023070179485996402
甜乐壁纸头像;1;1;2;21673;9.22807179439856e-05
北欧米粒和西北永鸿;6;94;100;21673;0.00461403589719928
月凝花朝胧鲸落;9;65;74;21673;0.0034143865639274674
林伟3037148833;1;5;6;21673;0.0002768421538319568
四川幼儿师范高等专科学校官微;24;28;52;21673;0.0023992986665436256
假装纯情男高_;16;105;121;21673;0.005582983435611129
lron1;8;50;58;21673;0.0026761408203755826
慧腐烂的心QY;7;8;15;21673;0.0006921053845798921
呈贡发布;4;2;6;21673;0.0002768421538319568
TT-WJY;70;471;541;21673;0.024961934203848107
大唐合盛陶瓷家居;8;7;15;21673;0.0006921053845798921
金金的幸福3_299;35;3;38;21673;0.0017533336409357265
奶盐专用沙发;18;134;152;21673;0.007013334563742906
敢敢ings;1;3;4;21673;0.0001845614358879712
可乐yao加冰200605;5;5;10;21673;0.00046140358971992804
与辉遥;1;2;3;21673;0.0001384210769159784
风暴鸟海瑶;1;3;4;21673;0.0001845614358879712
Dasiy--c;1;2;3;21673;0.0001384210769159784
lv记忆裏嘚童话已经融化淚;1;2;3;21673;0.0001384210769159784
星落my;60;103;163;21673;0.007520878512434827
汪喵爱宁;1;1;2;21673;9.22807179439856e-05
安韵小鹿my;18;12;30;21673;0.0013842107691597841
熙允诺;100;5;105;21673;0.004844737692059244
冰冰妹子;52;1496;1548;21673;0.07142527568864486
carefully67460;3;4;7;21673;0.0003229825128039496
Fong110;11;19;30;21673;0.0013842107691597841
读书版开心ice公主-;1;1;2;21673;9.22807179439856e-05
粉粉分分;68;7;75;21673;0.00346052692289946
安达英司;26;93;119;21673;0.005490702717667144
夜晚宝石;1;5;6;21673;0.0002768421538319568
刘风云又讲故事;2;1;3;21673;0.0001384210769159784
萧晏松;5;9;14;21673;0.0006459650256078992
彩云小梦Dream;4;6;10;21673;0.00046140358971992804
写手吐槽bot_;15;104;119;21673;0.005490702717667144
BeatYouLikeAHurricane;1;1;2;21673;9.22807179439856e-05
刷假子弹专用号;2;4;6;21673;0.0002768421538319568
吃掉这个红烧鸭头;3;13;16;21673;0.0007382457435518848
_故乡之星倒映之海;1;2;3;21673;0.0001384210769159784
倪忆不忆你;18;46;64;21673;0.002952982974207539
芋泥波波M1;3;4;7;21673;0.0003229825128039496
清茗依心yo;9;6;15;21673;0.0006921053845798921
淇淇小王子2023;7;7;14;21673;0.0006459650256078992
春日心动日记v;119;5;124;21673;0.005721404512527108
虹巢RainbowNest;2;1;3;21673;0.0001384210769159784
慧腐烂的心QY;8;5;13;21673;0.0005998246666359064
IvysWorld_;1;1;2;21673;9.22807179439856e-05
我是谨言的手机;9;8;17;21673;0.0007843861025238776
cheerwithu-;1;1;2;21673;9.22807179439856e-05
快乐的淇雅;4;6;10;21673;0.00046140358971992804
fishing飞_576;4;5;9;21673;0.0004152632307479352
坤寂;244;23;267;21673;0.012319475845522078
紫衣人WBL;1;1;2;21673;9.22807179439856e-05
乐乐爬蔷狂魔;1;3;4;21673;0.0001845614358879712
嘻嘻卷不动了;1;2;3;21673;0.0001384210769159784
星晨繁花;219;1;220;21673;0.010150878973838416
一隻學術狗;13;21;34;21673;0.0015687722050477552
幽灵灵代号U00;8;29;37;21673;0.0017071932819637337
云南平安高速;2;1;3;21673;0.0001384210769159784
正能量de黄跳跳O;1;1;2;21673;9.22807179439856e-05
太白居士888;2;4;6;21673;0.0002768421538319568
黄蓉;1;11;12;21673;0.0005536843076639136
陳企鵝_Patty;10;4;14;21673;0.0006459650256078992
GALI味·季米花;-13;9;-4;21673;-0.0001845614358879712
我家坚果是个姑娘;110;5;115;21673;0.005306141281779172
黑乐藤四郎;70;444;514;21673;0.0237161445116043
没有就没有吧别想找到我;1;2;3;21673;0.0001384210769159784
孙彩瑛_StrawberryPassion;27;325;352;21673;0.016241406358141468
何爷O_o;2;2;4;21673;0.0001845614358879712
池晓央很能打;2;32;34;21673;0.0015687722050477552
影岁我长;1;1;2;21673;9.22807179439856e-05
草原900;9;52;61;21673;0.002814561897291561
鹿晗来云南吃过桥米线呀;12;50;62;21673;0.002860702256263554
起风0801;25;27;52;21673;0.0023992986665436256
随感随记随录;1;1;2;21673;9.22807179439856e-05
我家坚果是个姑娘;109;1;110;21673;0.005075439486919208
86name-chen;1;1;2;21673;9.22807179439856e-05
慕杉呐;23;11;34;21673;0.0015687722050477552
StellaVee;27;36;63;21673;0.0029068426152355467
500px摄影社区;4;25;29;21673;0.0013380704101877913
幽忧优;1;1;2;21673;9.22807179439856e-05
木香彡sarah;1;8;9;21673;0.0004152632307479352
幸运healthy;1;35;36;21673;0.0016610529229917409
瞬间就懵逼了;1;12;13;21673;0.0005998246666359064
陈康令_礼和天下;61;175;236;21673;0.010889124717390302
吸睛穿搭术;7;805;812;21673;0.037465971485258154
平安曲靖;11;13;24;21673;0.0011073686153278272
葛归愚;1;1;2;21673;9.22807179439856e-05
flmoon2020;1;1;2;21673;9.22807179439856e-05
做一只合格的鹰;22;6;28;21673;0.0012919300512157985
梓兮梓沐;2;1;3;21673;0.0001384210769159784
舒芙蕾的梦;2;1;3;21673;0.0001384210769159784
云南平安高速;5;10;15;21673;0.0006921053845798921
慧腐烂的心QY;8;9;17;21673;0.0007843861025238776
东东大声说;1;1;2;21673;9.22807179439856e-05
Yu芋圆煮好没;4;3;7;21673;0.0003229825128039496
季春桃良;5;16;21;21673;0.0009689475384118488
·Cydonian·;1;6;7;21673;0.0003229825128039496
白狗脫壳;1;8;9;21673;0.0004152632307479352
陳企鵝_Patty;3;6;9;21673;0.0004152632307479352
一勺含春;7;131;138;21673;0.0063673695381350065
咬一口桃桃冰淇淋;1;1;2;21673;9.22807179439856e-05
浅安1333;3;7;10;21673;0.00046140358971992804
浅安1333;6;8;14;21673;0.0006459650256078992
憨憨的奇异果果;208;1;209;21673;0.009643335025146495
阿贵时评;53;60;113;21673;0.005213860563835187
刘亦菲家小猫咪;3;4;7;21673;0.0003229825128039496
嘿嘿-嘻嘻-哈哈-吼吼;78;156;234;21673;0.010796843999446316
程思斐考研四六级;7;154;161;21673;0.0074285977944908415
北回归线看海;1;1;2;21673;9.22807179439856e-05
月雫_行舟中-;3;1;4;21673;0.0001845614358879712
冲浪阿秋;0;4;4;21673;0.0001845614358879712
cy万事顺毅;117;16;133;21673;0.006136667743275042
回毅的缺角;65;30;95;21673;0.004383334102339316
奢华汽车控;464;2575;3039;21673;0.14022055091588612
酒窝男孩成长记;2;1;3;21673;0.0001384210769159784
蜜瓜包經銷金閃閃;1;6;7;21673;0.0003229825128039496
晚时听月;1;10;11;21673;0.0005075439486919209
彩云校园圈;1;1;2;21673;9.22807179439856e-05
彩云校园圈;1;1;2;21673;9.22807179439856e-05
陳企鵝_Patty;1;4;5;21673;0.00023070179485996402
彩云校园圈;2;1;3;21673;0.0001384210769159784
彩云校园圈;1;2;3;21673;0.0001384210769159784
菠萝饼干炒饭;1;2;3;21673;0.0001384210769159784
云南平安高速;10;12;22;21673;0.0010150878973838417
Kiss-派宝巴宝;6;12;18;21673;0.0008305264614958704
小殿下无心;56;39;95;21673;0.004383334102339316
水苑南;3;4;7;21673;0.0003229825128039496
随和的孤人席809;2;1;3;21673;0.0001384210769159784
兔兔是有钱;229;8;237;21673;0.010935265076362295
东哥到处走;134;241;375;21673;0.0173026346144973
火红的沙棘花儿;6;31;37;21673;0.0017071932819637337
岁杪初十;2;6;8;21673;0.0003691228717759424
秋水一鴻;1;1;2;21673;9.22807179439856e-05
小果子琪6;6;8;14;21673;0.0006459650256078992
陳企鵝_Patty;2;4;6;21673;0.0002768421538319568
没菜扣肉酱;2;2;4;21673;0.0001845614358879712
黑眼圈小神仙;1;2;3;21673;0.0001384210769159784
青宇_fighting;3;5;8;21673;0.0003691228717759424
慧腐烂的心QY;9;11;20;21673;0.0009228071794398561
高淳固城街道;21;19;40;21673;0.0018456143588797122
傅家媛可儿;109;65;174;21673;0.008028422461126748
飞花入境;1;1;2;21673;9.22807179439856e-05
飞花入境;1;1;2;21673;9.22807179439856e-05
小白团子A;116;147;263;21673;0.012134914409634106
紫衣人WBL;1;1;2;21673;9.22807179439856e-05
狂奔的小图;8;21;29;21673;0.0013380704101877913
心灵诗画;1;22;23;21673;0.0010612282563558343
将河流紧握于手;1;1;2;21673;9.22807179439856e-05
黄跳跳de美学分享;1;1;2;21673;9.22807179439856e-05
小阿兔蹦蹦跳;7;1;8;21673;0.0003691228717759424
某土匪;53;6;59;21673;0.0027222811793475754
木凡木可;1;1;2;21673;9.22807179439856e-05
踹你一脚就美了;1;4;5;21673;0.00023070179485996402
藤椒挂钩;7;8;15;21673;0.0006921053845798921
----Solitude----;1;1;2;21673;9.22807179439856e-05
恐龙大白鲨;3;12;15;21673;0.0006921053845798921
久西鸥;1;10;11;21673;0.0005075439486919209
tricoder;5;8;13;21673;0.0005998246666359064
银河尽头的yu;5;5;10;21673;0.00046140358971992804
125玛卡巴卡;1;1;2;21673;9.22807179439856e-05
阳阳y_kun;93;11;104;21673;0.004798597333087251
小冰55912;1;1;2;21673;9.22807179439856e-05
有仙则灵825;1;2;3;21673;0.0001384210769159784
邻家焉得许多兔兔;2;4;6;21673;0.0002768421538319568
棣峂遇琪日;8;10;18;21673;0.0008305264614958704
wind风筝有风;3;17;20;21673;0.0009228071794398561
男性美女bot;15;129;144;21673;0.0066442116919669635
阿华田是个饕餮客重生版;1;51;52;21673;0.0023992986665436256
走走停停2173;1;6;7;21673;0.0003229825128039496
urnot坒夏;2;1;3;21673;0.0001384210769159784
kkkqi2;1;3;4;21673;0.0001845614358879712
典籍里的中国;2;47;49;21673;0.002260877589627647
好一个粥;1;1;2;21673;9.22807179439856e-05
央视一套;7;121;128;21673;0.005905965948415078
陌上风诗词;3;12;15;21673;0.0006921053845798921
什奇ccc;1;2;3;21673;0.0001384210769159784
你的猛1我的娇妻;1;18;19;21673;0.0008766668204678633
葛归愚;2;15;17;21673;0.0007843861025238776
你的猛1我的娇妻;1;7;8;21673;0.0003691228717759424
明月何时携你还;115;2;117;21673;0.005398421999723158
鹿畔曦阳_luhan420;13;6;19;21673;0.0008766668204678633
萍儿影;235;4;239;21673;0.01102754579430628
夕夕姐姐看脸;1;1;2;21673;9.22807179439856e-05
小七仔旅行日记;36;301;337;21673;0.015549300973561574
对言嘎嘎纯情;57;16;73;21673;0.0033682462049554746
Miss-沈小娴;642;2080;2722;21673;0.1255940571217644
Bhynascy;20;25;45;21673;0.0020763161537396763
Century_sun;18;49;67;21673;0.0030914040511235176
无名无姓清淡漂泊;225;1;226;21673;0.010427721127670373
xyses;2;57;59;21673;0.0027222811793475754
瘸心彦子;110;5;115;21673;0.005306141281779172
想见你只想见旎;1;1;2;21673;9.22807179439856e-05
捞起桃花的咸鱼;1;6;7;21673;0.0003229825128039496
在灵隐寺拉磨;1;1;2;21673;9.22807179439856e-05
tatakau;2;1;3;21673;0.0001384210769159784
MD_LEG;21;3;24;21673;0.0011073686153278272
对言嘎嘎纯情;2;3;5;21673;0.00023070179485996402
陳企鵝_Patty;3;3;6;21673;0.0002768421538319568
有兽焉漫画;28;446;474;21673;0.02187053015272459
魔婧果果;105;4;109;21673;0.005029299127947215
黄濑家的小舅妈喵;57;941;998;21673;0.046048078254048816
风堤归祎;17;37;54;21673;0.0024915793844876113
TF_CZ;5;2;7;21673;0.0003229825128039496
1Alone_ls;1;2;3;21673;0.0001384210769159784
长城炮;6;76;82;21673;0.00378350943570341
路过晚风吹行舟;3;30;33;21673;0.0015226318460757624
葛归愚;1;1;2;21673;9.22807179439856e-05
麻里麻麻的鱼;7;7;14;21673;0.0006459650256078992
慧腐烂的心QY;9;19;28;21673;0.0012919300512157985
云南平安高速;10;8;18;21673;0.0008305264614958704
Amberrr_Zzz;3;2;5;21673;0.00023070179485996402
_四次元_;1;2;3;21673;0.0001384210769159784
_四次元_;1;1;2;21673;9.22807179439856e-05
_四次元_;1;3;4;21673;0.0001845614358879712
汐漫在看星星吖;23;18;41;21673;0.001891754717851705
一一戒糖ing;1;1;2;21673;9.22807179439856e-05
孙鹤榕的妈妈;109;33;142;21673;0.006551930974022978
与辉遥;1;2;3;21673;0.0001384210769159784
Lukita_mio;5;1;6;21673;0.0002768421538319568
总角之好悄悄话bot;3;29;32;21673;0.0014764914871037696
-个几;1;2;3;21673;0.0001384210769159784
Mulberry酱;20;10;30;21673;0.0013842107691597841
小约翰可敦;8;40;48;21673;0.0022147372306556543
迁行枫竹居;4;18;22;21673;0.0010150878973838417
南楼樱花;2;6;8;21673;0.0003691228717759424
油煎干尸烩饭;1;1;2;21673;9.22807179439856e-05
太热了吗;3;7;10;21673;0.00046140358971992804
格子衫Nice13114;1;5;6;21673;0.0002768421538319568
吃掉这个红烧鸭头;1;13;14;21673;0.0006459650256078992
婚吕厨;2;2;4;21673;0.0001845614358879712
零玖氿;1;136;137;21673;0.006321229179163014
紫薯冰激凌_;2;5;7;21673;0.0003229825128039496
方尘Hikari;1;1;2;21673;9.22807179439856e-05
吃掉这个红烧鸭头;5;13;18;21673;0.0008305264614958704
折与叠;3;2;5;21673;0.00023070179485996402
彩云小梦Dream;5;10;15;21673;0.0006921053845798921
在下司空;1;12;13;21673;0.0005998246666359064
镜中记事;1;1;2;21673;9.22807179439856e-05
星空中鹰小懿;29;57;86;21673;0.003968070871591381
太宰梓童;5;7;12;21673;0.0005536843076639136
好耶lll;1;1;2;21673;9.22807179439856e-05
徒手摘星星喽;3;1;4;21673;0.0001845614358879712
West西边;1;2;3;21673;0.0001384210769159784
管人吃如何调理;1;2;3;21673;0.0001384210769159784
我是幸福逼;1;1;2;21673;9.22807179439856e-05
小羊不吃骨头999;23;20;43;21673;0.0019840354357956906
等閒無間;2;3;5;21673;0.00023070179485996402
今天你电子阳痿了吗;2;8;10;21673;0.00046140358971992804
太热了吗;1;2;3;21673;0.0001384210769159784
彩云小梦Dream;8;6;14;21673;0.0006459650256078992
猫头鹰嗯-镇魂;3;13;16;21673;0.0007382457435518848
月落江南_言;7;7;14;21673;0.0006459650256078992
吴谨言不翻我不改名;16;7;23;21673;0.0010612282563558343
吴谨言不翻我不改名;3;1;4;21673;0.0001845614358879712
吴谨言不翻我不改名;2;4;6;21673;0.0002768421538319568
吴谨言不翻我不改名;1;3;4;21673;0.0001845614358879712
吴谨言不翻我不改名;5;3;8;21673;0.0003691228717759424
吴谨言不翻我不改名;1;3;4;21673;0.0001845614358879712
睡不足de珊;1;1;2;21673;9.22807179439856e-05
锦鲤本梨是玖梨;2;1;3;21673;0.0001384210769159784
锦鲤本梨是玖梨;3;1;4;21673;0.0001845614358879712
可爱的奶盐卿;3;4;7;21673;0.0003229825128039496
夕夕姐姐攻略博;1;1;2;21673;9.22807179439856e-05
今天不喝奶茶0311;1;1;2;21673;9.22807179439856e-05
正能量de黄跳跳O;1;1;2;21673;9.22807179439856e-05
轻拾月光·听风声;4;5;9;21673;0.0004152632307479352
初见沐阳;3;1;4;21673;0.0001845614358879712
小仙男iPad养乐多;2;2;4;21673;0.0001845614358879712
二次元凝视男性bot;86;1760;1846;21673;0.08517510266229872
WanNan婉岚;1;13;14;21673;0.0006459650256078992
慧腐烂的心QY;9;5;14;21673;0.0006459650256078992
吴谨言不是搞笑女;5;3;8;21673;0.0003691228717759424
陳企鵝_Patty;4;2;6;21673;0.0002768421538319568
可一不可再yay;1;2;3;21673;0.0001384210769159784
商丘医专微校园;5;11;16;21673;0.0007382457435518848
spend盐;4;1;5;21673;0.00023070179485996402
山野念川y;7;9;16;21673;0.0007382457435518848
-酌幂難寒月;6;18;24;21673;0.0011073686153278272
盐式夏日;8;5;13;21673;0.0005998246666359064
栀鸢悸屿_;5;1;6;21673;0.0002768421538319568
Y張好看;4;2;6;21673;0.0002768421538319568
陵鹤尤美;211;119;330;21673;0.015226318460757624
心念奶鹽;10;14;24;21673;0.0011073686153278272
-择一;2;7;9;21673;0.0004152632307479352
是王怀玉yu呀;14;21;35;21673;0.001614912564019748
天空树上的城堡;1;3;4;21673;0.0001845614358879712
DEAR樂然;12;21;33;21673;0.0015226318460757624
字体设计;3;76;79;21673;0.0036450883587874315
木兰心扉;2;3;5;21673;0.00023070179485996402
正能量的黄跳跳_;1;1;2;21673;9.22807179439856e-05
爱鱼丸丸的刺;27;26;53;21673;0.0024454390255156185
莹儿KKW;5;10;15;21673;0.0006921053845798921
新年伊始丶;6;6;12;21673;0.0005536843076639136
音浪剧;108;113;221;21673;0.01019701933281041
娱赞赞;114;142;256;21673;0.011811931896830156
_扬媚兔淇;5;4;9;21673;0.0004152632307479352
以帅治国方能长久;3;4;7;21673;0.0003229825128039496
千毅yi;92;100;192;21673;0.008858948922622617
追剧;511;1425;1936;21673;0.08932773496977807
娱文洛;100;107;207;21673;0.00955105430720251
追剧情报社;6;134;140;21673;0.006459650256078992
少女追剧指南;91;105;196;21673;0.009043510358510589
烫水的热嘴;708;1915;2623;21673;0.12102616158353711
剧综淡淡;104;104;208;21673;0.009597194666174503
剧综哇哇;103;119;222;21673;0.010243159691782402
微博电视剧;111;413;524;21673;0.024177548101324227
星空下的萤火虫___;10;14;24;21673;0.0011073686153278272
你好呀我的宠爱;1;2;3;21673;0.0001384210769159784
木兰心扉;2;2;4;21673;0.0001845614358879712
剧迷成团;23;307;330;21673;0.015226318460757624
我变一颗凌檬;10;113;123;21673;0.005675264153555115
旎的小小小可爱;9;12;21;21673;0.0009689475384118488
·不用长大;7;3;10;21673;0.00046140358971992804
想在五斤盐睫毛上荡秋千;6;3;9;21673;0.0004152632307479352
太龙宫主;1;3;4;21673;0.0001845614358879712
北北北小方;7;37;44;21673;0.0020301757947676835
亦生亦心珍茜你;1;1;2;21673;9.22807179439856e-05
闪电泡芙饼干;3;9;12;21673;0.0005536843076639136
燕野行;6;6;12;21673;0.0005536843076639136
_落雨羡鱼;1;6;7;21673;0.0003229825128039496
且行且歌Aaron;6;21;27;21673;0.0012457896922438056
灰灰有娱;2;2;4;21673;0.0001845614358879712
Lyreair;1;26;27;21673;0.0012457896922438056
洛阳师范学院微博协会;1;2;3;21673;0.0001384210769159784
雪魔武卫小莫离;7;37;44;21673;0.0020301757947676835
南瓜味礼帽;1;2;3;21673;0.0001384210769159784
火力橙现;132;2;134;21673;0.006182808102247035
南瓜味礼帽;3;1;4;21673;0.0001845614358879712
存够100万就退休;3;7;10;21673;0.00046140358971992804
吃娱的蟹老板;3;55;58;21673;0.0026761408203755826
蓝色王毛毛;2;2;4;21673;0.0001845614358879712
云呢拿小卖部;2;1;3;21673;0.0001384210769159784
开开开开开得了;1;3;4;21673;0.0001845614358879712
猫九九爱六六;1;4;5;21673;0.00023070179485996402
考古娱乐圈;4;14;18;21673;0.0008305264614958704
陳企鵝_Patty;6;3;9;21673;0.0004152632307479352
幸运草Angelina;20;5;25;21673;0.00115350897429982
我需要2颗西柚;4;1;5;21673;0.00023070179485996402
热恋言_;11;3;14;21673;0.0006459650256078992
用户阿现小酷宝;3;3;6;21673;0.0002768421538319568
星空下的萤火虫___;9;9;18;21673;0.0008305264614958704
薛薛de猫;1;2;3;21673;0.0001384210769159784
观海等风来2022;3;3;6;21673;0.0002768421538319568
李现工作室;2673;19000;21673;21673;1.0
心念奶鹽;10;10;20;21673;0.0009228071794398561
刘亦菲小龙女lyf;2;4;6;21673;0.0002768421538319568
岂曰无衣·2146;51;14;65;21673;0.002999123333179532
毅淇一生-0517;23;4;27;21673;0.0012457896922438056
树梅zzzz;1;1;2;21673;9.22807179439856e-05
昆明五华发布;3;1;4;21673;0.0001845614358879712
傅诗淇玲儿;110;7;117;21673;0.005398421999723158
-耀和玺一起看海-;4;6;10;21673;0.00046140358971992804
青罗劳;1;1;2;21673;9.22807179439856e-05
傅总宝儿;1;2;3;21673;0.0001384210769159784
一一戒糖ing;1;1;2;21673;9.22807179439856e-05
想吃一颗盐;6;2;8;21673;0.0003691228717759424
有盐才好吃啊;8;3;11;21673;0.0005075439486919209
酒醉的蝴蝶__;8;3;11;21673;0.0005075439486919209
异于你的我;8;2;10;21673;0.00046140358971992804
思雨丁;9;5;14;21673;0.0006459650256078992
816號候車厅;8;3;11;21673;0.0005075439486919209
清枝吟Spoil;97;155;252;21673;0.011627370460942187
去话-海吧;3;3;6;21673;0.0002768421538319568
沈吟未绝;3;5;8;21673;0.0003691228717759424
怂到躲开奶盐正视的钧倪;7;9;16;21673;0.0007382457435518848
长安不困;3;16;19;21673;0.0008766668204678633
栀鸢悸屿_;3;1;4;21673;0.0001845614358879712
可爱的奶盐卿;12;11;23;21673;0.0010612282563558343
云南平安高速;7;10;17;21673;0.0007843861025238776
栀鸢悸屿_;5;6;11;21673;0.0005075439486919209
沏茶小小盐;3;2;5;21673;0.00023070179485996402
东营广播电视台;3;9;12;21673;0.0005536843076639136
慧腐烂的心QY;22;10;32;21673;0.0014764914871037696
董慕幂;36;36;72;21673;0.0033221058459834817
糖糖糖果颖;8;11;19;21673;0.0008766668204678633
冬曼祀言境;5;3;8;21673;0.0003691228717759424
虞-祎安JSjjyl;35;19;54;21673;0.0024915793844876113
-酌幂難寒月;3;3;6;21673;0.0002768421538319568
永吴止尽的爱言;4;10;14;21673;0.0006459650256078992
世盼望;37;153;190;21673;0.008766668204678632
华莱士吃了拉肚子战士;1;1;2;21673;9.22807179439856e-05
AlainProust;2;1;3;21673;0.0001384210769159784
包子瑜;3;25;28;21673;0.0012919300512157985
海盐风铃草;9;32;41;21673;0.001891754717851705
茜茜00后粉丝;27;51;78;21673;0.0035989479998154387
红豆盼盼;3;1;4;21673;0.0001845614358879712
b盐味302橘汁c302;20;27;47;21673;0.0021685968716836615
少年JUMP吧;15;271;286;21673;0.013196142665989941
小吴会wink;10;15;25;21673;0.00115350897429982
有盐才好吃啊;12;9;21;21673;0.0009689475384118488
Aries_肆;222;18;240;21673;0.011073686153278273
816號候車厅;8;3;11;21673;0.0005075439486919209
热恋言_;11;7;18;21673;0.0008305264614958704
吾愛Gillian;2;4;6;21673;0.0002768421538319568
思雨丁;7;2;9;21673;0.0004152632307479352
异于你的我;6;5;11;21673;0.0005075439486919209
是王怀玉yu呀;11;17;28;21673;0.0012919300512157985
hooooay;1;1;2;21673;9.22807179439856e-05
万千的崽崽;1;2;3;21673;0.0001384210769159784
Yanagi_6分間休憩;4;3;7;21673;0.0003229825128039496
彩云小梦Dream;1;10;11;21673;0.0005075439486919209
夏木折葵;1;5;6;21673;0.0002768421538319568
哦呓呦;3;15;18;21673;0.0008305264614958704
怎么这么多烊;3;125;128;21673;0.005905965948415078
哈雷酱_;2;1;3;21673;0.0001384210769159784
Sa娇的午后红茶;10;56;66;21673;0.0030452636921515248
宇璐jy;2;11;13;21673;0.0005998246666359064
星辰与大海_心上人;2;1;3;21673;0.0001384210769159784
chjming;14;73;87;21673;0.004014211230563374
风过无痕dear;11;7;18;21673;0.0008305264614958704
abanger;1;5;6;21673;0.0002768421538319568
醒醒汤;2;23;25;21673;0.00115350897429982
krss彤;1;6;7;21673;0.0003229825128039496
正半轴有解;1;1;2;21673;9.22807179439856e-05
晴噗噗;1;1;2;21673;9.22807179439856e-05
正能量的黄跳跳;1;1;2;21673;9.22807179439856e-05
西北师大附中;6;17;23;21673;0.0010612282563558343
紫衣z云梦;212;15;227;21673;0.010473861486642366
川西野猴;5;34;39;21673;0.0017994739999077193
美琴方hmk;4;32;36;21673;0.0016610529229917409
nh海纳百川;1;2;3;21673;0.0001384210769159784
Fong110;2;36;38;21673;0.0017533336409357265
汕头气象爱好者;8;72;80;21673;0.0036912287177594243
大强聊娱乐;4;13;17;21673;0.0007843861025238776
商丘医专微校园;33;193;226;21673;0.010427721127670373
祎个阿惗ye;2;4;6;21673;0.0002768421538319568
超爱吃煲仔饭的迪迪;2;1;3;21673;0.0001384210769159784
Fong110;1;35;36;21673;0.0016610529229917409
墨律;3;18;21;21673;0.0009689475384118488
江婷L易只肥鹤;7;1;8;21673;0.0003691228717759424
可爱的奶盐卿;8;7;15;21673;0.0006921053845798921
蹦-迪迪;1;4;5;21673;0.00023070179485996402
Tloml_WJY;26;112;138;21673;0.0063673695381350065
司凤永远的白月光;3;3;6;21673;0.0002768421538319568
中原-老张;63;75;138;21673;0.0063673695381350065
雨中梅儿香;3;1;4;21673;0.0001845614358879712
心念奶鹽;6;8;14;21673;0.0006459650256078992
红楼梦bot;11;82;93;21673;0.00429105338439533
茟梨-;7;23;30;21673;0.0013842107691597841
spend盐;5;4;9;21673;0.0004152632307479352
有人字拖的夏天;1;1;2;21673;9.22807179439856e-05
厦门文旅;4;5;9;21673;0.0004152632307479352
彩云天气;16;10;26;21673;0.0011996493332718128
舞着萌着啦;10;3;13;21673;0.0005998246666359064
陳企鵝_Patty;3;3;6;21673;0.0002768421538319568
是王红蓝呀;1;2;3;21673;0.0001384210769159784
亚妮伪物语;2;39;41;21673;0.001891754717851705
国家大剧院;30;60;90;21673;0.004152632307479353
爱淇毅8989;18;12;30;21673;0.0013842107691597841
Candy_小惠;12;18;30;21673;0.0013842107691597841
厦门广电;23;194;217;21673;0.010012457896922438
代找_难找汁源;2;1;3;21673;0.0001384210769159784
L_wuuu;1;4;5;21673;0.00023070179485996402
哥宝宝你可以的fffffffff1;1;1;2;21673;9.22807179439856e-05
戏精茶茶子;28;23;51;21673;0.002353158307571633
大强聊娱乐;5;12;17;21673;0.0007843861025238776
小李儿妹;1;1;2;21673;9.22807179439856e-05
云呢拿小卖部;5;1;6;21673;0.0002768421538319568
Candy_小惠;10;9;19;21673;0.0008766668204678633
perounce7;5;2;7;21673;0.0003229825128039496
宇宙中心cc;3;2;5;21673;0.00023070179485996402
sagil的一名小透明;2;6;8;21673;0.0003691228717759424
小游不游-0508;5;11;16;21673;0.0007382457435518848
陳企鵝_Patty;2;2;4;21673;0.0001845614358879712
永吴止尽的爱言;4;11;15;21673;0.0006921053845798921
xiao银;1;1;2;21673;9.22807179439856e-05
日尧雨路Pricer;51;542;593;21673;0.02736123287039173
可爱的奶盐卿;9;5;14;21673;0.0006459650256078992
一只吃土喵呀;6;1;7;21673;0.0003229825128039496
盐式夏日;3;1;4;21673;0.0001845614358879712
与盐相随H;4;3;7;21673;0.0003229825128039496
夕夕姐姐攻略博;1;1;2;21673;9.22807179439856e-05
_湾藕汁夹;1;4;5;21673;0.00023070179485996402
语花-蝶;122;1;123;21673;0.005675264153555115
_清亦;20;75;95;21673;0.004383334102339316
mendlsiii;1;4;5;21673;0.00023070179485996402
冰城心凌男孩;1;2;3;21673;0.0001384210769159784
历史探秘;4;65;69;21673;0.0031836847690675033
沂蒙山上一匹狼;5;51;56;21673;0.002583860102431597
Hercules-Girl;1;1;2;21673;9.22807179439856e-05
别岚我sa娇;135;2383;2518;21673;0.11618142389147787
你马了嘎比;3;38;41;21673;0.001891754717851705
希光bot;1;1;2;21673;9.22807179439856e-05
星空下的萤火虫___;6;10;16;21673;0.0007382457435518848
问问夕夕姐姐;1;1;2;21673;9.22807179439856e-05
闹脾气的狮子座;67;52;119;21673;0.005490702717667144
spend盐;4;2;6;21673;0.0002768421538319568
娱乐吃瓜小可爱;1;4;5;21673;0.00023070179485996402
嗷呜口九;26;111;137;21673;0.006321229179163014
整圈儿美悦宝;1;1;2;21673;9.22807179439856e-05
夏夏沐沐601;4;2;6;21673;0.0002768421538319568
魚颂谙--;2;3;5;21673;0.00023070179485996402
长安不困;3;6;9;21673;0.0004152632307479352
十八保送北大;1;1;2;21673;9.22807179439856e-05
过雨开楼看晚虹1640;12;3;15;21673;0.0006921053845798921
中国移动安徽公司;4;8;12;21673;0.0005536843076639136
慧腐烂的心QY;12;9;21;21673;0.0009689475384118488
星空落在银河亦是我会珍惜的人;70;677;747;21673;0.03446684815207862
小综小艺小雨;1;2;3;21673;0.0001384210769159784
Sa嬌紀念冊_CharleneGillian;45;401;446;21673;0.02057860010150879
执笔绘卿城_;3;14;17;21673;0.0007843861025238776
子饮;1;5;6;21673;0.0002768421538319568
蛋蛋手可摘星辰;9;1;10;21673;0.00046140358971992804
飒漫画官方微博;1;36;37;21673;0.0017071932819637337
我变一颗凌檬;13;166;179;21673;0.008259124255986712
栀鸢悸屿_;3;5;8;21673;0.0003691228717759424
逸時無兩丨Y;48;331;379;21673;0.017487196050385272
-酌幂難寒月;7;18;25;21673;0.00115350897429982
BJ雍秦2;1;2;3;21673;0.0001384210769159784
永吴止尽的爱言;9;23;32;21673;0.0014764914871037696
ChoisaList·蔡卓妍物料集;23;108;131;21673;0.006044387025331057
怎么起能用呢3333;8;46;54;21673;0.0024915793844876113
lettofhjklj;4;2;6;21673;0.0002768421538319568
Peter连li;1;7;8;21673;0.0003691228717759424
落葉秋風dcw;1;8;9;21673;0.0004152632307479352
俊八登月实验室;6;53;59;21673;0.0027222811793475754
言式记y;4;15;19;21673;0.0008766668204678633
火热xyz_Astraeus;13;2;15;21673;0.0006921053845798921
Whisperwordz;1;1;2;21673;9.22807179439856e-05
miraclepill;2;2;4;21673;0.0001845614358879712
Shirleyyylll;4;8;12;21673;0.0005536843076639136
不到120不改名_坚定决心版;13;40;53;21673;0.0024454390255156185
正能量的黄跳跳__;1;1;2;21673;9.22807179439856e-05
星光遇璐丶;30;182;212;21673;0.009781756102062474
Cyndilovestocreate;11;158;169;21673;0.007797720666266783
Rain-Cyndi;28;205;233;21673;0.010750703640474323
DC小蛋壳;4;4;8;21673;0.0003691228717759424
想吃一颗盐;5;3;8;21673;0.0003691228717759424
酒醉的蝴蝶__;5;3;8;21673;0.0003691228717759424
FlyingSHE;11;55;66;21673;0.0030452636921515248
有盐才好吃啊;5;3;8;21673;0.0003691228717759424
异于你的我;5;4;9;21673;0.0004152632307479352
Sa娇的午后红茶;20;377;397;21673;0.018317722511881143
也趁月光_;1;1;2;21673;9.22807179439856e-05
816號候車厅;6;4;10;21673;0.00046140358971992804
什么小蛋挞x;5;26;31;21673;0.001430351128131777
Sreadlys;19;114;133;21673;0.006136667743275042
浦东发布;3;3;6;21673;0.0002768421538319568
布瓜pourquoiv;209;1;210;21673;0.009689475384118488
四平校园;2;6;8;21673;0.0003691228717759424
爆款噗噗鹅;3;3;6;21673;0.0002768421538319568
凭山临水;5;6;11;21673;0.0005075439486919209
牙牙木木夕;1;1;2;21673;9.22807179439856e-05
心念奶鹽;5;7;12;21673;0.0005536843076639136
清茗依心yo;3;3;6;21673;0.0002768421538319568
啊喵喵喵呜咪;98;57;155;21673;0.0071517556406588845
半价薯片-;1;11;12;21673;0.0005536843076639136
是林未央呀;1;9;10;21673;0.00046140358971992804
成都共青团;3;5;8;21673;0.0003691228717759424
青春湖北;14;2;16;21673;0.0007382457435518848
潍坊文旅;4;3;7;21673;0.0003229825128039496
音箱蟀大侠_;14;29;43;21673;0.0019840354357956906
廊坊师范学院微博协会;1;13;14;21673;0.0006459650256078992
可爱的奶盐卿;5;3;8;21673;0.0003691228717759424
四川交警;35;22;57;21673;0.0026300004614035898
风过无痕dear;3;1;4;21673;0.0001845614358879712
-BBBB女;1;1;2;21673;9.22807179439856e-05
慧腐烂的心QY;8;3;11;21673;0.0005075439486919209
安阳市第二十五中学;1;7;8;21673;0.0003691228717759424
Longlivelau;2;1;3;21673;0.0001384210769159784
手起刀落不留情;21;86;107;21673;0.00493701841000323
狮与麒;1;1;2;21673;9.22807179439856e-05
来宾共青团;21;122;143;21673;0.006598071332994971
DEAR樂然;82;180;262;21673;0.012088774050662113
滁州公安在线;2;1;3;21673;0.0001384210769159784
DKD-FUTURE;2;1;3;21673;0.0001384210769159784
悄悄溜过来的猫儿;24;6;30;21673;0.0013842107691597841
傅诗淇的眼里有星河;112;6;118;21673;0.005444562358695151
顶风望月;5;17;22;21673;0.0010150878973838417
926梁溪之声广播;1;1;2;21673;9.22807179439856e-05
来一杯蜜桃吴龙茶;117;54;171;21673;0.00789000138421077
人民日报数字传播;1;2;3;21673;0.0001384210769159784
·不用长大;5;2;7;21673;0.0003229825128039496
西铁资讯;7;12;19;21673;0.0008766668204678633
小草莓果酱·;5;2;7;21673;0.0003229825128039496
想在五斤盐睫毛上荡秋千;6;2;8;21673;0.0003691228717759424
远方de你丶;4;2;6;21673;0.0002768421538319568
兰州文化旅游;53;46;99;21673;0.004567895538227287
Mr夏赤赤;22;154;176;21673;0.008120703179070734
非耦合解;4;38;42;21673;0.0019378950768236976
北京晚报;1;4;5;21673;0.00023070179485996402
当阳检察;94;61;155;21673;0.0071517556406588845
栀鸢悸屿_;5;6;11;21673;0.0005075439486919209
栀鸢悸屿_;6;4;10;21673;0.00046140358971992804
北京日报;2;9;11;21673;0.0005075439486919209
夕夕姐姐攻略bo;1;1;2;21673;9.22807179439856e-05
内蒙古反邪教;6;4;10;21673;0.00046140358971992804
Toywang2011;-8;1;-7;21673;-0.0003229825128039496
Candy_小惠;11;17;28;21673;0.0012919300512157985
可爱的奶盐卿;9;7;16;21673;0.0007382457435518848
慕容姐姐1005;110;7;117;21673;0.005398421999723158
吴谨言FashionNotes导航;27;96;123;21673;0.005675264153555115
北京发布;2;7;9;21673;0.0004152632307479352
西绯月;2;2;4;21673;0.0001845614358879712
大果粒吼哈;1;7;8;21673;0.0003691228717759424
spend盐;7;5;12;21673;0.0005536843076639136
凌晨3点26分说爱你;1;3;4;21673;0.0001845614358879712
Bettyzzzzz_;1;1;2;21673;9.22807179439856e-05
嘀哩哩哒噼里啪啦;2;13;15;21673;0.0006921053845798921
竹已__;7;31;38;21673;0.0017533336409357265
嗷呜口九;10;13;23;21673;0.0010612282563558343
慕容1005;110;7;117;21673;0.005398421999723158
行走的海风;1;15;16;21673;0.0007382457435518848
Candy_小惠;6;9;15;21673;0.0006921053845798921
橙桔橙色;7;8;15;21673;0.0006921053845798921
警犬铲屎官;6;26;32;21673;0.0014764914871037696
盐式夏日;9;3;12;21673;0.0005536843076639136
蘅梅同梦;1;5;6;21673;0.0002768421538319568
英皇老爷车;3;1;4;21673;0.0001845614358879712
夏夏沐沐601;2;2;4;21673;0.0001845614358879712
Ares彩云;2;2;4;21673;0.0001845614358879712
幻彩旧影RR_;6;60;66;21673;0.0030452636921515248
顶风望月;5;10;15;21673;0.0006921053845798921
珍珠珍珠爱读书;1;3;4;21673;0.0001845614358879712
老王老王v你最强;5;36;41;21673;0.001891754717851705
小王子的1019朵玫瑰花;4;187;191;21673;0.008812808563650625
阿凯说要相信光;7;4;11;21673;0.0005075439486919209
轻拾月光·听风声;3;2;5;21673;0.00023070179485996402
看剧;102;518;620;21673;0.028607022562635538
初见沐阳;3;3;6;21673;0.0002768421538319568
圈内观众;96;517;613;21673;0.028284040049831587
我哩脑壳已死机;107;552;659;21673;0.030406496562543257
追星少女柳飘飘;103;325;428;21673;0.01974807364001292
藏地牧羊人;2;6;8;21673;0.0003691228717759424
埃菲尔上的铁塔梦-17;7;5;12;21673;0.0005536843076639136
圈内指南;195;534;729;21673;0.033636321690582754
可爱的奶盐卿;6;2;8;21673;0.0003691228717759424
印象彩云南;1;6;7;21673;0.0003229825128039496
小吴会wink;9;11;20;21673;0.0009228071794398561
Candy_小惠;13;17;30;21673;0.0013842107691597841
我需要2颗西柚;5;2;7;21673;0.0003229825128039496
影视圈大魔王;220;356;576;21673;0.026576846767867854
马栏山综艺资讯;152;1411;1563;21673;0.07211738107322475
白樱许桃鹿;20;11;31;21673;0.001430351128131777
马栏山综艺资讯;50;415;465;21673;0.021455266921976652
crystal_ovo_17;1;1;2;21673;9.22807179439856e-05
与盐相随H;5;1;6;21673;0.0002768421538319568
陳企鵝_Patty;4;2;6;21673;0.0002768421538319568
不想每天黑眼圈;1;4;5;21673;0.00023070179485996402
王樱桃WW;1;2;3;21673;0.0001384210769159784
江苏娱乐头条;2;6;8;21673;0.0003691228717759424
Fong110;5;6;11;21673;0.0005075439486919209
唯icc茜;4;2;6;21673;0.0002768421538319568
网易云音乐;10;30;40;21673;0.0018456143588797122
心念奶鹽;11;18;29;21673;0.0013380704101877913
紫云阿姨的围脖;2;7;9;21673;0.0004152632307479352
L_wuuu;3;19;22;21673;0.0010150878973838417
若有若无之间;7;11;18;21673;0.0008305264614958704
星空下的萤火虫___;7;16;23;21673;0.0010612282563558343
酒醉的蝴蝶__;2;1;3;21673;0.0001384210769159784
想吃一颗盐;3;1;4;21673;0.0001845614358879712
异于你的我;2;3;5;21673;0.00023070179485996402
思雨丁;2;3;5;21673;0.00023070179485996402
816號候車厅;2;3;5;21673;0.00023070179485996402
永吴止尽的爱言;8;8;16;21673;0.0007382457435518848
吴谨言的大白;46;123;169;21673;0.007797720666266783
叶白芷颜;19;7;26;21673;0.0011996493332718128
不正经的奶茶火锅;1;2;3;21673;0.0001384210769159784
萝卜乔儿;65;36;101;21673;0.004660176256171273
陳企鵝_Patty;1;2;3;21673;0.0001384210769159784
中医太美;1;16;17;21673;0.0007843861025238776
为爱发电的一天;7;2;9;21673;0.0004152632307479352
围脖情感语录;1;10;11;21673;0.0005075439486919209
奔跑的锅包肉r;106;150;256;21673;0.011811931896830156
Kelly_予禾;54;9;63;21673;0.0029068426152355467
慧腐烂的心QY;18;16;34;21673;0.0015687722050477552
刘亦菲小龙女lyf;2;5;7;21673;0.0003229825128039496
商丘医专微校园;41;156;197;21673;0.009089650717482581
热恋言_;10;7;17;21673;0.0007843861025238776
茗素9513;69;19;88;21673;0.004060351589535367
海米-玉染;5;23;28;21673;0.0012919300512157985
叶白芷颜;22;3;25;21673;0.00115350897429982
改名换姓就不会再找到我;2;1;3;21673;0.0001384210769159784
樱木_道花明寺;1;3;4;21673;0.0001845614358879712
酱茄子__;1;19;20;21673;0.0009228071794398561
大大金小小gil;2;2;4;21673;0.0001845614358879712
梦倩li;2;2;4;21673;0.0001845614358879712
超爱喝烧仙草的迪迪;-6;1;-5;21673;-0.00023070179485996402
毅淇加油0517-;6;7;13;21673;0.0005998246666359064
清茗依心yo;6;3;9;21673;0.0004152632307479352
只饮一杯水;2;1;3;21673;0.0001384210769159784
闲房什么时候去打FFT;1;5;6;21673;0.0002768421538319568
讨厌吃南瓜饭的迪迪;4;3;7;21673;0.0003229825128039496
慧腐烂的心QY;9;2;11;21673;0.0005075439486919209
-婧婧哇-;1;1;2;21673;9.22807179439856e-05
中国农业大学;4;12;16;21673;0.0007382457435518848
青宇_fighting;3;1;4;21673;0.0001845614358879712
booxyz;10;13;23;21673;0.0010612282563558343
风过无痕dear;3;3;6;21673;0.0002768421538319568
可爱的奶盐卿;5;2;7;21673;0.0003229825128039496
明治爱喝矿泉水;7;8;15;21673;0.0006921053845798921
一个想了半天凑了十五个字的昵称;1;1;2;21673;9.22807179439856e-05
盐式夏日;4;2;6;21673;0.0002768421538319568
池汐66;5;6;11;21673;0.0005075439486919209
北京老杨68;1;1;2;21673;9.22807179439856e-05
想吃一个烤地瓜;1;6;7;21673;0.0003229825128039496
商丘医专微校园;34;170;204;21673;0.009412633230286531
英语情诗表白;8;1011;1019;21673;0.047017025792460664
又枝梨花予;108;16;124;21673;0.005721404512527108
scarlettvioleting;124;2;126;21673;0.0058136852304710935
秦谨Nice;4;5;9;21673;0.0004152632307479352
巧克力张张包-Aurora;4;6;10;21673;0.00046140358971992804
有盐才好吃啊;7;4;11;21673;0.0005075439486919209
想吃一颗盐;8;3;11;21673;0.0005075439486919209
酒醉的蝴蝶__;6;2;8;21673;0.0003691228717759424
异于你的我;6;5;11;21673;0.0005075439486919209
816號候車厅;7;3;10;21673;0.00046140358971992804
思雨丁;5;3;8;21673;0.0003691228717759424
小敏爱战;114;3;117;21673;0.005398421999723158
诺-小朱;94;74;168;21673;0.00775158030729479
聽丸心妮碎碎念;312;265;577;21673;0.02662298712683985
淇珍毅宝Qq;10;10;20;21673;0.0009228071794398561
萧强-摄影;1;2;3;21673;0.0001384210769159784
傻子的左手;21;407;428;21673;0.01974807364001292
喵喵教永不言败;2;1;3;21673;0.0001384210769159784
谕她乘风;4;10;14;21673;0.0006459650256078992
陳企鵝_Patty;8;5;13;21673;0.0005998246666359064
_哇噻Y_;7;6;13;21673;0.0005998246666359064
南瓜味礼帽;1;2;3;21673;0.0001384210769159784
羽翼落入叻星河;2;1;3;21673;0.0001384210769159784
气定神闲的生活;1;1;2;21673;9.22807179439856e-05
昆明铁路;1;1;2;21673;9.22807179439856e-05
青宇家的念博吖;7;10;17;21673;0.0007843861025238776
与盐相随H;9;3;12;21673;0.0005536843076639136
南京邮电大学;4;4;8;21673;0.0003691228717759424
香格里拉的奶酪;3;6;9;21673;0.0004152632307479352
sansandy33;2;1;3;21673;0.0001384210769159784
Fiona_ouyang;1;1;2;21673;9.22807179439856e-05
岁月先生·;12;15;27;21673;0.0012457896922438056
MICO刘为;3;20;23;21673;0.0010612282563558343
阿木古楞天籁女声;1;8;9;21673;0.0004152632307479352
天山网;3;6;9;21673;0.0004152632307479352
楚雄州政法;8;5;13;21673;0.0005998246666359064
Andyyang若若;1;2;3;21673;0.0001384210769159784
金银异尾;3;4;7;21673;0.0003229825128039496
crystal_ovo_17;1;1;2;21673;9.22807179439856e-05
娱圈冲浪;29;31;60;21673;0.0027684215383195683
要永远健康快乐;2;5;7;21673;0.0003229825128039496
想变成熟的丸心妮;19;189;208;21673;0.009597194666174503
天象爱好者;2;44;46;21673;0.0021224565127116687
与盐相随H;6;4;10;21673;0.00046140358971992804
小惊奇a;3;9;12;21673;0.0005536843076639136
一半痴情两份疯癫;1;4;5;21673;0.00023070179485996402
广东台触电新闻;28;1084;1112;21673;0.051308079176855995
触电文娱;85;1736;1821;21673;0.0840215936879989
陳企鵝_Patty;6;5;11;21673;0.0005075439486919209
村头霸王犬;0;3;3;21673;0.0001384210769159784
_哇噻Y_;6;1;7;21673;0.0003229825128039496
守护ing_1019;52;419;471;21673;0.02173210907580861
可爱的奶盐卿;7;5;12;21673;0.0005536843076639136
衙衙衙;8;10;18;21673;0.0008305264614958704
格格巫实验室_81939;2;3;5;21673;0.00023070179485996402
米修_just_cream;1;7;8;21673;0.0003691228717759424
暴躁香菜c;2;1;3;21673;0.0001384210769159784
梦中环游地球ing;1;9;10;21673;0.00046140358971992804
我大猪蹄子是我;1;1;2;21673;9.22807179439856e-05
奥紫花店;1;3;4;21673;0.0001845614358879712
猫猫S不吃鱼;1;2;3;21673;0.0001384210769159784
乐是雾城;4;3;7;21673;0.0003229825128039496
是小珺不是小君;1;3;4;21673;0.0001845614358879712
惊鸿一瞥1019;7;7;14;21673;0.0006459650256078992
小板凳-4MINUTES;1;3;4;21673;0.0001845614358879712
小板凳-4MINUTES;1;4;5;21673;0.00023070179485996402
云南政法;20;113;133;21673;0.006136667743275042
崔狗要做音乐;1;1;2;21673;9.22807179439856e-05
很困的生椰拿铁;1;3;4;21673;0.0001845614358879712
美乐不哭;14;77;91;21673;0.004198772666451345
娱甜宝;20;325;345;21673;0.015918423845337516
星空下的萤火虫___;14;35;49;21673;0.002260877589627647
膜法世家;11;27;38;21673;0.0017533336409357265
小登要加油;1;1;2;21673;9.22807179439856e-05
_芋泥半糖_;3;8;11;21673;0.0005075439486919209
不乖44261;2;8;10;21673;0.00046140358971992804
锦江法院;3;3;6;21673;0.0002768421538319568
爱琴海的鱼_22619;3;5;8;21673;0.0003691228717759424
喜羊羊oo8;4;12;16;21673;0.0007382457435518848
卡中的神;1;2;3;21673;0.0001384210769159784
商丘医专微校园;55;272;327;21673;0.015087897383841647
chjming;18;190;208;21673;0.009597194666174503
郑开心郑可爱郑美丽郑优秀;1;3;4;21673;0.0001845614358879712
慧腐烂的心QY;12;10;22;21673;0.0010150878973838417
Shelley的星星;112;1;113;21673;0.005213860563835187
哈鲁猫头;1;1;2;21673;9.22807179439856e-05
广州日报大洋网;1;1;2;21673;9.22807179439856e-05
淇开得胜毅往无前;110;13;123;21673;0.005675264153555115
好甜的报纸;6;6;12;21673;0.0005536843076639136
更坚持微笑要暖得像太阳_;2;3;5;21673;0.00023070179485996402
