label;一级评论;真实二级评论数;真实点赞数;边数;最大边数;集群密度
0;Gh上的二维码过期了，目前无法入群[微笑];1;0;1;79;0.012658227848101266
14;Gh上的二维码过期了，目前无法入群[微笑];1;0;1;79;0.012658227848101266
34;“肯恩解释了什么是多模态人工智能，它不仅可以将文本相应地翻译成图像，还可以翻译成音乐和视频。”;1;2;3;79;0.0379746835443038
40;“肯恩解释了什么是多模态人工智能，它不仅可以将文本相应地翻译成图像，还可以翻译成音乐和视频。”;1;2;3;79;0.0379746835443038
46;今晚直播吗？在哪里能看到[打脸];2;0;2;79;0.02531645569620253
53;那以后办公室里办公会不会很吵啊有点尴尬[笑cry];1;0;1;79;0.012658227848101266
76;@am药;1;0;1;79;0.012658227848101266
80;Microsoft365会不会要涨价了;1;0;1;79;0.012658227848101266
84;今晚直播吗？在哪里能看到[打脸];2;0;2;79;0.02531645569620253
91;那以后办公室里办公会不会很吵啊有点尴尬[笑cry];1;0;1;79;0.012658227848101266
114;@am药;1;0;1;79;0.012658227848101266
118;Microsoft365会不会要涨价了;1;0;1;79;0.012658227848101266
122;今晚直播吗？在哪里能看到[打脸];2;0;2;79;0.02531645569620253
129;那以后办公室里办公会不会很吵啊有点尴尬[笑cry];1;0;1;79;0.012658227848101266
152;@am药;1;0;1;79;0.012658227848101266
156;Microsoft365会不会要涨价了;1;0;1;79;0.012658227848101266
160;一键做出PPT真的是太幸福了吧，打工人节省了很多时间;18;47;65;79;0.8227848101265823
179;哇呀哇呀，这个我爱了，真的超级方便啊，好智能啊！[抓狂][抓狂][抓狂][抓狂];18;51;69;79;0.8734177215189873
198; 是不是意味着 我告诉他帮我写什么就可以了？我不用亲自动手了[哈哈];8;32;40;79;0.5063291139240507
207;直接生成ppt吗  太可以了  我的痛苦啊  ppt;5;8;13;79;0.16455696202531644
213;所以啊  互联网时代太厉害了 简直[赞][赞][赞];5;7;12;79;0.1518987341772152
219;人工智能是越来越厉害了，真的很方便了;4;7;11;79;0.13924050632911392
224;微软的这项技术，真的很牛，相信不久的将来，很多岗位要消失了;2;1;3;79;0.0379746835443038
227;非常方便的良心软件了，一键生成谁用谁省心啊[报税][报税][报税];2;0;2;79;0.02531645569620253
230;打工人的福音啊 解放双手 能快速提高工作效率[good];1;3;4;79;0.05063291139240506
232;这真的太好了吧，对于打工人来说是福音啊[打call][打call][打call][打call];1;2;3;79;0.0379746835443038
236;这就是打工人的福音吧[哈哈];2;2;4;79;0.05063291139240506
241;现在技术发展得也太快了吧，做PPT这么折磨人的事也能帮我们搞啦[打call];1;2;3;79;0.0379746835443038
244;这是真的很方便诶，工作的效率大大的提高了，太棒了[打call][打call];4;4;8;79;0.10126582278481013
256;还是挺不错的我觉得，非常实用的了;1;0;1;79;0.012658227848101266
263;现在人工智能这么厉害了[哆啦A梦害怕]我会不会被取代[单身狗];1;2;3;79;0.0379746835443038
308;工作党非常需要这么方便的办公软件[抓狂][抓狂][抓狂]期待发布会呀！[哇];1;2;3;79;0.0379746835443038
310;这也太棒了吧这样是不是以后会更方便啊我好期待啊[打call];1;1;2;79;0.02531645569620253
312;一键做出PPT真的是太幸福了吧，打工人节省了很多时间;18;47;65;79;0.8227848101265823
331;哇呀哇呀，这个我爱了，真的超级方便啊，好智能啊！[抓狂][抓狂][抓狂][抓狂];18;51;69;79;0.8734177215189873
350; 是不是意味着 我告诉他帮我写什么就可以了？我不用亲自动手了[哈哈];8;32;40;79;0.5063291139240507
359;直接生成ppt吗  太可以了  我的痛苦啊  ppt;5;8;13;79;0.16455696202531644
365;所以啊  互联网时代太厉害了 简直[赞][赞][赞];5;7;12;79;0.1518987341772152
371;人工智能是越来越厉害了，真的很方便了;4;7;11;79;0.13924050632911392
376;微软的这项技术，真的很牛，相信不久的将来，很多岗位要消失了;2;1;3;79;0.0379746835443038
379;非常方便的良心软件了，一键生成谁用谁省心啊[报税][报税][报税];2;0;2;79;0.02531645569620253
382;打工人的福音啊 解放双手 能快速提高工作效率[good];1;3;4;79;0.05063291139240506
384;这真的太好了吧，对于打工人来说是福音啊[打call][打call][打call][打call];1;2;3;79;0.0379746835443038
388;这就是打工人的福音吧[哈哈];2;2;4;79;0.05063291139240506
393;现在技术发展得也太快了吧，做PPT这么折磨人的事也能帮我们搞啦[打call];1;2;3;79;0.0379746835443038
396;这是真的很方便诶，工作的效率大大的提高了，太棒了[打call][打call];4;4;8;79;0.10126582278481013
408;还是挺不错的我觉得，非常实用的了;1;0;1;79;0.012658227848101266
415;现在人工智能这么厉害了[哆啦A梦害怕]我会不会被取代[单身狗];1;2;3;79;0.0379746835443038
460;工作党非常需要这么方便的办公软件[抓狂][抓狂][抓狂]期待发布会呀！[哇];1;2;3;79;0.0379746835443038
462;这也太棒了吧这样是不是以后会更方便啊我好期待啊[打call];1;1;2;79;0.02531645569620253
464;一键做出PPT真的是太幸福了吧，打工人节省了很多时间;18;47;65;79;0.8227848101265823
483;哇呀哇呀，这个我爱了，真的超级方便啊，好智能啊！[抓狂][抓狂][抓狂][抓狂];18;51;69;79;0.8734177215189873
502; 是不是意味着 我告诉他帮我写什么就可以了？我不用亲自动手了[哈哈];8;32;40;79;0.5063291139240507
511;直接生成ppt吗  太可以了  我的痛苦啊  ppt;5;8;13;79;0.16455696202531644
517;所以啊  互联网时代太厉害了 简直[赞][赞][赞];5;7;12;79;0.1518987341772152
523;人工智能是越来越厉害了，真的很方便了;4;7;11;79;0.13924050632911392
528;微软的这项技术，真的很牛，相信不久的将来，很多岗位要消失了;2;1;3;79;0.0379746835443038
531;非常方便的良心软件了，一键生成谁用谁省心啊[报税][报税][报税];2;0;2;79;0.02531645569620253
534;打工人的福音啊 解放双手 能快速提高工作效率[good];1;3;4;79;0.05063291139240506
536;这真的太好了吧，对于打工人来说是福音啊[打call][打call][打call][打call];1;2;3;79;0.0379746835443038
540;这就是打工人的福音吧[哈哈];2;2;4;79;0.05063291139240506
545;现在技术发展得也太快了吧，做PPT这么折磨人的事也能帮我们搞啦[打call];1;2;3;79;0.0379746835443038
548;这是真的很方便诶，工作的效率大大的提高了，太棒了[打call][打call];4;4;8;79;0.10126582278481013
560;还是挺不错的我觉得，非常实用的了;1;0;1;79;0.012658227848101266
567;现在人工智能这么厉害了[哆啦A梦害怕]我会不会被取代[单身狗];1;2;3;79;0.0379746835443038
612;工作党非常需要这么方便的办公软件[抓狂][抓狂][抓狂]期待发布会呀！[哇];1;2;3;79;0.0379746835443038
614;这也太棒了吧这样是不是以后会更方便啊我好期待啊[打call];1;1;2;79;0.02531645569620253
616;一键做出PPT真的是太幸福了吧，打工人节省了很多时间;18;47;65;79;0.8227848101265823
635;哇呀哇呀，这个我爱了，真的超级方便啊，好智能啊！[抓狂][抓狂][抓狂][抓狂];18;51;69;79;0.8734177215189873
654; 是不是意味着 我告诉他帮我写什么就可以了？我不用亲自动手了[哈哈];8;32;40;79;0.5063291139240507
663;直接生成ppt吗  太可以了  我的痛苦啊  ppt;5;8;13;79;0.16455696202531644
669;所以啊  互联网时代太厉害了 简直[赞][赞][赞];5;7;12;79;0.1518987341772152
675;人工智能是越来越厉害了，真的很方便了;4;7;11;79;0.13924050632911392
680;微软的这项技术，真的很牛，相信不久的将来，很多岗位要消失了;2;1;3;79;0.0379746835443038
683;非常方便的良心软件了，一键生成谁用谁省心啊[报税][报税][报税];2;0;2;79;0.02531645569620253
686;打工人的福音啊 解放双手 能快速提高工作效率[good];1;3;4;79;0.05063291139240506
688;这真的太好了吧，对于打工人来说是福音啊[打call][打call][打call][打call];1;2;3;79;0.0379746835443038
692;这就是打工人的福音吧[哈哈];2;2;4;79;0.05063291139240506
697;现在技术发展得也太快了吧，做PPT这么折磨人的事也能帮我们搞啦[打call];1;2;3;79;0.0379746835443038
700;这是真的很方便诶，工作的效率大大的提高了，太棒了[打call][打call];4;4;8;79;0.10126582278481013
712;还是挺不错的我觉得，非常实用的了;1;0;1;79;0.012658227848101266
719;现在人工智能这么厉害了[哆啦A梦害怕]我会不会被取代[单身狗];1;2;3;79;0.0379746835443038
764;工作党非常需要这么方便的办公软件[抓狂][抓狂][抓狂]期待发布会呀！[哇];1;2;3;79;0.0379746835443038
766;这也太棒了吧这样是不是以后会更方便啊我好期待啊[打call];1;1;2;79;0.02531645569620253
768;一键做出PPT真的是太幸福了吧，打工人节省了很多时间;18;47;65;79;0.8227848101265823
787;哇呀哇呀，这个我爱了，真的超级方便啊，好智能啊！[抓狂][抓狂][抓狂][抓狂];18;51;69;79;0.8734177215189873
806; 是不是意味着 我告诉他帮我写什么就可以了？我不用亲自动手了[哈哈];8;32;40;79;0.5063291139240507
815;直接生成ppt吗  太可以了  我的痛苦啊  ppt;5;8;13;79;0.16455696202531644
821;所以啊  互联网时代太厉害了 简直[赞][赞][赞];5;7;12;79;0.1518987341772152
827;人工智能是越来越厉害了，真的很方便了;4;7;11;79;0.13924050632911392
832;微软的这项技术，真的很牛，相信不久的将来，很多岗位要消失了;2;1;3;79;0.0379746835443038
835;非常方便的良心软件了，一键生成谁用谁省心啊[报税][报税][报税];2;0;2;79;0.02531645569620253
838;打工人的福音啊 解放双手 能快速提高工作效率[good];1;3;4;79;0.05063291139240506
840;这真的太好了吧，对于打工人来说是福音啊[打call][打call][打call][打call];1;2;3;79;0.0379746835443038
844;这就是打工人的福音吧[哈哈];2;2;4;79;0.05063291139240506
849;现在技术发展得也太快了吧，做PPT这么折磨人的事也能帮我们搞啦[打call];1;2;3;79;0.0379746835443038
852;这是真的很方便诶，工作的效率大大的提高了，太棒了[打call][打call];4;4;8;79;0.10126582278481013
864;还是挺不错的我觉得，非常实用的了;1;0;1;79;0.012658227848101266
871;现在人工智能这么厉害了[哆啦A梦害怕]我会不会被取代[单身狗];1;2;3;79;0.0379746835443038
916;工作党非常需要这么方便的办公软件[抓狂][抓狂][抓狂]期待发布会呀！[哇];1;2;3;79;0.0379746835443038
918;这也太棒了吧这样是不是以后会更方便啊我好期待啊[打call];1;1;2;79;0.02531645569620253
920;一键做出PPT真的是太幸福了吧，打工人节省了很多时间;18;47;65;79;0.8227848101265823
939;哇呀哇呀，这个我爱了，真的超级方便啊，好智能啊！[抓狂][抓狂][抓狂][抓狂];18;51;69;79;0.8734177215189873
958; 是不是意味着 我告诉他帮我写什么就可以了？我不用亲自动手了[哈哈];8;32;40;79;0.5063291139240507
967;直接生成ppt吗  太可以了  我的痛苦啊  ppt;5;8;13;79;0.16455696202531644
973;所以啊  互联网时代太厉害了 简直[赞][赞][赞];5;7;12;79;0.1518987341772152
979;人工智能是越来越厉害了，真的很方便了;4;7;11;79;0.13924050632911392
984;微软的这项技术，真的很牛，相信不久的将来，很多岗位要消失了;2;1;3;79;0.0379746835443038
987;非常方便的良心软件了，一键生成谁用谁省心啊[报税][报税][报税];2;0;2;79;0.02531645569620253
990;打工人的福音啊 解放双手 能快速提高工作效率[good];1;3;4;79;0.05063291139240506
992;这真的太好了吧，对于打工人来说是福音啊[打call][打call][打call][打call];1;2;3;79;0.0379746835443038
996;这就是打工人的福音吧[哈哈];2;2;4;79;0.05063291139240506
1001;现在技术发展得也太快了吧，做PPT这么折磨人的事也能帮我们搞啦[打call];1;2;3;79;0.0379746835443038
1004;这是真的很方便诶，工作的效率大大的提高了，太棒了[打call][打call];4;4;8;79;0.10126582278481013
1016;还是挺不错的我觉得，非常实用的了;1;0;1;79;0.012658227848101266
1023;现在人工智能这么厉害了[哆啦A梦害怕]我会不会被取代[单身狗];1;2;3;79;0.0379746835443038
1068;工作党非常需要这么方便的办公软件[抓狂][抓狂][抓狂]期待发布会呀！[哇];1;2;3;79;0.0379746835443038
1070;这也太棒了吧这样是不是以后会更方便啊我好期待啊[打call];1;1;2;79;0.02531645569620253
1072;一键做出PPT真的是太幸福了吧，打工人节省了很多时间;18;47;65;79;0.8227848101265823
1091;哇呀哇呀，这个我爱了，真的超级方便啊，好智能啊！[抓狂][抓狂][抓狂][抓狂];18;51;69;79;0.8734177215189873
1110; 是不是意味着 我告诉他帮我写什么就可以了？我不用亲自动手了[哈哈];8;32;40;79;0.5063291139240507
1119;直接生成ppt吗  太可以了  我的痛苦啊  ppt;5;8;13;79;0.16455696202531644
1125;所以啊  互联网时代太厉害了 简直[赞][赞][赞];5;7;12;79;0.1518987341772152
1131;人工智能是越来越厉害了，真的很方便了;4;7;11;79;0.13924050632911392
1136;微软的这项技术，真的很牛，相信不久的将来，很多岗位要消失了;2;1;3;79;0.0379746835443038
1139;非常方便的良心软件了，一键生成谁用谁省心啊[报税][报税][报税];2;0;2;79;0.02531645569620253
1142;打工人的福音啊 解放双手 能快速提高工作效率[good];1;3;4;79;0.05063291139240506
1144;这真的太好了吧，对于打工人来说是福音啊[打call][打call][打call][打call];1;2;3;79;0.0379746835443038
1148;这就是打工人的福音吧[哈哈];2;2;4;79;0.05063291139240506
1153;现在技术发展得也太快了吧，做PPT这么折磨人的事也能帮我们搞啦[打call];1;2;3;79;0.0379746835443038
1156;这是真的很方便诶，工作的效率大大的提高了，太棒了[打call][打call];4;4;8;79;0.10126582278481013
1168;还是挺不错的我觉得，非常实用的了;1;0;1;79;0.012658227848101266
1175;现在人工智能这么厉害了[哆啦A梦害怕]我会不会被取代[单身狗];1;2;3;79;0.0379746835443038
1220;工作党非常需要这么方便的办公软件[抓狂][抓狂][抓狂]期待发布会呀！[哇];1;2;3;79;0.0379746835443038
1222;这也太棒了吧这样是不是以后会更方便啊我好期待啊[打call];1;1;2;79;0.02531645569620253
1224;微软这步子迈的也是够快的;8;7;15;79;0.189873417721519
1233;现在的压力是不是来到了WPS和金山这边了...;1;7;8;79;0.10126582278481013
1236;微软真的好快啊 不过感觉不是特别成熟吧;1;1;2;79;0.02531645569620253
1259;微软这步子迈的也是够快的;8;7;15;79;0.189873417721519
1268;现在的压力是不是来到了WPS和金山这边了...;1;7;8;79;0.10126582278481013
1271;微软真的好快啊 不过感觉不是特别成熟吧;1;1;2;79;0.02531645569620253
1294;微软这步子迈的也是够快的;8;7;15;79;0.189873417721519
1303;现在的压力是不是来到了WPS和金山这边了...;1;7;8;79;0.10126582278481013
1306;微软真的好快啊 不过感觉不是特别成熟吧;1;1;2;79;0.02531645569620253
1329;微软这步子迈的也是够快的;8;7;15;79;0.189873417721519
1338;现在的压力是不是来到了WPS和金山这边了...;1;7;8;79;0.10126582278481013
1341;微软真的好快啊 不过感觉不是特别成熟吧;1;1;2;79;0.02531645569620253
1364;微软这步子迈的也是够快的;8;7;15;79;0.189873417721519
1373;现在的压力是不是来到了WPS和金山这边了...;1;7;8;79;0.10126582278481013
1376;微软真的好快啊 不过感觉不是特别成熟吧;1;1;2;79;0.02531645569620253
1399;微软这步子迈的也是够快的;8;7;15;79;0.189873417721519
1408;现在的压力是不是来到了WPS和金山这边了...;1;7;8;79;0.10126582278481013
1411;微软真的好快啊 不过感觉不是特别成熟吧;1;1;2;79;0.02531645569620253
1434;微软这步子迈的也是够快的;8;7;15;79;0.189873417721519
1443;现在的压力是不是来到了WPS和金山这边了...;1;7;8;79;0.10126582278481013
1446;微软真的好快啊 不过感觉不是特别成熟吧;1;1;2;79;0.02531645569620253
1469;这个技术普及的话，对打工人来说可以提高很多效率;7;19;26;79;0.3291139240506329
1477; 是不是意味着 我告诉他帮我写什么就可以了？我不用亲自动手了;5;23;28;79;0.35443037974683544
1483;微软这也太牛了吧，这个技术太实用了[泪];5;21;26;79;0.3291139240506329
1489;微软现在这么厉害啦？真的是与时俱进啊，真不错！;4;5;9;79;0.11392405063291139
1494;还是很不错的吧我觉得，这个技术也太强了[允悲];2;4;6;79;0.0759493670886076
1498;哇塞，微软的这个技术也太牛逼了，以后就方便，省时省力;1;2;3;79;0.0379746835443038
1500;时代在进步科技在发展这次的改动真的是帮助了我们人类一个大忙[爱你][爱你];1;1;2;79;0.02531645569620253
1514;哇，挺好的诶，这样会方便很多诶，期待发布会呀！[抓狂][抓狂][抓狂];1;1;2;79;0.02531645569620253
1524;哇塞，感觉还挺牛的，应该会很方便吧！[开学季][开学季][开学季];3;4;7;79;0.08860759493670886
1528;这个技术普及的话，对打工人来说可以提高很多效率;7;19;26;79;0.3291139240506329
1536; 是不是意味着 我告诉他帮我写什么就可以了？我不用亲自动手了;5;23;28;79;0.35443037974683544
1542;微软这也太牛了吧，这个技术太实用了[泪];5;21;26;79;0.3291139240506329
1548;微软现在这么厉害啦？真的是与时俱进啊，真不错！;4;5;9;79;0.11392405063291139
1553;还是很不错的吧我觉得，这个技术也太强了[允悲];2;4;6;79;0.0759493670886076
1557;哇塞，微软的这个技术也太牛逼了，以后就方便，省时省力;1;2;3;79;0.0379746835443038
1559;时代在进步科技在发展这次的改动真的是帮助了我们人类一个大忙[爱你][爱你];1;1;2;79;0.02531645569620253
1573;哇，挺好的诶，这样会方便很多诶，期待发布会呀！[抓狂][抓狂][抓狂];1;1;2;79;0.02531645569620253
1583;哇塞，感觉还挺牛的，应该会很方便吧！[开学季][开学季][开学季];3;4;7;79;0.08860759493670886
1587;这个技术普及的话，对打工人来说可以提高很多效率;7;19;26;79;0.3291139240506329
1595; 是不是意味着 我告诉他帮我写什么就可以了？我不用亲自动手了;5;23;28;79;0.35443037974683544
1601;微软这也太牛了吧，这个技术太实用了[泪];5;21;26;79;0.3291139240506329
1607;微软现在这么厉害啦？真的是与时俱进啊，真不错！;4;5;9;79;0.11392405063291139
1612;还是很不错的吧我觉得，这个技术也太强了[允悲];2;4;6;79;0.0759493670886076
1616;哇塞，微软的这个技术也太牛逼了，以后就方便，省时省力;1;2;3;79;0.0379746835443038
1618;时代在进步科技在发展这次的改动真的是帮助了我们人类一个大忙[爱你][爱你];1;1;2;79;0.02531645569620253
1632;哇，挺好的诶，这样会方便很多诶，期待发布会呀！[抓狂][抓狂][抓狂];1;1;2;79;0.02531645569620253
1642;哇塞，感觉还挺牛的，应该会很方便吧！[开学季][开学季][开学季];3;4;7;79;0.08860759493670886
1646;这个技术普及的话，对打工人来说可以提高很多效率;7;19;26;79;0.3291139240506329
1654; 是不是意味着 我告诉他帮我写什么就可以了？我不用亲自动手了;5;23;28;79;0.35443037974683544
1660;微软这也太牛了吧，这个技术太实用了[泪];5;21;26;79;0.3291139240506329
1666;微软现在这么厉害啦？真的是与时俱进啊，真不错！;4;5;9;79;0.11392405063291139
1671;还是很不错的吧我觉得，这个技术也太强了[允悲];2;4;6;79;0.0759493670886076
1675;哇塞，微软的这个技术也太牛逼了，以后就方便，省时省力;1;2;3;79;0.0379746835443038
1677;时代在进步科技在发展这次的改动真的是帮助了我们人类一个大忙[爱你][爱你];1;1;2;79;0.02531645569620253
1691;哇，挺好的诶，这样会方便很多诶，期待发布会呀！[抓狂][抓狂][抓狂];1;1;2;79;0.02531645569620253
1701;哇塞，感觉还挺牛的，应该会很方便吧！[开学季][开学季][开学季];3;4;7;79;0.08860759493670886
1705;这个看上去也挺方便的，可将Word文档转换。不得不佩服;24;45;69;79;0.8734177215189873
1730;在几个月后扩大范围，这一点还是相当的让人期待的;12;44;56;79;0.7088607594936709
1743;不得不说，这一块他们属实是有点实力在身上的[doge];5;32;37;79;0.46835443037974683
1749;这种就是股票有涨有跌的，好消息过后那是一定会大涨的;3;4;7;79;0.08860759493670886
1753;这样一来 以后在办公的时候会更加省心省力了;3;7;10;79;0.12658227848101267
1757;这个体验感一定会特别好;1;4;5;79;0.06329113924050633
1759;我好期待未来的这些应用啊，感觉也是我们平常生活会用到的;1;1;2;79;0.02531645569620253
1761;能够自由转换还可以制定计划 这就非常优秀了;1;1;2;79;0.02531645569620253
1764;一下子涨了好多;1;4;5;79;0.06329113924050633
1767;这样操作起来就方便很多了，办公室文员的一大福音啊;1;2;3;79;0.0379746835443038
1810;这个看上去也挺方便的，可将Word文档转换。不得不佩服;24;45;69;79;0.8734177215189873
1835;在几个月后扩大范围，这一点还是相当的让人期待的;12;44;56;79;0.7088607594936709
1848;不得不说，这一块他们属实是有点实力在身上的[doge];5;32;37;79;0.46835443037974683
1854;这种就是股票有涨有跌的，好消息过后那是一定会大涨的;3;4;7;79;0.08860759493670886
1858;这样一来 以后在办公的时候会更加省心省力了;3;7;10;79;0.12658227848101267
1862;这个体验感一定会特别好;1;4;5;79;0.06329113924050633
1864;我好期待未来的这些应用啊，感觉也是我们平常生活会用到的;1;1;2;79;0.02531645569620253
1866;能够自由转换还可以制定计划 这就非常优秀了;1;1;2;79;0.02531645569620253
1869;一下子涨了好多;1;4;5;79;0.06329113924050633
1872;这样操作起来就方便很多了，办公室文员的一大福音啊;1;2;3;79;0.0379746835443038
1915;这个看上去也挺方便的，可将Word文档转换。不得不佩服;24;45;69;79;0.8734177215189873
1940;在几个月后扩大范围，这一点还是相当的让人期待的;12;44;56;79;0.7088607594936709
1953;不得不说，这一块他们属实是有点实力在身上的[doge];5;32;37;79;0.46835443037974683
1959;这种就是股票有涨有跌的，好消息过后那是一定会大涨的;3;4;7;79;0.08860759493670886
1963;这样一来 以后在办公的时候会更加省心省力了;3;7;10;79;0.12658227848101267
1967;这个体验感一定会特别好;1;4;5;79;0.06329113924050633
1969;我好期待未来的这些应用啊，感觉也是我们平常生活会用到的;1;1;2;79;0.02531645569620253
1971;能够自由转换还可以制定计划 这就非常优秀了;1;1;2;79;0.02531645569620253
1974;一下子涨了好多;1;4;5;79;0.06329113924050633
1977;这样操作起来就方便很多了，办公室文员的一大福音啊;1;2;3;79;0.0379746835443038
2020;这个看上去也挺方便的，可将Word文档转换。不得不佩服;24;45;69;79;0.8734177215189873
2045;在几个月后扩大范围，这一点还是相当的让人期待的;12;44;56;79;0.7088607594936709
2058;不得不说，这一块他们属实是有点实力在身上的[doge];5;32;37;79;0.46835443037974683
2064;这种就是股票有涨有跌的，好消息过后那是一定会大涨的;3;4;7;79;0.08860759493670886
2068;这样一来 以后在办公的时候会更加省心省力了;3;7;10;79;0.12658227848101267
2072;这个体验感一定会特别好;1;4;5;79;0.06329113924050633
2074;我好期待未来的这些应用啊，感觉也是我们平常生活会用到的;1;1;2;79;0.02531645569620253
2076;能够自由转换还可以制定计划 这就非常优秀了;1;1;2;79;0.02531645569620253
2079;一下子涨了好多;1;4;5;79;0.06329113924050633
2082;这样操作起来就方便很多了，办公室文员的一大福音啊;1;2;3;79;0.0379746835443038
2125;这个看上去也挺方便的，可将Word文档转换。不得不佩服;24;45;69;79;0.8734177215189873
2150;在几个月后扩大范围，这一点还是相当的让人期待的;12;44;56;79;0.7088607594936709
2163;不得不说，这一块他们属实是有点实力在身上的[doge];5;32;37;79;0.46835443037974683
2169;这种就是股票有涨有跌的，好消息过后那是一定会大涨的;3;4;7;79;0.08860759493670886
2173;这样一来 以后在办公的时候会更加省心省力了;3;7;10;79;0.12658227848101267
2177;这个体验感一定会特别好;1;4;5;79;0.06329113924050633
2179;我好期待未来的这些应用啊，感觉也是我们平常生活会用到的;1;1;2;79;0.02531645569620253
2181;能够自由转换还可以制定计划 这就非常优秀了;1;1;2;79;0.02531645569620253
2184;一下子涨了好多;1;4;5;79;0.06329113924050633
2187;这样操作起来就方便很多了，办公室文员的一大福音啊;1;2;3;79;0.0379746835443038
2230;感觉他们的这种想法还是非常的有创新的。 http://t.cn/A6C8kXkl;2;3;5;79;0.06329113924050633
2235;把聊天机器人技术置入到office中是一个成熟的技术吗？ http://t.cn/A6CYqnPg;1;1;2;79;0.02531645569620253
2237;效率应该会得到很大的提升吧 有点期待;2;2;4;79;0.05063291139240506
2240;感觉他们的这种想法还是非常的有创新的。 http://t.cn/A6C8kXkl;2;3;5;79;0.06329113924050633
2245;把聊天机器人技术置入到office中是一个成熟的技术吗？ http://t.cn/A6CYqnPg;1;1;2;79;0.02531645569620253
2247;效率应该会得到很大的提升吧 有点期待;2;2;4;79;0.05063291139240506
2250;感觉他们的这种想法还是非常的有创新的。 http://t.cn/A6C8kXkl;2;3;5;79;0.06329113924050633
2255;把聊天机器人技术置入到office中是一个成熟的技术吗？ http://t.cn/A6CYqnPg;1;1;2;79;0.02531645569620253
2257;效率应该会得到很大的提升吧 有点期待;2;2;4;79;0.05063291139240506
2260;感觉他们的这种想法还是非常的有创新的。 http://t.cn/A6C8kXkl;2;3;5;79;0.06329113924050633
2265;把聊天机器人技术置入到office中是一个成熟的技术吗？ http://t.cn/A6CYqnPg;1;1;2;79;0.02531645569620253
2267;效率应该会得到很大的提升吧 有点期待;2;2;4;79;0.05063291139240506
2270;感觉他们的这种想法还是非常的有创新的。 http://t.cn/A6C8kXkl;2;3;5;79;0.06329113924050633
2275;把聊天机器人技术置入到office中是一个成熟的技术吗？ http://t.cn/A6CYqnPg;1;1;2;79;0.02531645569620253
2277;效率应该会得到很大的提升吧 有点期待;2;2;4;79;0.05063291139240506
2280;感觉他们的这种想法还是非常的有创新的。 http://t.cn/A6C8kXkl;2;3;5;79;0.06329113924050633
2285;把聊天机器人技术置入到office中是一个成熟的技术吗？ http://t.cn/A6CYqnPg;1;1;2;79;0.02531645569620253
2287;效率应该会得到很大的提升吧 有点期待;2;2;4;79;0.05063291139240506
2290;感觉他们的这种想法还是非常的有创新的。 http://t.cn/A6C8kXkl;2;3;5;79;0.06329113924050633
2295;把聊天机器人技术置入到office中是一个成熟的技术吗？ http://t.cn/A6CYqnPg;1;1;2;79;0.02531645569620253
2297;效率应该会得到很大的提升吧 有点期待;2;2;4;79;0.05063291139240506
2429;收集数据更方便了，你用ai就传他服务器里;26;21;47;79;0.5949367088607594
2456;这玩意儿对人类工作的推动可是质的飞跃;1;19;20;79;0.25316455696202533
2481;收集数据更方便了，你用ai就传他服务器里;26;21;47;79;0.5949367088607594
2508;这玩意儿对人类工作的推动可是质的飞跃;1;19;20;79;0.25316455696202533
2533;收集数据更方便了，你用ai就传他服务器里;26;21;47;79;0.5949367088607594
2560;这玩意儿对人类工作的推动可是质的飞跃;1;19;20;79;0.25316455696202533
2585;收集数据更方便了，你用ai就传他服务器里;26;21;47;79;0.5949367088607594
2612;这玩意儿对人类工作的推动可是质的飞跃;1;19;20;79;0.25316455696202533
2637;收集数据更方便了，你用ai就传他服务器里;26;21;47;79;0.5949367088607594
2664;这玩意儿对人类工作的推动可是质的飞跃;1;19;20;79;0.25316455696202533
2725;为白领节省了大量的时间和精力，也砸了一些人的饭碗。;10;69;79;79;1.0
2736;这微软是想掌握和控制全球办公数据啊;5;40;45;79;0.569620253164557
2742;忽然有种1999年微软的感觉，似乎又重回巅峰了，微软太可怕了[贊];6;23;29;79;0.3670886075949367
2752;今后人类仅需游山玩水吃吃喝喝了[笑cry];4;7;11;79;0.13924050632911392
2761;我有种被耍了的感觉 怎么青浦公安不骂我了;2;0;2;79;0.02531645569620253
2789;@_无为分子 整一个？[doge];1;0;1;79;0.012658227848101266
2792;有人试用过了吗？边开会边整理资料的能力如何。之前用讯飞，中文要通畅可没那么容易。;6;0;6;79;0.0759493670886076
2820;开启上班不用带脑子系列，躺平自由了么[awsl];2;0;2;79;0.02531645569620253
2843;快告诉我 WPS 的应对之策是什么;1;0;1;79;0.012658227848101266
2853;@暮色可可 [泪]好牛;1;0;1;79;0.012658227848101266
2856;为白领节省了大量的时间和精力，也砸了一些人的饭碗。;10;69;79;79;1.0
2867;这微软是想掌握和控制全球办公数据啊;5;40;45;79;0.569620253164557
2873;忽然有种1999年微软的感觉，似乎又重回巅峰了，微软太可怕了[贊];6;23;29;79;0.3670886075949367
2883;今后人类仅需游山玩水吃吃喝喝了[笑cry];4;7;11;79;0.13924050632911392
2892;我有种被耍了的感觉 怎么青浦公安不骂我了;2;0;2;79;0.02531645569620253
2920;@_无为分子 整一个？[doge];1;0;1;79;0.012658227848101266
2923;有人试用过了吗？边开会边整理资料的能力如何。之前用讯飞，中文要通畅可没那么容易。;6;0;6;79;0.0759493670886076
2951;开启上班不用带脑子系列，躺平自由了么[awsl];2;0;2;79;0.02531645569620253
2974;快告诉我 WPS 的应对之策是什么;1;0;1;79;0.012658227848101266
2984;@暮色可可 [泪]好牛;1;0;1;79;0.012658227848101266
2987;为白领节省了大量的时间和精力，也砸了一些人的饭碗。;10;69;79;79;1.0
2998;这微软是想掌握和控制全球办公数据啊;5;40;45;79;0.569620253164557
3004;忽然有种1999年微软的感觉，似乎又重回巅峰了，微软太可怕了[贊];6;23;29;79;0.3670886075949367
3014;今后人类仅需游山玩水吃吃喝喝了[笑cry];4;7;11;79;0.13924050632911392
3023;我有种被耍了的感觉 怎么青浦公安不骂我了;2;0;2;79;0.02531645569620253
3051;@_无为分子 整一个？[doge];1;0;1;79;0.012658227848101266
3054;有人试用过了吗？边开会边整理资料的能力如何。之前用讯飞，中文要通畅可没那么容易。;6;0;6;79;0.0759493670886076
3082;开启上班不用带脑子系列，躺平自由了么[awsl];2;0;2;79;0.02531645569620253
3105;快告诉我 WPS 的应对之策是什么;1;0;1;79;0.012658227848101266
3115;@暮色可可 [泪]好牛;1;0;1;79;0.012658227848101266
3118;为白领节省了大量的时间和精力，也砸了一些人的饭碗。;10;69;79;79;1.0
3129;这微软是想掌握和控制全球办公数据啊;5;40;45;79;0.569620253164557
3135;忽然有种1999年微软的感觉，似乎又重回巅峰了，微软太可怕了[贊];6;23;29;79;0.3670886075949367
3145;今后人类仅需游山玩水吃吃喝喝了[笑cry];4;7;11;79;0.13924050632911392
3154;我有种被耍了的感觉 怎么青浦公安不骂我了;2;0;2;79;0.02531645569620253
3182;@_无为分子 整一个？[doge];1;0;1;79;0.012658227848101266
3185;有人试用过了吗？边开会边整理资料的能力如何。之前用讯飞，中文要通畅可没那么容易。;6;0;6;79;0.0759493670886076
3213;开启上班不用带脑子系列，躺平自由了么[awsl];2;0;2;79;0.02531645569620253
3236;快告诉我 WPS 的应对之策是什么;1;0;1;79;0.012658227848101266
3246;@暮色可可 [泪]好牛;1;0;1;79;0.012658227848101266
3249;为白领节省了大量的时间和精力，也砸了一些人的饭碗。;10;69;79;79;1.0
3260;这微软是想掌握和控制全球办公数据啊;5;40;45;79;0.569620253164557
3266;忽然有种1999年微软的感觉，似乎又重回巅峰了，微软太可怕了[贊];6;23;29;79;0.3670886075949367
3276;今后人类仅需游山玩水吃吃喝喝了[笑cry];4;7;11;79;0.13924050632911392
3285;我有种被耍了的感觉 怎么青浦公安不骂我了;2;0;2;79;0.02531645569620253
3313;@_无为分子 整一个？[doge];1;0;1;79;0.012658227848101266
3316;有人试用过了吗？边开会边整理资料的能力如何。之前用讯飞，中文要通畅可没那么容易。;6;0;6;79;0.0759493670886076
3344;开启上班不用带脑子系列，躺平自由了么[awsl];2;0;2;79;0.02531645569620253
3367;快告诉我 WPS 的应对之策是什么;1;0;1;79;0.012658227848101266
3377;@暮色可可 [泪]好牛;1;0;1;79;0.012658227848101266
3380;为白领节省了大量的时间和精力，也砸了一些人的饭碗。;10;69;79;79;1.0
3391;这微软是想掌握和控制全球办公数据啊;5;40;45;79;0.569620253164557
3397;忽然有种1999年微软的感觉，似乎又重回巅峰了，微软太可怕了[贊];6;23;29;79;0.3670886075949367
3407;今后人类仅需游山玩水吃吃喝喝了[笑cry];4;7;11;79;0.13924050632911392
3416;我有种被耍了的感觉 怎么青浦公安不骂我了;2;0;2;79;0.02531645569620253
3444;@_无为分子 整一个？[doge];1;0;1;79;0.012658227848101266
3447;有人试用过了吗？边开会边整理资料的能力如何。之前用讯飞，中文要通畅可没那么容易。;6;0;6;79;0.0759493670886076
3475;开启上班不用带脑子系列，躺平自由了么[awsl];2;0;2;79;0.02531645569620253
3498;快告诉我 WPS 的应对之策是什么;1;0;1;79;0.012658227848101266
3508;@暮色可可 [泪]好牛;1;0;1;79;0.012658227848101266
3511;为白领节省了大量的时间和精力，也砸了一些人的饭碗。;10;69;79;79;1.0
3522;这微软是想掌握和控制全球办公数据啊;5;40;45;79;0.569620253164557
3528;忽然有种1999年微软的感觉，似乎又重回巅峰了，微软太可怕了[贊];6;23;29;79;0.3670886075949367
3538;今后人类仅需游山玩水吃吃喝喝了[笑cry];4;7;11;79;0.13924050632911392
3547;我有种被耍了的感觉 怎么青浦公安不骂我了;2;0;2;79;0.02531645569620253
3575;@_无为分子 整一个？[doge];1;0;1;79;0.012658227848101266
3578;有人试用过了吗？边开会边整理资料的能力如何。之前用讯飞，中文要通畅可没那么容易。;6;0;6;79;0.0759493670886076
3606;开启上班不用带脑子系列，躺平自由了么[awsl];2;0;2;79;0.02531645569620253
3629;快告诉我 WPS 的应对之策是什么;1;0;1;79;0.012658227848101266
3639;@暮色可可 [泪]好牛;1;0;1;79;0.012658227848101266
3642;为白领节省了大量的时间和精力，也砸了一些人的饭碗。;10;69;79;79;1.0
3653;这微软是想掌握和控制全球办公数据啊;5;40;45;79;0.569620253164557
3659;忽然有种1999年微软的感觉，似乎又重回巅峰了，微软太可怕了[贊];6;23;29;79;0.3670886075949367
3669;今后人类仅需游山玩水吃吃喝喝了[笑cry];4;7;11;79;0.13924050632911392
3678;我有种被耍了的感觉 怎么青浦公安不骂我了;2;0;2;79;0.02531645569620253
3706;@_无为分子 整一个？[doge];1;0;1;79;0.012658227848101266
3709;有人试用过了吗？边开会边整理资料的能力如何。之前用讯飞，中文要通畅可没那么容易。;6;0;6;79;0.0759493670886076
3737;开启上班不用带脑子系列，躺平自由了么[awsl];2;0;2;79;0.02531645569620253
3760;快告诉我 WPS 的应对之策是什么;1;0;1;79;0.012658227848101266
3770;@暮色可可 [泪]好牛;1;0;1;79;0.012658227848101266
3773;为白领节省了大量的时间和精力，也砸了一些人的饭碗。;10;69;79;79;1.0
3784;这微软是想掌握和控制全球办公数据啊;5;40;45;79;0.569620253164557
3790;忽然有种1999年微软的感觉，似乎又重回巅峰了，微软太可怕了[贊];6;23;29;79;0.3670886075949367
3800;今后人类仅需游山玩水吃吃喝喝了[笑cry];4;7;11;79;0.13924050632911392
3809;我有种被耍了的感觉 怎么青浦公安不骂我了;2;0;2;79;0.02531645569620253
3837;@_无为分子 整一个？[doge];1;0;1;79;0.012658227848101266
3840;有人试用过了吗？边开会边整理资料的能力如何。之前用讯飞，中文要通畅可没那么容易。;6;0;6;79;0.0759493670886076
3868;开启上班不用带脑子系列，躺平自由了么[awsl];2;0;2;79;0.02531645569620253
3891;快告诉我 WPS 的应对之策是什么;1;0;1;79;0.012658227848101266
3901;@暮色可可 [泪]好牛;1;0;1;79;0.012658227848101266
3952;客气话;1;6;7;79;0.08860759493670886
3961;给你客套两句你还当真了？;1;2;3;79;0.0379746835443038
3964;客气话;1;6;7;79;0.08860759493670886
3973;给你客套两句你还当真了？;1;2;3;79;0.0379746835443038
3976;客气话;1;6;7;79;0.08860759493670886
3985;给你客套两句你还当真了？;1;2;3;79;0.0379746835443038
4076;我的耳机双击也不出门蓝色闪烁，请问怎么解决;1;0;1;79;0.012658227848101266
4078;我的耳机双击也不出门蓝色闪烁，请问怎么解决;1;0;1;79;0.012658227848101266
4080;我的耳机双击也不出门蓝色闪烁，请问怎么解决;1;0;1;79;0.012658227848101266
4082;我的耳机双击也不出门蓝色闪烁，请问怎么解决;1;0;1;79;0.012658227848101266
4109;沙发[打call];1;0;1;79;0.012658227848101266
4111;沙发[打call];1;0;1;79;0.012658227848101266
4113;沙发[打call];1;0;1;79;0.012658227848101266
4115;沙发[打call];1;0;1;79;0.012658227848101266
4135;屁，看看股价;1;1;2;79;0.02531645569620253
4139;阿里没有搜索引擎;1;0;1;79;0.012658227848101266
4142;啥，，但关键显卡还得是英伟达家的呀，，，;1;0;1;79;0.012658227848101266
4165;屁，看看股价;1;1;2;79;0.02531645569620253
4169;阿里没有搜索引擎;1;0;1;79;0.012658227848101266
4172;啥，，但关键显卡还得是英伟达家的呀，，，;1;0;1;79;0.012658227848101266
4195;屁，看看股价;1;1;2;79;0.02531645569620253
4199;阿里没有搜索引擎;1;0;1;79;0.012658227848101266
4202;啥，，但关键显卡还得是英伟达家的呀，，，;1;0;1;79;0.012658227848101266
4225;屁，看看股价;1;1;2;79;0.02531645569620253
4229;阿里没有搜索引擎;1;0;1;79;0.012658227848101266
4232;啥，，但关键显卡还得是英伟达家的呀，，，;1;0;1;79;0.012658227848101266
4255;屁，看看股价;1;1;2;79;0.02531645569620253
4259;阿里没有搜索引擎;1;0;1;79;0.012658227848101266
4262;啥，，但关键显卡还得是英伟达家的呀，，，;1;0;1;79;0.012658227848101266
4285;屁，看看股价;1;1;2;79;0.02531645569620253
4289;阿里没有搜索引擎;1;0;1;79;0.012658227848101266
4292;啥，，但关键显卡还得是英伟达家的呀，，，;1;0;1;79;0.012658227848101266
4315;屁，看看股价;1;1;2;79;0.02531645569620253
4319;阿里没有搜索引擎;1;0;1;79;0.012658227848101266
4322;啥，，但关键显卡还得是英伟达家的呀，，，;1;0;1;79;0.012658227848101266
4375;屁，看看股价;1;1;2;79;0.02531645569620253
4379;阿里没有搜索引擎;1;0;1;79;0.012658227848101266
4382;啥，，但关键显卡还得是英伟达家的呀，，，;1;0;1;79;0.012658227848101266
4405;屁，看看股价;1;1;2;79;0.02531645569620253
4409;阿里没有搜索引擎;1;0;1;79;0.012658227848101266
4412;啥，，但关键显卡还得是英伟达家的呀，，，;1;0;1;79;0.012658227848101266
4435;屁，看看股价;1;1;2;79;0.02531645569620253
4439;阿里没有搜索引擎;1;0;1;79;0.012658227848101266
4442;啥，，但关键显卡还得是英伟达家的呀，，，;1;0;1;79;0.012658227848101266
4465;屁，看看股价;1;1;2;79;0.02531645569620253
4469;阿里没有搜索引擎;1;0;1;79;0.012658227848101266
4472;啥，，但关键显卡还得是英伟达家的呀，，，;1;0;1;79;0.012658227848101266
4495;屁，看看股价;1;1;2;79;0.02531645569620253
4499;阿里没有搜索引擎;1;0;1;79;0.012658227848101266
4502;啥，，但关键显卡还得是英伟达家的呀，，，;1;0;1;79;0.012658227848101266
4525;屁，看看股价;1;1;2;79;0.02531645569620253
4529;阿里没有搜索引擎;1;0;1;79;0.012658227848101266
4532;啥，，但关键显卡还得是英伟达家的呀，，，;1;0;1;79;0.012658227848101266
4555;屁，看看股价;1;1;2;79;0.02531645569620253
4559;阿里没有搜索引擎;1;0;1;79;0.012658227848101266
4562;啥，，但关键显卡还得是英伟达家的呀，，，;1;0;1;79;0.012658227848101266
4615;挺多公关稿的啊  尤其是常见的科技媒体  微软的Copilot都没有飞书的公关稿多;1;6;7;79;0.08860759493670886
4623;挺多公关稿的啊  尤其是常见的科技媒体  微软的Copilot都没有飞书的公关稿多;1;6;7;79;0.08860759493670886
4631;挺多公关稿的啊  尤其是常见的科技媒体  微软的Copilot都没有飞书的公关稿多;1;6;7;79;0.08860759493670886
4639;挺多公关稿的啊  尤其是常见的科技媒体  微软的Copilot都没有飞书的公关稿多;1;6;7;79;0.08860759493670886
4647;挺多公关稿的啊  尤其是常见的科技媒体  微软的Copilot都没有飞书的公关稿多;1;6;7;79;0.08860759493670886
4655;挺多公关稿的啊  尤其是常见的科技媒体  微软的Copilot都没有飞书的公关稿多;1;6;7;79;0.08860759493670886
4663;挺多公关稿的啊  尤其是常见的科技媒体  微软的Copilot都没有飞书的公关稿多;1;6;7;79;0.08860759493670886
4671;我是2305好像[二哈];1;2;3;79;0.0379746835443038
4673;为什么要禁用啊？;1;0;1;79;0.012658227848101266
4681;我先问一下excel里日语乱码怎么破;5;1;6;79;0.0759493670886076
4688;我是2305好像[二哈];1;2;3;79;0.0379746835443038
4690;为什么要禁用啊？;1;0;1;79;0.012658227848101266
4698;我先问一下excel里日语乱码怎么破;5;1;6;79;0.0759493670886076
4705;我是2305好像[二哈];1;2;3;79;0.0379746835443038
4707;为什么要禁用啊？;1;0;1;79;0.012658227848101266
4715;我先问一下excel里日语乱码怎么破;5;1;6;79;0.0759493670886076
4740;挺多公关稿的啊  尤其是常见的科技媒体  微软的Copilot都没有飞书的公关稿多;1;6;7;79;0.08860759493670886
4748;挺多公关稿的啊  尤其是常见的科技媒体  微软的Copilot都没有飞书的公关稿多;1;6;7;79;0.08860759493670886
4756;挺多公关稿的啊  尤其是常见的科技媒体  微软的Copilot都没有飞书的公关稿多;1;6;7;79;0.08860759493670886
4764;挺多公关稿的啊  尤其是常见的科技媒体  微软的Copilot都没有飞书的公关稿多;1;6;7;79;0.08860759493670886
4772;挺多公关稿的啊  尤其是常见的科技媒体  微软的Copilot都没有飞书的公关稿多;1;6;7;79;0.08860759493670886
4780;挺多公关稿的啊  尤其是常见的科技媒体  微软的Copilot都没有飞书的公关稿多;1;6;7;79;0.08860759493670886
4788;挺多公关稿的啊  尤其是常见的科技媒体  微软的Copilot都没有飞书的公关稿多;1;6;7;79;0.08860759493670886
4814;挺多公关稿的啊  尤其是常见的科技媒体  微软的Copilot都没有飞书的公关稿多;1;6;7;79;0.08860759493670886
4822;挺多公关稿的啊  尤其是常见的科技媒体  微软的Copilot都没有飞书的公关稿多;1;6;7;79;0.08860759493670886
4830;挺多公关稿的啊  尤其是常见的科技媒体  微软的Copilot都没有飞书的公关稿多;1;6;7;79;0.08860759493670886
4838;挺多公关稿的啊  尤其是常见的科技媒体  微软的Copilot都没有飞书的公关稿多;1;6;7;79;0.08860759493670886
4846;挺多公关稿的啊  尤其是常见的科技媒体  微软的Copilot都没有飞书的公关稿多;1;6;7;79;0.08860759493670886
4854;挺多公关稿的啊  尤其是常见的科技媒体  微软的Copilot都没有飞书的公关稿多;1;6;7;79;0.08860759493670886
4862;挺多公关稿的啊  尤其是常见的科技媒体  微软的Copilot都没有飞书的公关稿多;1;6;7;79;0.08860759493670886
4888;挺多公关稿的啊  尤其是常见的科技媒体  微软的Copilot都没有飞书的公关稿多;1;6;7;79;0.08860759493670886
4896;挺多公关稿的啊  尤其是常见的科技媒体  微软的Copilot都没有飞书的公关稿多;1;6;7;79;0.08860759493670886
4904;挺多公关稿的啊  尤其是常见的科技媒体  微软的Copilot都没有飞书的公关稿多;1;6;7;79;0.08860759493670886
4912;挺多公关稿的啊  尤其是常见的科技媒体  微软的Copilot都没有飞书的公关稿多;1;6;7;79;0.08860759493670886
4920;挺多公关稿的啊  尤其是常见的科技媒体  微软的Copilot都没有飞书的公关稿多;1;6;7;79;0.08860759493670886
4928;挺多公关稿的啊  尤其是常见的科技媒体  微软的Copilot都没有飞书的公关稿多;1;6;7;79;0.08860759493670886
4936;挺多公关稿的啊  尤其是常见的科技媒体  微软的Copilot都没有飞书的公关稿多;1;6;7;79;0.08860759493670886
4962;屁，看看股价;1;1;2;79;0.02531645569620253
4966;阿里没有搜索引擎;1;0;1;79;0.012658227848101266
4969;啥，，但关键显卡还得是英伟达家的呀，，，;1;0;1;79;0.012658227848101266
4992;屁，看看股价;1;1;2;79;0.02531645569620253
4996;阿里没有搜索引擎;1;0;1;79;0.012658227848101266
4999;啥，，但关键显卡还得是英伟达家的呀，，，;1;0;1;79;0.012658227848101266
5022;屁，看看股价;1;1;2;79;0.02531645569620253
5026;阿里没有搜索引擎;1;0;1;79;0.012658227848101266
5029;啥，，但关键显卡还得是英伟达家的呀，，，;1;0;1;79;0.012658227848101266
5052;屁，看看股价;1;1;2;79;0.02531645569620253
5056;阿里没有搜索引擎;1;0;1;79;0.012658227848101266
5059;啥，，但关键显卡还得是英伟达家的呀，，，;1;0;1;79;0.012658227848101266
5082;屁，看看股价;1;1;2;79;0.02531645569620253
5086;阿里没有搜索引擎;1;0;1;79;0.012658227848101266
5089;啥，，但关键显卡还得是英伟达家的呀，，，;1;0;1;79;0.012658227848101266
5112;屁，看看股价;1;1;2;79;0.02531645569620253
5116;阿里没有搜索引擎;1;0;1;79;0.012658227848101266
5119;啥，，但关键显卡还得是英伟达家的呀，，，;1;0;1;79;0.012658227848101266
5142;屁，看看股价;1;1;2;79;0.02531645569620253
5146;阿里没有搜索引擎;1;0;1;79;0.012658227848101266
5149;啥，，但关键显卡还得是英伟达家的呀，，，;1;0;1;79;0.012658227848101266
5196;屁，看看股价;1;1;2;79;0.02531645569620253
5200;阿里没有搜索引擎;1;0;1;79;0.012658227848101266
5203;啥，，但关键显卡还得是英伟达家的呀，，，;1;0;1;79;0.012658227848101266
5226;屁，看看股价;1;1;2;79;0.02531645569620253
5230;阿里没有搜索引擎;1;0;1;79;0.012658227848101266
5233;啥，，但关键显卡还得是英伟达家的呀，，，;1;0;1;79;0.012658227848101266
5256;屁，看看股价;1;1;2;79;0.02531645569620253
5260;阿里没有搜索引擎;1;0;1;79;0.012658227848101266
5263;啥，，但关键显卡还得是英伟达家的呀，，，;1;0;1;79;0.012658227848101266
5286;屁，看看股价;1;1;2;79;0.02531645569620253
5290;阿里没有搜索引擎;1;0;1;79;0.012658227848101266
5293;啥，，但关键显卡还得是英伟达家的呀，，，;1;0;1;79;0.012658227848101266
5316;屁，看看股价;1;1;2;79;0.02531645569620253
5320;阿里没有搜索引擎;1;0;1;79;0.012658227848101266
5323;啥，，但关键显卡还得是英伟达家的呀，，，;1;0;1;79;0.012658227848101266
5346;屁，看看股价;1;1;2;79;0.02531645569620253
5350;阿里没有搜索引擎;1;0;1;79;0.012658227848101266
5353;啥，，但关键显卡还得是英伟达家的呀，，，;1;0;1;79;0.012658227848101266
5376;屁，看看股价;1;1;2;79;0.02531645569620253
5380;阿里没有搜索引擎;1;0;1;79;0.012658227848101266
5383;啥，，但关键显卡还得是英伟达家的呀，，，;1;0;1;79;0.012658227848101266
5427;屁，看看股价;1;1;2;79;0.02531645569620253
5431;阿里没有搜索引擎;1;0;1;79;0.012658227848101266
5434;啥，，但关键显卡还得是英伟达家的呀，，，;1;0;1;79;0.012658227848101266
5457;屁，看看股价;1;1;2;79;0.02531645569620253
5461;阿里没有搜索引擎;1;0;1;79;0.012658227848101266
5464;啥，，但关键显卡还得是英伟达家的呀，，，;1;0;1;79;0.012658227848101266
5487;屁，看看股价;1;1;2;79;0.02531645569620253
5491;阿里没有搜索引擎;1;0;1;79;0.012658227848101266
5494;啥，，但关键显卡还得是英伟达家的呀，，，;1;0;1;79;0.012658227848101266
5517;屁，看看股价;1;1;2;79;0.02531645569620253
5521;阿里没有搜索引擎;1;0;1;79;0.012658227848101266
5524;啥，，但关键显卡还得是英伟达家的呀，，，;1;0;1;79;0.012658227848101266
5547;屁，看看股价;1;1;2;79;0.02531645569620253
5551;阿里没有搜索引擎;1;0;1;79;0.012658227848101266
5554;啥，，但关键显卡还得是英伟达家的呀，，，;1;0;1;79;0.012658227848101266
5577;屁，看看股价;1;1;2;79;0.02531645569620253
5581;阿里没有搜索引擎;1;0;1;79;0.012658227848101266
5584;啥，，但关键显卡还得是英伟达家的呀，，，;1;0;1;79;0.012658227848101266
5607;屁，看看股价;1;1;2;79;0.02531645569620253
5611;阿里没有搜索引擎;1;0;1;79;0.012658227848101266
5614;啥，，但关键显卡还得是英伟达家的呀，，，;1;0;1;79;0.012658227848101266
5637;屁，看看股价;1;1;2;79;0.02531645569620253
5641;阿里没有搜索引擎;1;0;1;79;0.012658227848101266
5644;啥，，但关键显卡还得是英伟达家的呀，，，;1;0;1;79;0.012658227848101266
5667;屁，看看股价;1;1;2;79;0.02531645569620253
5671;阿里没有搜索引擎;1;0;1;79;0.012658227848101266
5674;啥，，但关键显卡还得是英伟达家的呀，，，;1;0;1;79;0.012658227848101266
5697;屁，看看股价;1;1;2;79;0.02531645569620253
5701;阿里没有搜索引擎;1;0;1;79;0.012658227848101266
5704;啥，，但关键显卡还得是英伟达家的呀，，，;1;0;1;79;0.012658227848101266
5727;屁，看看股价;1;1;2;79;0.02531645569620253
5731;阿里没有搜索引擎;1;0;1;79;0.012658227848101266
5734;啥，，但关键显卡还得是英伟达家的呀，，，;1;0;1;79;0.012658227848101266
5757;屁，看看股价;1;1;2;79;0.02531645569620253
5761;阿里没有搜索引擎;1;0;1;79;0.012658227848101266
5764;啥，，但关键显卡还得是英伟达家的呀，，，;1;0;1;79;0.012658227848101266
5788;最后，一半人被炒，任务加一倍，工期要求缩短一半;1;24;25;79;0.31645569620253167
5792;最后，一半人被炒，任务加一倍，工期要求缩短一半;1;24;25;79;0.31645569620253167
5796;最后，一半人被炒，任务加一倍，工期要求缩短一半;1;24;25;79;0.31645569620253167
5800;最后，一半人被炒，任务加一倍，工期要求缩短一半;1;24;25;79;0.31645569620253167
5804;最后，一半人被炒，任务加一倍，工期要求缩短一半;1;24;25;79;0.31645569620253167
5808;最后，一半人被炒，任务加一倍，工期要求缩短一半;1;24;25;79;0.31645569620253167
5812;最后，一半人被炒，任务加一倍，工期要求缩短一半;1;24;25;79;0.31645569620253167
