label;一级评论;真实二级评论数;真实点赞数;边数;最大边数;集群密度
0;发视频改半天，评论发网盘也是吞的飞快，难顶。需要图包可以评论区留言或者关注私信有自动回复网盘哦。;5;1;6;18388;0.0003262997607135088
18;缅北电诈人员直呼素材库doge;2;164;166;18388;0.009027626713073745
21;现在ai已经到这个地步了吗，之前看还只是二次元人物;10;53;63;18388;0.0034261474874918425
32;应该用的是台湾人脸模型;3;52;55;18388;0.002991081139873831
36;我觉得以后真的能出一个虚拟女友应用了。ai绘画建模捏脸，chatgpt或者newbing技术做内核，真正的女友养成游戏。有没有搞头。对了加上vr;5;18;23;18388;0.0012508157494017839
42;一位靓仔点赞路过;5;15;20;18388;0.0010876658690450293
48;这样漂亮的妹我们学校很多的;4;11;15;18388;0.000815749401783772
53;照这样发展哪天ai会做视频了也不奇怪了;1;10;11;18388;0.0005982162279747662
55;没灵魂;4;8;12;18388;0.0006525995214270176
64;这是什么软件啊;4;1;5;18388;0.00027191646726125733
70;镜头放下一点doge;1;0;1;18388;5.438329345225147e-05
74;upuplora的比重是多少呀;1;0;1;18388;5.438329345225147e-05
76;要是这素质的游戏，用8090能顶吗滑稽;1;0;1;18388;5.438329345225147e-05
78;如果换成其他人的脸也这么细节么;1;0;1;18388;5.438329345225147e-05
82;什么时候弄真人视频doge;1;0;1;18388;5.438329345225147e-05
85;阿里雲網盤不能用;6;0;6;18388;0.0003262997607135088
93;大佬出个教程哇;1;0;1;18388;5.438329345225147e-05
98;up有没有学习交流群呀;1;0;1;18388;5.438329345225147e-05
108;三连，求图包;1;1;2;18388;0.00010876658690450294
110;三，求，谢;1;1;2;18388;0.00010876658690450294
113;已投币，求图包;1;1;2;18388;0.00010876658690450294
115;求图doge;1;1;2;18388;0.00010876658690450294
118;三连了，求包;1;0;1;18388;5.438329345225147e-05
120;求求打call;1;0;1;18388;5.438329345225147e-05
123;已三连;1;0;1;18388;5.438329345225147e-05
125;求图包;1;0;1;18388;5.438329345225147e-05
127;三关求;1;0;1;18388;5.438329345225147e-05
129;三连求图;1;0;1;18388;5.438329345225147e-05
131;三连了doge;1;0;1;18388;5.438329345225147e-05
133;求图包;1;0;1;18388;5.438329345225147e-05
135;三连，你懂的。;1;0;1;18388;5.438329345225147e-05
137;已投币，求图;1;0;1;18388;5.438329345225147e-05
139;求图;1;0;1;18388;5.438329345225147e-05
141;自己玩的话能让她穿更少吗这个软件有没有限制;1;0;1;18388;5.438329345225147e-05
143;已三连求图包;1;0;1;18388;5.438329345225147e-05
145;三连求图doge。;1;0;1;18388;5.438329345225147e-05
147;已三连你懂的dogedoge;1;0;1;18388;5.438329345225147e-05
149;求图doge;2;0;2;18388;0.00010876658690450294
152;求图包doge;1;0;1;18388;5.438329345225147e-05
154;3连收图包;1;0;1;18388;5.438329345225147e-05
156;求图;1;0;1;18388;5.438329345225147e-05
158;求图包;1;0;1;18388;5.438329345225147e-05
160;脸都不变了，都是这个;1;0;1;18388;5.438329345225147e-05
162;求图包星星眼;1;0;1;18388;5.438329345225147e-05
164;图包doge;1;0;1;18388;5.438329345225147e-05
166;有图必连滑稽;1;0;1;18388;5.438329345225147e-05
168;好棒吃瓜看到这个妹子就想到你哈哈doge;6;0;6;18388;0.0003262997607135088
175;求图;2;0;2;18388;0.00010876658690450294
178;老规矩，求图包;1;0;1;18388;5.438329345225147e-05
180;求图;4;0;4;18388;0.00021753317380900588
185;求图doge;1;0;1;18388;5.438329345225147e-05
187;脱单doge;1;0;1;18388;5.438329345225147e-05
189;三连等图包;1;0;1;18388;5.438329345225147e-05
191;不错，三连了;1;0;1;18388;5.438329345225147e-05
193;恭喜你离百大又近了一步;2;0;2;18388;0.00010876658690450294
196;热词系列打卡热词系列这次一定;1;0;1;18388;5.438329345225147e-05
199;三连了求图包doge;1;0;1;18388;5.438329345225147e-05
201;致我们热爱向往的;11;45;56;18388;0.0030454644333260824
213;还有脸喂迟迟的图，作者明确不同意;1;10;11;18388;0.0005982162279747662
215;三连了三连了大佬;1;21;22;18388;0.0011964324559495323
217;已三连，求私发;1;21;22;18388;0.0011964324559495323
219;已一键三连;1;23;24;18388;0.0013051990428540352
221;已三连，求私信;1;22;23;18388;0.0012508157494017839
223;已三连，求;1;19;20;18388;0.0010876658690450293
225;三连UP求素材;1;21;22;18388;0.0011964324559495323
227;已三连，蹲蹲;1;13;14;18388;0.0007613661083315206
229;一键三连了，求素材;1;13;14;18388;0.0007613661083315206
231;人类只会崇尚高端的画师，而不会膜拜高级的机器;12;42;54;18388;0.0029366978464215794
244;求素材（已三连;1;11;12;18388;0.0006525995214270176
246;已三连，求素材;1;6;7;18388;0.0003806830541657603
248;已三连可以蹲个素材嘛;1;6;7;18388;0.0003806830541657603
251;已三连，求素材打call;1;2;3;18388;0.0001631498803567544
254;实话是已经有公司大量裁员画师了;1;2;3;18388;0.0001631498803567544
256;终究会被取代，在国内毫无版权可言，有没有版权是资本家说的算;1;2;3;18388;0.0001631498803567544
263;这行本来就没什么前途，该回家种地进厂拧螺丝去吧;1;0;1;18388;5.438329345225147e-05
267;AI怡宝更美了;16;1856;1872;18388;0.10180552534261475
284;属于是我喜欢的女主播被全世界公认了，就这么自豪傲娇;7;1138;1145;18388;0.06226887100282793
292;因为AI画的图不会讲话doge;8;1098;1106;18388;0.060147922558190126
301;脱单doge;2;339;341;18388;0.01854470306721775
304;410;3;872;875;18388;0.04758538177072003
308;确实强doge;13;404;417;18388;0.02267783336958886
322;套图已经有21p142pdoge;61;561;622;18388;0.033826408527300414
384;AI这东西迟早要受控的，就一个换脸软件都闹出多大风波了。;65;276;341;18388;0.01854470306721775
450;0219这笑哭;8;68;76;18388;0.004133130302371111
460;周姐这脸ai换脸的时候也是换谁身上都合适，可能ai觉得这张脸真的很完美吧，而且这ai怎么这么喜欢给周姐配个大扔子;1;33;34;18388;0.00184903197737655
462;一想到好多人用怡宝的lora炼色色的图拿去做奇怪的事，我心里就好难受;8;202;210;18388;0.011420491624972808
472;这张;1;70;71;18388;0.003861213835109854
475;看过全图还是挺顶的;1;6;7;18388;0.0003806830541657603
477;k宝，想想你这视频为什么会被卖片的盯上doge;1;72;73;18388;0.003969980422014357
479;我的壁纸喜欢喜欢喜欢喜欢;4;28;32;18388;0.001740265390472047
485;周姐以后不管流出什么照片视频都不会塌房了doge;9;1486;1495;18388;0.08130302371111595
495;推动力周姐露猫咪委员会;2;50;52;18388;0.0028279312595170763
498;推动力什么委员会。。。可怕;1;78;79;18388;0.004296280182727866
500;这玩意没办法，一个普通人只要有你几十张照片就能整个模型，学习成本太低，出来的效果又真假难辨，如果有足够多角度的高清照片，可以实现所有角度所有姿势的周姐;1;22;23;18388;0.0012508157494017839
502;为什么有衣服，我刚下的好像不一样初音未来问号;8;44;52;18388;0.0028279312595170763
511;周姐的脸最失败的点就是长在了周姐身上大哭;2;211;213;18388;0.011583641505329563
514;不正经的对周姐没用，有声的如果是周姐的声音，你也没感觉了，如果不是周姐的声音，你也没感觉了;2;49;51;18388;0.002773547966064825
520;主要是周姐这张脸或者类似的脸在随机的画图里经常出现喜极而泣，应该是因为训练库里的含量比较高吃瓜，真正明星的脸反而少，估计是担心法律问题。;3;15;18;18388;0.0009788992821405265
524;树奈奈的身材周淑怡的脸完美;1;7;8;18388;0.00043506634761801175
532;光用脸，是真的能打，至于原版嘛，会张嘴。还是算了吧doge;2;283;285;18388;0.015499238633891669
536;社会我周姐;1;32;33;18388;0.0017946486839242985
538;在哪里可以看这些图啊星星眼;12;8;20;18388;0.0010876658690450293
556;周淑怡其实挺好看的;3;8;11;18388;0.0005982162279747662
561;好家伙连李沁、宋轶还有万茜诸葛大力的都有了;1;0;1;18388;5.438329345225147e-05
597;已经有图了兄弟们;4;0;4;18388;0.00021753317380900588
635;快把封面给换了老子要举办了生气;1;1;2;18388;0.00010876658690450294
674;我翻墙出去看了ai周姐。真的顶笑哭;2;0;2;18388;0.00010876658690450294
682;哦AI绘画，我看成AI换脸了，还以为后台没关妙啊;2;0;2;18388;0.00010876658690450294
699;以后都不能相信新闻图片了，再过不久连视频都有可能轻易造假;1;0;1;18388;5.438329345225147e-05
735;以后普通人真不能随便往社交平台上发照片了，哪个不怀好意的拿你照片喂给AI，整一堆以假乱真的图造谣，真受不了吧;1;0;1;18388;5.438329345225147e-05
739;外网关键字搜就行;2;1;3;18388;0.0001631498803567544
742;你摸摸自己的良心问问，像不像滑稽;1;1;2;18388;0.00010876658690450294
754;周姐怎么不出一些写真集;1;0;1;18388;5.438329345225147e-05
760;庆幸这个技术没在果贷电诈盛行的时候成熟。doge;3;21;24;18388;0.0013051990428540352
764;我有黄图套，看着看着就笑出来了tvdoge;6;15;21;18388;0.0011420491624972808
772;完整大牛杯;1;3;4;18388;0.00021753317380900588
777;后续，知乎这个人是编的;10;74;84;18388;0.004568196649989123
788;问题是无数ai迷和吃瓜人，觉得只有画师会失业，这中间就不曾有人知道一个问题，如果画师失业，其他行业也会失业，ai不可能未来10年还只会画画;42;144;186;18388;0.010115292582118773
831;现在很多初级画师以及被淘汰的混子画师，似乎已经把“ai替代画师”当成了自己不努力，不进取的一个退路了。但凡找不到工作，或者自己的原因被裁。就说“因为ai这个画师已经不行了”。但实际的情况呢？我去问了身边非常多研发以及外包的朋友。并没有发生此类事情。不过对于工作流程部分，特别是外包的朋友是希望通过ai来缩短流程的（比如ai细化后再修图）。未来会怎么样不知道。只知道，如果热爱画画，就好好去画。如果只是想用画画来赚钱，早点打消这个念头。早几年前这个行业就已经饱和了。;8;35;43;18388;0.002338481618446813
840;最近在北京找工作，面试过一个小公司，欧美卡通项目的，公司用AI去细化，草稿自己设计。原画最后裁的就剩三个人了，公司最后想在找一个人，可以把控整个项目风格的。我最后测试过了面试没过，因为经验不够。感觉以后能在这行工作的都是领域精英了。;6;57;63;18388;0.0034261474874918425
850;我蛮奇怪的，我专门问过在职的朋友，基本都在大厂，他们说虽然公司要求用ai，但没到全部裁掉的水平，偶尔会裁几个，是末位淘汰那种，不确定是不是和项目组有关，也可能是我认识的这几个都是国内赚钱手游项目。而且我外包也没太受影响，反而是那些没找到公司的或者家里蹲的特别焦虑思考;2;41;43;18388;0.002338481618446813
853;这有什么意义？我每个月累死累累活就那么点工资，不可能购买你这零成本的电子世界电子烂白菜，你觉得好看，我觉得还有更好看的可以随便出图，ai生成一个作品几秒，学习合成作品没有成本，我手里的币是有限，增加需要极大的成本，你ai一天就可以生成几千套游戏皮肤，每个皮肤188但是成本为0我看都不看一眼全是海量合成的味道更不会购买没有价值的意义没有意义doge;32;37;69;18388;0.003752447248205351
886;把画画当兴趣，可以。把画画当工作，造孽。;8;29;37;18388;0.002012181857733304
895;很多人说散播焦虑？哈哈我就说一个游戏研发公司的从上月开始我们公司就不发原画插画宣传画立绘图标外包了你们猜因为啥doge;11;61;72;18388;0.003915597128562106
909;啥时候能进军会计行业，不想替人坐牢;1;13;14;18388;0.0007613661083315206
911;物述有栖看戏嗯，船到桥头自然直，等我失业了再去考虑，ai画得都好看，但光好看还不够，我想要的是能打动我的画，可能很多人在资本和泛娱乐的冲击下一心只剩赚钱和瑟瑟了，都快忘了绘画本身是件艺术了，是条追寻美学、造就疯子的的路;2;10;12;18388;0.0006525995214270176
914;ai拼图并不是画微笑话说AI作图的原理不就是东拼西凑各种图吗，行业招聘已经出现AI画师了，这让辛辛苦苦自己搞创作的画师以后怎么搞;14;32;46;18388;0.0025016314988035677
929;冷知识，ai绘画是不受版权保护的，另外，大厂裁员不是因为ai，而是其他不可说的原因;5;13;18;18388;0.0009788992821405265
935;今天画师群有人吵了不少时间，大大小小公司全都在用AI，场景和图标已经大量被AI覆盖，有几个小公司的，他们老板要求直接用AI的立绘批量出图，最小幅度改图节省人力资源，所有商业上的甲方都已经默认用AI了。可以说一大部分画师已经被AI替代了。;1;4;5;18388;0.00027191646726125733
937;我俩个朋友都是入行画师，表示不慌，可以适当的用AI辅助或者参考。不会真的以为那种图能修修就用吧？不会真以为你没有板绘和专业审美，老板会招你吧？;6;13;19;18388;0.0010332825755927778
945;ai只会让绘画工人难找工作，只会针对商业行为。但人创作的艺术是不会被抹杀的，任何人都可以去创作，这是人类感情的投放，会画画的可以把绘画当成爱好，虽然它无法成为职业。;3;19;22;18388;0.0011964324559495323
949;少看知乎，全是编故事的。。。。;10;29;39;18388;0.002120948444637807
962;doge既然无法毁掉ai那就搞掉ai研发者的收益一起毁灭吧;9;14;23;18388;0.0012508157494017839
976;复网络上：已取代，节约大量人力。现实中：裁员是因为版号寒冬绘圈接单量一点没少招聘条件几乎没有提到AI的用AI的人被全网声讨部分画师用AI节约了找参考资料的时间，画得更好了。;1;18;19;18388;0.0010332825755927778
982;不用焦虑，画师速速与Ai绘图合体，组成画师AI的模式;1;4;5;18388;0.00027191646726125733
984;下一代通过聊天来画图？ai都能跟你聊天了谁还担心绘画这个行业，ai进化得再快人家也不是专盯着绘画吃，说这些不是散播焦虑还是什么;9;9;18;18388;0.0009788992821405265
994;继续编;149;7;156;18388;0.008483793778551229
1145;ai什么时候能把ai味去掉，在谈商业应用吧;1;2;3;18388;0.0001631498803567544
1152;点赞多就代表认同么，逻辑清奇，游戏很多都是个性化的风格，你看mj生出来那些风格有多一致，实际游戏开发是讲逻辑还有很多细碎东西ai根本很难代替，或是使用起来并不那么方便易用，做做头图还有电商海报我觉还行，很多那些截图都不是游戏行业的人发的。;1;1;2;18388;0.00010876658690450294
1155;如果ai绘图被广泛认可了可以说人类就会迎来一次思维退化同时也证明了直接利益可以代替深度追求以后各个领域的事件会越来越多人变成不会思考没有追求的溺水猪的时代也就指日可待了，快餐文化无营养短视频ai批量抄袭作品，代表了人类精神世界的逐步降级，科学进步了，人类的审美与精神世界却荒芜了，创造力是人类最宝贵的特征，如今也将要被剥夺，这个问题很值得思考：将知识性劳动交予没有思维机器，真的是正确的吗？;1;13;14;18388;0.0007613661083315206
1159;会的，以后除了高定应该没有别的市场，我已经在做一个公司的ai试稿了，就是要求你用ai生成一个角色的三视图，ai的发展有点像xg，也是一下子波及全部人，不是裁人，现在是连单都派不出，游戏政策也有影响吧，反正不单单是ai那么简单，现在整个行业发展都不好，我现在能给出唯一利好的消息就是，c站开始删模型了，剩下的只有美化lora，大部分模型被删除，但具体什么情况我也不清楚反正现在最大ai交流网风向就是这样，几乎主流的模型都没了;2;1;3;18388;0.0001631498803567544
1164;新事物的出现如果不接受，那就只能被淘汰。我就奇了怪了，你能十年如一日学画画，就不能花个一两周，最多一个月学一下AI绘画吗？学会了，你自己生成。而且因为你有绘画功底，所以AI生成的，不满意的，可以自己改。比如现在AI还画不好手指等细节。你可以自己把手指改好。明明AI只是个更好的工具。有的人却非要把它当洪水猛兽。不过AI绘画来了，会淘汰某些画师也确实是有的。因为确实不需要那么多画师了。所以不接受AI绘画，自己能力又一般般的就只能被淘汰了。;2;2;4;18388;0.00021753317380900588
1173;厂子都想试试尝口鲜，但除了影响了美术组的心情之外没什么大影响。前期设计可以随机跑出些古神找找灵感，后期没法用也没人敢用。我就是个原画。;5;1;6;18388;0.0003262997607135088
1186;版权局干嘛吃的;1;0;1;18388;5.438329345225147e-05
1191;实际上是门槛变高，淘汰末端从业者，但AI热度会逐渐走低，因为无形之中已经形成行业共识，并彻底成为辅助性工具。;1;0;1;18388;5.438329345225147e-05
1195;画漫画，这个AI还做不到吧;9;1;10;18388;0.0005438329345225147
1208;AI画画没让任何人失业，只会大幅提高专业绘画人的效率和速度，你要知道AI画画是有大量漏洞的，这样职业绘画人就可手动绘画填补那些漏洞;4;0;4;18388;0.00021753317380900588
1222;AI就是一个分水岭，能够精炼各个领域的人才，将半壶水叮当响的那些人淘汰下去。从大的角度而言，这不该完全是一种焦虑。我先前看到一个3000块女仆游轮的视频，说的就很透彻。对于灰色的那些事情，提升了有这些心思各怀鬼胎的人们发布这类信息的成本，有助于平常人们生活时对于这类信息的辨识。那么同理，对于一个常规的行业，AI同样能够起到鉴别的能力。区别于通过职业测试这种批量划分等级的规则，AI的加入更像一条及格线，能够从另一个角度区别该行业工作者的水平和能力层级。说到底，这仍然是一个人类为主的世界，至少我认为在我的有生之年里应是如此。而人是一种逆来顺受的生物，每一个新鲜事物的介入所带来的阵痛，往往会在时间的洗刷下逐渐被接受。反倒是AI的出现或许能够成为一个契机，毕竟自互联网发展以来，人类的发展已经度过了很长一段时间的低谷期。或许AI的出现能够刺激市场，出现新的变革和机遇。;4;0;4;18388;0.00021753317380900588
1227;AI是没有版权的，他出了就意味着可以随便被人拿来用。;3;0;3;18388;0.0001631498803567544
1235;只不过是门槛变低了，画师变成了AI修图师。;2;0;2;18388;0.00010876658690450294
1240;老婆真棒哈哈哈失业只能说闭门造车会的人都会运用ai;5;0;5;18388;0.00027191646726125733
1250;小画师失业我是支持的，这个图收了7000，你敢信，b站某up约的皮套立绘;4;0;4;18388;0.00021753317380900588
1255;邪恶冥刻的P03;14;227;241;18388;0.013106373721992604
1270;看著AI作畫是識別色塊進行創作，从最后一个例子可以看出来（都是同一个光源），所以sans识别不出的原因可能是黑白画不在他的认知范围，换彩色的（雪镇那边，非战斗画面）的会不会好一点鼓掌;5;130;135;18388;0.007341744616053948
1276;我想看小花妙啊更想看精污花脱单doge;64;1660;1724;18388;0.09375679791168152
1341;虽然感觉不能过审，但还是想看scp173脱单doge;56;848;904;18388;0.04916249728083533
1398;有sans受伤的世界出来了热词系列知识增加;8;635;643;18388;0.03496845768979769
1407;我很好奇野兽先辈会识别出什么dogedogedoge;9;575;584;18388;0.03175984337611486
1417;AI绘图的出世，让很多“人不能，至少不应该”的生物都能成为老婆脱单doge;12;430;442;18388;0.024037415705895147
1430;植物大战僵尸的向日葵和豌豆射手吃瓜;17;395;412;18388;0.022405916902327606
1448;二代黄金弗莱迪;11;420;431;18388;0.02343919947792038
1460;试试Minecraft中的史蒂夫，艾莉克斯，监守者，村民，苦力怕，悦灵或者植物大战僵尸中的疯狂戴夫，豌豆射手，僵尸也不错sans下次的衣服加上颜色脱单doge;11;246;257;18388;0.013976506417228628
1472;undertale里边的Chara行吗脱单doge;8;122;130;18388;0.007069828148792691
1481;不搞个弗奈弗的玩具们吗？freddy、chica、bennie、foxy和mangle都搞一遍行吗？子墨;8;118;126;18388;0.006852294974983685
1490;nightmaresans;4;62;66;18388;0.003589297367848597
1495;黑暗欺骗的三只吉祥物;7;50;57;18388;0.003099847726778334
1503;可以试试脑叶公司里的锁妈吗？或者是一无所有或尸山。;4;48;52;18388;0.0028279312595170763
1508;我的世界的凋零风暴和凋零斯拉doge;3;31;34;18388;0.00184903197737655
1513;carrets233看第二个脱单doge;2;1;3;18388;0.0001631498803567544
1517;《脑叶公司》里面的“一无所有”脱单doge;1;12;13;18388;0.0007069828148792691
1519;我的世界的末影人？;1;9;10;18388;0.0005438329345225147
1521;子墨子墨AI一下这个传说之下的帕派瑞斯精灵宝可梦的甜冷美后;5;79;84;18388;0.004568196649989123
1527;Illnessdogedogedoge（我已经不能想象他究竟能变成什么了）;2;8;10;18388;0.0005438329345225147
1530;欢乐帮;6;78;84;18388;0.004568196649989123
1538;三角符文斯潘顿neo怎么样？doge感觉会很抽象辣眼睛;1;7;8;18388;0.00043506634761801175
1540;我想看三角符文里面的苏西和兰瑟;2;26;28;18388;0.0015227322166630412
1544;试试彩虹朋友吧，是一个刚形成的冷圈子;6;23;29;18388;0.0015771155101152925
1552;阿曼达脱单doge;3;5;8;18388;0.00043506634761801175
1556;汉克（不是死神汉克是暴力迪吧的汉克）;6;18;24;18388;0.0013051990428540352
1565;蓝色妖姬doge妙啊;1;2;3;18388;0.0001631498803567544
1567;安迪的苹果农场里面那个红苹果安迪星星眼星星眼星星眼可以吗可以吗？;5;16;21;18388;0.0011420491624972808
1574;sans127;1;1;2;18388;0.00010876658690450294
1578;想看后室扫兴客兄弟们把我顶上去脱单doge;1;9;10;18388;0.0005438329345225147
1583;少年骇客里的四手霸王打call;1;4;5;18388;0.00027191646726125733
1587;我发布了一篇笔记，快来看看吧;2;4;6;18388;0.0003262997607135088
1590;爱玩游戏的屑派对客原来你是实体脱单doge;2;1;3;18388;0.0001631498803567544
1593;恐怖奶奶，我很好奇。。。;1;11;12;18388;0.0006525995214270176
1596;后室的肢团白色情人节好想要;2;5;7;18388;0.0003806830541657603
1599;纪念碑谷的主角MuseDash暗中观察;2;8;10;18388;0.0005438329345225147
1602;想看看弹簧陷阱嗑瓜子;3;11;14;18388;0.0007613661083315206
1606;我想看荒野乱斗里的人物吃瓜;4;10;14;18388;0.0007613661083315206
1611;原神的谁都行;5;6;11;18388;0.0005982162279747662
1617;有些好奇废墟图书馆的达洛科和格洛丽亚画出来是什么样，想看;1;10;11;18388;0.0005982162279747662
1620;致命错误sans;3;9;12;18388;0.0006525995214270176
1632;后世里的笑魇dogedogedoge;1;3;4;18388;0.00021753317380900588
1638;想看欢乐帮和人体模型doge;4;3;7;18388;0.0003806830541657603
1644;城堡破坏者里的初始四骑士，和最终boss死亡骑士和男巫。星星眼星星眼;1;3;4;18388;0.00021753317380900588
1646;我头像是;5;5;10;18388;0.0005438329345225147
1653;我想看老玩具四人组，已三连，您看脱单doge;3;4;7;18388;0.0003806830541657603
1660;脑叶公司的异想体，行吗？;1;4;5;18388;0.00027191646726125733
1666;up主的头像;1;1;2;18388;0.00010876658690450294
1670;下期做一个弹簧陷阱的，还有安全漏洞里的罗克珊;2;2;4;18388;0.00021753317380900588
1674;求个索尼克里面的索尼克塔尔斯纳克鲁斯惊喜;1;2;3;18388;0.0001631498803567544
1697;fnf的别克，tabi，烟叔，hex，炸弹人，磁带女孩，修女，ruv;1;2;3;18388;0.0001631498803567544
1703;试试apetshopafterdark里的角色吧;1;2;3;18388;0.0001631498803567544
1717;数学书里面的淘气和笑笑，（人教版滴）脱单doge;1;2;3;18388;0.0001631498803567544
1721;识别下明日方舟里的小车;1;2;3;18388;0.0001631498803567544
1731;传说之下的羊妈，chara;1;2;3;18388;0.0001631498803567544
1733;子弹地狱;1;2;3;18388;0.0001631498803567544
1735;塞尔达传说旷野之息里的莫尔德拉吉克和米法滑稽兄弟们，顶我上去。;1;2;3;18388;0.0001631498803567544
1737;弹簧陷阱doge;1;2;3;18388;0.0001631498803567544
1744;欢乐帮欢乐帮;1;2;3;18388;0.0001631498803567544
1749;负奈负三的弹簧陷阱来一个doge;1;2;3;18388;0.0001631498803567544
1754;来个欧洲国家芬兰滑稽;1;2;3;18388;0.0001631498803567544
1761;一无所有申请出站doge;1;4;5;18388;0.00027191646726125733
1763;脑叶公司的一无所有;1;4;5;18388;0.00027191646726125733
1765;废墟图书馆的扭曲在宪和脑叶公司的沉默乐团;1;4;5;18388;0.00027191646726125733
1772;sansDoyouwanthaveabadtime对AI说审判开始sans由于过于生气，直接开审判眼漫长的对局过后sans《累了》AI准备攻击sans释放蓝骨盖火锅sans去死吧一发龙骨炮袭来AI无了sans下次再敢画的那么难看试试dogedoge;1;3;4;18388;0.00021753317380900588
1774;能不能弄彩虹朋友;2;3;5;18388;0.00027191646726125733
1781;玩具熊一代四人组和黄金《求求了》;1;1;2;18388;0.00010876658690450294
1790;当看到这个时我直接皱眉并大喊了声：瓦特我的发无语;1;1;2;18388;0.00010876658690450294
1792;我想看刻晴啊脱单doge脱单doge脱单doge脱单doge脱单doge脱单doge脱单doge;1;1;2;18388;0.00010876658690450294
1809;沙耶之歌的沙耶本体;1;1;2;18388;0.00010876658690450294
1815;红警2的动员兵;1;1;2;18388;0.00010876658690450294
1834;邪恶铭刻的六大boss（有一个是隐藏的，还有一个不进行战斗）懂得都懂;1;1;2;18388;0.00010876658690450294
1853;096;1;1;2;18388;0.00010876658690450294
1868;这是什么软件？疑惑;1;1;2;18388;0.00010876658690450294
1871;试试hrhr行吗doge;1;1;2;18388;0.00010876658690450294
1887;童年回忆安排一下doge喜羊羊与灰太狼海绵宝宝猫和老鼠托马斯小火车果宝特攻铁甲小宝快乐酷宝变形金刚超能勇士米奇妙妙屋题外话沙奈朵安排一下脱单doge;1;1;2;18388;0.00010876658690450294
1896;一只霸道的狗;1;1;2;18388;0.00010876658690450294
1939;sns的好哥们你懂的脱单doge;5;1;6;18388;0.0003262997607135088
1948;想看LOL里的雷克塞和生化八的那个鱼的boss（好像叫莫罗来着）doge脱单doge;1;1;2;18388;0.00010876658690450294
1961;空洞骑士老玩家们，有哪些boss是让你们肝几百个小时的，我先来，梦魇之王格林;4;1;5;18388;0.00027191646726125733
1981;《至上主义构图》来一张;1;1;2;18388;0.00010876658690450294
1998;有FNFtv抓狂打call;2;1;3;18388;0.0001631498803567544
2003;荒野乱斗里的科莱特（老婆啊）;1;1;2;18388;0.00010876658690450294
2009;说实话我不想改的doge;2;1;3;18388;0.0001631498803567544
2024;承太郎;1;1;2;18388;0.00010876658690450294
2027;明日方舟的花惊怨doge;1;1;2;18388;0.00010876658690450294
2065;大大，我想看第五人格里的求生者：玩具商，画家，囚徒;2;1;3;18388;0.0001631498803567544
2103;冰淇淋罗德;1;1;2;18388;0.00010876658690450294
2111;少年骇客;1;1;2;18388;0.00010876658690450294
2115;后室实体“细菌”;3;1;4;18388;0.00021753317380900588
2134;MC的村民小姐姐保卫萝卜哇脑叶的一无所有保卫萝卜哇;1;1;2;18388;0.00010876658690450294
2141;搞一个墨水班迪妙啊;2;1;3;18388;0.0001631498803567544
2148;我想看武器A（速速顶我）;1;1;2;18388;0.00010876658690450294
2202;后室扫兴客与最近出的那个蓝色眼睛有叉微笑有王冠的生物;1;1;2;18388;0.00010876658690450294
2204;传说之下，小花保卫萝卜哇;1;1;2;18388;0.00010876658690450294
2220;ModernWarshipsdoge这期点赞和投币啊;1;1;2;18388;0.00010876658690450294
2224;脑叶公司的部长们;2;1;3;18388;0.0001631498803567544
2243;识别一下荒野乱斗的塔妮;3;1;4;18388;0.00021753317380900588
2251;托马斯小火车doge;1;1;2;18388;0.00010876658690450294
2256;可以把upAI娘化吗doge;1;1;2;18388;0.00010876658690450294
2266;霍普先生的玩具屋的霍普;1;1;2;18388;0.00010876658690450294
2270;wotb中的鼠式doge;1;1;2;18388;0.00010876658690450294
2284;安全漏洞的vanny;1;1;2;18388;0.00010876658690450294
2288;我不管，我要克苏鲁脱单doge每一个都试一遍，大闹钟，格赫罗斯，黄衣之主哈斯达，生命之神，我要看看还有谁？;1;1;2;18388;0.00010876658690450294
2295;塞尔达传说，林克;1;1;2;18388;0.00010876658690450294
2300;我的头像doge;1;1;2;18388;0.00010876658690450294
2311;要不，把老狂也搞一下滑稽滑稽滑稽滑稽滑稽滑稽;1;1;2;18388;0.00010876658690450294
2327;战神2，战神奎尔托。让Al画这个吧。;1;1;2;18388;0.00010876658690450294
2329;光遇;1;1;2;18388;0.00010876658690450294
2332;识别arcaea里的风暴对立;1;1;2;18388;0.00010876658690450294
2335;明日方舟凯尔希的Mou3ster;1;1;2;18388;0.00010876658690450294
2354;下次就改（does）;1;1;2;18388;0.00010876658690450294
2356;有我，你币有了;1;1;2;18388;0.00010876658690450294
2362;小羊启示录里边的那个主角;1;1;2;18388;0.00010876658690450294
2408;想看多多良小伞;2;2;4;18388;0.00021753317380900588
2417;up试试UT的chara和小羊;1;2;3;18388;0.0001631498803567544
2422;我想看喷射战士3海胆哥;1;2;3;18388;0.0001631498803567544
2426;怕怕肉丝妙啊;2;2;4;18388;0.00021753317380900588
2437;暴力迪吧联合计划里的，1337特工，工程师，，汉克。;1;1;2;18388;0.00010876658690450294
2447;逃离塔科夫的killa和艾伦沃克，兄弟们，顶上去，看到了挨个叫爸爸doge;1;1;2;18388;0.00010876658690450294
2467;失落银;2;1;3;18388;0.0001631498803567544
2472;东方project的芙兰朵露的翅膀要zun绘的脱单doge;1;1;2;18388;0.00010876658690450294
2494;武器a试试辣眼睛辣眼睛;1;0;1;18388;5.438329345225147e-05
2573;要看后室扫兴客;1;0;1;18388;5.438329345225147e-05
2649;想看造梦西游的悟空doge;2;0;2;18388;0.00010876658690450294
2655;我想看二代恶魔班迪;1;0;1;18388;5.438329345225147e-05
2671;哥斯拉怎么样doge;1;0;1;18388;5.438329345225147e-05
2726;滑稽滑稽滑稽;1;0;1;18388;5.438329345225147e-05
2738;house的tabby，或者其他家人也可以文森梅尔斯的秘密第五章文森的最终形态（可能有点冷门但是是个优质游戏）脑叶的蕾蒂希亚（应该是这个名字）然后不是那个八音盒希望别搞错脱单doge;1;0;1;18388;5.438329345225147e-05
2793;我想看彩虹朋友蓝色;1;0;1;18388;5.438329345225147e-05
2797;火柴人亨利;1;0;1;18388;5.438329345225147e-05
2805;6无语;1;0;1;18388;5.438329345225147e-05
2822;fnf可以吗星星眼星星眼星星眼;1;0;1;18388;5.438329345225147e-05
2830;搜索Luckey老白，他视频里的世纪刊祖爷。;1;0;1;18388;5.438329345225147e-05
2944;PPT的兔子和PJ;1;0;1;18388;5.438329345225147e-05
3018;姐妹地点怎样？滑稽;1;0;1;18388;5.438329345225147e-05
3037;我我我天使两姐妹;2;0;2;18388;0.00010876658690450294
3066;空洞骑士;1;0;1;18388;5.438329345225147e-05
3128;蓝色的朋友，绿色的朋友。;1;0;1;18388;5.438329345225147e-05
3136;大哥，你能不能把我的这个头像识别一下？;1;0;1;18388;5.438329345225147e-05
3227;卡通猫;1;0;1;18388;5.438329345225147e-05
3232;看看你王者荣耀里的安琪拉呗tv难过tv大哭;1;0;1;18388;5.438329345225147e-05
3282;明日方舟里面的掉san花，或者进化的本质，还有教主昆图斯;1;0;1;18388;5.438329345225147e-05
3323;能画太空狼人杀吗？;1;0;1;18388;5.438329345225147e-05
3353;笑魇。;2;0;2;18388;0.00010876658690450294
3401;这不突击鹰小队全员安排一波？（三连警告脱单doge）;2;0;2;18388;0.00010876658690450294
3438;默认给你随机;1;0;1;18388;5.438329345225147e-05
3475;想看忍者必须死3里的主角团;1;0;1;18388;5.438329345225147e-05
3550;史蒂夫;1;0;1;18388;5.438329345225147e-05
3569;那就试试scp096吧滑稽;1;0;1;18388;5.438329345225147e-05
3709;荒野乱斗里的角色;1;0;1;18388;5.438329345225147e-05
3712;如果派对客长这样，我宁愿去享乐尽找死;1;0;1;18388;5.438329345225147e-05
3741;辣眼睛;1;0;1;18388;5.438329345225147e-05
3747;把帕派瑞斯识别一下吧;1;0;1;18388;5.438329345225147e-05
3821;马里奥可以吗（搓手）;1;0;1;18388;5.438329345225147e-05
3838;原神迪卢克（搞个女的doge）;1;0;1;18388;5.438329345225147e-05
3880;碧尔斯，兄弟们，把我顶上去;1;0;1;18388;5.438329345225147e-05
3903;这难道就是？脑叶公司的AI识别？;1;0;1;18388;5.438329345225147e-05
3940;地铁离去主角阿尔乔姆;1;0;1;18388;5.438329345225147e-05
4016;想看把游戏《欧洲卡车模拟2》的封面图AI娘化（卡车应该是这个评论区里最离谱的“物种”了罢;1;0;1;18388;5.438329345225147e-05
4023;這是什麼AI;1;0;1;18388;5.438329345225147e-05
4026;音游人来了，来个键，什么音游都可以，但我喜欢阿卡抑的扭扭大蛇（;6;0;6;18388;0.0003262997607135088
4058;托拉姆物语的蒙丹和皮诺;1;0;1;18388;5.438329345225147e-05
4100;想康康曼陀罗魔花元气骑士里面的;1;0;1;18388;5.438329345225147e-05
4140;我要看泰坦陨落;2;0;2;18388;0.00010876658690450294
4166;荒野乱斗里的珍妮特;1;0;1;18388;5.438329345225147e-05
4184;我想看一下黄金弗雷迪脱单doge;1;0;1;18388;5.438329345225147e-05
4238;是笨蛋猪猪笑死我了鹅鹅鹅鹅离谱;1;0;1;18388;5.438329345225147e-05
4252;艾彼中的Abi和DD;1;0;1;18388;5.438329345225147e-05
4257;投稿火柴人亨利系列的亨利，查尔斯，艾莉;1;0;1;18388;5.438329345225147e-05
4286;backrooms的扫兴客脱单doge;1;0;1;18388;5.438329345225147e-05
4310;阿曼达doge;1;0;1;18388;5.438329345225147e-05
4312;是你视频吗你乱发你就会盗视频是吧这是原视频别被骗了httpsb23tvj0rQzU;2;0;2;18388;0.00010876658690450294
4319;求求作者能不能把柔焛转性成男孩因为我想看一下帅不帅;1;0;1;18388;5.438329345225147e-05
4321;迪迦;1;0;1;18388;5.438329345225147e-05
4325;李元芳;1;0;1;18388;5.438329345225147e-05
4445;想看《大理寺日志》中的一枝花害羞;1;0;1;18388;5.438329345225147e-05
4456;索都有了，来个sonicexe;1;0;1;18388;5.438329345225147e-05
4494;FNFBF;3;0;3;18388;0.0001631498803567544
4524;乔儿;1;0;1;18388;5.438329345225147e-05
4621;下回整个sans;1;0;1;18388;5.438329345225147e-05
4695;him，苦力怕，末影龙;1;0;1;18388;5.438329345225147e-05
4708;海绵宝宝;1;0;1;18388;5.438329345225147e-05
4721;死亡细胞的细胞人和我的勇者的法师;1;0;1;18388;5.438329345225147e-05
4742;能给我搞一个光遇的主角吗？;3;0;3;18388;0.0001631498803567544
4752;fnf为人模组：马克，凯撒，亚当，约拿;1;0;1;18388;5.438329345225147e-05
4789;索尼克里的塔尔斯;2;0;2;18388;0.00010876658690450294
4867;就决定是你了，笑魇;1;0;1;18388;5.438329345225147e-05
4903;求求sallyface里的sal和Larry大哭;1;0;1;18388;5.438329345225147e-05
4955;也许就sans的关键词书成我这样的，也许能出个好的。;1;0;1;18388;5.438329345225147e-05
4998;MGRR的阿姆斯特朗doge;1;0;1;18388;5.438329345225147e-05
5025;Portaboy（doge;1;0;1;18388;5.438329345225147e-05
5060;陈子墨，我搞了一张脑叶公司的照片可以有A绘画呀;1;0;1;18388;5.438329345225147e-05
5086;试一试凋零风暴吧;1;0;1;18388;5.438329345225147e-05
5113;小骨英雄杀手脱单doge脱单doge脱单doge;1;0;1;18388;5.438329345225147e-05
5137;FNAF的傀儡;1;0;1;18388;5.438329345225147e-05
5203;迷你世界中的迷斯拉;1;0;1;18388;5.438329345225147e-05
5217;来了;1;0;1;18388;5.438329345225147e-05
5221;老夫一眼就看出来这秘书业务能力特别出众。一定很能干;4;107;111;18388;0.006036545573199913
5226;网图多了就腻了，红书选了俩清纯俩性感的做成了模型，图片一出来我就OMG，比网图惊艳太多了星星眼;6;121;127;18388;0.006906678268435936
5233;省流;2;59;61;18388;0.0033173809005873395
5236;他们都喜欢圆圆的家伙滑稽;6;48;54;18388;0.0029366978464215794
5243;有一说一，画师不一定被第一个取代，一些十八线野模怕是要先被淘汰了，我要是不需要t台走秀，以后做广告拿ai做未尝不可;2;48;50;18388;0.0027191646726125733
5246;希望可以把意识上传到数据;6;24;30;18388;0.001631498803567544
5253;金鸡湖女仆游艇画风doge;2;8;10;18388;0.0005438329345225147
5256;网黄要失业了;1;2;3;18388;0.0001631498803567544
5259;这手指看得我一愣一愣的辣眼睛;1;3;4;18388;0.00021753317380900588
5261;你是懂职场的;1;3;4;18388;0.00021753317380900588
5263;真不错星星眼;1;4;5;18388;0.00027191646726125733
5265;销售冠军;1;1;2;18388;0.00010876658690450294
5267;ai可把衣服画透明点吗doge;10;1;11;18388;0.0005982162279747662
5278;很好，加大力度doge;1;2;3;18388;0.0001631498803567544
5280;有这样的秘书，老板可能就扑街在公司门口了;1;1;2;18388;0.00010876658690450294
5282;好家伙困的手机都快砸脸上了，正准备睡觉发现了这个视频;1;1;2;18388;0.00010876658690450294
5284;三连了打call;1;1;2;18388;0.00010876658690450294
5286;nb;1;1;2;18388;0.00010876658690450294
5288;吃瓜喜欢doge;1;1;2;18388;0.00010876658690450294
5291;这东西能不能用别人照片整;1;0;1;18388;5.438329345225147e-05
5293;用什么软件画的;1;0;1;18388;5.438329345225147e-05
5295;请问用什么画的;1;0;1;18388;5.438329345225147e-05
5297;看看我发现了什么宝藏;1;1;2;18388;0.00010876658690450294
5299;有tag吗脱单doge脱单doge脱单doge;3;0;3;18388;0.0001631498803567544
5303;三连了，支持一波微笑;1;0;1;18388;5.438329345225147e-05
5305;这特么是AI画的？？;1;0;1;18388;5.438329345225147e-05
5308;大佬，运行吃显卡吗;1;0;1;18388;5.438329345225147e-05
5310;三连了;1;0;1;18388;5.438329345225147e-05
5312;这个模型：原八重cos作附Cy1zu在哪能找到？;1;0;1;18388;5.438329345225147e-05
5314;带腿的脱单doge脱单doge;1;1;2;18388;0.00010876658690450294
5316;啥软件能这样;1;0;1;18388;5.438329345225147e-05
5318;以三连请求神秘连接;3;0;3;18388;0.0001631498803567544
5322;有点东西;1;0;1;18388;5.438329345225147e-05
5324;好耶星星眼;1;0;1;18388;5.438329345225147e-05
5326;直接人生巅峰tv呆;1;0;1;18388;5.438329345225147e-05
5328;ai有点厉害啊这个;1;0;1;18388;5.438329345225147e-05
5331;思考吃瓜OK;1;0;1;18388;5.438329345225147e-05
5333;加大力度，币大大的有脱单doge;1;0;1;18388;5.438329345225147e-05
5335;挺不错微笑;1;0;1;18388;5.438329345225147e-05
5337;这么漂亮能干嘛脸红;1;0;1;18388;5.438329345225147e-05
5339;好离谱啊，太厉害了;1;0;1;18388;5.438329345225147e-05
5341;可以把背景换成我办公室吗脱单doge;1;0;1;18388;5.438329345225147e-05
5343;适合和我出差doge;1;0;1;18388;5.438329345225147e-05
5345;up主加油打call，可以分享一下用哪些模型做出来的吗doge;4;0;4;18388;0.00021753317380900588
5350;那个软件制作的吃瓜吃瓜吃瓜;1;0;1;18388;5.438329345225147e-05
5352;针不戳吃瓜;1;0;1;18388;5.438329345225147e-05
5354;以三连up加油;1;0;1;18388;5.438329345225147e-05
5356;加油;1;0;1;18388;5.438329345225147e-05
5358;这是什么ai软件画的？;1;0;1;18388;5.438329345225147e-05
5360;ai图有没有那样子的doge;1;1;2;18388;0.00010876658690450294
5362;创作不易给你点赞;1;0;1;18388;5.438329345225147e-05
5364;模型用的啥啊？lora是韩国那个对吧;4;0;4;18388;0.00021753317380900588
5369;很快东京就不热了;1;0;1;18388;5.438329345225147e-05
5371;直接反手就是投币点赞收藏，望up主能出全竖屏的doge;1;0;1;18388;5.438329345225147e-05
5375;求个tag，为什么我的都做不出这样的动作，你这个好稳啊;8;0;8;18388;0.00043506634761801175
5385;三连送上，下次多来些全身的doge;1;0;1;18388;5.438329345225147e-05
5394;黑色的，黑色的瞄见了doge;1;0;1;18388;5.438329345225147e-05
5398;好评，只要你给链接了，我就给你两个圆圆的东西doge;3;0;3;18388;0.0001631498803567544
5402;什么时候就直接来实体的吧，尊重女性，从我做起doge;2;0;2;18388;0.00010876658690450294
5409;这有什么意义？我每个月累死累累活就那么点工资，不可能购买你这零成本的电子世界电子烂白菜，你觉得好看，我觉得还有更好看的可以随便出图，ai生成一个作品几秒，学习合成作品没有成本，我手里的币是有限，增加需要极大的成本，你ai一天就可以生成几千套游戏皮肤，每个皮肤188但是成本为0我看都不看一眼全是海量合成的味道更不会购买没有价值的意义没有意义doge;4;7;11;18388;0.0005982162279747662
5414;看多了，对现实中的妹子提不起兴趣咋办？永雏塔菲累;1;1;2;18388;0.00010876658690450294
5417;喜欢第4张和第5张;1;0;1;18388;5.438329345225147e-05
5419;水溶固;1;0;1;18388;5.438329345225147e-05
5421;点赞投币一气呵成;1;0;1;18388;5.438329345225147e-05
5423;不错三连了脱单doge;1;0;1;18388;5.438329345225147e-05
5426;必需投币;1;0;1;18388;5.438329345225147e-05
5428;离鸢你是我老婆;1;0;1;18388;5.438329345225147e-05
5430;好看求图;2;0;2;18388;0.00010876658690450294
5459;下次能不能画点不能播的doge喜欢;2;53;55;18388;0.002991081139873831
5463;太保守了doge;1;1;2;18388;0.00010876658690450294
5466;期待更多的竖版鸡腿;1;8;9;18388;0.0004894496410702633
5468;求图包;1;1;2;18388;0.00010876658690450294
5470;已三连，求doge脱单doge;2;1;3;18388;0.0001631498803567544
5473;求图包;1;1;2;18388;0.00010876658690450294
5475;求图包星星眼星星眼;1;1;2;18388;0.00010876658690450294
5477;三连求图脱单doge;1;1;2;18388;0.00010876658690450294
5480;已三连，求图包;1;1;2;18388;0.00010876658690450294
5482;来个图包doge;1;1;2;18388;0.00010876658690450294
5489;嗑瓜子嗑瓜子嗑瓜子打call打call打call;1;1;2;18388;0.00010876658690450294
5509;能不能跑一些雪女近距离观看图吃瓜;2;0;2;18388;0.00010876658690450294
5512;刻晴史诗级加强笑哭感觉像是长大版的doge;10;274;284;18388;0.015444855340439417
5523;这是婚后的阿晴脱单doge;7;138;145;18388;0.007885577550576462
5531;感觉ai绘图都有自己的一套模型数据，然后再把人物套在这个模型上，所以看起来ai绘图的人物除了颜色之外，脸型，身高，体型，的大小，都是一样的的。;2;19;21;18388;0.0011420491624972808
5534;这才是我的刻晴星星眼给心心;3;66;69;18388;0.003752447248205351
5538;来个网盤链接dogedogedoge;11;63;74;18388;0.004024363715466608
5550;用的什么模型tvdoge;1;4;5;18388;0.00027191646726125733
5552;up主能发下全图不脱单doge;1;2;3;18388;0.0001631498803567544
5556;感觉所有ai都一个画风，很精致又有点不精致;3;9;12;18388;0.0006525995214270176
5561;一股子甘雨味笑哭;1;14;15;18388;0.000815749401783772
5563;绝对有投乌橄榄菜;3;2;5;18388;0.00027191646726125733
5567;能来点甘雨的嘛;1;5;6;18388;0.0003262997607135088
5569;针不戳星星眼关注了，再来点这种风格的申鹤喜欢;2;12;14;18388;0.0007613661083315206
5574;三连了up，求图包脱单doge;1;0;1;18388;5.438329345225147e-05
5576;三连求图包，up给心心;1;0;1;18388;5.438329345225147e-05
5578;水冰氷氺太君里边请;1;0;1;18388;5.438329345225147e-05
5580;净瞎说，什么叫AI画的刻晴好看，明明是老婆本来就好看吃瓜doge;1;1;2;18388;0.00010876658690450294
5583;这恐怖的收藏量;1;0;1;18388;5.438329345225147e-05
5586;加油哦;1;0;1;18388;5.438329345225147e-05
5589;歌好听，图好看。三连了打call;1;0;1;18388;5.438329345225147e-05
5591;音乐挺好听，歌名是什么啊？;1;0;1;18388;5.438329345225147e-05
5593;这刻晴太老了;1;0;1;18388;5.438329345225147e-05
5595;不看手挑战;1;0;1;18388;5.438329345225147e-05
5597;越来越喜欢ai了;1;0;1;18388;5.438329345225147e-05
5599;何止三连我直接加多个关注;1;0;1;18388;5.438329345225147e-05
5602;太大了不够还原doge多来点;1;0;1;18388;5.438329345225147e-05
5605;这种风格可以再多几个角色吗;2;3;5;18388;0.00027191646726125733
5611;你可以看看我动态的刻晴，你这个是不太有少女感脸红;1;0;1;18388;5.438329345225147e-05
5614;有我想看的东西吗doge;3;0;3;18388;0.0001631498803567544
5618;好看吃瓜;1;0;1;18388;5.438329345225147e-05
5620;up有没有图包喜欢;1;0;1;18388;5.438329345225147e-05
5622;UP用什么软件做的呀;1;0;1;18388;5.438329345225147e-05
5624;真好看咱还是喜欢桃打call;2;0;2;18388;0.00010876658690450294
5628;感觉一股魅魔味;2;0;2;18388;0.00010876658690450294
5634;刻晴有这么大吗;1;0;1;18388;5.438329345225147e-05
5636;666666;1;0;1;18388;5.438329345225147e-05
5638;私聊了我全要你懂的;1;0;1;18388;5.438329345225147e-05
5640;她想跟我回家doge;1;0;1;18388;5.438329345225147e-05
5642;up方便发下图嘛;3;0;3;18388;0.0001631498803567544
5646;我知道出处doge而且还有很多无衣图;1;0;1;18388;5.438329345225147e-05
5648;三连送上，不要骄傲;1;0;1;18388;5.438329345225147e-05
5650;你们就是想要我娶妻生子。无奈;1;0;1;18388;5.438329345225147e-05
5652;现在的美颜和ai跑出来的也没什么区别了ai还更好看一点，算是极致精修;1;65;66;18388;0.003589297367848597
5654;很真实的很好看。能不能搞点限制级的身材doge;9;72;81;18388;0.004405046769632369
5664;都重要，每次自己出图最烦古神脸和古神手;2;24;26;18388;0.0014139656297585382
5667;全都要不就行了;1;1;2;18388;0.00010876658690450294
5669;说实话，这样的颜值和身材，就算二十个手指我都喜欢呲牙呲牙;1;0;1;18388;5.438329345225147e-05
5671;都不重要，手重要，会出戏;1;0;1;18388;5.438329345225147e-05
5674;好奇这些都是什么软件做的？;1;3;4;18388;0.00021753317380900588
5676;已三连求这期视频的图脱单doge;4;6;10;18388;0.0005438329345225147
5682;三连加关注，求图包;1;0;1;18388;5.438329345225147e-05
5684;赢家是扔子;1;2;3;18388;0.0001631498803567544
5686;图呢？最好私发，不想要网盘的给心心我给你关注加三连，Up主;1;0;1;18388;5.438329345225147e-05
5688;能不能把腿安排上;1;0;1;18388;5.438329345225147e-05
5690;当然是全都要脱单doge;1;2;3;18388;0.0001631498803567544
5694;手最重要，没有手的都好美，有手的好诡异;1;0;1;18388;5.438329345225147e-05
5703;用的什么模型和关健字？;1;0;1;18388;5.438329345225147e-05
5705;加油;1;0;1;18388;5.438329345225147e-05
5710;有几张图里的手太可怕了doge;1;0;1;18388;5.438329345225147e-05
5726;富有但不慷慨;5;93;98;18388;0.005329562758320644
5732;链接：httpspanbaiducoms1xCX0FPRTrMjO83FFZxYRogpwd7m7a提取码：7m7a来自百度网盘超级会员V2的分享图包来了别加群了群满了笑哭;5;31;36;18388;0.001957798564281053
5738;没有图包我不是很认可脱单doge脱单doge脱单doge;9;32;41;18388;0.00222971503154231
5748;三连后突然发现没图包，这是一种怎样的落寞囧;1;16;17;18388;0.000924515988688275
5750;我发现她们穿着衣服是最好看的时候，衣服没了，却感觉缺了些什么脱单doge;2;12;14;18388;0.0007613661083315206
5754;看了那么多，脸都差不多，神似南韩魅魔藏狐;3;5;8;18388;0.00043506634761801175
5758;差评;1;0;1;18388;5.438329345225147e-05
5761;后面的那个女的脸一模一样，哈哈。歪嘴;1;8;9;18388;0.0004894496410702633
5767;求图包doge;1;0;1;18388;5.438329345225147e-05
5770;已三连求链接doge;1;0;1;18388;5.438329345225147e-05
5772;求图星星眼;1;0;1;18388;5.438329345225147e-05
5788;三连求包doge;1;1;2;18388;0.00010876658690450294
5790;求图包星星眼;1;0;1;18388;5.438329345225147e-05
5792;打call打call;1;0;1;18388;5.438329345225147e-05
5797;为什么别的不打码都照样发出来，你要打码;1;3;4;18388;0.00021753317380900588
5816;有包吗吃瓜;1;0;1;18388;5.438329345225147e-05
5818;点赞投币了doge，求图;1;0;1;18388;5.438329345225147e-05
5834;是动画，还是在真人摄影后加工的？;1;0;1;18388;5.438329345225147e-05
5845;你对汉服是不是有什么误解;1;0;1;18388;5.438329345225147e-05
5855;感觉Ai就是画不好手，不是多根手指就是少;3;10;13;18388;0.0007069828148792691
5861;吃瓜预感一堆颜色画师得转行当编剧。;3;10;13;18388;0.0007069828148792691
5868;虽然但是真人脸套动漫人物的身材看着很奇怪，胸太大了doge;2;4;6;18388;0.0003262997607135088
5871;对于ai画画和拟合照片没有什么区别吧笑哭;1;5;6;18388;0.0003262997607135088
5876;怎么都是南亚人笑哭;1;1;2;18388;0.00010876658690450294
5883;什么时候做视频，我迫不及待了;1;1;2;18388;0.00010876658690450294
5886;满朝文武，支支吾吾囧;1;0;1;18388;5.438329345225147e-05
5894;这是哪个ai绘画软件？;1;0;1;18388;5.438329345225147e-05
5896;请问是什么模型？;2;0;2;18388;0.00010876658690450294
5908;虽然，但是伯爵胸口有个痣来着;8;129;137;18388;0.007450511202958451
5918;有几张比那些coser的高p图还像人呲牙;1;28;29;18388;0.0015771155101152925
5920;虽然不太像，但是我爱看。吃瓜;3;41;44;18388;0.0023928649118990647
5925;拒绝ai绘画藏狐;1;18;19;18388;0.0010332825755927778
5928;粉色大猫猫;1;6;7;18388;0.0003806830541657603
5930;来个卡米利安喜欢喜欢喜欢喜欢;1;3;4;18388;0.00021753317380900588
5932;唯有那种嚣张的感觉doge;1;10;11;18388;0.0005982162279747662
5936;多搞点吃瓜;1;2;3;18388;0.0001631498803567544
5938;求BGM;1;0;1;18388;5.438329345225147e-05
5941;太感谢up了感觉当做手机壁纸壁纸很好看要说缺点就是只能投两个币太少了星星眼;1;0;1;18388;5.438329345225147e-05
5944;大佬能教一下怎么只让ai按照一张脸来生成？有时候跑出一张喜欢的，然后就再也跑不出相似的脸了;4;1;5;18388;0.00027191646726125733
5949;好看是挺好看的，再姐一点就更像了嗑瓜子;2;0;2;18388;0.00010876658690450294
5958;投币三连了，BGM是啥;1;0;1;18388;5.438329345225147e-05
5967;BGM不错支持;1;0;1;18388;5.438329345225147e-05
5976;脱单doge脱单doge脱单doge脱单doge;1;0;1;18388;5.438329345225147e-05
5978;呜呜呜好喜欢有那味;1;1;2;18388;0.00010876658690450294
5982;好看UP主加油;1;0;1;18388;5.438329345225147e-05
5988;多搞点，我爱看doge（已投币）;1;0;1;18388;5.438329345225147e-05
5992;什么时候来个10娜？？;1;0;1;18388;5.438329345225147e-05
5997;她真美啊脱单doge;1;0;1;18388;5.438329345225147e-05
5999;大家看看美图就行了呲牙和这标题有关的游戏千万别入坑;7;0;7;18388;0.0003806830541657603
6010;老三是不是有点早doge;1;0;1;18388;5.438329345225147e-05
6015;图包晚一点放评论区;2;0;2;18388;0.00010876658690450294
6018;怎么这么像我女儿呢笑哭;14;65;79;18388;0.004296280182727866
6033;三连了，大佬，0015你这个角度是怎么控制的呀笑哭，想做;4;7;11;18388;0.0005982162279747662
6038;加油，顺便蹲个图包;4;19;23;18388;0.0012508157494017839
6043;竖屏图你弄成横屏吃瓜;1;2;3;18388;0.0001631498803567544
6045;出了图记得通知我;1;2;3;18388;0.0001631498803567544
6047;三连求图包doge;1;2;3;18388;0.0001631498803567544
6050;三连求图包;1;1;2;18388;0.00010876658690450294
6052;蹲图包1;1;1;2;18388;0.00010876658690450294
6054;三连求图包;1;1;2;18388;0.00010876658690450294
6056;网盘链接星星眼来个;1;1;2;18388;0.00010876658690450294
6058;拜托三连了耶，不整个度盘嘛;2;1;3;18388;0.0001631498803567544
6061;三连求图;1;1;2;18388;0.00010876658690450294
6063;想要图包已三连来古呆滞;1;1;2;18388;0.00010876658690450294
6065;三连求图打call;2;1;3;18388;0.0001631498803567544
6068;已投币期待图包;1;1;2;18388;0.00010876658690450294
6070;已三连，请把包拿来生气;1;1;2;18388;0.00010876658690450294
6072;三连已交，求图星星眼;1;1;2;18388;0.00010876658690450294
6074;能不能发个专栏啊;1;1;2;18388;0.00010876658690450294
6077;已赞，送你上首页;1;2;3;18388;0.0001631498803567544
6079;6a，有图包吗？星星眼;1;1;2;18388;0.00010876658690450294
6082;下包呀dogedogedoge我三连了，你包呢;1;1;2;18388;0.00010876658690450294
6084;包呐？愣着干嘛你倒是下包呀敌人都压到B点了，你还不下包。爱心下包了记得踢我一下，我挂会儿机，上个厕所。吃瓜;1;2;3;18388;0.0001631498803567544
6086;这个是什么风格？ol？;1;0;1;18388;5.438329345225147e-05
6090;三连力，有图包了踹我一脚星星眼;1;2;3;18388;0.0001631498803567544
6100;两个圆圆的东西换图包;1;1;2;18388;0.00010876658690450294
6106;这个是谁好看;1;0;1;18388;5.438329345225147e-05
6125;三连求图包;1;0;1;18388;5.438329345225147e-05
6129;打call;1;1;2;18388;0.00010876658690450294
6131;币先投了吃瓜，等你链接;1;1;2;18388;0.00010876658690450294
6133;三连求图;1;1;2;18388;0.00010876658690450294
6135;三连来图包;1;1;2;18388;0.00010876658690450294
6137;三连求图;4;2;6;18388;0.0003262997607135088
6143;三连求图笑哭;1;1;2;18388;0.00010876658690450294
6145;三连求图包doge;1;1;2;18388;0.00010876658690450294
6147;留图不留种下一句是啥来着dogedogedoge;1;0;1;18388;5.438329345225147e-05
6149;彻底疯狂;1;1;2;18388;0.00010876658690450294
6151;你火了，我说的;3;2;5;18388;0.00027191646726125733
6155;三连已交，球图;1;1;2;18388;0.00010876658690450294
6157;赞你，顶顶顶，吃瓜吃瓜吃瓜;1;1;2;18388;0.00010876658690450294
6176;每次都听成“进进出出的说你爱我”;2;19;21;18388;0.0011420491624972808
6179;看到一条评论说要把up主的图喂ai，白嫖党还真是脸皮厚啊呲牙哦不对白嫖党没有脸怪我咯怪我咯;14;486;500;18388;0.027191646726125736
6194;我因为热爱选择了绘画的岗位，但工作后才发现，无论是我还是身边同学，作为一个底层画师，大多数公司只是把你当作做图工具。他们强迫着你没日没夜地加班，通过各种缝合拼贴，只是为了实现策划主美以及老板想要赚快钱的想法。久而久之，热爱变成了麻木，变成了机械。现实很残酷，只有那些大佬们，才有表达自己艺术想法的权利。而当下绘画圈内卷厉害，且公司疯狂压榨员工的时间。底层画师要成为大佬，谈何容易。而回过头来，底层画师那种机械式的工作，AI绘画绝对是非常有冲击力。据我所知，我一个做大数据的同学对绘画一窍不通现在都能用AI绘画来赚点外快了。当然了，这完全不是大大担忧的事啦。;22;877;899;18388;0.04889058081357407
6217;现在有网站可以识别ai图了，我觉得这个反而应该推广出去wwwilluminartyai，让更多人知道，你把ai图放上去基本上是百分之99的，自己的画的图基本在105区间，无关画技，只要是你画的都在百分10左右，因为我已经把小画师的作品传上去看过了，而且ai的图是有是无法商用，已经国外出过政策了，因为你出的每一张图都归模型设计师所有，且现在ai图不能商用，加上我上面那个网站可以测ai图，你越改她降得越低，（三国题材的插画有部份会在86左右），还有还有就是现在整个画圈都很排挤ai图，其实你逛b站就知道，没人会买ai图，所谓ai画师，大家也只是想关注他拿词条，因为图不能商用，大家更多只是拿来玩，炫耀更说不上，你儿子跟你爷爷学习几天生成的东西会跟你一样，所以根本没有炫耀和攀比价值，而且他是每个人都可以用的，当一个东西大家都可以用的时候他就会失去价值，你能完全改到可以用你的能力其实也有这张图百分7080，因为你要改到这种图降到测试网站在百分之10左右才算你作品，而ai图可不是你随便改几笔就能降下去的，甚至她最后只是给你提供了一个参考，现在唯一需要焦虑就是ai为什么画的比你好，当然有些做小头像的画师可能会比较倒霉，因为有些人能给自己生成一张自己满意的头像，自然就不找你了，但是你说能冲击商稿圈现在ai还做不到，学会他，利用他，同时自己要更加努力学习是你唯一要做的事情;50;576;626;18388;0.03404394170110942
6268;想起看过一个宫崎骏的纪录片里，有人向宫崎骏展示用AI做出来的三维动画，宫崎骏沉默的看完以后说：世界末日可能要来了，人类对自己失去了自信，也许未来的动画将不再出自人类之手。汽车取代马车是科学文明的进步，可是像绘画这种本身是由人类表达情感的行为，也被AI用机器计算取代，这种真的会是人类的进步吗？;25;596;621;18388;0.03377202523384816
6294;ai绘画在普通人手中，画出的上限取决去ai。ai绘画在画师手中，画出的上限则是取决于画师的能力。;15;313;328;18388;0.01783772025233848
6310;行业被ai冲击是大趋势，也是普遍存在的。我是会计，一些顶尖的会计师事务所已经引入ai进行会计工作了，只会基础的记账报税在未来很快就会被取代。但之前看过一句话很有道理，在火车刚刚发明的时候，很多人担心车夫会就此失业，因此规定火车速度不能超过车夫。但火车诞生的同时，也创造了无数个铁路工人的就业岗位。随随的画好漂亮打call打call打call这张还有点恐怖hhh;14;239;253;18388;0.013758973243419622
6325;这东西画师又不是不能用。平民拿枪跟军人拿枪效果能一样吗？歪嘴;12;187;199;18388;0.010822275396998041
6338;ai冲击元年最恐怖的地方在于比人脑的学习构思速度快太多了我突然在想ai能不能编程建模场景美术如果可以的话不知道多少人要失业蛆音娘扶额;13;76;89;18388;0.0048401131172503805
6352;我们的一些文化手艺本来就没怎么传承起来，若是人们都接受了ai，未来都在用ai画画，估计连现在这样的绘画过程都看不到了吧。;4;36;40;18388;0.0021753317380900587
6358;ai是必然的，普通底层的老板跟甲方只是需要低成本高效率的出图，以后不光是插画，设计等等那种一键模板都将会取代底层的设计，然后高手负责出一款流行的设计，低层的就用ai模仿就行了，说白了，不管是插画还是设计都是服务外行的，如果人人都是大师也就不用找你们画了，而且这种东西主观性又这么强，所以插画，设计这条路底层的人以后只会越来越没有市场，我已经认清自己了，不在干设计了，抓紧转行，免得老了之后在被ai淘汰;3;49;52;18388;0.0028279312595170763
6363;那个恶意的人截画师直播图丢进ai的事件害的我不能看宝的直播大哭大哭大哭;1;94;95;18388;0.0051664128779638895
6366;用ai的不太配用“画”这个词吧，他们根本没画;22;91;113;18388;0.006145312160104416
6389;AI最大的问题是掌握在资本的手里，那它就不是真正的解放生产力，资本家会觉得有这种廉价的劳动力为什么用人，普通人就业难度进一步提高，群体消费能力进一步降低，直到资本产出的商品没有消费者消费，不得不说马克思是真的强;3;65;68;18388;0.0036980639547531
6393;我反而奇怪为什么有这么多人对AI绘图感到有热烈讨论的必要照片技术来了之后绘画被代替了么后来只是增加了一个叫摄影师的职业photoshop被发明了一样可以快速缝合各种风格的图片操作者也不需要很严格的美术训练传统绘画被photoshop代替了么后来只是增加了很多熟练操作photoshop的人AI绘图也一样最后不外是承担了部分的作图步骤但也会相对应地增加一些熟练操作AI绘图软件的职业工作者这还是往好的方面想不好的方面还有可能是你用AI怎么做都做不出满意的效果来到头来选择更原始的方案进行创作CG绘画就是一个典型虽然有很多模仿的手法可以模拟出铅笔钢笔甚至水墨的画风但如果阁下是能灵活运用铅笔水墨等的话还不如直接在纸上做的效果最自然或者很多画师为了追求相对自然的画味起初的铅笔稿毛笔稿就用真正的画具上色才用CG说白了就是连铅笔毛笔都还没被CG代替大家就来担心AI能代替人攻壳机动队说AD2029年才会出现电脑人可以某些程度上模拟人类但现在的情况来看估计到了那个时候街上的车子还需要轮胎很多事并没有像科幻电影那样发展得那么快现在去担心那些什么AI智能反过来统治人类啥啥的还有点早;7;37;44;18388;0.0023928649118990647
6401;艺术创造就停滞了艺术家的心血被任意盗窃以后没人愿意创造了;19;23;42;18388;0.0022840983249945617
6426;未来会有ai画师这个岗位;2;7;9;18388;0.0004894496410702633
6430;目前来看AI绘画目前还有一些难点要解决，或许还会有更多可能，近期每天都有新的绘画软件上线，也算是今年来现象级别的产品形态。手机端试试wx公号“一句画师”;1;5;6;18388;0.0003262997607135088
6432;目前AI绘画还是需要人工提高完整度的，所以还是可控的，但是这个东西发展太快了，需要观望可控程度。就怕发展到一个完全不懂画画的人都能使用AI批量制造优秀的作品，绘画失去过程，那才是可怕。;1;11;12;18388;0.0006525995214270176
6434;喷up主的，甚至画不出up主的画吧辣眼睛真的魔怔了，评论区里也有绘画岗位的人，那么多前辈说的话，怎么就不听呢，怎么就那么固执呢;1;7;8;18388;0.00043506634761801175
6440;法律上讲肆意偷窃别人的知识成果，是侵权的，扯学习原理没用的，这只是个软件算物不算人，你给软件用禁止商用禁止私用的图，就是构成侵权了。属于使用者单方面侵权;7;8;15;18388;0.000815749401783772
6448;目前看，别说商业图替代不了，就现在约私人图，少一个零件都是个大问题;1;8;9;18388;0.0004894496410702633
6450;ai在半年期间迅速发展，并且已经被国内很多公司投入使用，大批画师被裁员，不知道各位还能气定神闲多久。;3;7;10;18388;0.0005438329345225147
6455;ai成时代的退步了可还行，仅仅因为威胁到小画师的饭碗和所谓的“版权”“灵魂”的问题就说ai是时代退步，能说出这话的小朋友也有够天真的;12;16;28;18388;0.0015227322166630412
6476;那么素材库呢？ai凭什么拿走画手的商稿，去做素材库呢？我不是指用自己的照片，用ai形成新图，是现在的输入关键词形成新画，新画是ai在素材库缝合的产物，商家再用素材库赚钱，但是并没有给素材付费，没有取得作者的同意;1;5;6;18388;0.0003262997607135088
6478;如果ai绘图被广泛认可了可以说人类就会迎来一次思维退化同时也证明了直接利益可以代替深度追求以后各个领域的事件会越来越多人变成不会思考没有追求的溺水猪的时代也就指日可待了，快餐文化无营养短视频ai批量抄袭作品，代表了人类精神世界的逐步降级，科学进步了，人类的审美与精神世界却荒芜了，创造力是人类最宝贵的特征，如今也将要被剥夺，这个问题很值得思考：将知识性劳动交予没有思维机器，真的是正确的吗？;3;5;8;18388;0.00043506634761801175
6482;可惜AI所绘制出来的各种天马行空的画作已经超越绝大多数人的想象力了并且AI还能准确打光和较好的完成度;4;3;7;18388;0.0003806830541657603
6487;“ai不会直接取代人，但使用ai的人可以”，说白了如果ai仅仅做到帮助人提高生产的效率，那么需要的生产力就会减少，还是会导致一部分从业者失业;2;3;5;18388;0.00027191646726125733
6495;为什么人学习临摹画作提升画技没有问题，ai学习画作就是侵权，ai在创作过程中也没有对画作进行借鉴啊人通过临摹学习可以获得和作者相似的画风，ai学习能力更强生产效率更高就要被口诛笔伐;6;4;10;18388;0.0005438329345225147
6508;ai非常nb是真的，但就是来到太晚了，培训机构已经赚麻了呲牙呲牙呲牙;3;6;9;18388;0.0004894496410702633
6516;问题在于，有些平民比军人还会拿枪;8;2;10;18388;0.0005438329345225147
6527;效率不一样，而且人的绘画能力远远比不过计算机;7;2;9;18388;0.0004894496410702633
6535;先让ai随机生成，然后抄ai吃瓜;2;1;3;18388;0.0001631498803567544
6539;个人对绘画发展不太了解，我只能问一下，如果说初学者都是从模仿绘画开始的，那么熟练后的创新是他们思维的产物，那么ai通过大量模仿，能否会有进步和创新呢？再简单一点，人没有见过上帝，但是能想象上帝的样子，那么如果没有告诉过ai上帝是什么样子，他能否创造出上帝呢？如果不能，那么ai的是否会影响整个绘画发展呢？;3;1;4;18388;0.00021753317380900588
6543;AI自由做头像，免费生成，轻松实现头像自由o哔哩哔哩httpsb23tvZlDPfr7调皮调皮调皮;1;2;3;18388;0.0001631498803567544
6545;刚开始还没看清，我还以为你画的是白骨精;1;0;1;18388;5.438329345225147e-05
6547;笑死一群不会画画的人以为自己能掌控得了AI;1;0;1;18388;5.438329345225147e-05
6556;思考可是有的画师工作就是与画画有关，以此长项来混口饭吃，Ai学习能力很强，到时候Ai成熟之后将会是大量画师失业，首先Ai效率比人高，修改也快速，效果也好，多薪聘请画师为什么不选择选择电脑降低成本？商人又不傻，到时候画师更卷更是人才多岗位少工资低的现像，你不干有的是别人干。doge生存可离不开吃。;4;0;4;18388;0.00021753317380900588
6561;从去年3月末ai画风景直到目前3月5日，ai进化的程度不是辅助人，而是让人去辅助ai。再过两年ai生产ai时候人可以回家种地了。绘画不存在了。;16;0;16;18388;0.0008701326952360235
6588;我花一天时间学的咒语，我要你花五年来超越挺过分的。;3;0;3;18388;0.0001631498803567544
6593;羡慕你这板子;2;0;2;18388;0.00010876658690450294
6599;好画师大可不必恐惧，Ai是工具，工具是替换不了操作者的，它只会增加画师的效率把更多的时间用于精雕细琢和构图，这也是一幅作品的价值所在。但如果只是无脑出图的体力劳动画师可能会被淘汰掉。做个不恰当的比喻，一百年前，开车的司机是一个绝对的专业活，但技术的升级，现在是个人都可以开车。尤其不远的未来，可能不需要人开车，但这些技术永远只是舒马赫之流的工具，让他们如虎添翼，并不会代替他们。只是代替了出租车司机而已。;1;0;1;18388;5.438329345225147e-05
6617;普通作品是一个“直接创作”的过程，即由人类思想到表达的转化过程；而人工智能创作物是一个“间接创作”的过程，人类思想用于设计人工智能算法程序，通过算法程序产生“思想”，再进一步转化为表达。因此，无论是设计人工智能的思想，还是其算法本身均不能受到知识产权法的有效保护;7;0;7;18388;0.0003806830541657603
6625;请问这个视频中使用的哪一款设备保卫萝卜哇，看了up的几个视频没有分辨出是哪一款;1;0;1;18388;5.438329345225147e-05
6628;随随的图真好看能拿去喂AI吗？脱单doge;4;0;4;18388;0.00021753317380900588
6633;实际上通过混各种Al绘画的贴吧，我发现确实有很多人用Al给自己的画补细节加背景甚至找灵感。或许这也是个提升绘圈整体画技，淘汰劣种的机会吧，害谁知道未来如何呢。顺便一提，Al也没那么好驯服，我在贴吧里看到不少诡异的画笑哭笑哭;4;0;4;18388;0.00021753317380900588
6642;Ai画科幻类真的有东西，风景也还可，其他的根本没感觉吃瓜;4;0;4;18388;0.00021753317380900588
6647;ai的大模型也就7g大小，制图也根本不是什么缝合吃瓜，唯一可能涉及侵权的只有训练模型使用的图，但攻击这些都是没意义的，只要训练的图被授权使用，是不是ai就无懈可击？;2;0;2;18388;0.00010876658690450294
6650;up主是不是在淘宝开过淘宝店，我一眼就认出来了，好多好多年前去你那买过。想不到这里能看到你。打call;1;0;1;18388;5.438329345225147e-05
6653;啊啊啊啊我老婆喜欢喜欢喜欢;1;0;1;18388;5.438329345225147e-05
6658;图包来咯httpspanquarkcnsf60ece3f0f8a图包内还有额外图三连交出来吧喜欢喜欢喜欢;25;31;56;18388;0.0030454644333260824
6684;不知道为什么这期看着很有食欲思考;3;20;23;18388;0.0012508157494017839
6688;什么时候能画手就完美了;1;6;7;18388;0.0003806830541657603
6690;质量真的天花板doge;1;4;5;18388;0.00027191646726125733
6692;3连了赞竖屏哈哈;1;2;3;18388;0.0001631498803567544
6694;每天来点赞投币都习惯了。呲牙;1;2;3;18388;0.0001631498803567544
6696;加大力度星星眼;1;4;5;18388;0.00027191646726125733
6698;还得是龙哥爱了爱了星星眼星星眼;1;5;6;18388;0.0003262997607135088
6700;我超，龙哥打call打call打call;2;3;5;18388;0.00027191646726125733
6703;up作品6啊doge;1;2;3;18388;0.0001631498803567544
6705;打开是空的;1;1;2;18388;0.00010876658690450294
6710;吃瓜;1;1;2;18388;0.00010876658690450294
6712;喜欢喜欢喜欢喜欢;1;1;2;18388;0.00010876658690450294
6714;龙哥懂我;1;1;2;18388;0.00010876658690450294
6716;为什么我是异常操作，请检查文件是怎么回事大哭;1;1;2;18388;0.00010876658690450294
6718;啊这，会不会有点疯狂试探了doge;1;1;2;18388;0.00010876658690450294
6720;喜欢哇哇哇;1;1;2;18388;0.00010876658690450294
6722;大哭没币了而且真的一滴也没有了doge;1;1;2;18388;0.00010876658690450294
6724;中间休息来看你星星眼;1;1;2;18388;0.00010876658690450294
6726;哇哦;1;1;2;18388;0.00010876658690450294
6728;求图包啊;1;1;2;18388;0.00010876658690450294
6730;叫龙哥，龙哥给我们好康的脱单doge;1;1;2;18388;0.00010876658690450294
6732;滑稽脱单doge脱单doge脱单doge;1;1;2;18388;0.00010876658690450294
6734;来了来了打call;1;1;2;18388;0.00010876658690450294
6736;doge;1;1;2;18388;0.00010876658690450294
6738;你是不是有些视频被下架了感觉不止这些;2;1;3;18388;0.0001631498803567544
6741;每一期都不负期待脱单doge;1;1;2;18388;0.00010876658690450294
6743;喜欢喜欢打call打call;1;1;2;18388;0.00010876658690450294
6745;我来投币啦。星星眼;1;1;2;18388;0.00010876658690450294
6747;哎，这衣裙飘的。我币又没了OK;1;1;2;18388;0.00010876658690450294
6754;十一周年好耶;2;1;3;18388;0.0001631498803567544
6767;夸克要花钱吧;1;0;1;18388;5.438329345225147e-05
6769;恭喜你离百大又近了一步;1;0;1;18388;5.438329345225147e-05
6771;没有之前的真实了doge;1;0;1;18388;5.438329345225147e-05
6773;进去就是被作者删除撇嘴;1;0;1;18388;5.438329345225147e-05
6775;咨询一下大大，你这个画风是和角色一起训练的么，还是画风单独的模型，;3;0;3;18388;0.0001631498803567544
6779;这压缩包是rar格式的吗，;1;0;1;18388;5.438329345225147e-05
6781;打不开;1;0;1;18388;5.438329345225147e-05
6783;喜欢喜欢喜欢;1;0;1;18388;5.438329345225147e-05
6785;喜欢喜欢图包大佬;1;0;1;18388;5.438329345225147e-05
6788;解压不了啊，解压之后是空的;5;0;5;18388;0.00027191646726125733
6807;想问问要怎么增强分辩率，我做出的图也就19201152，再大就不出图了显卡3060;1;0;1;18388;5.438329345225147e-05
6819;怎么没有啦;1;0;1;18388;5.438329345225147e-05
6821;咳咳;1;0;1;18388;5.438329345225147e-05
6823;有没有可能，其实这个手是AI自己生成的作品水印doge;30;5412;5442;18388;0.29595388296715247
6854;就像当年英国的手工织女不曾会想到，如此复杂的织布技术会被没有感情一口一口吐蒸汽的钢铁所取代。;275;5856;6131;18388;0.33342397215575376
7130;有没有一种可能，断手的维纳斯也是古代AI做的，为了防止被人发现故意切了脱单doge;39;5497;5536;18388;0.30106591255166415
7170;ai：我模仿了大部分的画师的技法，但是我保留了画手的缺陷，我觉得保留画手的缺陷，才知道你看的瑟图是AI生成，是故意的。;9;3912;3921;18388;0.213236893626278
7180;以后美工找工作要求是1、会改画；2、会画手doge;42;1778;1820;18388;0.09897759408309767
7224;别说AI了，人画手都都很难，当初学画画的时候，手就是很难画的。;21;464;485;18388;0.026375897324341962
7246;有没有可能不仅仅是手画不好，各个地方基本都没怎么画好，只不过大部分地方大部分人不好鉴别罢了。比如头发和瞳孔就可以画的随意些，眼睛比例，在脸上的位置就算出了问题只要不相差太大也没什么，人不会认为画错了。不同的是，对手指评鉴的严格程度就不一样。;9;204;213;18388;0.011583641505329563
7256;最后“升华”得有点儿尬。织布是一种重复的机械式工作，机械可以完成的更快更好，完全没必要用人工，而绘画不是，拿AI取代画师是个彻头彻尾的笑话，最多也就只会抢走那些只会“临摹”的画手的活。人的审美是会不断改变的（有的是因为自身审美疲劳，有的是随时代改变）现在强人工智能依旧遥不可及，AI没有人类提供素材的话无法跟上审美的变化，也无法完美的复刻一个人想要的所有的细节盲猜有人会拿部分纺织大师没有被取代当例子，我认为纺织大师更像艺术家，相比纺织工人跟画家的关系更近一些;91;127;218;18388;0.01185555797259082
7348;高一美术生，毕业就失业，太开心辣笑;62;241;303;18388;0.016478137916032195
7411;请在下列图片中找出所有包含“手”的图片;2;73;75;18388;0.00407874700891886
7414;织布机？织布机可没有习惯拿女工织出来的布上面纹个花、加个边就说是自己织的的习惯。;1;45;46;18388;0.0025016314988035677
7416;已经画的很好了;18;116;134;18388;0.007287361322601697
7435;还有一个原因就是人类的视觉对手和脚的结构非常敏感。即使只是稍微畸形都能立刻识别出来。而人身体的其他部位，即使略微夸张或扭曲，也不影响视觉上的美观性。;1;146;147;18388;0.007994344137480966
7437;所以给ai喂涩图还是很有必要的，要全面发展;16;394;410;18388;0.022297150315423103
7454;画人难画手，画马难画走。;3;96;99;18388;0.0053839460517728956
7458;所以呢？早在四年多前就有能号称替代大多数平面设计师的“鹿班”了，结果现在平面设计还是需要人来做，咋的？这么多年了，还没进化好啊？;1;17;18;18388;0.0009788992821405265
7460;我不理解，一个没学过ai的up也能来解释ai？？？;8;55;63;18388;0.0034261474874918425
7471;按照传统逻辑来看，应当首先实现ai建模然后再依据模型进行ai绘画，这才是正常的绘画逻辑，先认识体积然后将体积表现在二维平面上，现在的只能叫做“生成图片”，远远称不上“绘画”;36;543;579;18388;0.0314879269088536
7508;看了几个月ai绘画相关评论，我终于是发现所谓大众基本就不懂画师这概念，p站推特上千个画上数十年的一个不知道，国内饭绘圈几个倒被当成代表了，一个纯靠热爱的同人画师画上十多年可能画出上千张图，而收益只是卖的一些同人本和粉丝赞助，ai爬虫吞了无数画师成千上万的图让某些不学无术轻易用上画师数十年的功底拿去跳脸，还让某些ai添购把画师贬低为织布的重复性劳动者，在我看来就像国内的盗版游戏，有的人实在没钱闷头玩无人能说，而现况属于是玩盗版玩出优越感还去和开发商跳脸，并且这类人还竟是多数，看得出来比起工业革命更像道德底线革命;33;110;143;18388;0.00777681096367196
7543;ai不仅画不好手，而是什么都画不好，比如配饰、花边、二分、小调子等，一个是基于stablediffusion本身的原理，画师会仔细设计二分来强调重点，ai肯定没有这个能力，训练集里不同画师对这方面的处理偏好不相同，模型总结不出经验。还有一个就是训练集图片分辨率不高，无法做清晰的物体识别。;18;363;381;18388;0.02072003480530781
7562;我以前很看好AI，但后来想想，或许这玩意永远都是残缺品，细节方面，可能永远都做不好，整体的设计，也会有各种问题。估计永远都解决不了，因为它本身并不具有思想。说是艺术的工业革命，还差得远;41;48;89;18388;0.0048401131172503805
7604;个人认为是良心程序员故意留的破绽，防止被太轻易地拿来以次充好，不然为什么手指每次都不偏不倚多一根，而且脚趾通常能画对;7;26;33;18388;0.0017946486839242985
7612;三个猜想，纯属娱乐1ai画不好手是因为手喂的太少，脸部画的好主要是各种美颜软件和其他扫描脸部轮廓的软件喂出来的，但是扫描手的软件几乎没有，只有普通照片。2掉san手是ai绘画的防伪标志，可能是故意为止，为了推广ai绘画的。3（可能性最低的）ai故意示弱，降低自己过于智能给人带来的恐惧。;6;54;60;18388;0.003262997607135088
7622;ai不是画不好手，只是画好的概率不高。其实不光是手，其他部位也是一样的，只是结构没有手复杂给人一种ai挺会画的感觉，事实上ai画出3条腿4条胳膊的图比比皆是，你看到的几张比较美的图都是从千百张里面挑出来的。说到底，ai的唯一优势就是画得快。;4;78;82;18388;0.00445943006308462
7627;学过画画就知道，人画最难画的部分也是手;19;160;179;18388;0.009734609527953013
7647;作为一个艺术生，在学人体期间，真的最难的我感觉就是手部的形体透视尴尬;5;56;61;18388;0.0033173809005873395
7653;我电脑上就有一个本地部署的绘画ai，不联网，请问这不到10G的内存，能存储多少图片，而且实际上训练ai是以像素点为基本单位的，假如训练ai画一个橘子，给ai喂几万个，乃至几十万张橘子的图片以及图片的描述，ai不会具体的看橘子长什么样，而且也理解不了图片的含义，只会统计每张图片的像素点分布和描述词缀的相关性，所以往往是ai一整张图片画的不错，甚至很优秀，但是局部是崩坏的。;2;17;19;18388;0.0010332825755927778
7656;还是有点区别的你朋友挣的钱不会给你但是不会砸你饭碗但是ai以后会挣走你的钱还把你饭碗砸了;2;5;7;18388;0.0003806830541657603
7659;只能说现在的ai绘画仍停留在弱人工智能，本质上还是搜集数以亿计的元素再拼接，并不是真正能够理解它画的内容，虽然chatgpt的出现，强人工智能可以看出也在突破，总之，现在给ai的时间还不够，未来ai一定是像蒸汽机一样能颠覆整个人类生产，生活方式的产物。;12;40;52;18388;0.0028279312595170763
7672;AI不会三维理解，只会二维理解，它能理解二维版的三庭五眼但永远无法理解三维化的手和水袋;18;63;81;18388;0.004405046769632369
7691;早就能画好了。现在才出视频解释。不只是画手画头发。现在质量高点的你都很难看出来是AI化的。;5;19;24;18388;0.0013051990428540352
7697;这个好画doge支持;3;47;50;18388;0.0027191646726125733
7701;吃瓜我是专业的，关于画不好手，真实原因我也讲不清楚，但是我可以给你指出一个错误，那就是现在这些绘画ai，用的都是对比学习的方式，简单来说，用的是网上非人工标注的图片文本对的数据，比如你用百度搜图片，搜的美女，那搜出来的图片就对应美女的语义，跟人工标注关系不大。所以画不好手的原因可能还是这些图片修的太厉害，让ai理解错了语义，毕竟有时候修图也能把一条柱子修歪来对吧。;7;109;116;18388;0.00630846204046117
7709;还是这句话，AI是工具，人是核心。;1;10;11;18388;0.0005982162279747662
7711;画手们赶紧练习画手，以后AI出图你改手，完美doge;1;4;5;18388;0.00027191646726125733
7713;你让ai不要画带手的作品，不就行了;2;4;6;18388;0.0003262997607135088
7716;为什么没有个参数强制规定手指数量？;3;4;7;18388;0.0003806830541657603
7720;我的是画不好脚啊，不论怎么加标签，或者负面标签，大部分时候都畸形，偶尔会完美一次大哭还有一些细节描述比如嘴部动作，表情，脸颊鼓起，都要看运气。。;2;7;9;18388;0.0004894496410702633
7727;其实脚更难画，无论是对人还是ai，别说复杂的肌肉和骨骼，正反有时候都搞不清，理想ai应当是类似于基于物理和3D的渲染器组成，用物理引擎模拟骨骼限位、肌肉的牵引和挤压、脂肪的堆砌、布料解算，ai训练集主要是动态和构图，再用物理渲染器渲染，能杜绝绝大多数常识性的问题，光影也更真实;2;18;20;18388;0.0010876658690450293
7731;我觉得AI只能画风景，这是我对AI最大的理解;1;2;3;18388;0.0001631498803567544
7733;学美术的都知道手是梦魇而ai是靠人在喂doge主子画起来都抠脑壳ai你慢慢学吧;12;73;85;18388;0.004622579943441374
7749;al就是合成人体组织碎块，它怎么知道什么是器官融合就行了;4;8;12;18388;0.0006525995214270176
7756;不是，不讨论什么骨骼，ai就连手指数目都画不对，就很奇怪，明明知道两个眼睛长哪里，嘴巴哪里，耳朵鼻子哪里，手也知道在哪里，为什么就连基本的根数都画不对呢。;5;7;12;18388;0.0006525995214270176
7762;高情商：我不会画手低情商：怕被拔电源抠鼻;1;6;7;18388;0.0003806830541657603
7765;看到现在controlnet的运用，我觉得人手应该很快就可以被攻克了;5;7;12;18388;0.0006525995214270176
7771;AI没有学过人体解剖学;4;26;30;18388;0.001631498803567544
7779;AIcoser4K原神纳西妲这不比我cos草神更可爱吗哔哩哔哩httpsb23tv62v0Tp8;1;5;6;18388;0.0003262997607135088
7783;目前做不到的，一段时间后必然能做到，只要算法和训练数据优化就可以。图像问题对ai不是难度很大。;1;2;3;18388;0.0001631498803567544
7787;没事，我可以看没有手和脚丫的本子OK;1;5;6;18388;0.0003262997607135088
7789;现在绝大部分模型都是512x512训练的，sd20是768x768，有一点点改善，但是提高分辨率也不一定能解决，因为现在sd经常区分不了左右手，甚至手和脚;1;31;32;18388;0.001740265390472047
7792;有没有可能AI是故意画不好的，好让人类认为它没有能力替代人类dogedogedoge;3;6;9;18388;0.0004894496410702633
7799;手部那就不画了，画好水袋就行了脱单doge;2;2;4;18388;0.00021753317380900588
7805;画龙画虎难画骨，知人知面不知心。;1;1;2;18388;0.00010876658690450294
7810;我画不好手，虽说不会多指，但是伸出的手指头跟封面也差不多。AI竟是我自己;1;1;2;18388;0.00010876658690450294
7812;我怀疑我就是个ai转世，一样不会画手，还要眼睛（悲;3;1;4;18388;0.00021753317380900588
7816;我：AI你怎么连手都不会画AI：你会吗滑稽;1;0;1;18388;5.438329345225147e-05
7818;说了那么多，不就是因为优先级性价比不如其他地方。但凡给加个程序，识别一下手指头的数量，起码数量上不会出错啊。;6;12;18;18388;0.0009788992821405265
7832;个人猜想，手指基本上就是多个重复结构并在一起，ai并没有数量概念，只知道这个位置应该有指头;1;1;2;18388;0.00010876658690450294
7834;不知道网络喷子会不会被ai喷子取代;2;1;3;18388;0.0001631498803567544
7842;你说得对，但是AI已经会画手了。只用了6个月的进化;1;1;2;18388;0.00010876658690450294
7862;计算机视觉和AI喂画归根结底还是训练像素点之间的关系，本质上还是2D输入2D输出的；而人类学画画要从透视、人体、光影学起，学的本质是3D的体积关系，只不过绘画最终投映在一张二维的平面上。不说那些大画家了，就算是一个上画画课外班的小学生，光理解二维的点线面也是远远不够的，我没学过画画，但是一般学画画的人都是从素描各个角度的长方体球体学起的吧？这就是典型的三维在二维的映射。小学课文画杨桃，不同角度完全不一样，但你喂给AI一个角度的杨桃，它就只会这个角度的，想让它就算是只转10度都做不到的，因为输入的是二维点线面而不是三维的建模。这也是AI为什么那么多人体崩坏的画，因为AI永远不能从二维的点线面美少女去推理三维的人体是什么样的，AI作画至少现在来说，就是被二向箔干崩坏的世界，你觉得能取代更高维的人类吗？;7;1;8;18388;0.00043506634761801175
7871;AI画不好手是为了给在座的人类留点面子笑;1;1;2;18388;0.00010876658690450294
7890;很正常，傲娇很多人也画不好手，但是扔子谁都会画;1;1;2;18388;0.00010876658690450294
7897;Al没逻辑;1;0;1;18388;5.438329345225147e-05
7904;我这个AI好像没有那么畸形。;3;0;3;18388;0.0001631498803567544
7915;不是ai画不好，即便是人。手也是难画的;2;1;3;18388;0.0001631498803567544
7920;为什么我觉得眼睛才是最难画的，能把眼睛画出生动灵性勾魂很难吃瓜;2;1;3;18388;0.0001631498803567544
7923;ai配音吗up;1;0;1;18388;5.438329345225147e-05
7933;芯片比纺织更复杂呢，不还是机器生产的呲牙不懂什么叫创造性行业什么叫机械流水线就别升华了，怪尴尬的;1;0;1;18388;5.438329345225147e-05
7963;BV1724y1V732;2;0;2;18388;0.00010876658690450294
7980;starofsky;1;0;1;18388;5.438329345225147e-05
7989;其实，好的画师怕AI，其实真没必要，我在好几个AI画画群，里面有好多画师，他们也用的，还在群里找灵感笑哭;1;0;1;18388;5.438329345225147e-05
8006;我有个想法，如果整合全须弥人的智慧对虚空进行训练，能否将ai升级？;1;0;1;18388;5.438329345225147e-05
8015;有没有一种可能，AI在装;1;0;1;18388;5.438329345225147e-05
8022;现在手的问题快解决;6;0;6;18388;0.0003262997607135088
8037;所谓人工智能就是有多少人工就有多少智能是吧？;1;0;1;18388;5.438329345225147e-05
8041;那怎么不直接告诉他两个问题tv坏笑;1;0;1;18388;5.438329345225147e-05
8061;AI普及且全面超过人类后，人类的存在还有意义吗？或者说，什么都交给AI这样的文明还能被称之为人类文明吗？;2;0;2;18388;0.00010876658690450294
8072;板绘也算科技对艺术的冲击吧，现在手绘画师都成珍惜物种了。板绘有图层，能让你把画布上不用的线条擦得干干净净，能复制粘贴花纹，能复用素材，能买笔刷，甚至有对称轴这样逆天的东西可大规模的抵触出现了吗？没有，因为这次是科技降低了绘画入门的门槛，让更多人混到了饭吃。当然，好处是让一些以绘画为基础的产业繁荣了。只能说，这对许多画手来说难道不是一种幸运吗，既然是幸运，早晚会结束的。gafa这种寡头企业拿个人作品当学习库，当然要抵制，但别抵制偏了。我看到太多嘲讽ai，说什么人的想象力肯定比机器强别骗自己了，ai没有想象力，但它绝对能表现出想象力。包括画手部，常识性错误等等，这个问题大家都能看出来了，就会有人去解决它的。ai背后是什么，是机器学习领域的精英和搬砖客不是吗，这也是一个学术领域，里面的人们的审美、敏锐程度未必就比那么多画师差。正视它，才是最好的武器，不是攻击，而是保护自己和自己珍重的东西。;2;0;2;18388;0.00010876658690450294
8081;边缘识别连接问题，另外人的漫画也有铜锣烧两根三根四根六根的;1;0;1;18388;5.438329345225147e-05
8091;既然训练的图片手部模糊，那为什么不直接让ai设计出模糊的手部;1;0;1;18388;5.438329345225147e-05
8098;看下最新的动画吧，已经迭代的很厉害了;1;0;1;18388;5.438329345225147e-05
8100;AI不懂手，不懂物理知识，只知道画一个像手的东西藏狐;1;0;1;18388;5.438329345225147e-05
8103;你看，AI都画不好手，更别说我了笑哭;3;0;3;18388;0.0001631498803567544
8114;手的结构真的很难画;2;0;2;18388;0.00010876658690450294
8122;肯定是故意的，细节骨骼画不好不至于5跟手指都不知道，为了辨别是否是AI画的;1;0;1;18388;5.438329345225147e-05
8127;我们早晚会被这些东西取代2023;2;0;2;18388;0.00010876658690450294
8139;别说手了，a能画出脚趾吗？;1;0;1;18388;5.438329345225147e-05
8154;现在ai还是拼图，然后去除错误图像。如果算法能实现骨骼会更好一点。;2;0;2;18388;0.00010876658690450294
8170;AI手画不好我手也画不好我AI;1;0;1;18388;5.438329345225147e-05
8173;。。。呃其实现在的ai只要调教得当是能画好手的，包括其他部位也是，还拿手说事儿多少有点孤陋寡闻了;4;0;4;18388;0.00021753317380900588
8203;可是我觉得手确实不难画，有参考就很容易笑哭;4;0;4;18388;0.00021753317380900588
8211;不消半年你再看看吧;2;0;2;18388;0.00010876658690450294
8215;ai画不好手，只能说训练的素材不够多。;1;0;1;18388;5.438329345225147e-05
8229;我们是免费的AI训练师，验证图片就是在给AI训练;2;0;2;18388;0.00010876658690450294
8233;以后说你的手画得跟ai一样脱单doge;1;0;1;18388;5.438329345225147e-05
8267;我觉得要想AI有序发展，必须限制商业使用，可以制作商业平台，按照加权分配利润给原画师，让他们提供作品素材，用的人多钱就多。AI生产的绘画只有使用权没有著作权，或者只有部分著作权。;1;0;1;18388;5.438329345225147e-05
8272;不知道是不是段子某个公司，已经把自家的美工全部给裁了，然后直接让策划给AI下命令，然后自动生成图片。;1;0;1;18388;5.438329345225147e-05
8279;那有怎么样呢？还不是一样需要工人，ai的确在计算上很强，但是它是通电的，同样需要各种工业品，你不会以为ai能替代所有吧;1;0;1;18388;5.438329345225147e-05
8282;就是程序员写的代码有问题而已，画不好改代码不就好了。;4;0;4;18388;0.00021753317380900588
8288;好像不只是手吧，一个肚脐眼他都算不清楚。时常性出现两个肚脐眼的奇观笑哭仍需进步。;1;3;4;18388;0.00021753317380900588
8294;得亏画不好就指望着看手分辨AI图了;1;0;1;18388;5.438329345225147e-05
8298;我觉得人画手也不好画，我作为一个纯外行凭借兴趣画过一个图，里面最难的就是画手和想一个比较生动的构图;1;0;1;18388;5.438329345225147e-05
8302;卧槽这不是《诗云》么ai什么都能画，但只要缺少审美，就画不出美的画。大刘，真神啊;1;0;1;18388;5.438329345225147e-05
8305;啊，虽然哪怕他画的再好，再怎么能量产，但是听不懂人话这一点，很难被人工替代。毕竟人的感情和逻辑很难被量化，当什么时候这都能被人工智能代替的话，那这玩意儿都不能算是人工智能了。那都可以算是人工生命了，或者说是数字生命那就是另一个东西了。;2;0;2;18388;0.00010876658690450294
8309;我最希望的结局其实是ai可以让动画绘制变成少数画师即可完成的工作，可貌似办不到思考;1;0;1;18388;5.438329345225147e-05
8311;能不能训练七八个AI，一个AI练骨骼结构，一个练肌肉分布，一个练皮肤分布，一个专门练风景训练样本用CT检查片子？仓鼠阿巴;2;0;2;18388;0.00010876658690450294
8314;不止AI画不好手，我也画不好笑哭不过AI学会藏手了，直接背过去不画doge;1;0;1;18388;5.438329345225147e-05
8327;画师们都在避开画手ai学不会了;2;0;2;18388;0.00010876658690450294
8342;任何领域都是：20的付出就能得到80的结果。但是想精进到90或者100，则需要付出远高于之前。AI也一样。这些年，很容易听到AI领域的大突破。但是想让这些大突破达到精致，则需要很久。;2;0;2;18388;0.00010876658690450294
8347;故意保留的，让人类误以为ai并不完美;3;1;4;18388;0.00021753317380900588
8353;0002;1;1;2;18388;0.00010876658690450294
8359;这个事，有点看运气;2;0;2;18388;0.00010876658690450294
8364;你永远不知道一个人为了涩涩，会爆发出什么样的力量;18;434;452;18388;0.024581248640417663
8383;严格上来讲电绘人都是会整电脑的，会画画和会ai不冲突，就今后大方向应该是两个都要会，不学白不学，收藏了doge;3;14;17;18388;0.000924515988688275
8387;软件安装：up主独立研究员星空基础操作文生图图生图局部重绘针对萌新解析输入正面tag和负面tag，调整参数参数的参考：采样器（采样方;3;71;74;18388;0.004024363715466608
8391;刚带着瑟瑟的念头准备在AI绘画的领域干出一番事业。就发现我的轻薄本完成不了我的大业。涩帝创业未半而中道崩殂了属于是生病生病生病;1;2;3;18388;0.0001631498803567544
8393;建议ai编程，ai科研搞起来。只有绘画不太行阴险;4;28;32;18388;0.001740265390472047
8398;我就想知道可不可以涩涩;8;46;54;18388;0.0029366978464215794
8407;没有管控岂不是很危险，拿别人的照片去画图明前奶绿这是什么;2;5;7;18388;0.0003806830541657603
8410;百度网盘说要6天下完。。。热;18;88;106;18388;0.005764629105938656
8429;为什么我搭建的，生成的图片，都不带衣服啊？是哪里没设置好吗;7;40;47;18388;0.0025560147922558192
8437;外行人表示，tag就开始听不懂了妙啊;4;3;7;18388;0.0003806830541657603
8442;我核显轻薄本岂不是会直接爆炸嗑瓜子;7;34;41;18388;0.00222971503154231
8450;三连了，学这个比天天打高血压游戏好多了热;3;44;47;18388;0.0025560147922558192
8454;独立研究员星空给大家引个路;4;45;49;18388;0.002664781379160322
8459;AI能把小孩画成大人吗？;1;0;1;18388;5.438329345225147e-05
8461;感谢陈老师的教程，请问我复制别人的tag，经常出现生成图到最后就生成不出来的情况，挨个排查，像Whitebackground就会在控制台显示Python运行出错，但是疑难解答也查不出来，我应该如何解决呢;10;20;30;18388;0.001631498803567544
8472;upup关注了星星眼我有个问题，如果我生成了一个很好看的图，我想用这张图的人物做底子脸型都保持不变该怎么办，我看生成下面有个保存模板，但我还不太清楚，如果嫌麻烦能不能给我发个教程视频笑哭我没找到;1;35;36;18388;0.001957798564281053
8474;请问我lora位置放对了但每次都不会使用是怎么回事啊笑哭;2;20;22;18388;0.0011964324559495323
8477;大佬，这个会不会像挖矿一样费显卡？应该不会出现用了一段时间后显卡变矿卡的闪屏情况吧tv点赞;4;1;5;18388;0.00027191646726125733
8483;up，再问下我选的这个配置应该超级快了吧，cpu还要不要换i9的？还是i7的足够了（就单纯ai跑图用）;11;12;23;18388;0.0012508157494017839
8495;大佬，为什么同样的tag和模型我现在很容易生成畸形脸啊，或者生成四张图有三张图是畸形一张能看什么原理;1;0;1;18388;5.438329345225147e-05
8497;点开了命令提示符然后刚加载完就自动关闭了是什么情况啊？;4;0;4;18388;0.00021753317380900588
8502;up，那个safetensors的模型跑出来和要的不一样正常吗，我模型是c站下的游戏角色人物模型，tag是图片带的，但是跑出来的不是我要的人物，;3;9;12;18388;0.0006525995214270176
8506;纯路人，刚关注，这就是男妈妈吗doge爱心（5毛一条，发的时候记得删掉括号;2;21;23;18388;0.0012508157494017839
8509;软件下载要的吗？;2;7;9;18388;0.0004894496410702633
8514;下载怎么下呀;1;5;6;18388;0.0003262997607135088
8516;我在D盘部署的本地，玩着玩着C盘满了，求帮忙笑哭;1;1;2;18388;0.00010876658690450294
8520;谢谢up;1;2;3;18388;0.0001631498803567544
8523;唉，显存只有6g，高清选项打开就跑不了了，是不是影响很大呀，感觉没得玩了大哭;3;2;5;18388;0.00027191646726125733
8527;独立研究员星空。主页里我找了十分钟没找到，唉，，，，，悲剧;1;1;2;18388;0.00010876658690450294
8529;我安装包说py文件报错。。;1;9;10;18388;0.0005438329345225147
8534;呵呵，以前画师约稿优势是独特的画风，现在人人都会ai出图，ai什么画风都能模仿，现在甲方约稿就看谁要的稿费更低;5;1;6;18388;0.0003262997607135088
8540;我有个大胆的想法。让ai自动生成呲牙呲牙呲牙;2;1;3;18388;0.0001631498803567544
8543;谢谢你，陈老师;1;2;3;18388;0.0001631498803567544
8545;线稿提取怎么搞上色呢;1;1;2;18388;0.00010876658690450294
8547;请问大模型是不是还有版本要求啊？就是不同版本可能软件识别不了？;1;1;2;18388;0.00010876658690450294
8550;请教一下底模型怎么下载呀？;1;0;1;18388;5.438329345225147e-05
8552;啥叫tag;1;0;1;18388;5.438329345225147e-05
8555;3070笔记本带得动吗;1;0;1;18388;5.438329345225147e-05
8557;想搞sese笑哭;1;0;1;18388;5.438329345225147e-05
8561;a卡用不了吗;1;1;2;18388;0.00010876658690450294
8563;能不能告诉我一下，开始训练时我的11G显存没爆为什么提示CUDA内存不足啊;1;0;1;18388;5.438329345225147e-05
8565;大佬我放完模型左上角没有啊重启了即便刷新也没有;1;0;1;18388;5.438329345225147e-05
8567;缓存满了怎么清除跪了跪了;3;0;3;18388;0.0001631498803567544
8571;UP，想请问一下，模型可以自己随便改名字吗中文的那种;1;0;1;18388;5.438329345225147e-05
8574;我怎么感觉我的1650带不动藏狐;3;0;3;18388;0.0001631498803567544
8578;upupai绘画的关键词的数据是从模型里读取的吗？;1;0;1;18388;5.438329345225147e-05
8580;3060会不会炸;2;0;2;18388;0.00010876658690450294
8584;PPT打不开了;1;0;1;18388;5.438329345225147e-05
8586;要钱的吗;1;0;1;18388;5.438329345225147e-05
8589;在？封面发一下東雪蓮打拳;1;1;2;18388;0.00010876658690450294
8591;lora的使用2种存放，有什么区别吗;1;1;2;18388;0.00010876658690450294
8593;老师3d风格怎么做啊，我用了3d模型为什么出的还是平面图啊笑哭;1;1;2;18388;0.00010876658690450294
8595;课件打不开啊老师，求助;1;0;1;18388;5.438329345225147e-05
8597;请问电脑配置有要求吗？感觉一般电脑会跑不动。微笑;4;0;4;18388;0.00021753317380900588
8602;请问，除了生成人物，还可以生成物品例如珠宝或者产品方面的吗？我想用AI来辅助设计;1;0;1;18388;5.438329345225147e-05
8604;去哪里下载AI怎么制作;1;0;1;18388;5.438329345225147e-05
8606;已4连，加关注，求问，启动的时候就卡在网站这里进不去了是什么原因;2;0;2;18388;0.00010876658690450294
8609;4060笔记本端带得动吗;1;0;1;18388;5.438329345225147e-05
8611;为什么我没dreamartist和outpainting;1;0;1;18388;5.438329345225147e-05
8613;怎么启动啊;7;0;7;18388;0.0003806830541657603
8621;问问。ai绘画可以取代建筑效果图或者景观效果图或者室内效果图吗？;1;0;1;18388;5.438329345225147e-05
8623;请问老显卡1080支持吗;1;0;1;18388;5.438329345225147e-05
8625;问一下，这玩意儿多大内存。需要什么配置才跑的起来？;1;0;1;18388;5.438329345225147e-05
8627;webUI咋启动;5;0;5;18388;0.00027191646726125733
8633;没有D盘怎么办;1;0;1;18388;5.438329345225147e-05
8635;4g显存的我只能干看了大哭;1;0;1;18388;5.438329345225147e-05
8637;AMD显卡可以吗;1;0;1;18388;5.438329345225147e-05
8639;老师问一下，a卡可以像n卡一样使用吗？我看好像都是默认n卡;1;0;1;18388;5.438329345225147e-05
8641;在用大模型时，lora私教怎么搞啊，up主;3;0;3;18388;0.0001631498803567544
8645;呜呜呜呜，为啥我生成的是动漫的;1;0;1;18388;5.438329345225147e-05
8647;6950能跑吗;1;0;1;18388;5.438329345225147e-05
8649;老师我想问下，我选择了脸部修复，或者将图片大小调大，都会导致我95卡住，然后图片消失是什么原因啊;3;0;3;18388;0.0001631498803567544
8653;你好，想问一下手机可以吗;10;0;10;18388;0.0005438329345225147
8664;没有extensionssdwebuicontrolnetmodels啊;3;0;3;18388;0.0001631498803567544
8670;请问老师，为什么我找不到lora模型使用插件的路径？就是extensions里的sdwebuiadditionalnetworks这个文件夹整个没有;4;0;4;18388;0.00021753317380900588
8676;网盘里面pptx打不开;2;0;2;18388;0.00010876658690450294
8679;老师我想问问，AI怎么输入特殊字母啊，比如希腊字母和;1;0;1;18388;5.438329345225147e-05
8681;UP你好可以自定义人物的背景和穿戴物吗;2;0;2;18388;0.00010876658690450294
8684;大佬。刚看了你的训练教程视频，看了这么多真的是最清晰明了的教程了打call。有个问题请教一下，我看一开始概述那里训练是要用7G那个模型，那训练出来的tag是只能用在这个模型的绘图么，如果用在别的模型是不是是要换模型重新训练;2;1;3;18388;0.0001631498803567544
8687;出图和跑模型的区别是什么呢原神嗯电脑只有2060笔记本6g，想出几张做参考;3;0;3;18388;0.0001631498803567544
8694;弱弱问一句，需要什么配置的显卡呀;1;0;1;18388;5.438329345225147e-05
8699;argumentoftypenonetypeisnotiterable启动报错怎么搞;6;0;6;18388;0.0003262997607135088
8706;upup是sd15是sdv15inpainting这个东西吗，这个我下好了切换到这个不知道为啥就不认lora了，跑出来的图一团糟。;8;0;8;18388;0.00043506634761801175
8715;这两天一直没什么画画的灵感画不出东西索性就来学ai了，正好反向学习一下ai;1;0;1;18388;5.438329345225147e-05
8721;课件打不开啊大佬;1;0;1;18388;5.438329345225147e-05
8723;生成的图片不精致，很糊，问题多，如果硬件确认达标就是tag问题吗;1;0;1;18388;5.438329345225147e-05
8726;我能用这个给我画龙珠人物么;1;0;1;18388;5.438329345225147e-05
8728;硬件要求咋样？;3;0;3;18388;0.0001631498803567544
8732;《关于收藏比赞多这件事doge》;1;0;1;18388;5.438329345225147e-05
8734;这个跑的时候要用梯子吗？;1;0;1;18388;5.438329345225147e-05
8736;老师，课件下载页面已经失效了。;2;0;2;18388;0.00010876658690450294
8739;up这个a卡是不是不能直接跑啊;4;0;4;18388;0.00021753317380900588
8744;老师，我想问问刚安装好训练完后怎么把模型放到webui里，那个文件夹在哪里;1;0;1;18388;5.438329345225147e-05
8746;问下up，ai跑图配置是不是就吃显卡显存啊？想组装电脑（性能极好）专门跑图，就用4090的卡就行了？还有别的配置需求吗（内存和CPU？预算充足）;5;0;5;18388;0.00027191646726125733
8752;问一下大佬，我用其他模型都正常，但是有一个模型画出来的全部都是彩色的像素点，其他人用的正常是什么原因？;4;0;4;18388;0.00021753317380900588
8764;洛阳烟雨灬学习一下;1;0;1;18388;5.438329345225147e-05
8775;pptx打不开，;1;0;1;18388;5.438329345225147e-05
8778;up主，httpscivitaicom网站原本有的tag直接复制功能现在没有了怎么办啊？大哭;5;0;5;18388;0.00027191646726125733
8791;已赞，送你上首页;1;0;1;18388;5.438329345225147e-05
8796;各位大佬我问一下，我想让一个人物头发配饰服装什么的。都不改变。只改变动作怎么做？;1;0;1;18388;5.438329345225147e-05
8803;一键安装包都找不到是不是不能学习Vi绘画了笑哭笑哭笑哭;4;0;4;18388;0.00021753317380900588
8817;大佬知道xformers怎么更新吗;1;0;1;18388;5.438329345225147e-05
8823;大佬们ai画图是更吃显卡性能还是处理器啊;1;0;1;18388;5.438329345225147e-05
8826;有这技术能不能做点更凉快的图啊up，币大大的有doge;8;22;30;18388;0.001631498803567544
8835;ai绘画就是好，量大还管饱;1;3;4;18388;0.00021753317380900588
8837;已三连，已关注;2;0;2;18388;0.00010876658690450294
8840;等你下课的链接呢;1;2;3;18388;0.0001631498803567544
8842;币已投，求个原图;4;1;5;18388;0.00027191646726125733
8847;我看到的怎么都是全身光溜溜的滑稽滑稽;1;1;2;18388;0.00010876658690450294
8849;三连了但是这期没看到置顶哦妙啊;1;0;1;18388;5.438329345225147e-05
8851;链接名字？doge;1;0;1;18388;5.438329345225147e-05
8853;已三连、求图包;4;0;4;18388;0.00021753317380900588
8858;链接给一下币大大的有;2;0;2;18388;0.00010876658690450294
8863;？为什么私信了也没回复？骗子;4;0;4;18388;0.00021753317380900588
8893;感觉可以做成剧情游戏了吃瓜;2;0;2;18388;0.00010876658690450294
8902;期待那个齐扔器;4;50;54;18388;0.0029366978464215794
8909;有张图ai画错了doge，多出来一个;3;5;8;18388;0.00043506634761801175
8913;可以的，就是两个rt有点恐怖doge;2;6;8;18388;0.00043506634761801175
8922;信任呢;1;0;1;18388;5.438329345225147e-05
8975;百度网盘不放吗？;3;0;3;18388;0.0001631498803567544
8991;省流;4;168;172;18388;0.009353926473787253
8996;看见个人就周姐周姐。蚌埠住，关键也不像啊。而且到处刷;14;68;82;18388;0.00445943006308462
9041;你是我看到的第一个不在简介放分享链接的;1;5;6;18388;0.0003262997607135088
9043;ai的尽头果然是周淑怡;2;5;7;18388;0.0003806830541657603
9047;为什么ai只会画女的;4;1;5;18388;0.00027191646726125733
9053;艹，周姐;1;1;2;18388;0.00010876658690450294
9055;什么执行官;1;2;3;18388;0.0001631498803567544
9072;这不周淑怡吗;2;7;9;18388;0.0004894496410702633
9099;来点机娘;1;2;3;18388;0.0001631498803567544
9101;扩展这里为什么跟你们的不一样，是什么东西没下载吗;3;3;6;18388;0.0003262997607135088
9105;大佬，我想问一下，就是我用本地端生图为什么经常没有图片出来;1;0;1;18388;5.438329345225147e-05
9107;感觉你被限流了;2;0;2;18388;0.00010876658690450294
9112;413的是什么doge;13;496;509;18388;0.027681096367195998
9126;显卡擦着眼泪：刚出生时以为可以天天打游戏。没料到被卖到黑矿当矿工，那日子不想再提了。好不容易熬到矿坑倒闭，现在又被人卖到大芬村当画工;17;61;78;18388;0.004241896889275614
9144;显示这个咋办，重启了很多次都是这样;13;80;93;18388;0.0050576462910593865
9158;卧槽，大家学习热情太高了吧，一晚上五百多关注，我都怀疑你们是机器人粉丝喜极而泣周末加更一期视频，助力大家自由玩耍AI绘画从此大家没有秘密（仅限玩耍阶段，玩深了我也不懂）最后那个群是交流群，是为了招募一起玩耍的伙伴设门槛是不想很多人进来无语教程我会在B站免费分享软件在本视频的说明里已经留了链接求求你们认真找找吃瓜吃瓜吃瓜;55;185;240;18388;0.013051990428540352
9214;rojanAndroidOSZkarletFlash警报级别严重状态活动日期20232152145类别特洛伊木马详细信息：这个程序很危险，而且执行来自攻击者的命令。受影响的项目fileD度盘度盘文件sdwebui启动器webui启动器1zipbaiduyunpdownloading;26;228;254;18388;0.013813356536871872
9241;我感觉你视频从开始就漏了很多步对你来说没什么，对小白来说少一步就是地狱。。。要不整理个文字版置顶一下？;5;42;47;18388;0.0025560147922558192
9247;840000在这里下载httpshuggingfacecostabilityaisdvaeftmseoriginalblobmainvaeftmse840000emaprunedsafetensors下载后放入modelVAE;13;41;54;18388;0.0029366978464215794
9261;没有basil的去下一个，勾选本地就行了OKhttpshuggingfaceconuigurumibasilmixblobmainBasilmixfixedsafetensors;16;43;59;18388;0.0032086143136828365
9278;那有的xp关键词ai可以识别么，比如魔物娘（monstergirl），皮物（skinsuit），多臂腿头（multiple系列），扶她（futanari）这种之类的doge;14;77;91;18388;0.0049488797041548835
9293;AttributeErrorNoneTypeobjecthasnoattributepop提示：Python运行时抛出了一个异常。请检查疑难解答页面。Stablediffusionmodelfailedtoloadexiting已退出进程，代码为10x00000001提示：检测到SDWebUI进程退出状态不正常，建议前往疑难解答页面扫描错误记录或寻求其他帮助。大佬，怎么解;8;18;26;18388;0.0014139656297585382
9302;懂了。启动器解压当前文件夹，将解压出的内容都放到一键包里。一键包解压那个10G的文件到当前文件夹，然后点击启动器（先安装启动器运行依赖），进启动器点击版本管理一键升级，不用选直接点，然后去小工具里的C站，下载模型去。;4;28;32;18388;0.001740265390472047
9307;MD，我忘记说一个重要的事打开启动器，启动绘画之前，记得点一下启动器页面“版本管理”右上角的“一键升级”这样你跟我的操作界面就完全一样了对不住了老铁们吓吓吓;31;85;116;18388;0.00630846204046117
9340;感谢up，还没加别的模型，感觉很好脱单doge;3;9;12;18388;0.0006525995214270176
9344;画不穿衣服的逼真吗dogedoge来个断句鬼才把标点打上;19;54;73;18388;0.003969980422014357
9365;TypeErrorargumentoftypeNoneTypeisnotiterable提示：Python运行时抛出了一个异常。请检查疑难解答页面。已退出进程，代码为10x00000001提示：检测到SDWebUI进程退出状态不正常，建议前往疑难解答页面扫描错误记录或寻求其他帮助。委屈委屈;12;85;97;18388;0.0052751794648683925
9378;虽然很感谢出教程，但是第一步就是错的啊，你视频和实际的下载文件不一样，至少说明一下为何不一样，影响在哪里，怎么解决，不然对新手太不友好了。;6;15;21;18388;0.0011420491624972808
9385;模型管理找不到捂脸basil;14;11;25;18388;0.0013595823363062867
9401;这么吃显存吗，20606g搞不了吗;2;3;5;18388;0.00027191646726125733
9404;打开启动器提示检测到SDWebUI文件了，但无法找到与之对应的版本信息，你可能正在使用不支持的整合包。。。晕;1;13;14;18388;0.0007613661083315206
9406;画的太慢，画出来的是一张虎皮一样的东西怎么解决？;1;3;4;18388;0.00021753317380900588
9408;成功运行了，但是似乎没有正常调用显卡，CPU和内存占用增高，显卡的性能一直再59徘徊。大哭;1;2;3;18388;0.0001631498803567544
9410;能画不带衣服的吗？呲牙;13;40;53;18388;0.002882314552969328
9424;TracebackmostrecentcalllastFileDnovelaiwebui一键包novelaiwebuiakiv2launchpyline251inmodulestartFileDnovelaiwebui一键包novelaiwebuiakiv2launchpyline246instartwebuiwebuiFileDnovelaiwebui一键包novelaiwebuiakiv2webuipyline150inwebuiinitializeFileDnovelaiwebui一键包novelaiwebuiakiv2webuipyline85ininitializemodulessdmodelsloadmodelFileDnovelaiwebui一键包novelaiwebuiakiv2modulessdmodelspyline248inloadmodelloadmodelweightssdmodelcheckpointinfoFileDnovelaiwebui一键包novelaiwebuiakiv2modulessdmodelspyline177inloadmodelweightsifglobalstepinplsdTypeErrorargumentoftypeNoneTypeisnotiterable提示：Python运行时抛出了一个异常。请检查疑难解答页面。已退出进程，代码为10x00000001这样怎么办;2;3;5;18388;0.00027191646726125733
9427;大佬，启动器检测不到SDWEBUI相关文件，求解我已经放到一键包的位置了;9;10;19;18388;0.0010332825755927778
9437;提示启动器检测不到SDWEBUI的小伙伴们，把“novelaiwebui一键包”文件夹里的“novelaiwebuiakiv2zip”解压出来到一个文件夹中，然后再把“A启动器exe”放入该文件夹中，再启动就可以了;1;6;7;18388;0.0003806830541657603
9439;如果我想用我自己脸作为ai的脸型可以的吗？类似用我的照片生成图片什么的？我的中二之魂已经蠢蠢欲动了doge;6;27;33;18388;0.0017946486839242985
9446;我管这叫AI搜图，不叫绘画;2;15;17;18388;0.000924515988688275
9449;在discord里面用Midjourney就可以昨天刚画的，第一张有点偏题哈哈哈哈;6;11;17;18388;0.000924515988688275
9458;已退出进程，代码为10x00000001提示：检测到SDWebUI进程退出状态不正常，建议前往疑难解答页面扫描错误记录或寻求其他帮助。点击一键启动后，黑色窗口弹出了这个，打不开网页，有大佬知道怎么处理么。。。电脑配置是i912900H3080ti16G64G;5;4;9;18388;0.0004894496410702633
9464;带佬们图片生成完以后就自己消失了是咋回事呀;1;1;2;18388;0.00010876658690450294
9467;想问问up，这个怎么设置调用显卡，我看生存图片都一直调用CPU;4;1;5;18388;0.00027191646726125733
9474;你这个视频和你的压缩包文件内容不一样啊，，，A启动器点了跳出一个错误报告;1;2;3;18388;0.0001631498803567544
9476;这样就不动了，。。浏览器白屏难过难过;12;10;22;18388;0.0011964324559495323
9489;准备一些词汇和解释脱单doge;3;6;9;18388;0.0004894496410702633
9498;A卡与狗不得入内;1;1;2;18388;0.00010876658690450294
9501;启动器更新了，该下载的也下载了，该解压的也解压了，但是启动后就这样了笑哭;2;5;7;18388;0.0003806830541657603
9504;模型VAE选择里面没有84000文件;7;27;34;18388;0.00184903197737655
9512;靠，那我1660S是不是玩不起了？才6G显存笑哭笑哭;12;3;15;18388;0.000815749401783772
9529;为什么我生成的图片是一堆乱七八糟的东西大哭;2;1;3;18388;0.0001631498803567544
9532;后面的二维码没了;1;0;1;18388;5.438329345225147e-05
9534;为什么webui启动器zip解压出来跟你不一样，只有俩个，一个是launcher，一个是A启动器exe;3;1;4;18388;0.00021753317380900588
9538;大佬千万别用百度网盘了，明年都下不完;1;1;2;18388;0.00010876658690450294
9540;为什么我解压novelaiwebuiakiv2这个10G文件要1天时间？进度一直卡在13;1;1;2;18388;0.00010876658690450294
9551;6G显存可以跑得动吗？喜欢大哭惊讶;2;3;5;18388;0.00027191646726125733
9554;up请问我解压到了一件包然后我点开启动器它提示我找不到sdwebui是什么情况;5;1;6;18388;0.0003262997607135088
9560;最近看到好多AI画的色图;2;1;3;18388;0.0001631498803567544
9565;为啥我的模型管理里面空空的，没有视频说的那些;4;0;4;18388;0.00021753317380900588
9574;干得好，等到AI把你们饭碗抢了，让你们都去住桥洞，就知道当初的自己有多么愚蠢了;5;0;5;18388;0.00027191646726125733
9580;UPUP为啥只能CPU搞事？生成引擎只有1CPU怎么调用显卡。;1;0;1;18388;5.438329345225147e-05
9582;可不可以画那种，就是那种啊，应该是你懂的那种可以吗？;1;4;5;18388;0.00027191646726125733
9596;报毒;1;0;1;18388;5.438329345225147e-05
9600;我用titanz这样的双芯卡双显存加起来有12g的可以吗;1;0;1;18388;5.438329345225147e-05
9602;up，为什么我这没有basil模型啊;2;1;3;18388;0.0001631498803567544
9608;这些都是安到C盘里面去的吗;1;0;1;18388;5.438329345225147e-05
9610;alueErrorTypeErrorcoroutineobjectisnotiterableTypeErrorvarsargumentmusthavedictattribute提示：Python运行时抛出了一个异常。请检查疑难解答页面。;1;0;1;18388;5.438329345225147e-05
9612;没有basil文件呀;3;0;3;18388;0.0001631498803567544
9617;ai绘画是无中生有的意思吗，还是我可以自定义的图片来生成呢;1;0;1;18388;5.438329345225147e-05
9622;能把2D图改25D吗。;3;4;7;18388;0.0003806830541657603
9631;生成的都是动漫类型的，想生成真人类型怎么搞。思考;3;4;7;18388;0.0003806830541657603
9639;为什么用了up的关键词画出来好多挖掘机啊？十张有六张挖掘机两张不明所以的，两张是人的，，，;2;1;3;18388;0.0001631498803567544
9649;请问楼主有A卡用的吗？？;4;0;4;18388;0.00021753317380900588
9658;想问下：下载了新的模型refslaveV2v2safetensors，放到了Stablediffusion文件夹里，软件的模型管理也有这个模型的本地显示了，但打开网页刷新模型就是出不来这个模型是怎么回事呀？;2;0;2;18388;0.00010876658690450294
9676;为啥我装了这个生成比之前用的二次元那个渲染慢了好多，贼慢那种。;1;0;1;18388;5.438329345225147e-05
9683;有病毒怎么解决？？辣眼睛解压不了;4;0;4;18388;0.00021753317380900588
9690;亲爱的up，有什么方法能保证生产的图片不是卡通的吗;2;0;2;18388;0.00010876658690450294
9695;按教程一步一步设置一切都很顺利最后打开网站布局分成混乱按钮有大有小求助求助委屈;1;0;1;18388;5.438329345225147e-05
9701;有A卡的版本吗？;2;0;2;18388;0.00010876658690450294
9713;有大佬知道为什么嘛;1;0;1;18388;5.438329345225147e-05
9716;共享里面启动器的东西怎么比你的少呀;1;0;1;18388;5.438329345225147e-05
9727;A卡怎么办;1;0;1;18388;5.438329345225147e-05
9730;大佬你的basil模型是在哪找的啊;1;1;2;18388;0.00010876658690450294
9734;求个A卡版本吧，没N卡只靠CPU太慢了;3;2;5;18388;0.00027191646726125733
9746;basil这个我在c网都搜不到了。。。;1;0;1;18388;5.438329345225147e-05
9758;问一下，我能说百度网盘里面下载回来的东西跟你视频里面的不一样吗？;2;0;2;18388;0.00010876658690450294
9765;描述词汇不是很能理解呀笑哭，有啥规定吗？;1;0;1;18388;5.438329345225147e-05
9767;你这个压缩包的文件和视频里的对不上;1;0;1;18388;5.438329345225147e-05
9777;Linux系统能跑吗doge;1;0;1;18388;5.438329345225147e-05
9779;vae里面没有东西咋回事啊;1;0;1;18388;5.438329345225147e-05
9782;为什么我生成的图都是画面灰蒙蒙的;3;0;3;18388;0.0001631498803567544
9797;请问一下UP为什么下载后启动器文件夹里的压缩包解压出来比视频里的东西少很多，移动到一键包文件夹也显示启动器检测不到SDWebul相关文件;2;1;3;18388;0.0001631498803567544
9807;显存6可以吗GB;1;0;1;18388;5.438329345225147e-05
9811;安装basil是真滴慢啊;7;0;7;18388;0.0003806830541657603
9821;启动器压缩包就2个文件，一个launcher文件夹，一个A启动器exe的应用程序，啥情况？;1;0;1;18388;5.438329345225147e-05
9833;杰尼星星眼星星眼星星眼我爱你;2;5;7;18388;0.0003806830541657603
9836;代码为10737415150xC0000135什么情况;1;0;1;18388;5.438329345225147e-05
9838;显存8G，我新买的3060Ti总共才8G是不是用不了。这个会不会程序异常被检测带毒。被误检测。作为臭打游戏的我害怕我打着游戏说我这个异常给我封号;3;0;3;18388;0.0001631498803567544
9843;a卡为啥不行哇好不容易买个6900xt结果用不了诶;1;0;1;18388;5.438329345225147e-05
9845;这样的话，macm1m2就不是用不了哇大哭;1;0;1;18388;5.438329345225147e-05
9847;3060能玩吗doge;2;0;2;18388;0.00010876658690450294
9850;笔记本3060可以跑吗6g显存;4;3;7;18388;0.0003806830541657603
9861;哪位大佬解答一下，为什么hiresfix勾选后生成完了图就消失了;2;0;2;18388;0.00010876658690450294
9867;1080能跑的动吗;1;0;1;18388;5.438329345225147e-05
9873;dalao我想问一下这个文件下载是下到哪里的，如果不想玩了在哪个位置删啊脱单doge;2;0;2;18388;0.00010876658690450294
9880;启动器包里怎么没了;1;0;1;18388;5.438329345225147e-05
9882;能做场景吗？还是只能人物？;2;0;2;18388;0.00010876658690450294
9887;up你好，为什么我的生成图片这么慢啊。我的显卡和CPU也不差啊，8分钟了才70;1;0;1;18388;5.438329345225147e-05
9889;a卡为什么用不了呢是因为冲突吗;1;0;1;18388;5.438329345225147e-05
9893;正在下载模型文件，速度几百和几十KB，这个需要下载好再开始绘画吗;2;1;3;18388;0.0001631498803567544
9901;为什么下载链接里没有一键包文件夹撇嘴;1;0;1;18388;5.438329345225147e-05
9904;这些东西全部下载解压50g够不够;1;0;1;18388;5.438329345225147e-05
9907;6g内存的显卡不行吗;2;0;2;18388;0.00010876658690450294
9918;为啥选不了刚下载的basil模板？谢谢;1;0;1;18388;5.438329345225147e-05
9921;为什么为什么生成的都是这样二次元哦？;2;0;2;18388;0.00010876658690450294
9927;python安装报错apimswincorepathl110dll丢失怎么解决更换了这个也不行。。是不是WIN7用不了或者电脑太烂。。;1;0;1;18388;5.438329345225147e-05
9929;a卡可以吗;1;0;1;18388;5.438329345225147e-05
9934;为什么没有下半身;1;0;1;18388;5.438329345225147e-05
9938;按up说的都设置好了，但是无法生成图片，提示词那里无论写入或者复制进去什么都是显示075或者错误，最后我干脆使用图生图，在C站下载下图片后直接拖进去，点击生成，稍停顿后自动停止生成，图片生成栏里已然没有图片出现。;1;0;1;18388;5.438329345225147e-05
9942;n给你多少广告费;2;1;3;18388;0.0001631498803567544
9947;为毛我跑出的图全都是同一张脸。。。是模型问题吗？;1;0;1;18388;5.438329345225147e-05
9953;提取码错了;2;0;2;18388;0.00010876658690450294
9956;解决了吗？我1066的显卡，16G内存，是必须要加内存吗？;1;0;1;18388;5.438329345225147e-05
9969;有一些tag明明在词典里有的，但是我发现跑了几十张都没有，ai拿我的指令当放屁一样;8;1;9;18388;0.0004894496410702633
9981;为啥我解压出来的和up不一样喜极而泣;1;0;1;18388;5.438329345225147e-05
9985;up，下载后成功打开了，可浏览器里的界面和你不一样啊？是不是更新了;2;0;2;18388;0.00010876658690450294
9990;下载后包坏了。。在up的云盘和秋佬的云盘下载都是这样;1;0;1;18388;5.438329345225147e-05
9992;10个G百度网盘没有会员下到啥时候去;1;0;1;18388;5.438329345225147e-05
9999;大佬，启动器检测不到SDWEBUI相关文件，求解;10;0;10;18388;0.0005438329345225147
10013;东西呢无语;1;0;1;18388;5.438329345225147e-05
10015;为什么渲染一张图需要7分钟？;1;0;1;18388;5.438329345225147e-05
10017;能生成动画吗？;4;0;4;18388;0.00021753317380900588
10031;3070可以吗;1;0;1;18388;5.438329345225147e-05
10037;目前遇到一个问题，模型合成，把把失败，显存不够得原因吗？有没有解决办法笑哭;1;0;1;18388;5.438329345225147e-05
10048;3060的6g显存可以吗大哭大哭;1;0;1;18388;5.438329345225147e-05
10055;还没装过请问这与自己部署的有什么不同吗？;4;0;4;18388;0.00021753317380900588
10062;下载速度慢有没有办法解决;2;0;2;18388;0.00010876658690450294
10065;封面图能分享吗哥;3;0;3;18388;0.0001631498803567544
10069;这个怎么避免炸显存啊我8g前98都挺好就98时候炸显存得卡半天;7;1;8;18388;0.00043506634761801175
10077;下载basil文件要9个多小时笑哭;1;0;1;18388;5.438329345225147e-05
10080;下载basil和8400都说我没联网，是需要科学上网么;1;1;2;18388;0.00010876658690450294
10090;模型管理中点击下载basil或者84000safe弹窗“模型文件下载失败，请检查网络连接或重试”，多次开关软件仍是这样，但网络可以正常上网，点“版本管理”右上角的“一键升级”也没问题，翻了也仍然弹这个窗，请问要怎么做;5;0;5;18388;0.00027191646726125733
10097;大佬，请问这个和SD哪个比较好用，准备入坑。;2;0;2;18388;0.00010876658690450294
10100;一键升级后，还是没有lora的tab，另外vae也没有84000选项，不知道怎么回事，该下载的都下载了;5;1;6;18388;0.0003262997607135088
10108;A卡没救了吗？;1;0;1;18388;5.438329345225147e-05
10111;咋和up主的设置界面不一样，都不知道怎么操作了笑哭;1;0;1;18388;5.438329345225147e-05
10113;求助：您的SDWebUI本体或部分拓展正在使用已废弃接口，但是拓展管理那边已经把能更新的都更新了，还是不行怎么办;1;0;1;18388;5.438329345225147e-05
10117;这个可以我画了草图，ai来帮我上色或者细化嘛，我画欧美的也可以嘛;2;1;3;18388;0.0001631498803567544
10120;AI能绘图二次元人物么？;4;0;4;18388;0.00021753317380900588
10125;3G显存会爆么doge;1;0;1;18388;5.438329345225147e-05
10129;什么叫n卡;1;0;1;18388;5.438329345225147e-05
10137;8400下载后选项里没有，有人知道怎么弄吗;1;0;1;18388;5.438329345225147e-05
10141;啥玩意儿啊，视频里的跟下载下来的都不一样;1;0;1;18388;5.438329345225147e-05
10147;为啥必须要n卡呢6750可以吗笑哭;2;0;2;18388;0.00010876658690450294
10150;不是自己用画笔画出来的有成就感吗？跟随便找张网图没区别;2;0;2;18388;0.00010876658690450294
10160;酸了5700X绘一个图十多分钟炸了;1;0;1;18388;5.438329345225147e-05
10168;为什么我打开启动器里没有basil文件了？;4;1;5;18388;0.00027191646726125733
10174;一样的启动器，我没有实时预览啊，是要在哪开吗;1;0;1;18388;5.438329345225147e-05
10177;ai画手什么时候才能画好doge;5;1;6;18388;0.0003262997607135088
10184;8G内存1650可以可以运行吗热词系列知识增加;3;0;3;18388;0.0001631498803567544
10189;我这边画一张半小时以前，你们多久啊;5;0;5;18388;0.00027191646726125733
10195;up，我看到你的启动器里有lora选项卡，我的没有，我自己下了很的lora的模型，所以想问下，你怎么弄的。。;1;0;1;18388;5.438329345225147e-05
10197;路人本搞快点本子不够看;1;0;1;18388;5.438329345225147e-05
10199;检测不到sdwebUI;1;0;1;18388;5.438329345225147e-05
10205;AttributeErrorNoneTypeobjecthasnoattributekeys提示：Python运行时抛出了一个异常。请检查疑难解答页面。Stablediffusionmodelfailedtoloadexiting已退出进程，代码为10x00000001;1;1;2;18388;0.00010876658690450294
10212;请问丢失apimswincore我该如果解决啊;4;0;4;18388;0.00021753317380900588
10218;我怕我学会之后，我就对这些再也不感兴趣了;1;0;1;18388;5.438329345225147e-05
10220;那个，能画一些我喜欢看的东西吗？捂眼;1;0;1;18388;5.438329345225147e-05
10229;你说的内涵，最好是正经的内涵doge;1;0;1;18388;5.438329345225147e-05
10231;AssertionErrorTorchisnotabletouseGPUaddskiptorchcudatesttoCOMMANDLINEARGSvariabletodisablethischeck提示：Python运行时抛出了一个异常。请检查疑难解答页面。辣眼睛;1;0;1;18388;5.438329345225147e-05
10234;A卡是不是就没办法了？唉，早知道就不买6800了;2;0;2;18388;0.00010876658690450294
10237;整个这种配置的电脑需要多少钱，前几天用自己那台垃圾笔记本，跑一张图要10分钟，实在没意思笑哭;5;0;5;18388;0.00027191646726125733
10243;hxd1080能玩吗星星眼;4;0;4;18388;0.00021753317380900588
10263;我只是出个教学视频，只是想让接触AI绘画或者了解AI绘画的人多一个渠道，并且我在视频的末尾处也做出了安全声明。这只是一个教学视频，评论区和弹幕问候我家里人的可以省点力气了，站内做AI绘画题材的视频的那么多，大可不必把精力都浪费在我一个无名小卒上。我也知道我的声音不算好听，我完全可用AI配音，甚至是文字图文教学，但是我还是想亲自来录音，因为这样传达出来的教学效果最好，我不是学的播音主持，我也没有一个很好听的声线，我只是想为这个软件的人录一期详细的教学，仅此而已。愿世界永保和平;82;1218;1300;18388;0.07069828148792691
10346;19世纪的人：蒸汽机真是太伟大了，未来的人们如果真的实现了机械化解放生产力该多幸福啊21世纪的人：天哪AI太恐怖了这根本不是画这是对画画的讽刺工具是拿来用的，抨击新技术只能说吃得太饱了;56;215;271;18388;0.014737872525560148
10405;希望能将标题改为“从零开始学会AI制图，让你也能生成出自己的图”谢谢作者对画师的尊重;16;125;141;18388;0.007668044376767457
10422;人与人的悲欢并不相通微笑别乐，下一个就是你的工作;113;600;713;18388;0.0387752882314553
10536;其实很正常，你动谁的利益，谁就和你急。围棋圈也是这么过来的。想想以后还会有更多的领域被AI冲击，而普通人又无可奈何，也是可怕。笑哭;11;140;151;18388;0.008211877311289972
10548;笑，都可以笑，没必要争论，因为所有人都有可能被AI取代。我是画师，从围棋，AI配音开始，就已经知道大致结果了，玩了2077，里面剧情，写作，音乐，服装设计全是AI超越人类，太真实了。所以我预防针属于是打满了。最近COS圈也开始出现AI的话题了笑哭笑哭还能怎么样？摆咯赛博朋克身在其中啊;39;296;335;18388;0.018218403306504243
10588;《画》出《自己的图》;8;68;76;18388;0.004133130302371111
10598;对于视频中几点问题的勘误和补充勘误1从c站抄来的tag需要进行修改微和微调，进行自我调整，这一点没说错，但是生成的图片并不是由电脑算力显卡之类因素决;1;69;70;18388;0.0038068305416576026
10600;我依然坚持手绘，当然需要付出大量的努力和时间，我不会计较于一小时出上千万张高质量的作品，偶尔也会看看ai的图但不会沉迷ai也不会去用ai出图做视频来挣流量，画画就是画画，在这个时代能静下心来画画就是一件难得美的事情了，只因为打从我心底里是对绘画的热爱，有时候目的性太强真的不是一件好事。;12;102;114;18388;0.006199695453556668
10613;真是可怕，一些大型私炉已经可以生成“真人”图片了，对版权没有概念的话，对肖像权也没概念吗？;20;152;172;18388;0.009353926473787253
10634;我现在有点明白为什么道德伦理要约束科学家，因为科学家乱搞真的会出事，同样软件技术人员乱来也挺恐怖的，他们呼喊着技术无罪然后试图用算法解决世间一切事并且把开源精神乱用到其他行业，我没有指责技术人员和开源精神，我鄙夷的是唯技术论，时代发展太快，道德和律法跟不上就会出问题，尤其是心术不正的可以较轻易的学到技术并滥用还没人能监管。;57;201;258;18388;0.014030889710680878
10692;感觉不如每天绘画1小时，成功饿死自己doge;14;165;179;18388;0.009734609527953013
10707;分享一个百分百属于自己的绘画流程，使用3D软件摆设裸模导出图片，设置AI的TAG，导出AI绘画图片，修改AI绘画的瑕疵和优化不合理的地方。随便商用，根本没任何问题，这套流程早就被跟进时代的画师运用上了，而且我发现根本没人法律风险，你也抵制不了，因为这类创作就是人的创作，难道我之前除去AI，用3D辅助制作的画就商用不了了？只不过AI负责的色块需要自己花时间画而已，工具就是工具，输出我的创意才是关键，无脑的叫嚣AI不能算创作，其实很可笑;32;100;132;18388;0.007178594735697194
10741;画出自己的图实在太了;12;145;157;18388;0.00853817707200348
10754;我如果是从职业学院学了三年毕业出入社会的职业工人，准备大展拳脚的时候发现车间现在已经是自动化了，不需要职业工人了，我也会着急，恨不得砸烂自动化车间。但自动化车间还是需要研究生技术员，他们在没有自动化车间的时候是技术员，在自动化时代还是技术员，没有影响，所以他们不着急。;2;32;34;18388;0.00184903197737655
10757;好在我不靠这个吃饭，AI对我喜欢画画没有影响，我只是为还在努力练习绘画技巧并想在未来靠绘画某生的人儿感到不值;4;71;75;18388;0.00407874700891886
10763;ai最牛的地方，就是完美利用了人性自私的弱点。在殃及自己之前，都无所谓，甚至乐在其中，因为ai是通过毁灭行业的方式来让其它所有非这个行业的人受益。在殃及自己之前，都是受益者。受益者怎么会去抨击ai呢？还会推波助澜，然后自诩无辜。比如无数和up类似的人。他们都是趴在倒下的画师身上吸血的人，只是他们自己不会承认罢了。;12;23;35;18388;0.0019034152708288013
10777;吃瓜工具无罪，但是人性嘛，说什么不会用AI商用牟利巴拉巴拉的，信你个鬼哦，私底下还不是该怎么炼丹怎么炼丹，该怎么下模型下模型，然后拿着这些模型尝试能不能“变现”（不限于所谓的卖钱），现在法律又没有禁止，有钱不赚有便利不图不是王八蛋是什么？人人都想在新赛道上将来分一杯羹，表面上说得清高，私下有心人各种军备竞赛，说得不好听，但就是事实。呲牙呲牙呲牙;3;38;41;18388;0.00222971503154231
10781;ai不要带绘画标签;60;494;554;18388;0.030128344572547313
10843;当年翻译软件开始侵占翻译市场的时候咋没见这么多人抵制翻译软件呀;12;28;40;18388;0.0021753317380900587
10856;你至少把“绘画”和“自己的”等词替换掉吧，这玩意真的是“自己的”“绘画”吗;16;81;97;18388;0.0052751794648683925
10874;如果路过的真的对“抵制AI作画”感兴趣，诚挚欢迎观看这个视频。抵制AI作画，并不是有些人口中说的国内一些小圈子的低级画师才抵制，实际上，外网的很多知名画师都在自发抵制AI作画。httpswwwbilibilicomvideoBV13K411q7Puspmidfrom333337searchcardallclickvdsource0d00755defbbff002b447d05b8c742ed;6;60;66;18388;0.003589297367848597
10882;最后这句“请误将AI绘画用于商业用途”就很耐人寻味，AI绘画初衷就是用来商业的，还指望它用来提高绘画圈的学术高度吗，哈哈，拿ai来自我欣赏？不去搞商业就怪了;10;92;102;18388;0.00554709593212965
10894;绘画人感觉这个视频还是比较客观的合理性的不反对AI绘画这个技术反对的是用技术去破坏绘画用AI牟利的人和给AI喂没有授权图的人;4;49;53;18388;0.002882314552969328
10899;ai作画对于画师来说，可以用来进行参考，对于普通人来说，你就把他当做寻找自己需要的瑟图查找器就行，至于那些不会画画却妄想靠ai作画约稿的人我只能呵呵;8;40;48;18388;0.0026103980857080703
10908;AI以后发展的趋势就是商用随着AI技术的成熟游戏公司可以大大提高工作效率降低人员和时间成本对中低岗位的从业人员影响还是很大的而影响不到的恰恰是那些热爱画画享受绘画过程的爱好者不专门靠画画牟利的人虽然很残酷但这就是趋势以后各行各业都要面临AI的冲击唯有提升自己身为人的核心价值才不会被淘汰;6;31;37;18388;0.002012181857733304
10915;ai根本没有艺术审美，也没有自我追求的意识，ai只是靠大数据生成一个图片给你，这个大数据来源还很有可能不正当。ai的图也不可能算作你画的，如果真的喜欢艺术喜欢画画，就不要怕累慢慢去练临摹，就算达不到巅峰，自己画完一副属于自己的画其实是很有成就感的。;13;33;46;18388;0.0025016314988035677
10930;私信问的太多了，我这里统一说明下。原免费的整合包链接已下架，其分享者也撤回了分享。出于对分享者的尊重和理解，我已经删掉了视频中对应的部分，也不会将已经删除的分享包进行二次分享扩散。现在网络上流通的整合包很多，无论付费的还是免费的，大家稍微找一下都能找到，安装方法多半都是解压即用的懒人包。虽说可能不同的整合包之前有区别，但是使用方法都是大同小异，所以教程是通用的，大家可以放心看。;12;62;74;18388;0.004024363715466608
10944;绘画圈最黑暗的一天;2;24;26;18388;0.0014139656297585382
10948;ai涉及这么多领域，为啥只有绘画被这么激烈抵制，不是很理解。;34;26;60;18388;0.003262997607135088
10983;ai随便发展，大不了画师都失业，然后再去别的地方抢别人工作呗吃瓜，反正赢得永远是资本，普通人卷去吧。;2;14;16;18388;0.0008701326952360235
10986;首页见到这玩意儿目前这么多ai技术里最讨厌的就是ai绘画，这个技术被很多人想的太简单了。拿大师的画合成出一堆莫名其妙的垃圾真的就行了吗，关于版权问题，希望使用的人自己心里有数吧;24;27;51;18388;0.002773547966064825
11012;这图恐怕和你没什么关系吧？这也能叫你的作品吗;29;34;63;18388;0.0034261474874918425
11042;《学AI绘画》《自己的图》脱单doge;34;414;448;18388;0.02436371546660866
11080;有个问题，ai产生出来的作品能算是自己的吗？ai不是的画师图喂出来的嘛，能挂出去说是自己画的吗，甚至咋能说这图是自己的作品吗？doge;17;25;42;18388;0.0022840983249945617
11098;个人觉得绘画是人类特有的行为，AI的应该叫生成或者合成，不应使用绘画这个词，就像上了岸的鱼就不是鱼了，会有新的词语去进行定义，定义模糊会引起很多的分歧和冲突。;45;234;279;18388;0.01517293887317816
11144;既然点进ai作画相关视频，想必有些人有听说过“抵制ai作画”活动，实际上，抵制AI作画，并不是有些人口中说的国内一些小圈子的低级画师才抵制，外网的很多知名画师都在自发抵制AI作画。httpsb23tvT7Au0lM（无其他意思，只是希望其他人能对ai作画涉嫌侵权有更多的了解）;5;41;46;18388;0.0025016314988035677
11150;ai绘画热度明显比其他ai产品高，19年有个自动上色的ai时大家都普遍表示欢迎，22年初国内6pen有免费ai图生成时大家也只是表示好奇，十月novelai的爆红，突然让大家意识到ai可以短时间内大量生成完成度较高的二次元图片时才开始抵制ai绘画的声音才开始被听见，其实在novelai爆红之前sd跟mj都已经能够生成完成度很高看起来很绚丽的图片了，只是因为画风偏现实国内没什么画手注意而已;1;8;9;18388;0.0004894496410702633
11153;建议把331秒的图片打个码，这个动漫是被全网封杀的;1;23;24;18388;0.0013051990428540352
11160;把AI用于牟利这里需要展开讲讲，不是反对一切牟利因为，本身这个东西能带来利益对它自身的发展一定能带来推动。我们应该抵制反对的是那种拿现成出名有名气（类似偶像肖像权）画师画风训练自己模型，然后生成该风格图片来牟利。这才是AI绘画被那么多人封杀的根源。;6;20;26;18388;0.0014139656297585382
11167;我是画师，我最近一直再思考，画不过AI是否还要继续下去，如果继续，努力变强，变得跟AI一样强后，拿出来会不会大家都认为你是AI做的，就算没人质疑，那么辛辛苦苦画1个月跟AI一分钟生成的质量一样，意义在哪。社会不只是悦己，未来该如何生存？;5;3;8;18388;0.00043506634761801175
11173;有沒有一種可能，你覺得你的工作會被取代很大程度的原因是因為;2;4;6;18388;0.0003262997607135088
11176;用ai生成的图都是我的图哦你们自己的图是不存在的星星眼;6;16;22;18388;0.0011964324559495323
11184;笑死了，真以为自己是什么理智群体啊。表面说的冠冕堂皇，不就是好维护自己干脏事星星眼;1;14;15;18388;0.000815749401783772
11186;ai可以替代任何职业，只是时间问题;3;5;8;18388;0.00043506634761801175
11190;我觉得这是很好的，我终于可以无限制地生成自己喜欢角色的图片了。只是目前还不能靠关键词生成我光怪陆离的梦境，我有惊醒后迅速拿起手机记录梦境的习惯，根据AI进化的速度，那一天应该也快了。;1;3;4;18388;0.00021753317380900588
11194;AI还是叫AI合成AI生成什么的比较合适。B占好多AI绘画就是别人的图高清化风格化也叫AI绘画。。。毕竟绘画是个动词。电脑的运行可能只是一种计算最多相当于人的一种想法。如果人所想的画面也能直接投射显示出来也能叫绘画么？;1;3;4;18388;0.00021753317380900588
11198;软件名webui，b站一搜就能找到免费的整合包，请大家稍微花点时间找一下好吗？不要找都没找就直接来问我要。安装基本上都是解压就可以用的懒人包。视频中因为部分原因，不得不对软件获取的有关内容做删减处理，也请各位拿到软件的低调点，不要在弹幕或者评论区刷别的up主的名字，我不想再给别的up主造成没必要的困扰了。关于AI绘画中遇到的问题，我很乐意回答你，但是请您先耐心的看完我的视频再来问我，不要我视频里讲到过的内容，你都没耐心讲它仔细的看完就又是各种问，我没有及时回复你还要被你各种骂小电视发愁难道你们班主任没有教过你，应该上课好好听，课后再来问问题吗小电视无语;11;159;170;18388;0.009245159886882749
11212;右边是大佬的作品，左边是我复制了他的tag正在制作的作品，大晚上的看得我虎躯一震灵魂出窍;1;3;4;18388;0.00021753317380900588
11215;挺好的教程，值得一提的是在模型网站上下载模型来使用，可能会和我一样发现自己跑的图和示例里的图效果完全不一样的画面效果（感觉画面灰色、完成度低等），up主提到vea美化模型可能会有些影响，但是我的情况是因为没有下载EasyNegative造成的，和vea无关。;3;7;10;18388;0.0005438329345225147
11222;作为一个还在学画画的人，我并不反感ai我之所以讨厌AI，是因为有一批人天天在评论区里吵着画师下岗我这个只是作为兴趣爱好的人看着也很反感，更别提那些职业画师和喜欢画画的小朋友们了。辣眼睛现在ai已经能干很多事了，如果有一批人天天跑到你喜欢的up的评论区下面说让AI取代up你们会是个什么样的感觉;3;19;22;18388;0.0011964324559495323
11226;文娱方面都不需要人了，而是让机器来告诉你看什么用什么听什么，那人类还活着干嘛，毁灭了算了撇开上面不说ai只要一天不出相关法律法规，就一天都不应该用到任何商用品上再者ai能叫“绘画”？屁那特么是合成，生成现在各大绘画平台充斥着大量ai图，还不打aitag屏蔽都屏蔽不过来。有本事就别拿别人的图喂ai，喂自己的图，哦对了你不会画，所以才有ai啊。;5;67;72;18388;0.003915597128562106
11233;有些人质疑AI绘画的东西是不是自己的画，这个我不做评价，因为我还有几个问题没搞明白：AI图像生成模型是不是工具；这个模型需不需要人类输入参数指导它做相应数学计算来计算最终成果；这个输入的参数是不是从生物的大脑中出来的；AI能不能在没有任何输入的情况下输出计算结果；AI模型的本质是不是数学计算模型；只有搞明白了这些问题我才好对前面的东西做出评价;4;4;8;18388;0.00043506634761801175
11243;基本我们中流以下画师差不多都接不到稿了，我以前一个月610稿，现在俩月一稿，不过这也是大趋势，大城市甚至有智能车卖早餐，这个世界早晚会迎来高科技智慧城市，很多人力都要被代替，宛如底特律变人。仔细想想以前很多人工的工厂都倒闭了，就是因为有了机械流水线，这都是不能避免的。;1;2;3;18388;0.0001631498803567544
11246;AI替代人工不是必然的吗，也就是肯定会用于谋求商业利益。就跟前几次工业革命一样，机器替代人工。现在国内很多游戏大厂已经成专门的部门研究AI绘画，AI制作模型用来替代成本高昂，慢速的原画师和模型师。;4;2;6;18388;0.0003262997607135088
11253;这期视频请结合第二期视频观看，效果最佳httpsb23tvV7CskrJ另外，在私信里问up问题的太多了，Up实在回复不过来，所以创了一个AI绘画QQ群，群号看置顶动态。有问题可以在群里面问，有大佬会回答你，当然群里面也可以分享的作品，分享模型，交流经验，喜欢玩AI绘画的，可以加进来;10;53;63;18388;0.0034261474874918425
11264;我想用AI画漫画把自己脑子想象的故事用AI画出来。;4;7;11;18388;0.0005982162279747662
11271;这期不是上期的教程么，怎么这么多闻着味来的暴躁评论;1;7;8;18388;0.00043506634761801175
11273;小白完全不能看，说话没有逻辑，想到哪就说到哪，你也是刚学会吧;1;1;2;18388;0.00010876658690450294
11277;up你也太实诚了笑哭20分钟的教程，很少有人能一口气看完吧笑哭咱不如分开一集一集的放不过讲的确实挺好，这样我就不用出视频讲怎么从零开始了打call打call;3;7;10;18388;0.0005438329345225147
11282;点进来之前就能猜到评论区有什么东西，笑死;4;15;19;18388;0.0010332825755927778
11289;看了两次了。也没看懂。小白也就这个水平了。真的看不懂，不过我也三连了。看到UP主也很用心做视频了。AI绘画电脑要求高吗？;3;4;7;18388;0.0003806830541657603
11297;还有现在lora不用装插件就能用了笑哭;2;5;7;18388;0.0003806830541657603
11300;没说LORA文件放哪个位置啊，网站下载的LORA文件后缀还是safetensors;1;2;3;18388;0.0001631498803567544
11305;我想问下目前主流的ai绘画平台有哪些给心心;6;1;7;18388;0.0003806830541657603
11320;感谢UP的教程，目前的AI绘画，对小画师影像大不大我不清楚，毕竟小画师可以用AI出更高质量的图，但对于绘画培训班打击肯定大，特别是线上培训班，本来线上报班就是冲动消费，现在有了AI绘画，更不太可能报班了，现在抵制AO绘画的也许根本不是所谓的小画师，而是线上绘画培训班，AI绘画对小画师来说，应该就和我PS那一堆笔刷一样就是好用的工具，正常人哪里会抵制工具呢？;1;1;2;18388;0.00010876658690450294
11323;不去指责把没版权的图喂给ai的人，而去指责ai就像不指责上传盗版资源的人，而去指责论坛是个坏东西一样搞笑崩坏3差不多得了;1;2;3;18388;0.0001631498803567544
11327;这么说吧，我认识的一个厚涂画风原画师，早就用ai给自己提供画画灵感了，他说绘画行业的上层一点影响都没有，人家负责美术风格提出概念。中下层已经开始用ai辅助自己作画了，大大提高绘画效率。最后嘲笑担心被ai淘汰的画师，说只有流水线画师才会担心这个。（ps我只是把他的大体意思总结一下，这话不是我说的）;5;1;6;18388;0.0003262997607135088
11335;我有个喜欢画画但画的烂的同学我向他推荐了AI绘图，好家伙，现在他用AI改自己的画，出来的东西你不说还以为他是啥职业大佬呢;1;1;2;18388;0.00010876658690450294
11338;求助大佬们，stablediffusion模型，我下载了好多个，后缀是safetensors格式的，都是好几个G的大小。但是我一键启动之后，左上角死活刷新不出来我下载的模型，软件重启过。电脑也重启过大哭;3;1;4;18388;0.00021753317380900588
11342;求助extensions文件夹下边没有stablediffusionwebuiadditionalnetworks这个文件夹，我自己新建一个文件夹放进去可以吗？;1;1;2;18388;0.00010876658690450294
11347;挺好的，感觉ai还是版权问题严重;7;3;10;18388;0.0005438329345225147
11356;自己按照教程生成的图可以免费商用么？有没有版权？;3;1;4;18388;0.00021753317380900588
11360;大佬，为啥我经常绘图后没有图片出来;1;1;2;18388;0.00010876658690450294
11362;交作业永雏塔菲1883安心;1;1;2;18388;0.00010876658690450294
11368;首先AdditionalNetworks插件早就过时了，新版web启动器是用tag加载lora的，没有数量限制更方便，civitai的帮助里面已经说了，1千多评论没人说就离谱;3;1;4;18388;0.00021753317380900588
11377;不觉得可耻吗;4;1;5;18388;0.00027191646726125733
11382;还是想再说明一下，这是我第一次制作这类教程视频，没有经验，无论是在录制还是后期制作配音上，所以有些地方可能讲的不够到位，所以我才出了第二期视频进行了补充和勘误，强烈建议配合第二期视频来看httpsb23tv3ggXkIA，包括评论区的up笔记也会对视频内容进行补充，如果给您造成了不良观感，给您道歉希望这两期视频对你能有帮助;2;16;18;18388;0.0009788992821405265
11385;怎么C网站一下子就进不去了;1;1;2;18388;0.00010876658690450294
11390;起真早哦呼;1;0;1;18388;5.438329345225147e-05
11396;第一步就完蛋CIVITAICOM网站登不上去手机用流量能上流放编年史也登不上听说要SSL证书;7;1;8;18388;0.00043506634761801175
11406;有个问题，明明在词典上存在的tag，我用标上加权了也不执行，拿我的指令当放屁辣眼睛;1;1;2;18388;0.00010876658690450294
11410;这只要出现了，就一定会商业啊;1;1;2;18388;0.00010876658690450294
11414;ai进化真快啊以前奇形怪状的现在社保的色图都能做出来了;2;4;6;18388;0.0003262997607135088
11417;为什么秋叶大佬说后坠为pt的文件要放在lora文件夹里，跟你说的不一样，能不能出一期各种模型下载放入文件夹使用出图的教程;2;1;3;18388;0.0001631498803567544
11420;秋叶dalao是真的b站活佛啊大家记得关注三连啊;1;3;4;18388;0.00021753317380900588
11423;Ai作图虽然很干净，但是没有灵魂，所以不耐看。手动画画的画师会千方百计让自己的图更好看更完美，因此仔细看会发现很多细节;1;1;2;18388;0.00010876658690450294
11428;Ai绘画刚火起来的时候有人就说过这解放了劳动力，以后依靠创意就可以了，全民创作的时代要来了。说实话，绘画本身就是一种创作，以后不管是绘画还是故事，包括影视剧电影，但凡是和设计相关，都能够分解成为几个关键字。Ai从某些角度使用确实是减轻工作难度的工具，但如今大多数人会怎么使用它呢？或许大家以后都可以等着别人的创作，然后将关键字输入Ai之中。很难想象在这样的发展趋势下，究竟是谁受益了？消费者还是创作者？一切发展都要以人为本，奈何科技是一把双刃剑。如果使用不当，很容易造成不可挽回的损失。;2;1;3;18388;0.0001631498803567544
11433;不抵制ia绘画，那以后你648的纸片老婆都是ia画的量产图，一周出一次新的ia纸片老婆甚至一天出一次新的ia纸片老婆，然后搁着天天更新ia纸片老婆皮肤，即使成本降下来了但是资本为了赚钱可是不会降价格的，看你有没有钱、愿不愿意买不买吧嗑瓜子;7;1;8;18388;0.00043506634761801175
11441;lora的网址也没放到评论区啊搜索lora出现很多条目也没说具体哪个条目下载不是说辛辛苦苦做教程不好，确实做的很急躁，对于我这种急于学会的看的真是又急又不知道怎么办;2;0;2;18388;0.00010876658690450294
11448;尾缀safetensors的到底是放到哪个路径啊01：29，1和3都写了safetensors;1;0;1;18388;5.438329345225147e-05
11451;只有一个问题，下载好的lora怎么安装，安装到哪，打开sd后又怎么加载，视频因为没有鼠标指示，看不清;1;0;1;18388;5.438329345225147e-05
11455;很好的教程，一个教程出来难免有细节上的少许错误，何况是一个新玩意的教程，老师并不是需要全都懂，对所有事物都有完全认知的人是不存在的，所以能以一个好的出发点，将知识分享给需要的人就可以称之为是老师。至于AI的未来的应用也不要悲观和魔怔，工具本身是中立性的，技术的发展只会越来越普适，AI绘画就是叫AI绘画，因为AI有很多种，NovelAI是绘图的，CatGTP是聊天的，所以这个教程里含AI绘画的标签是没问题的，但是不能含有不带AI的绘画标签。不要觉得AI绘画能代替画师，因为AI绘画是面向结果的，中间过程不可控，并且商业化是需要负责人的，AI无法作为法律意义上的负责人，目前说AI绘画不可商用是因为模型都是网络资源训练没有版权，但如果是公司用自己的资源训练一个自己的模型集，那很可惜，大概率是可以商用的。就拿其他AI举例，AI剪辑只是辅助了剪辑师的部分工作，没有取代剪辑师；AI配音只是方便了普通人，没有取代配音员；AI写作只是辅助了作家，没有取代作家；就连人类无法战胜的AI下棋，你觉得下棋是输赢重要？还是过程中要？难道有了AI人就不下棋了吗？所以目前的AI绘画的定位个人感觉是用于辅助创作的，可以开拓人的想象，因为AI无法完全生成你想象中的画面，人与人沟通都可能会出现偏差，更何况是人与机器。没有任何人会因为工具取代了一部分人的工作，出于可怜而阻止那个为人们带来便捷工具的发展，更何况那一部分人敌意很强。同理也没有任何人会因为工具的发展而放弃自己的生活，因为工具也能带给自己便捷，减轻原有负担的同时可以去做更多的活。所以一项技术能够大众化是最好的，请不要把一项技术逼成一小部分人的专权，不然你们说的悲剧未来，就有可能成为现实，只有将技术门槛拉倒最低，人人都能从中受益，那才是光明的未来。;1;1;2;18388;0.00010876658690450294
11464;建议重新做一期，1弄个鼠标点击标记的插件，不然不开弹幕根本不知道你说的是哪里2逻辑再考虑一下，例如lora的安装你不放在前面说就不要在讲，我还以为是我下载的有问题界面和你不一样重新下了10多G的文件。;1;0;1;18388;5.438329345225147e-05
11467;AI绘画刚开始看很惊艳，看多了就觉得没灵气了;16;2;18;18388;0.0009788992821405265
11490;之前玩过，ai画不露手的半身像或者头像还是很好看的，或者纯场景，非常梦幻。但只要露手，除非你会p图，不然画完全不能看，因为你会格外注意画面里扭曲的手指;3;2;5;18388;0.00027191646726125733
11494;话说可以让ai学习很多张本地图片，然后再安装这个图来确定风格和细节么？我只看到有图生图小电视笑;4;2;6;18388;0.0003262997607135088
11504;up生成一张图要多久，我生成一张图要半个小时正常吗;5;0;5;18388;0.00027191646726125733
11517;请问至少需要电脑是什么配置呀;1;0;1;18388;5.438329345225147e-05
11523;up这种ai绘画软件断网能使用吗;1;0;1;18388;5.438329345225147e-05
11533;我会科学上网，也不需要汉化，就是想要下载一个好用的ai作画软件，请问需要搜索哪个名字？;1;0;1;18388;5.438329345225147e-05
11537;我以为只要输几个关键词就能出图呢，怎么这么麻烦？;2;0;2;18388;0.00010876658690450294
11540;ai绘画配置一般得多高才能正常游玩啊;10;0;10;18388;0.0005438329345225147
11554;求助求助，我想知道如果生成了，一张非常合适的脸。如何用这张脸来做其他的图，如何用这张脸的来做其他的表情？如何做这张图的三视图？;3;0;3;18388;0.0001631498803567544
11558;不会英语是不是就没法玩ai绘图了;3;0;3;18388;0.0001631498803567544
11563;lora没有模型是要去下吗;4;0;4;18388;0.00021753317380900588
11585;amd显卡能用吗;1;0;1;18388;5.438329345225147e-05
11588;up我想问下有些Lora文件像模型一样有几个G那么大，但是作者还给了触发词，这样的算是模型还算是Lora文件呢？;1;0;1;18388;5.438329345225147e-05
11594;已经三连两币，请问我这个头像能生成喝酒的剑客类似ai图吗;1;0;1;18388;5.438329345225147e-05
11599;小白想问下各位大佬，ai作图对电脑配置有什么要求吗，特别是显卡内存之类的;4;0;4;18388;0.00021753317380900588
11606;下载过试过很多模型，总的来说让他们（文生图）自己生成全身图，各种动作成功率真的低（所以只能图生图）;1;0;1;18388;5.438329345225147e-05
11617;即使所有参数和tag都一样，也不见得就会得到一模一样的结果，ai在运算的过程中本身就有随机的成分，它不是一个固定程式，只要输入A，就必定得到B。就像画家即使重复画同一个内容，每次画出来的结果也不可能是完全一样的。就连拿同样的问题去问chatGPT，它每次给到的回答也不是一字不差的;1;0;1;18388;5.438329345225147e-05
11622;问一下大伙现在它会画手指了吗;4;1;5;18388;0.00027191646726125733
11631;当学个新软件，但是建议在“画出”加个双引号，而且这个也不能当做“自己的”作品思考;29;108;137;18388;0.007450511202958451
11677;AdditionalNetworks里点了启动，但Model1里还是只有无怎么办？其他已经按照视频教程一步一步做了;2;1;3;18388;0.0001631498803567544
11680;喜剧效果拉满哈哈哈哈哈;1;0;1;18388;5.438329345225147e-05
11727;看了视频，我好难受，ai发展太快了，我不知道以后能去干什么了，学了这么多年的东西，比不过ai一秒生成的，现在就连摊煎饼的都有机器代替了，好无奈，我以后能干什么呢？都找不到人倾诉，好孤独好迷茫;6;0;6;18388;0.0003262997607135088
11743;我的lora插件下显示没有模型，求问是如何解决;1;0;1;18388;5.438329345225147e-05
11746;我2060跑了一下，主机直接闪了笑哭，还有一股焦味，是电脑有问题还是我软件的问题，目前在联系客服发回去;3;0;3;18388;0.0001631498803567544
11791;这跟画有啥关系，是调;1;0;1;18388;5.438329345225147e-05
11795;AI来了我们普通人怎么办？一旦失业，不拿它来牟利，饿了啃手指头吗？;1;0;1;18388;5.438329345225147e-05
11803;A卡是否无法使用novelAI？;1;0;1;18388;5.438329345225147e-05
11818;感谢大佬;1;0;1;18388;5.438329345225147e-05
11843;画画人赶紧学了用起来吧。以后这个指定就是主流辣。冲这个还不如多练练基本功，免得调不来ai的图，新时代要来力。;1;0;1;18388;5.438329345225147e-05
11862;有没有办法给出一张肖像照片，然后利用这张肖像照生成特定美术风格的画。比如我想让AI画一张GAT5风格的高启强，我下载安装好了GTA5的模型。然后也有了高启强的照片。接下来需要怎么整;3;0;3;18388;0.0001631498803567544
11888;up发油管吧;1;0;1;18388;5.438329345225147e-05
11893;那么问题来了，黑丝的关键词是什么？;1;0;1;18388;5.438329345225147e-05
11895;其实真正在厂里工作的画师并不急，因为公司高层在ai出现的时候已经研究一遍了，同时给各个研发组的美术部门开了一门公开课：ai并不成熟，并且如果没有相应的立法跟上，AI生成的图是不能直接用于商用的，只能用于参考和找灵感。所以真的小画师并不急，AI也确实在学习，而无知的人确实很急doge;1;0;1;18388;5.438329345225147e-05
11903;up大大，麻烦问一下，这个适用于苹果系统吗？;1;0;1;18388;5.438329345225147e-05
11909;谁能分享秋叶的整合包给我doge;1;0;1;18388;5.438329345225147e-05
11911;生成最大尺寸是根据显卡的速度还是内存决定吗;2;0;2;18388;0.00010876658690450294
11921;秋叶那里没有下载链接啊，是取消了吗？？？;1;0;1;18388;5.438329345225147e-05
11939;AMD显卡可以吗？;1;0;1;18388;5.438329345225147e-05
11948;学AI绘画的动力还是当时为了随便给小说搞个封面，在网上随便找了个并不出名的画手。结果张口一幅画就要1200。虽然不知道正常行情应该是什么价格。但是对于普通人来说确实有点离谱了。后来网上认识几个学艺术的。说是可以帮我画，但是最后又是放鸽子又是甩脸色。现在看到画手的低端产业像当年的翻译一样，被冲击成这样。怕被喷，就不做评价了。;2;0;2;18388;0.00010876658690450294
11962;个人理解，绘画是审美和画技，其中通过反复练习得到的ai能替代的是画技，而审美才是创作，p站上带ai绘画标签，好看的图基本都是经过人工反复调整精修的，和那种输两个关键词就一键生成的低质量图片差距还是很明显的。所以靠ai来创作其实也是有门槛的，毕竟有时候培养审美比练习画技还难，只会输关键词的人其实不算拿ai创作，只是相当于打开ps拿各种各样的笔刷乱涂乱画的程度画师这个职业不会被取代，只是从重视画技偏向到重视审美;1;0;1;18388;5.438329345225147e-05
11964;请问生成过程是彩色，生成完就是灰色咋回事？;2;0;2;18388;0.00010876658690450294
11969;各位用什么卡绘的？1660super够不够用;3;0;3;18388;0.0001631498803567544
11978;wonderful，可能有些人反对AI绘画，然而画漫画的可能变成了AI，可讲故事的仍然还是人类自己，创意比技巧更重要的时代来临了;1;0;1;18388;5.438329345225147e-05
11987;up主什么显卡？我的跑的太慢了;1;0;1;18388;5.438329345225147e-05
11992;有没有可以用手机画的呢;1;0;1;18388;5.438329345225147e-05
11994;还好还好，我是昨天晚上才下了秋叶的整合包。;7;0;7;18388;0.0003806830541657603
12006;c站上有些没放tag信息的图片该怎么找大哭好喜欢这张就是弄不出来这个风格的下载放图片信息识别不出来;6;0;6;18388;0.0003262997607135088
12014;并且，这场争论主要指拿ai出来在做商业行为在讨论，自娱自乐的ai玩家没必要站出来，毕竟没威胁到你饭碗。还有，这拼的是最后作品吗，拼的是生成文案吧吃瓜;1;0;1;18388;5.438329345225147e-05
12017;老師怎麼在C站下載LORA，我點下載只下載到onePieceWanoSagaStyle20safetensors這個文件;1;0;1;18388;5.438329345225147e-05
12020;学习到了，感谢up，已三连，另外，还好周末画了一天时间来研究，下载了整合，不然想提前体验下这项新技术都吃不到热的笑哭;1;0;1;18388;5.438329345225147e-05
12026;不懂就问，科研绘图能用嘛;2;0;2;18388;0.00010876658690450294
12031;感觉ai没啥问题主要的问题还是其实从下模型开始用户就已经是挑选了别人做好的风格框架，，，这东西用多了会困在自己目前已有的审美茧房里;2;0;2;18388;0.00010876658690450294
12034;那个checkpoint怎么搞啊？;2;0;2;18388;0.00010876658690450294
12041;lora是不是跟不同的模型都可以用还是说只适合一种模型呢;1;0;1;18388;5.438329345225147e-05
12043;僵局不急快过来学习最新的ai绘图，这样你的抖音素材就不用发愁了;2;0;2;18388;0.00010876658690450294
12050;要是感觉费劲生气直接找个AI读文本不完了，何必受罪呢？;1;0;1;18388;5.438329345225147e-05
12068;上热门是因为学绘画的都要进来踩一脚吧，我也是脱单doge脱单doge;2;0;2;18388;0.00010876658690450294
12075;谢谢up主了，挺详细的;1;0;1;18388;5.438329345225147e-05
12080;没办法图生图，ai出来的都是跟图片无关联的，只跟tag有关联，请问怎么解决？;1;0;1;18388;5.438329345225147e-05
12092;我的界面出不了lora好奇怪用的话可以在tag里带lora，但是总感觉没你这个方便不知道怎么搞出来;1;0;1;18388;5.438329345225147e-05
12107;为什么lora没mod笑哭;1;0;1;18388;5.438329345225147e-05
12117;下的秋叶资源，就是无法打开网络，很尴尬;2;0;2;18388;0.00010876658690450294
12120;建议b站搜赛博coser，以后coser比画师更急给心心;1;0;1;18388;5.438329345225147e-05
12124;up，我只想问一句，mac可用否笑哭;2;0;2;18388;0.00010876658690450294
12130;lora文件下下来咋装捏？？？喜极而泣;1;0;1;18388;5.438329345225147e-05
12132;怎么说呢，ai目前在商业应用上面还是要人来修改辅助，不然很容易出破绽，比如手脚衣服透视上，加上产出100张图也不一定能保证画风和场景动作是百分百还原需要的，所以目前为止还是需要美工去进行加工笑哭不过就不知道在之后的发展会怎么样了;1;0;1;18388;5.438329345225147e-05
12146;up请问在cicitai标签显示是lora、后缀是safetensors、体积为一百多MB的文件，这个应该放lora的文件夹还是ckpt的文件夹;1;0;1;18388;5.438329345225147e-05
12159;等我学会了，就想办法去搞自己喜欢的角色的本子。说到底还是自己喜欢的角色太冷门，画画生产力太低;1;0;1;18388;5.438329345225147e-05
12162;想请问一下，Lora插件装好之后文生图那里的AdditionalNetworks一栏加载不出Lora的model，该怎么办呢脱单doge;1;0;1;18388;5.438329345225147e-05
12166;还就那个“自己的图”大笑;4;0;4;18388;0.00021753317380900588
12171;up主你好，我有点不明白lora和模型文件的关系。比如你视频中，你加载了一个玛琪玛的lora，但主页左上角也默认有一个模型文件在的呀，那么这时候lora和模型之间是怎样的关系，会生成玛琪玛还是默认的模型？;2;0;2;18388;0.00010876658690450294
12178;要是想生成非二次元，贴近现实人物的图怎么搞？;2;0;2;18388;0.00010876658690450294
12190;自动化导致工人失业就不应该继续了吗？;7;0;7;18388;0.0003806830541657603
12200;优秀的画师会成为AI学习的方向，所以水平够用的根本不担心被取代，只会被学习;3;0;3;18388;0.0001631498803567544
12208;大佬为啥我训练出来的都是动漫不是真人;2;0;2;18388;0.00010876658690450294
12214;问一下1280配几好那个高分辨率修复实在不想用太慢;1;0;1;18388;5.438329345225147e-05
12218;这几天找时间试试;1;0;1;18388;5.438329345225147e-05
12221;都没说怎么安装，还零基础？;1;0;1;18388;5.438329345225147e-05
12226;我6G内存的极限分辨率就是512640，想给手机跑个清晰的壁纸都不行捂脸;8;1;9;18388;0.0004894496410702633
12241;请问大佬生成图片错误，无法生成图片，这是什么原因呀？RuntimeErrorCUDAoutofmemoryTriedtoallocate12800MiBGPU0400GiBtotalcapacity136GiBalreadyallocated7261MiBfree140GiBreservedintotalbyPyTorchIfreservedmemoryisallocatedmemorytrysettingmaxsplitsizembtoavoidfragmentationSeedocumentationforMemoryManagementandPYTORCHCUDAALLOCCONF;2;0;2;18388;0.00010876658690450294
12244;秋叶大佬doc启动器显示以下内容，请问要如何解决呢raiseRuntimeErrormessageRuntimeErrorCouldntinstallopenclipCommandEnovelaiwebuipy310pythonexempipinstallgithttpsgithubcommlfoundationsopenclipgitbb6e834e9c70d9c27d0dc3ecedeebeaeb1ffad6bpreferbinaryErrorcode1stdoutCollectinggithttpsgithubcommlfoundationsopenclipgitbb6e834e9c70d9c27d0dc3ecedeebeaeb1ffad6bCloninghttpsgithubcommlfoundationsopenclipgittorevisionbb6e834e9c70d9c27d0dc3ecedeebeaeb1ffad6btocusersadministratorappdatalocaltemppipreqbuildb3fzy4stderrERRORErrorWinError2whileexecutingcommandgitversionERRORCannotfindcommandgitdoyouhavegitinstalledandinyourPATHnoticeAnewreleaseofpipavailable22312301noticeToupdaterunEnovelaiwebuipy310pythonexempipinstallupgradepip;1;0;1;18388;5.438329345225147e-05
12249;up的schoolmax的vae在哪儿下的呀笑哭;1;0;1;18388;5.438329345225147e-05
12253;建议改一下封面和标题，点进来之前还以为是卖课的笑哭;1;0;1;18388;5.438329345225147e-05
12264;家人们动动小手点个举办嗷给心心给心心;4;17;21;18388;0.0011420491624972808
12270;转身看CG刚兴起时，传统纸绘抨击电脑绘画是作图不是艺术，现在不过是新的一轮更替而已;22;52;74;18388;0.004024363715466608
12293;惊动了好多绘圈（倦）的小工啊吃瓜;1;14;15;18388;0.000815749401783772
12295;学习了，感谢，很多画手都挺反感AI的，毕竟抢饭碗，不过我倒觉得挺好的，用好了就是辅助工具，比人肉渲染省事省力。我在想，能不能把自己画的线稿让AI自动帮我上色？？吃瓜;5;14;19;18388;0.0010332825755927778
12303;希望画画的人可以专心追求自己的艺术，玩AI的人可以好好利用AI生成自己喜欢的图片，不需要争吵，专心做自己觉得有意义的事吧。;4;9;13;18388;0.0007069828148792691
12308;美院油画专业，也卖过不少画，我很欢迎ai的加入，有些人急是因为本来套着艺术外壳的智商税现在收不到了，对于真正搞艺术的人来说ai超过了以往所有工具的变迁，是十分好用的，帮助艺术家节省了大量的体力，也可以少走很多弯路，获得很多灵感。;24;54;78;18388;0.004241896889275614
12333;做出ai作品不是画出。。。;17;160;177;18388;0.00962584294104851
12352;作为一个AI绘图的前辈，我必须要说，问题已经不算AI绘图精致和多元这2块了，现在问题是你的想法能不能跟上AI绘图的脚步;4;5;9;18388;0.0004894496410702633
12357;无语;1;2;3;18388;0.0001631498803567544
12359;ai不要标绘画区;32;290;322;18388;0.017511420491624973
12393;意义何在;9;3;12;18388;0.0006525995214270176
12403;程序员作家画家编剧在未来三十年都会一大部分被替代;1;2;3;18388;0.0001631498803567544
12405;从板绘转到ai绘了，有点可惜，自己画画注定只能当个爱好了辣眼睛;5;3;8;18388;0.00043506634761801175
12411;mdzz，视频录完了才发现我开的这个obs没有把我的鼠标给录进去笑哭笑哭不过我视频里面讲的很慢，也很清楚了，搭配着看，应该能看懂的tv笑哭;3;85;88;18388;0.004785729823798129
12416;1648我就好这口大笑抓狂生气哈欠大哭惊讶喜欢;1;1;2;18388;0.00010876658690450294
12418;绘圈震怒没米赚了;5;6;11;18388;0.0005982162279747662
12424;评论区里一堆说绘画圈被爆杀了的人不知道是什么三观，，，真正赋予绘画意义的从来都是绘画的过程，而这一过程是极其私人的体验，而无数艺术家之所以能够创造出新的东西也得益于此;21;14;35;18388;0.0019034152708288013
12446;正片叠底和颜色减淡都是数字ai的前身早期传统美术也是这么抵制板绘的tv呕吐;6;12;18;18388;0.0009788992821405265
12454;当小画师在抵制ai时，ai在学习;45;89;134;18388;0.007287361322601697
12500;艿子大就是好看doge;10;513;523;18388;0.02844246247552752
12511;挺好看的，就是衣服有点多;3;106;109;18388;0.00592777898629541
12515;大哥们，最新一期我把我最喜欢的图包贡献出来了，希望哥哥们点点赞;10;137;147;18388;0.007994344137480966
12526;姑娘，这样会冷的吧，我来帮你捂一捂，帮你挡住冰冷的雪花脸红，要是还冷不妨来寒舍暂住一晚给心心脱单doge;4;105;109;18388;0.00592777898629541
12531;说太大不协调的，是没见过真正画的离谱的，这种在se图里算刚好滑稽;1;10;11;18388;0.0005982162279747662
12533;以后的漫画直接用AI生成。这样的女主角吃瓜一天会爆更100章也不在话下了;9;124;133;18388;0.007232978029149445
12543;httpspanbaiducoms1i8iIe5v7JMrngB2wCLMDSA提取码：1xe3把横线去了;17;99;116;18388;0.00630846204046117
12561;她就是人间的美好胸怀着远大的理想真知灼见心摹手上大千世界不负于她;2;98;100;18388;0.005438329345225147
12564;奶白的雪子;1;7;8;18388;0.00043506634761801175
12566;歪日，这BGM越听越难听，建议关闭音乐播放;9;59;68;18388;0.0036980639547531
12576;北柯皆非王苤茢摆烂天才发抖擅长捉弄的张飞同学孜然丶Z吃兔子的白狼TonyT;2;4;6;18388;0.0003262997607135088
12579;太大就没有美感了但是我喜欢doge;1;28;29;18388;0.0015771155101152925
12581;感觉这些画和十几年前知音啊，故事会啊封面的画好像啊;4;25;29;18388;0.0015771155101152925
12589;链接不行啊;1;0;1;18388;5.438329345225147e-05
12591;显示文件分享被取消了;1;0;1;18388;5.438329345225147e-05
12593;抵制ai作画;2;3;5;18388;0.00027191646726125733
12598;doge哪几个模型啊我蠢蠢欲动了;1;2;3;18388;0.0001631498803567544
12603;我在抖音发这么大的，号被封了笑哭;1;3;4;18388;0.00021753317380900588
12606;靠，同事居然看著我手機說：還小，還有成長空間。doge;2;1;3;18388;0.0001631498803567544
12677;不够涩;1;0;1;18388;5.438329345225147e-05
12687;up可以动态发一下原图吗;1;0;1;18388;5.438329345225147e-05
12735;古人营养不良哪里有那么大的奈奈doge;1;0;1;18388;5.438329345225147e-05
12738;错子不奶dogedoge;1;0;1;18388;5.438329345225147e-05
12748;真勤啊up;1;2;3;18388;0.0001631498803567544
12758;这是人还是写真呢？;1;1;2;18388;0.00010876658690450294
12771;如果ai绘图被广泛认可了可以说人类就会迎来一次思维退化同时也证明了直接利益可以代替深度追求以后各个领域的事件会越来越多人变成不会思考没有追求的溺水猪的时代也就指日可待了;350;4750;5100;18388;0.2773547966064825
13122;一开始都以为是版权，结果现在最先出问题的反而是另一方面的道德问题，比如那个女仆趴，比如那群卖ai图包的，当人们还在考虑一个新技术在伦理上是否可行时，另一群人们早已用它突破了道德的底线藏狐;47;2515;2562;18388;0.13932999782466826
13170;AI最可怕的并不是量大，而是管饱。哪怕从业者或者阅图量大的业余画师都能一眼看出AI作图，但是绘画作品主观价值往往由受众决定。也就是说，画师审美只能提高作品质量，但是喜不喜欢还是得由观众来决定。然而更可怕的是观众的审美往往达不到画师的水平，AI拙劣的图已经足够塞饱他们的眼球，他们也没有画师一眼能看出AI的审美水平和需求。;209;1966;2175;18388;0.11828366325864695
13380;只能加油了，在这里甚至会被ai小画家冲辣眼睛;41;759;800;18388;0.04350663476180117
13422;学好马克思，引导人类进步的是“生产力”和“生产分配关系”两条线，仅仅提高生产力带来的是“垄断寡头”;132;1332;1464;18388;0.07961714161409615
13555;支持ai随意使用作品做训练集侵权的。想象一下中国国产大型单机游戏吧。一样的道理。在大众没有觉醒之前。是会断代甚至永无翻身之日的。ai滥用一定会导致创作者的减少从而导致行业无法良性循环。至于什么说热爱的，你们不会懂所谓热爱是需要基础的，不是你有心就能的，当你的一切都被推翻，被剽窃，被肆意践踏，你还能对这个世界抱有希望的话，你大概就是圣人吧。;252;1275;1527;18388;0.083043289101588
13808;有一句话我觉得说的特别对，“社会不惩罚坏人，只惩罚蠢人”。支撑我发这么多AI相关的评论评论的动力真不是什么画师利益，就是这帮网民实在是太呆了。就下边这还有个马车夫呢。你起码先知道知道AI是啥好吗，画画是生产图像，AI是把已经生产出来的图像再去加工，这么明显的两码事有啥不明白的。AI不是自动画画机，就好像外卖员不是自动做饭机，他给你那个饭是从别处取的，明白了吗。;279;2084;2363;18388;0.12850772242767022
14088;我本人对前景并不是很看好，因为就在前几天，我去成都出差的教授回来之后跟我们说，成都遍地的大小外包公司全在研究AI，这是个很恐怖的事情，至于大厂会不会也在这么做，我觉得肯定是会的，因为训练AI和制作模型的成本太低了，甚至目前来看比三渲二低的多，很多人说出台AI限制的文件肯定会越来越多，但是我并不觉得这有什么作用，画师完全可以Ai出完图自己调整细节，当年JB搞photobash的时候直接拿照片拼图最终调整之后都没人看得出来，现在3A大厂更是直接普及了photobash，也没见怎么样，AI绘图最大的优势在于有能力的画师出完线稿就可以给AI自动上基色和笔刷（大概会节省30左右的时间），然后再手动调整细节，这一套流程过后你根本看不出来他用没用AI（比如白夜极光那个图，要不是脚画反了加上背景液化一笔没动，基本上看不出来是AI），正因如此，AI普及并不等于不需要画师了，而是会加剧马太效应，大佬和有审美的画师完全不用AI，或者用AI可以如虎添翼，一周出好几张图，而低端画师就只能望着这些发愁，然后花更多时间提升自己甚至转行;74;1092;1166;18388;0.06341092016532521
14163;没事的，现在只是ai和画师的对立，他们觉得ai好，他们没想过，连艺术都能被ai取代，那有多少其他行业能不被取代嘛，但凡是有规律就可以运行的职业都可以被取代，你以为程序员就不会被取代嘛，程序也是一种规律;97;479;576;18388;0.03132477702849685
14261;如果ai绘图被广泛认可了可以说人类就会迎来一次思维退化同时也证明了直接利益可以代替深度追求以后各个领域的事件会越来越多人变成不会思考没有追求的溺水猪的时代也就指日可待了;350;4752;5102;18388;0.277463563193387
14612;一开始都以为是版权，结果现在最先出问题的反而是另一方面的道德问题，比如那个女仆趴，比如那群卖ai图包的，当人们还在考虑一个新技术在伦理上是否可行时，另一群人们早已用它突破了道德的底线藏狐;47;2516;2563;18388;0.13938438111812052
14660;AI最可怕的并不是量大，而是管饱。哪怕从业者或者阅图量大的业余画师都能一眼看出AI作图，但是绘画作品主观价值往往由受众决定。也就是说，画师审美只能提高作品质量，但是喜不喜欢还是得由观众来决定。然而更可怕的是观众的审美往往达不到画师的水平，AI拙劣的图已经足够塞饱他们的眼球，他们也没有画师一眼能看出AI的审美水平和需求。;209;1967;2176;18388;0.1183380465520992
14870;只能加油了，在这里甚至会被ai小画家冲辣眼睛;42;760;802;18388;0.04361540134870568
14913;学好马克思，引导人类进步的是“生产力”和“生产分配关系”两条线，仅仅提高生产力带来的是“垄断寡头”;132;1333;1465;18388;0.0796715249075484
15046;支持ai随意使用作品做训练集侵权的。想象一下中国国产大型单机游戏吧。一样的道理。在大众没有觉醒之前。是会断代甚至永无翻身之日的。ai滥用一定会导致创作者的减少从而导致行业无法良性循环。至于什么说热爱的，你们不会懂所谓热爱是需要基础的，不是你有心就能的，当你的一切都被推翻，被剽窃，被肆意践踏，你还能对这个世界抱有希望的话，你大概就是圣人吧。;252;1275;1527;18388;0.083043289101588
15299;有一句话我觉得说的特别对，“社会不惩罚坏人，只惩罚蠢人”。支撑我发这么多AI相关的评论评论的动力真不是什么画师利益，就是这帮网民实在是太呆了。就下边这还有个马车夫呢。你起码先知道知道AI是啥好吗，画画是生产图像，AI是把已经生产出来的图像再去加工，这么明显的两码事有啥不明白的。AI不是自动画画机，就好像外卖员不是自动做饭机，他给你那个饭是从别处取的，明白了吗。;279;2085;2364;18388;0.12856210572112248
15579;我本人对前景并不是很看好，因为就在前几天，我去成都出差的教授回来之后跟我们说，成都遍地的大小外包公司全在研究AI，这是个很恐怖的事情，至于大厂会不会也在这么做，我觉得肯定是会的，因为训练AI和制作模型的成本太低了，甚至目前来看比三渲二低的多，很多人说出台AI限制的文件肯定会越来越多，但是我并不觉得这有什么作用，画师完全可以Ai出完图自己调整细节，当年JB搞photobash的时候直接拿照片拼图最终调整之后都没人看得出来，现在3A大厂更是直接普及了photobash，也没见怎么样，AI绘图最大的优势在于有能力的画师出完线稿就可以给AI自动上基色和笔刷（大概会节省30左右的时间），然后再手动调整细节，这一套流程过后你根本看不出来他用没用AI（比如白夜极光那个图，要不是脚画反了加上背景液化一笔没动，基本上看不出来是AI），正因如此，AI普及并不等于不需要画师了，而是会加剧马太效应，大佬和有审美的画师完全不用AI，或者用AI可以如虎添翼，一周出好几张图，而低端画师就只能望着这些发愁，然后花更多时间提升自己甚至转行;74;1092;1166;18388;0.06341092016532521
15654;没事的，现在只是ai和画师的对立，他们觉得ai好，他们没想过，连艺术都能被ai取代，那有多少其他行业能不被取代嘛，但凡是有规律就可以运行的职业都可以被取代，你以为程序员就不会被取代嘛，程序也是一种规律;97;479;576;18388;0.03132477702849685
15752;现在很多模型作者也发现风向不太对劲了，比如chilloutmix的作者就把模型全权给了c站，之前很火的koreandoll的作者也把几个系列模型都删除了，还有虚拟周姐的事。洗稿的，说模型源头画师的画是ai作品的，用真人模型搞欺诈，高价卖ai图包的。新技术带来的道德滑坡越来越显眼。很多人喜欢用宏大叙事的角度来批判画师和艺术家，然而这个世界根本上不存在什么宏大叙事，社会和历史都是连续的，是人民一步一个脚印走过来，创造出来的。而且大多数画师反对的不是ai技术本身，而是ai带来的无止境的侵权困局，没有人能够保护受害人的权益。很难想象被ai引用最多的那些画师心里的滋味（随便逛逛c站就知道了，有些模型的风格真是一眼就能认得出用了那些画师的图）。;68;1623;1691;18388;0.09196214922775724
15821;视频讲的挺好的，真正的问题就是：由于过于肆无忌惮的炼炉和图生图洗稿，有些老手，可能也正在逐渐失去对于精益求精的热情，新人学习进步的动力受阻，还要面对这么大的一个诱惑，到是那些副业专家相当的兴奋。;23;469;492;18388;0.026756580378507724
15845;doge然而中国对于版权真的是可有可无的感觉doge;41;990;1031;18388;0.056069175549271266
15887;啊啊，，西方世界的反抗明显动静大多了，也希望世纪之战最终是以艺术家们胜利得以告终吧保卫萝卜哭哭;117;655;772;18388;0.04198390254513813
16005;我想Ai圖我是註定不能接受了，純手繪才是我最喜歡的，如果只是拿Ai輔助，整張圖還是有6090以上是畫師用手繪畫的還勉強能接受，但再過去就不行了既然科技要如此發展，那我只能期待這發展迅速的科技能儘快研究出腦繪科技並普及，讓大家能真正意義上的腦袋想什麼就畫什麼了，這才是真正可能取代手繪的科技;42;254;296;18388;0.016097454861866433
16048;讲的很棒，就觉得AI现在路子走歪了翻白眼;70;414;484;18388;0.02632151403088971
16119;当ai被用在凸显人类艺术文化精神的领域时，其存在本身就是矛盾的。;66;519;585;18388;0.03181422666956711
16186;副业专家是最可怕的，因为有很多可能是你曾经的老板，在他们眼中，你的图和ai没差笑;12;300;312;18388;0.016967587557102457
16199;终于见到一个能把实际上ai绘图涉及到的法律问题讲出来的视频了，之前老是能看到对线双方就搁那复读侵权的，都不知道在对什么，很多人说已经有判决了，但实际上都不知道现在在打什么官司。。我是觉得这案子很难打赢的。原告诉求的关键点其实是炼丹对原作品的使用行为侵权而不是作品侵权，作品侵权的判定和ai是没有关系的。所以为什么要提过拟合，因为过拟合就意味着ai产出的作品是必然导致“作品侵权”的，但我们也知道过拟合属于可以被避免的情况，它并不能用来论证ai模型的侵权问题，当然也和训练行为没有关系。因为即便论证了所有的ai作品都有过拟合的问题，也无法对训练行为的定性造成影响。再者为啥要提“从模型中还原数据”，一个是证明“使用行为确实存在”，不过我不知道就目前而言商业公司是否有义务直接披露其使用的数据集，且说不定训练数据集的举证责任还会倒置，只是可能。抛开这点还有一个是说明其公开的模型包含了对原作品全部或部分的展示，这个则构成了“模型”这个计算机软件对美术作品的一种未授权使用。但我们依然很清楚ai模型包含原数据仍然是一种技术上可避免且应该（不论从谁的角度看都应该）避免的失误。最后就是最核心的问题，假设已经证明了ai训练的数据集包含了未授权作品，那么这种“训练”行为能不能够构成侵权我不怎么能理解被告律师要从“合理使用”之外再找一个新的概念来描述它，当然我们仅从合理使用的要素去看，美国的合理使用制度适用国际上常用的（我们国家理论上适用）三部检验法，而检验第一步就是“该行为是否构成侵权”，用版权法本身的原则性规定，fair。use也需要判断“与该完整作品相比其使用原作品的质和量”，但是问题在于，训练行为本身根本不涉及到对原作写了好长啊。。楼下继续;63;248;311;18388;0.016913204263650207
16263;建议观看，;10;366;376;18388;0.020448118338046554
16274;“ai分析的是像素之间的排列规律，并不是理解其结构”up这句真是说到点子上了练模型的时候深有体会;15;213;228;18388;0.012399390907113336
16290;辣眼睛他们甚至不允许学了一辈子绘画的人以绘画获取正当工资。气死我了，画师的心血凭什么被那种按规定点上去的色块取代;10;122;132;18388;0.007178594735697194
16301;支持AI的别说爱画画就别老想着搞钱什么的。搞画画很费钱费时间，没钱挣没几个人会全身心投入，因为人需要吃饭。地球ol很残酷。画师想追逐梦想也要先保障自己的存活。最后，艺术这种东西本来就是人类的“专利”微笑;12;131;143;18388;0.00777681096367196
16314;只要这落后的分配方式不改进，生产技术越高，这世界越像地狱。以前是20的人夺走80的利益，以后就是20的人消灭80的人。;29;269;298;18388;0.016206221448770937
16344;有些人混淆视听有一手的，我们抵制的是AI吗？我们抵制的是没有法律管控的AI，所以我们的诉求只是更新相关法律，而不是直接把AI拍死，就这件事真的可以看到没有相关法律管控人类的道德下限到底是多么深不见底，我可忘不了之前有画师直播绘图，然后有人拿去喂AI，跑出整张图后反手告画师抄袭这件事保卫萝卜白眼;1;19;20;18388;0.0010876658690450293
16347;科技进步人类物种多样性道德低下性大展示;8;363;371;18388;0.020176201870785296
16356;画师技术垄断都出来了，画师拦着你不让你学画画了星瞳流汗;50;273;323;18388;0.017565803785077223
16407;画师已经麻了，本来国内游戏原画就被挤兑的很难了，现在岗位缩减更多，外包单价压低不少，已经都开始招ai作图了。已经摆了，现在就希望ai平等的降临到每个行业。;10;163;173;18388;0.009408309767239505
16418;笑哭看过最搞笑的评论：ai画画会解放人类生产力，画师抵制ai绘画是因为他们是既得利益者。（比起ai，这些糊涂或假装糊涂的人更令人担忧;20;278;298;18388;0.016206221448770937
16440;AI出图，AI设计，AI游戏，AI排版，AI剪片，AI特效，AI音乐，AI美妆，AI电影，AI电视剧，AI小说，AI短文，AI童话，AI设计服饰，AI设计房屋，AI设计车辆，AI统筹，AI指挥，AI美食，等等等等哈哈，真是光明的未来，一个用AI完美停滞在当下，永远不再前进半步的静止的未来。;5;40;45;18388;0.002447248205351316
16447;没吃过大师的苦还想享受大师的生活，门槛是低了，竞争对手也多了啊，操作员不是谁都能当吗，这不比学画画简单多了，外行想抢饭碗，你的优势在哪，绘画不光学的技法还有创作思维，只能看到光鲜亮丽的是吧，那只能说，欢迎来卷，感受一下强度;15;163;178;18388;0.009680226234500761
16463;网民觉得ai是代表生产力的发展，自己能从中获利，但事实上是对美术创作者的打压，是资本家对创作者的压榨，长远来看也不会获得更优秀的作品;15;150;165;18388;0.008973243419621493
16479;老子用个ppt模版都要付钱，这些b人随手拿别人作品喂AI怎么连授权都不授，时代在发展，但是直接侵权真的ex;2;52;54;18388;0.0029366978464215794
16482;以后对人侮辱性最大的一句话就是：“你这图是AI画出来的吧？”然后越来越多的人会为了一张画是不是AI画的而争吵，更多的原画师会被无限放大作品来找茬，所有不和谐的地方都会被说是AI画出来的无语无语;13;185;198;18388;0.010767892103545791
16496;ai绘画这场风波让我充分的见识到了人类的双标。网上骂资本家的言论不要太多，但到了ai取代画师的时候一个个却积极冲锋，恨不得让ai马上取代画师，让所有画师全部失业，一个个比资本家还资本家。有些人被资本家剥削一下就嗷嗷喊疼，看到了别人被剥削就兴奋地落井下石，只要不是发生在自己身上就幸灾乐祸，属实是让我看到了有些人的心理有多阴暗。;20;337;357;18388;0.019414835762453776
16517;你猜猜人为什么比起机器面更喜欢吃手工拉面;31;80;111;18388;0.006036545573199913
16549;最近不是有人拿“ai与人类画手”和“蒸汽机与马车夫”作比较吗，但是我觉得两者不具备可比性，虽然两者都有利益冲突的关系，但是AI的原料是人类画手的作品，然后吐出东西来挤兑画手的生存空间。蒸汽机取缔马车可以说是科技发展，但是AI取代人类进行艺术创作我只能说是道德的退化了。;29;140;169;18388;0.009190776593430499
16579;我感觉不画画的人真的有股看笑话的状态，反正自己的审美也在那里，也看不出好坏，但是看见你画得不如Ai还在那生气，就单纯觉得是因为嫉妒，我觉得真的很好笑。我跟室友说ai侵权问题，画得有错误，她说你又管不着版权（意思是我画的垃圾没资格去管），Ai会不断进步的，以后的错误也会改正，把我气的不行。我真觉得就是这种人，什么也不懂，但是就在舔Ai，只是因为石头没有砸中她们而已。;6;48;54;18388;0.0029366978464215794
16586;其实到现在也不太关心这些什么纺织机，阻碍ai发展科技罪人等等言论了。就一直就还挺好奇为什么这些人默认自己是资本家阿像秋叶，星空这些先行使用ai的人都没有敢这么说的，你拿ai图像技术除了给自己整点瑟图你还能干嘛了。抄别人tag，用炼好的模型就一副我就是原创ai画师的样子。。真就没了绘圈小鬼自己变ai小鬼了呗真资本家已经开始想着割大众韭菜了，大厂甚至在开会培训画师使用ai，自己炼丹等等等等。。。最后市面上只会多出一批同质化好美术低趣味性的换皮游戏，至于解决美术资源稀缺，什么发展中国动画游戏，不可能的。。国内从来就没有缺过，只是资本会看到更简单割韭菜的方式，狠狠一波收割。。。;5;107;112;18388;0.006090928866652165
16592;我是写手，虽然写作领域的AI技术还没有绘画这么大问题，但是我还是支持画手们的行为，因为不支持将来受害的就会是我自己。别给我扯什么宏大叙事，AI带来技术进步什么的。我只在乎我自己能不能吃到太太写的饭，画的图，是人创造出来的具有感情的东西。而不是“缝合怪”喂给我的冰冷，无机质的作品。玩游戏抽卡被迫收获一堆高价低质的赛博白菜;20;265;285;18388;0.015499238633891669
16613;看了看评论，现在原创劳动已经不值得尊重了吗？不仅看到了技术的无上限，但更多的是道德的无下限tv皱眉;51;250;301;18388;0.01636937132912769
16665;AI要是真的取代艺术家那艺术就死了。艺术本就是以人为本的，没了人的艺术就是空有躯壳。就算不谈AI的道德性和对伦理的挑战，不谈艺术这种高大上的概念，对普通消费者而言也会造成创意行业审美降级，再看不到好的作品。艺术是最不需要AI的，需要AI的比如某些高危职业反而没什么发展。更何况现在的AI战争关系到的还不仅仅是艺术，今天AI能取代我，明天AI就会取代你，总的生产力却没有提高，钱都跑AI公司手里去了，他们可以名正言顺地剽窃而不必承担任何责任，这是非常可怕的。;1;79;80;18388;0.004350663476180117
16667;刚有ai的时候我指望他发展发展规范版权了之后可以做那种绘画爱好者教学用的，比如把人体不好的吐拖进去ai给画红线这样，结果没人想过做这个，就想着把画师扒皮吸血了;4;154;158;18388;0.008592560365455732
16672;纺织机更新不需要献祭女工，ai不是纺织机谢谢。ai是像素高维度分布概率预测模型，历史规律来自爬取图像，不包含任何逻辑。;19;74;93;18388;0.0050576462910593865
16692;再发展下去个体越来越会不值钱，而资本会越来越富，这群困在温柔乡里的人还做着解放他们生产力的美梦，殊不知他们的个人价值也慢慢被资本吸干抹尽;9;192;201;18388;0.010931041983902545
16702;说ai淘汰的只是底层画师的真的让我看笑了。不会没有人知道还在坚持抵制ai的都是大佬，部分底层画师已经先一步拥抱ai了吧。越是创作无能和思想贫瘠的人，越想要通过ai给自己的屎上雕花。真正的大佬根本不希望ai污染自己的作品。;19;114;133;18388;0.007232978029149445
16723;网左在这些方面既不愿意深思却又要坐享其成;5;126;131;18388;0.007124211442244942
16729;一语中的;40;101;141;18388;0.007668044376767457
16770;AI可能影响不了米山舞，但会扼杀未来的米山舞;7;72;79;18388;0.004296280182727866
16778;用AI来挤压艺术的生存空间这本身就是很蠢的事，艺术审美是一直随着时间革新的，当AI把大部分艺术家都杀死了，那所谓的“AI画”的进化也就停滞了;15;123;138;18388;0.007504894496410702
16794;我上蓝p是为了看画师画，而不是看个AI生成，点进去标签AI是小写可以绕过那个蓝p自带的屏蔽AI，又接稿又开饭盒的潮不潮流啊，太潮了。点进去十有八九国人，只能说很符合我对的想象;6;7;13;18388;0.0007069828148792691
16801;笑死了金的那图身子上面和下面直接少了一块还能叫鸡蛋里挑骨头你家鸡蛋里全是碎骨头还不让人说以后祝你们天天买到假鸡蛋蛋黄能当球打的那种;3;41;44;18388;0.0023928649118990647
16805;我就说一句，你们688买的漂亮角色漂亮时装是希望是画师苦心设计的呢还是希望是烂大街ai关键词一键生成100套然后挑挑拣拣拼贴一下的“原创作品”呢，你老婆真好看，但是ai生成的，你时装真特别，但是ai出图10选一剩下的，你厨的小说真好看，但是ai写文作者仅润色一下的，你听的歌真好听，但是周杰伦曲库融出来的ai曲调这就是你们要的“生产力进步”，都有光明的未来热;7;34;41;18388;0.00222971503154231
16814;ai开发项目可以向着农业，工业，教育业，畜牧业等等，以减轻人类的生活劳动负担，但是却非要冲击人类用来享受的文艺工作和精神文化领域;12;124;136;18388;0.0073961279095062
16827;AI信徒还在狡辩”人类看图临摹是学习，所以给AI喂图也是学习”人的学习和AI学习已经因为算力的巨大差距已经是质的区别;6;23;29;18388;0.0015771155101152925
16835;人们好像急于加入这场品尝成熟果实的绝美盛宴殊不知这场狂欢的幕后站着许多等待吃人的巨兽;5;66;71;18388;0.003861213835109854
16842;有些人经典以偏概全，觉得一个画师赚大钱其他画师也赚大钱，赚大钱的那些是行业顶流好不好，大部分画师一个月也就几千来块啊。还有看一些绘圈的一些破事就觉得所有画画的人就这样了，然后就带着一种偏见对整个行业充满了恶意。然后借着ai热潮疯狂嘲讽画师，人画师要求维护自身权益，禁止ai吃他的作品，你就直接一个反ai反对科技发展的帽子扣过去，然后拿纺织女工马车夫等等类比，这特么能一样吗？;2;96;98;18388;0.005329562758320644
16845;之前听说AI绘画是工具，就像PS一样可以给行业带来变革，但看完UP的视频我开始重新思考，AI绘画和PS是存在本质上的不同的，他们两不能拿来一起比，AI绘画绝不是工具，它的诞生就是拿那些艺术家、绘画爱好者、从业者的血肉堆积的。AI绘画可以玩但要慎用，因为以现在的形势下，它几乎不可能会被抹杀，你得知道它的存在，并且在环境不健全甚至残酷地倒逼你去接受的情况下看到一篇官方的宣传稿，我整个人都麻了，自身一定要守住底线，不能放弃练习和钻研理解。祝各位热爱绘画的人可以经受住这次突如其来的洗礼，找到自己拿起画笔的本心。;3;53;56;18388;0.0030454644333260824
16849;淘宝已经有人开始拿ai盈利了，甚至AI绘画的稿酬比常规画师要高，更离谱的是还自称同人原创作品，我寻思着这不是一眼ai吗，粗糙的瞳孔以及意义不明的头饰，关键还真有人买;20;87;107;18388;0.005819012399390907
16871;我从始至今都瞧不起用ai作画的人，这就是一种无能的表现;8;15;23;18388;0.0012508157494017839
16881;看到有人说不经过画师同意拿画师图去喂AI的不算侵权，因为AI需要学习，没有画师的图怎么能进步，还咬死了这种行为只要是为了学习就没有错我就想问一句，画师明确表示不授权不同意喂图你还硬要拿去喂，你这是不是抢？我的画，我的劳动成果，我没有资格，我没有权利，我不能不让别人私自拿去喂AI，这是我听过最好笑的笑话，这跟把画师扒皮吸血有什么区别？;3;60;63;18388;0.0034261474874918425
16885;有人认为ai和艺术家是相同的学习方式，这是典型的机械论，ai的机器学习是大量模仿之后的制造，而艺术家不需要大量模仿也能做画，艺术家依靠天赋同时也会模仿，而ai只能模仿。ai只拥有艺术家的部分能力。任何机械论者，都无法证明机械论，无法证明宇宙中的一切因果关系，这是机械论者跨不去的坎。;12;83;95;18388;0.0051664128779638895
16898;AI的发展最先导致的问题反而不是版权问题，而是有人已经开始用AI造黄谣导致的法律问题了，真的很讽刺;1;12;13;18388;0.0007069828148792691
16902;明明是版权问题扯什么纺织机，，笑啦;8;83;91;18388;0.0049488797041548835
16913;那些觉得ai作画没有问题的人，要知道，现在这个时代不仅是艺术行业收到ai的冲击，无数行业都将被ai设计，如果你觉得这微不足道，自己的行业不会被取代，因此不在乎不在意。但这都是不可能的，现在我们并不是反对ai进步，但创作者应该获得创作者应有的保护，应有的权益。;16;108;124;18388;0.006743528388079182
16931;我都感觉评论里有好多资本的水军啊，说话都是固定的套路，说不准还是chatgpt生成的捏;13;96;109;18388;0.00592777898629541
16945;如果不加管控，任凭ai窃取画师的作品用于机器学习，人类艺术很快进入冰冻的中世纪，人类艺术宣告死亡，艺术的本质将从人与人之间的交流转变为人机交流，机器之间交流，人类艺术一旦死亡，人类审美，思想将彻底被ai控制，有趣的是，现在存在一批即不懂ai也不懂绘画的人，宣传人类跟机器一样，都是机械劳动的反人类的机械形而上学的落后哲学观点;1;12;13;18388;0.0007069828148792691
16951;如果AI绘图杀死了艺术家，艺术家都摆烂了，未来没有更多的艺术作品给AI学习，首次狂欢过后就是一地贫瘠以人为本才是正确的。;10;35;45;18388;0.002447248205351316
16962;说艺术被取代的未免太乐观了，事实会证明人就是喜欢人创造的艺术，因为人喜欢被人服务。倒是程序员和写文案的需要担心下了，GBT4直接冲着你们来了。;11;12;23;18388;0.0012508157494017839
16974;当市场接受了这种不严谨的美术制作，就是一个可怕的劣币驱逐良币的过程，审美也走向黑暗的固化;1;16;17;18388;0.000924515988688275
16976;如果现在全世界的绘画者集体罢工一年，那这一年内ai的创作是不是只会在目前仅有的程度内兜圈子;13;21;34;18388;0.00184903197737655
16990;没有人类成分的艺术毫无意义兔年吉祥東雪蓮下头;4;24;28;18388;0.0015227322166630412
16997;都用ai，那不就是让所有人类都在观众席场上没有玩家吗。怎么绘画现在都跟马车汽车类比起来了，我还以为绘画是人类的游戏。玩电子游戏看不起页游一键寻路自动打怪升级，绘画却认为这样是进步，看样子绘画现在已经纯纯的变成干活了，要的只是最后得到的那个图，商业让画变得值钱也让绘画失去了原本的意义。;22;82;104;18388;0.005655862519034153
17020;这些人完全搞错了一个重点，那就是以前的人，因为没有绘画能力，虽然他有很强的想象力，但是他没有办法把他的想象力转化成作品，以后的社会，人们拼的是想象力，现在最顶尖的画师，他的想象力真的比其他普通人更高吗？我看不一定，只不过以前因为技术的落后，普通的人没有掌握绘画技巧，那么他的想象力再怎么丰富？也呈现不出来，所以显得好像那些专业的画师们对艺术的感觉和把握超过普通人，但是当普通人不需要通过绘画技术就能够把大脑中的想象呈现出来的时候，那么这个时候其实是人类想象力的一个大解放，所有的人都可以通过人工智能把自己脑中的想象呈现出来了，这对整个人类社会的审美是一个巨大的提高，而那些所谓的美术生们，他们傲慢的认为普通人没有想象力，没有审美力，他们忽略了一点，他们只是掌握了绘画技巧，而普通人没有掌握绘画技巧，无法把自己内心深处的想象呈现出来罢了，所以显得他们比普通人更有审美层次，但是当大家都不需要绘画。就可以把想相力转化成作品的时候，那个时候，那些所谓的画师们的优势就没有了，虽然作品是人工智能生成的，但是最后这个作品人类满不满意是人类说了算的？对于美的标准还是掌握在人的手里，甚至现在已经有技术可以直接把人大脑里的画面直接，通过仪器呈现出来，所以，未来的社会比的不是绘画技巧，而是想象力，谁的想象力更丰富，谁的作品就更受欢迎，人工智能技术的进步，使得那些所谓的画师失去了唯一的优势和普通人，在同一个水平竞争了，这让他们感到恐惧;25;4;29;18388;0.0015771155101152925
17046;希望ai尽快扫荡各行各业，然后ai和少量巨头盆满钵满，然后一群吵着ai降临彰显自己懂科技的瓜皮一同被扫进垃圾堆，同时你用ai生成的那些毫无意义和乐趣的像素也一同留给你自个儿意淫;1;11;12;18388;0.0006525995214270176
17048;AI的学习，和人类的学习，就类似于，我通过学习课本知识，完成了考试，得到了90分，而AI通过记录下了课本知识，完成了考试，得到了100分，看起来一样？实际上，我能通过课本学到的知识，举一反三，或是进阶一下，就是一个更高级的知识面，能完成更难的问题和考题，而AI，永远只停留在“之前的课本”上，等待着一本新的课本送过来。;28;16;44;18388;0.0023928649118990647
17077;别扯什么工业革命时代进步，反正我作为这人类的八十亿分之一，不支持也不会用什么ai绘画。除非这个什么所谓的ai，和人类一样有需求有欲望有看法能感知现实世界并思考自己的未来，仅仅只是搁那天天吃画师的画作做tm所谓的学习的话，那我只能说这玩意就是个像素规律排列组合软件，他无法否定也没资格否定人类的绘画艺术，不配称之为绘画。就算普罗大众和资本再怎么拥立ai产图，我也仍然只愿意把我的钱花在真正用心创造的画师们身上，坚守这个市场。;2;10;12;18388;0.0006525995214270176
17080;现在8090的绘画从业者都是重复性，机械性的工作。百年前纺织机的创造，并没有让纺织工艺退化。反而让各种潮流发展有了最根本的空间。以后借助图像去创作就更容易，更简单了。可能普通人也可以利用这些算法去制作自己的漫画，动漫。更多因为成本问题而被迫终止的各种想法可以，因为AI去完成。他所带来的必定是文娱产业的大爆发。;78;53;131;18388;0.007124211442244942
17160;我一直从事图形化算法工作，这样工作前些年给人带来的是枯燥繁琐无止境的学习感。但到后期你会发现它居然在你黑白的世界中展现出了色彩。数据的行为描述，这是个很大的话题。看似目前大家都很能理解的数据模型学习其实不过是人类翻阅字典是的学习。最终目的是形成函数，比如梵高的画进入数据模型训练后将返回一个函数，可以理解为一把钥匙，那这把要是可以通过ai重新打开梵高绘画能力的大门。一旦得到了函数数据模型就像夜壶一样可以被丢弃，场面如同今天的地产公司。但之后随之而来的是什么呢？是你想人类思维还是创造新的思维，这一点我很希望人类可以选择，不过也许人类无法选择。但是人类为什么要追求搞笑的智能制造呢？此处我姑且先把ai或人工智能称作智能制造，搞笑的应对机制可以面对很多前所未见的问题，在人类面对灾难面前智能体会做出比我们更快的反应，这种封装属于人类压缩时间的变相实现。比如钢铁侠打绿巨人时，浩克装甲从太空飞入地球那一刻。ai绘画从表面来看是在与设计类利益群体的争，如果从这一角度看不像是竞争而很像收购，原因是设计只是表面，之后从设计的产品所带来的工业数据智能制造的机器也许都已经被贯通，一个电子时代，你觉得你手里的手绘板和智能体亲还是跟人类亲？一个美术画画出了成就后要追求更高的必然是走向工业设计然后是工业生产，出自己的独立产品，这一切ai也在做，他做完也就算接手你的产品设计未来了。ai也会学习孙子兵法，商业市场规则。如果不想落后于ai应该学习使用他。钢铁侠会因为贾维斯做了太多而讨厌贾维斯吗？事实上大家不喜欢ai的原因就是自己又要被逼迫学习了，本来已经稳定的社会关系赚钱模式被推翻了，未来的未来又变得如此不定对吧。这几年出了固定的工作我越来越想做一些自己喜欢并且能展现自己预测未来的事情了。去年开始我一直在分享一些枯燥的算法。我展示我如何独立开发web版的ps的过程顺带分享图形知识。如何通过记录笔触和路径来描述一个人的几何结构。大家有兴趣可以来一起研究我已经做成了视频分享，互联网时代来的时候大家也很讨厌。但实施是喜欢电商的是用户不需要和新商铺，你讨厌他也许你就会被你的竞争对手淘汰。如果你的敌人是ai，那你的人类敌人也许就是ai的朋友。人类创造出了芯片，芯片的亲儿子就该是智能软件。智能软件终有一日可以制造出属于自己的芯片。;3;16;19;18388;0.0010332825755927778
17165;早先我也觉得这东西和工业革命一样，“手工业者”们再怎么骂也是完全阻止不了的，但现在我觉得也不能完全这么类比，科学技术的发展是可以被道德钳制的，例如克隆人，一旦社会舆论压力足够大，道德至少是能暂时压制住一种技术的野蛮发展的，如果这种舆论氛围能够推动立法的完善，那就又加上了一道保险。所以AI绘画这件事上，画师也不要绝望，看客也不要嘲讽，团结起来维护权益、营造舆论、凝聚共识就是应该做的，结果不一定理想，但早早绝望的话一开始就结束了。;1;11;12;18388;0.0006525995214270176
17169;我不理解为什么评论区有人能把洗稿称为创作和进步，而且是在明知会被资本利用的前提下坎公骑冠剑无语;1;52;53;18388;0.002882314552969328
17175;虽然我是个唯技术论者，但是我还是觉得，想要限制ai的野蛮生长，还是得靠法律;9;61;70;18388;0.0038068305416576026
17185;一涉及自身利益都急红眼了。无非是利益相关不要讲啥大道理。ai让普通人可以越过画工直接作出脑内成品，降低了绘画的门槛。所以得利的是普通人，损失的是被打破垄断的美术行业从业者。普通人享受低成本便利的时候根本不会在意无关的画手的痛苦。;58;58;116;18388;0.00630846204046117
17244;呆很多人都没用过和了解过ai就在骂，也没有进厂做过项目也在骂，所以根本就是鸡同鸭讲毫无意义。网上好看的图实际上随机性过高，能用在项目里的几乎很少，反而是自己能画图的人结合ai和需求可以提高工作效率，要保护的只不过是其他人的图，喂自己的图给ai辅佐工作属于技术进步。所以归根结底要限制的是乱用ai的人而不是ai本身。当然，你水平不行坑定是会被淘汰的。;10;12;22;18388;0.0011964324559495323
17255;你们猜猜为织出来的布没有版权，但是画出来的画作做出来的音乐却有;8;13;21;18388;0.0011420491624972808
17267;我记得之前看到过，阿里有个视频鉴别技术。就是通过那一小段样本可以找到原视频的标识码。样本包括但不限于，一小段视频、视频截图、截图裁剪成非常小的部分、截图乱画些干扰、截图加滤镜、盗录，都能够给找出来。论文我没去搜过，但这项技术真的让我很震惊，如果能用在AI绘画的甄别上更好了;10;25;35;18388;0.0019034152708288013
17280;手工业工人开始抵制大机器;44;36;80;18388;0.004350663476180117
17325;哈哈笑死在ai时代来临以前经常逛pixiv就知道以前很多画师也就是找着别人画查重率估计比ai还高新技术来临必然面临革命革命就是新利益集团替代老集团汽车终将替代马车而目前不管是技术进步的要求生产力发展的要求还是资本逐利的要求都会为ai扫清障碍;8;34;42;18388;0.0022840983249945617
17334;生产力发展应该是将人类从枯燥重复的劳动中解放出来，让人们可以自由地追求创造性劳动。而这个所谓的“生产力发展”，反而把创作权从人类手中夺走了，人类就像甲方一样只需提一些要求，创作过程完全由AI自由发挥。世界上还有极大量底层劳动人民从事着枯燥、繁重、危险的工作，AI却抢先一步要把绘画、音乐、小说取代。当这种脱离社会实践的抽象的艺术取代人类的艺术后，社会究竟会向共产发展，还是向赛博朋克发展？;18;9;27;18388;0.0014683489232107897
17353;人不醒，天不明我们要团结起来学习海外的人才行呀明明我们才应该是最团结的现在这样子简直比棒子还棒子国内的画师不团结起来，上次起点的合同事件就要在AI绘画上重演;17;11;28;18388;0.0015227322166630412
17372;真正线下去看艺术家的画，会感受艺术家的画都有一种意境，是艺术家精神的传达，附和在画上。是很玄乎，但是看了几次画展，和一些学生画，都会有见到画就浮想联翩的感觉。但是AI没有，我看了很多AI画，都很冰冷。我想这是AI和人最大的区别，但是肯定这个时代正在淘汰这样的区别。冰冷和效率是这个时代追求的。怪我咯;1;7;8;18388;0.00043506634761801175
17374;做好分级制度，而不是一味的抵制。ai也可以是启发创造力的工具。;1;8;9;18388;0.0004894496410702633
17376;一堆不懂ai的人在那里一呼百应像是为了“大义”一样阻止人民接收、使用目前开源、人人可用的ai技术，是巴不得以后用ai都要给哪家公司充值几万才能使用是吧？;5;13;18;18388;0.0009788992821405265
17382;有些人说ai生图能解放生产力，更高的生产效率。首先图片能为你带来什么？你想过没有？你会在什么时候为一张图片消费？这是什么消费？ai为什么企图挤占这一行业？为什么不去开发更优秀的种地机器，为什么流水线依旧需要大量的工人，为什么？因为种地收益太低人比机器便宜开发一个机器可比人贵多了，买一台高精度的机床可比请人贵多了，机器需要维护，而流水线上的工人我只需要开除。ai绘图解放了什么生产力？解放了人从事具有高附加值创意工作的生产力？;1;8;9;18388;0.0004894496410702633
17384;有一个很恐怖的事就是，当行内人再说AI各种问题时，例如画面的各种错误，普通人是感觉不到的，他们只会觉得是业内人在无病呻吟，因为对于他们来说就是要一张还算不错的图片。;3;7;10;18388;0.0005438329345225147
17388;这些人拿着画师的画作，“创造”所谓的“画作”并声称这是先进的生产力，是创新。我就问一句这是不是另一种资本主义;5;32;37;18388;0.002012181857733304
17394;画猫头鹰头猫头鹰头猫头鹰头猫。;2;5;7;18388;0.0003806830541657603
17397;望月；绘画作为一只娱乐方式y要能在过程中感受到自己的价值，享受其过程也为结果感到高兴如果画画没有了这些东西，如果画画感受不到这些东西也无所谓的话，那么是不是越来越多人会开始觉得自己绘画是毫无价值的无意义的呢？这是我目前一点点的想法，这种由人类来画画的文化会不会衰退呢？如果是新入门想现在开始画画的人，是因为看到之前的人享受画画的过程产生的想法，但对于一开始就使用ai绘画的人来说，一开始就使用ai作画的人肯定会有增长，这样的话，那些到现在为止一幅一幅画的，能够从画中感悟到，“原来积少成多才是绘画享受的地方的这部分人”我想肯定会有减少吧，因为用AI就能画了，如果成了这种工作交给AI就没问题了的情况，对于工作者来讲那画画的重要性不就下降了嘛，对于那些认真绘画的人来说，这部分人也会减少吧，如果变成这样的话，那这个文化和我们创作的，对于这个从古至今流传积垫的绘画文化真的是有益（进步）的吗？我反而觉得是种退步，为了简单化事物而研究新的技术，虽然我能理解这种正当使用技术的想法，但我觉得人类应该不局限于此吧，如果不需要的技术就不去研究，在某个阶段需要对此进行选择，我认为是不是也应该有个到底这些需不需要的阶段，好好考虑一下吧，是否真的需要AI绘画呢？怎么做才是正确的，看到这些的人又该如何反应，如果什么都不想就对其进行称赞，一不留神绘画文化就此消亡的可能性也是有的，既有可能是真的需要的，也可能不需要的，我觉得每个人都应对此进行思考，差不多这样的想法我的；绘画需要环境韩国大佬金政基的出门靠的就是他在行业内的磨练出来的技术;2;8;10;18388;0.0005438329345225147
17400;ai这个东西还是要看怎么用，用不好了谁都遭罪。我觉破站上有人拿ai实现一些奇思妙想，个人创作者拿来整些低成本的活都挺好的，商业中有限度地用作辅助，也可以一定程度提高效率。不愿看到的是什么呢？是ai图变成我们的审美标准了。说审美有些空泛，以我的理解具体来讲，就是一个人花很长时间出一张图的时候，ta有很大的空间去做思考推敲，作品的每一笔可能都有一定的思路在里面，无论是图形的节奏，明暗虚实大小的对比、还有逻辑性的内在联系、故事性等等。这些东西都非常有趣，发掘他们就像寻宝一样，理解的瞬间就好比《头号玩家》主角和老头心意相通那样，产生了“交流”，这也是一张图看10s所不会体会到的。而纯粹的ai出图，它的有效信息就十分有限了，由绘画语言转译到自然语言，再转译为“咒语”，其间损失会非常大，而其余的信息则是概率统计的结果，是缺乏逻辑和思路的，更谈不上“交流”。但现在就会有很多人拿着ai图和人工图（不排除有些真的画的不行），觉得这不差不多吗，那我刚才所说的那些设计就被放弃掉了。这是很可惜的，创作者失去了欣赏（甚至热情），观众失去了更多的趣味以及深入探索的动力（什么叫快餐时代啊）。;5;7;12;18388;0.0006525995214270176
17406;只评价一点，如果试图描绘ai可能带来的悲观的未来，那这种图景正是许多ai支持者想看到的。有些人以为描绘人类被取代的末日会使ai支持者害怕，殊不知ai支持者正是渴望这样的末日。;23;20;43;18388;0.002338481618446813
17430;这有什么意义？我每个月累死累累活就那么点工资，不可能购买你这零成本的电子世界电子烂白菜，你觉得好看，我觉得还有更好看的可以随便出图，ai生成一个作品几秒，学习合成作品没有成本，我手里的币是有限，增加需要极大的成本，你ai一天就可以生成几千套游戏皮肤，每个皮肤188但是成本为0我看都不看一眼全是海量合成的味道更不会购买没有价值的意义没有意义doge;35;197;232;18388;0.01261692408092234
17468;我支持ai，并认为由ai发现所带来的一系列社会问题，都会得到解决，最终将促使整个人类社会科技进步。ai训练图像的本质是什么？是在学习人类审美原理。人类画手画画，就是通过总结的人类审美原理，运用一系列手法技巧，来创作出一幅画。在这里，重点是什么？是原理，人类画手理解人类的审美原理。那ai呢？ai一开始并不知道，所以它要学。怎么学？看人类的作品，然后ai知道色彩搭配，视角透视等等。那ai学的怎么样呢？答案是目前学的不怎么样。然而，学的不怎么的ai绘画如今却极大地冲击了人类绘画，问题在哪？根本原因在于，绝大多数人类的审美水平还不高，或者说不够苛刻。举个例子，要求画一只猫。人类画一张画的时间，ai画了1000张。人类的画90分，ai的画6080分。即使人类的这一张画，比ai的1000张都好，但是，ai的1000张画，至少可以有100种画法，那么在商业上，放弃一点质量，极大的丰富种类，显而易见更有经济价值（目前）。那假如绝大多数人类的审美很苛刻呢？那画的质量的权重就会更高，或者说，质量高的画，将会比现在更值钱，因为质量低的ai画没人喜欢，而能画出高质量的画的人类很少。那假如有一天ai画能达到媲美人类画的质量怎么办？参考打印书法字体。除非你能创新一种新字体，而且要符合人类审美，否则你的书法没有太大的商业意义。如果真有那么一天，绘画也一样。用机器画画就像如今人类打印各种字体一样，标准而完美。什么，你说画画是艺术？真正的艺术是作品中的重点只是作者的情感表达，而如果没人欣赏作品中作者的情感表达，那这样的作品就不是公认的艺术，当然也就不会有公认的商业价值。我下班回家喝完酒挺高兴，在白纸上潦草的写了几个大字，我觉得这几个字真是艺术，但你觉得有人会欣赏吗？有人会买这几个字吗？回到最初的结论，如果ai高度发达，社会中的绝大多数工作都被ai代替，几十亿人失业，这样的社会，你觉得不好？如何不好？ai高效率的产出各种产品，几十亿人只要关心政府如何分配产出的物资就行了，其他时间都是你的，你是天才那你就去搞发明搞科研，什么，你说连科学家都被ai代替了？那恭喜人类就完成了有史以来最伟大的壮举，创造了一个智慧物种。一个能搞科研的ai完全有能力把自己发展成为一个物种，进而发展出一个社会。;12;24;36;18388;0.001957798564281053
17481;总有人说热爱绘画就不会被ai绘画打击，把绘画当专业除了休息就是画练出来的水平和一边工作挣饭钱一边业余画练出来的水平能一样吗，还是说有了爱就可以不用吃饭了囧;6;6;12;18388;0.0006525995214270176
17489;现在的人为什么没有用创新的AI去创作创新的风格，而是用创新的AI模仿以前的风格？摄影都有段时期艺术家们尝试调整小孔成像的小孔数量，暗箱的结构来产生特殊效果，就是玩转了摄影的独特性，AI我觉得之前的克苏鲁风格的作品就很有趣，因为那是AI因为无逻辑性的产物，就是一股AI味，结果现在技术在不断细化，细化的话如果不开源只是科学上研究AI的上限我肯定是支持的，但是现在开源了大家都可以用了，那就会导致技术泛滥和技术依赖，对人类精神世界造成打击，毕竟如果以后人类不需要种地生产日用品，人类的消遣就是搞搞艺术创作了;1;15;16;18388;0.0008701326952360235
17491;不能武断地认为资本青睐ai，资本只青睐能卖出去的东西，这是ai生成图片的短板。要怎么说服消费者多花钱购买一个几乎没有成本（即使看起来很美好）的东西呢？唯一的选择是隐瞒，不让消费者知道自己购买了ai图，这就要求ai对人类达到乱真的高度拟合，也就导致人类画师不再将画公开发表，于是大众市场上还是只有带不来收益的ai图。长此以往，数量锐减的人类画只会变成价值更高的稀缺品，通过新的商业形式进行交易。这砸的是别人饭碗还是自己的锅，我暂且蒙在鼓里。;2;9;11;18388;0.0005982162279747662
17494;个人觉得科学进步没问题先把版权费结一下不然以后创作者刚创造出新作品新画风马上就被喂ai时间一久谁还会去坚持创作新的东西呢;70;54;124;18388;0.006743528388079182
17567;我只是觉得，现阶段资本的目的是利用散播AI焦虑，在掌握各行各业100的议价权，让生产关系不对等。;1;7;8;18388;0.00043506634761801175
17569;ai从未学会画画，不论它再怎么先进智能，它也只能算是另一个种族，你听一只猴子描述另一只猴子有多美，但你从心底不认为它是美的，ai理解不了人类的审美。。。。当然这是最坏的结果，就凭现在的ai，等它能明白“原创不等于抄一千个人的作业”再说吧;1;6;7;18388;0.0003806830541657603
17571;AI绘画首先得解决版权这个问题吧，它拿大佬画作碎尸拼接，给钱了吗？;6;9;15;18388;0.000815749401783772
17578;哎劣币驱逐良币，我真的越来越悲观让我想起极乐迪斯科的主创成果被窃取这件事，一个创作用自己一生去思考的作品，而且他确实做到了游戏史上独一无二，出现的时候你当然可以理解他创作框架是什么，他创作理念从何而来，但是我们不可否认，我们从未见到过像这样的游戏。而像这样充满个人特色与哲思的作品，版权都被夺走，创作者在艰难打官司，只是希望获得自己作品创作权大哭何况在网上只是因为爱好聚在一起，因为喜欢某种事物选择去创作的画师呐大哭;1;10;11;18388;0.0005982162279747662
17583;感觉ai滥用直接就把艺术的大厦根基直接抽走了，如果大部分天赋平平的从事艺术创作相关工作的普通人没法再从艺术大厦的中底层获得利益和正反馈，以后就没有人会再来干这个事了，没有了根基谈何创造，谈何审美;27;40;67;18388;0.0036436806613008486
17611;在我看来用ai谋利的就像最初印制假钞的人一样，觉得自己打开了一个取之不尽用之不竭的钱口袋是吧;2;20;22;18388;0.0011964324559495323
17615;还是那句话，人类是不可能因为道德停止发展的。;6;6;12;18388;0.0006525995214270176
17622;之前炒作得悻悻狂吠的石头剪刀布的看了后续，他们用了个很笨的法子：人工查找人设相似的图让AI练，压缩了库容量初步稳定了视频效果，然后使劲叠加抖动修复，后来再扣个像加特效什么的。最后效果还是头发，褶皱阴影乱抖。拍视频人就已经cos的差不多了，就是让AI绘图逐帧描了一遍（说白了和滤镜殊途同归）。这么烂的玩意儿都不知道有什么好炒作头的热，还不如paranormalstudio的AI风格化滤镜，画面稳定而且风格自由还不容易撞车。;1;7;8;18388;0.00043506634761801175
17624;手工业和工业的问题，作为消费者更愿意看到工业化降低成本。;8;4;12;18388;0.0006525995214270176
17634;如果是在外，我非常认同站在AI的对立面。但是我身处的地方，总是让我感觉到恐惧，这种恐惧的来源就是创作的内容无法得到保护。画家对自己创作的内容就像对待自己的孩子一样，努力养了好几年的孩子，最后成了别人的赚钱工具，每天都生活在这种恐慌当中，真的不知道该怎么办。;2;29;31;18388;0.0016858820970197955
17637;不论如何，我反对这种AI艺术商业化和无版权窃取;1;13;14;18388;0.0007613661083315206
17639;本来普通人就跟艺术没关系，怎么，ai不能代表艺术，那些艺术家就行了？ai线条不更优美，想象力不更丰富诡异？;13;12;25;18388;0.0013595823363062867
17654;再一次看到在技术突破的时候，保守派与革新派的斗争。说是有各种各样的问题其实那些都不是问题。最大的问题是保守派的利益被新事物影响，而他们不想改变自己、突破自己，来适应新时代，于是变着法子的想扼杀新事物。;9;6;15;18388;0.000815749401783772
17664;总有外行觉得两个ai相互对抗可以无限进化，只要数据集够就可以学习，你要是老老实实读几篇论文你怎么说的出来这话，对抗着对抗着自己陷入瓶颈了，数据集大着大着训练不出来了，跑不动了，别老是说什么“以后肯定会进化啦”的言论，要是tm这些脑瘫ai天天能这么简单就进化我就不愁水论文了;16;13;29;18388;0.0015771155101152925
17683;我只是一个作画路上的学习者，ai进步的速度让我看不到学习的希望，或许以后我会转向3d？都说不好，但是在我身边因为ai而停止或者收入降低导致对于绘画而迷茫的朋友并不少，我或许曾经也是想象过热爱就是生活，靠画图养活自己，但ai的普及像是当初高中墙外的疫情，让人看不到未来。;7;5;12;18388;0.0006525995214270176
17691;能源迭代更新迟缓因为有能源巨头AI驾驶迭代迟缓因为有汽车行业巨头绘画AI没有迟缓因为绘画行业没有巨头，艺术家最好欺负了诶不对，wacom你说句话啊wacom;6;23;29;18388;0.0015771155101152925
17700;来暴论一下滑稽：人类本身就不存在什么艺术，只是人自己定义的而已（你把好看的画给你家狗子看评价评价），这只是个客观的宇宙，只要是客观的东西就是可以被计算模拟的阴险，就算是人类的自称为主观的情感底层都是物理，好在宇宙这个基础物理一定，道生一一生万物，组合可以无穷多，有机生命体特别是有主观能动性的智慧生物还是可以在这个世界愉快玩耍。AIGC当下最棘手的问题确实是版权，当然因为新事物出现要有新的规则，这个过程不是一蹴而就的需要推动，而且最终没有可能很好的结果只能达到一个妥协平衡规则。AI可能更像是共产时代的事物，对当下私产的人类社会是降维打击，既然存在过渡期，那肯定是群魔乱舞血雨腥风。过多使用AI会不会使人类创新退化？宏观统计上应该是会有这样的呈现，但是还是取决于人，该创新的人还是会创新。审美会不会降低？大多数人的审美本就是低的客观观描述没有褒贬义工具使用门槛的降低呈现出来了而已，比如短视频时代，十年前制作视频需要好的拍摄设备和是会剪辑软件，如今手机的普遍使用和视频软件的门槛降低是大多数人都成为了创作者，然后在宏观统计之下肯定都是粗制滥造的作品，看起来人们人的审美降低了，其实在大基数上短视频时代有更多的创作者创作了比10年前不知道多少倍的好作品，还是一个推荐算法的锅，让人会局限在一个小圈子里，发挥人的主观能动性就能破局。AI时代我认为也是，市面上大多会粗制滥造的作品（AI工具成熟可能会好一些，但是千篇一律是逃不了的），工具创作门槛降低使大多数人具备了本来不具备的能力，本该有新想法新创造的人会发大放异彩，只不过现在还在初期人们在摸索，AI在进化（特别是最近的进步，更变得工具化）;2;8;10;18388;0.0005438329345225147
17703;我理解和支持画师的维权。但画师的作品终究是给大众看的，而在被AI冲刷后的大众眼中，这些作品终究不可避免的要贬值的。因此我对这种抗争的未来持悲观态度。;3;31;34;18388;0.00184903197737655
17707;这项技术带来的收益实在太大了，我不认为资本会松口，别说版权了，为了利益他们愿意沙人，甚至是毁灭一个文明。chatgbt也一样，甚至影响更大，掌握这个基本上就是公司极权。我不认为他们能抵御这个诱惑。还有最近好像有一场集体诉讼败诉了。;20;103;123;18388;0.006689145094626931
17730;实际上只要ai诞生了，一切的保护都是徒劳，我用本地部署的ai，喂别人的画生成的图，然后再在ps上临摹描图，最后得到我手动绘制的图，到了这一步就算有人质疑也没有证据，因为有psd文件可以证明是人工。虽然这个过程中涉及了描图抄袭和侵权，但就是难以被发现。事实上已经有人这么做了，可以提高效率。我只是一个p站几千粉的纯业余画师，novelai刚出没多久时候我抄ai光影和人体画的一张同人图上了每日热门榜前两百，到现在没人发现用了ai辅助。以后ai辅助必然会成为常态，就像现在3d辅助绘画一样;10;7;17;18388;0.000924515988688275
17742;我寻思AI绘画不就是个工具吗？至于这个工具能用出什么效果则是使用者的问题。我个人觉得没必要去反感AI以及AI绘画，毕竟这玩意是顺应时代发展的产物，就和手机电脑是一样的。关键的还是人的素质，不要因为工具的好用就去随意贬低创作者的劳动价值，因为创作的主体毕竟还是人;12;5;17;18388;0.000924515988688275
17755;评论区挺有意思的我提个问题，刀剑伤人错的是刀剑还是人？AI本质就是工具，把责任推到工具上不觉得可笑吗;20;15;35;18388;0.0019034152708288013
17776;说抵制也无法阻止ai绘画已经出现的，抵制没意义的那些人，你们好好想想，我们抵制的东西，有哪个消失了但是缉毒警依旧用着生命去扑灭某一些无法消失的东西，你是不是要说他们做的事情也也没意义？任何有争议的事情都是要闹出个结果的，只要做了，就有意义;1;8;9;18388;0.0004894496410702633
17780;也挺奇怪，ai绘画抵制的人怎么这么多。ai也能写代码，但我没看到多少程序员抵制啊，甚至不少拍手叫好呢，我公司也有好多人在用，包括我。;8;5;13;18388;0.0007069828148792691
17789;这就是所谓的降维打击了。历史的车轮滚滚而来，要么站在它的前面被碾成肉酱，要么站在后面成为它的一部分。反抗它就会被毁灭，无视它就会被遗忘。就算AI只能有现存百分之一的学习素材，也是够用的。如果画手选择不管不顾，那么百分之九十九都会被淘汰。如果选择把自己所有作品都封锁起来，那么恭喜，画师们在实质上就已经被淘汰了。毕竟，不能传播的作品还有什么意义？没有意义的作品还需要什么画师？万幸，与那场工业革命不同，二次元壁纸不是必需品，从业者也不会受到轻易导致死亡的反噬。;1;9;10;18388;0.0005438329345225147
17791;国外已经付诸行动，国内依然只有小画师和二极管们在对线;8;31;39;18388;0.002120948444637807
17800;我认为ai不仅冲击的创作者的版权权益，对我们普通人来说也是有重大影响，现在已经有人在侵犯的隐私了，你的一张照片被别有用心的人投喂给ai，会生成大量的涩图，甚至还有人买卖，那可真是膈应人。热;3;7;10;18388;0.0005438329345225147
17804;无所谓手工业者会砸烂纺纱机;10;11;21;18388;0.0011420491624972808
17816;我觉得AI对绘画圈最大的打击是训练积极性，之前很多人会说AI只会侵害到到那些大佬们，淘汰掉那些水平不行的小画手，但仔细想想有几个是天生的大佬呢，在你还在打基础的时候告诉你这个行业以后只有高精尖水平的人才有工作啦，家长，社会不会再鼓励你训练，只会告诉你：嗯，比起Ai还是差了好多。;3;5;8;18388;0.00043506634761801175
17826;其实若以史为鉴，可以发现和机械生产淘汰大量工人的情形很像。但仔细一想又有些差别，技术生产的是什么啊？工业产品，生活用品或者军火啥的，这些东西和艺术绘画有着本质不同。工业产品生产是为了用的，价值在于生产后的买卖，以及卖家的使用。艺术起初是用来表达自身情感的，那是一种人文方面的精神追求。所以这也是我们很多时候理解不了某些画家画作背后的原因微笑他承载着创作者之间的情感。那ai是什么？说是无意识的死物不过分吧？他有什么自身的情感吗？但这种情感如果下降为对金钱的追求，或者说对流量的迷恋而开始不择手段时，绘画就变成了和工业产品一样的东西了临表涕零，不知所言脱单doge望海涵;5;5;10;18388;0.0005438329345225147
17832;简直就是扼杀人类的创造力无语不止是美术，还有音乐文学这些领域;1;8;9;18388;0.0004894496410702633
17834;真人照片被炼已经泛滥了，C站什么迪丽热巴，周淑怡，各种coser的lora都有了，这个雷随时会爆;3;34;37;18388;0.002012181857733304
17840;这让我想起了大刘的诗篇，科技可以穷尽艺术吗？这一代ai训练可以是因为当下和之前的人类艺术家的积累，而这之后呢？当新一代的人一开始就接触的是ai艺术，训练也只是ai在训练，新一代的人真的还有训练的动力吗？当工具的能动性大于人的能动性，那么到底是人在当ai的工具，还是ai是人类的工具？创新又是属于谁的创新？;4;15;19;18388;0.0010332825755927778
17845;希望它会像克隆人技术一样被联合国拍死;19;3;22;18388;0.0011964324559495323
17865;要是ai笑子只用自己的图喂ai还好，但喂出来的也是ai的学习成果，跟你这个坐那等ai画完的人没有任何关系;3;8;11;18388;0.0005982162279747662
17869;08：10自动驾驶属于“只出不进”的分相似系统，不会对版权所有者产生竞争？？？自动驾驶训练到了L4L5，不会让司机失业么？;2;4;6;18388;0.0003262997607135088
17876;抄图就是抄图，偷东西就是偷东西，什么时候这些龌龊事这么多人支持啊思考;5;13;18;18388;0.0009788992821405265
17882;譞大的这张图其实很好地说明了现在ai生成图像与人类画图的基本差别，ai并非学习，它没有逻辑。看不懂手指这个是老生常谈了，饰品之类的也只能生成无意义的色块，鞋子和脚趾都分不清，换做人类，哪怕是小学生临摹都能懂。胸部和脸颊都比较平滑没有太多结构和转折所以是一般情况下ai图最出色的地方视频中有一点说的很对，关键看消费者，看市场反应，看读者们的反应如何。不过这方面我比较悲观。;52;72;124;18388;0.006743528388079182
17938;思考思考说实话，版权问题并不是ai和创作者矛盾的中心，只是单纯的表面问题，其中心问题应该是取代和被取代关系所造成的利益问题，科技和创作者的利益冲突。但讲真，这原本并不是AI发展的本意，原本AI的发展意图，是用来作为人类辅助工具被开发出来的，可以减轻繁重和重复的机械类工作，例如让漫画和动画类的产品小型化，让小型的工作室可以在低成本的情况下完成游戏，从而促进文化艺术事业的发展。另一方面，总体门槛的降低，势必会有各式各样的人入场，造成局势的一时混乱和滥用，例如出现的把画师直播的草图直接拿去出成图的情况，也是双刃剑的体现。而这一状况会随着科技的发展和资本的涌入，最终波及各行各业。抵抗的声音也会越发的激烈，并且催生出新的法律和规则以及社会职业，旧的职业被精简和淘汰，而人类社会需要时间去过度，所以要走的路还很长。因此创作者需要和ai在未来的社会关系上找到更好的共存形式，而我们现在正处在AI和社会发展的探索期而已，希望有机会在AI行业可以举办一些例如漫画短篇创作大赛之类的活动，可以去帮忙扶正AI作画原本的目的，引导所有AI使用者辅助创作，才是正确的做法，而不是非黑即白的去讨论这件事。;5;11;16;18388;0.0008701326952360235
17945;所以为什么ai的第一步是替代咱们的脑力劳动者doge;9;11;20;18388;0.0010876658690450293
17955;ai发展终究只会向前不会停滞，2017年ai战胜柯洁时很多人还在说ai只是学了足够多的棋谱才能战胜人类，而如今的围棋ai已经几乎不用学习人类棋谱，自己有了体系，相反甄别人类围棋手强度的标准变成了谁下棋更接近ai谁更强。或许有一天美术课老师讲起什么是印象派除了给你展现莫奈，梵高等古代大师画作，还会随手打开一个叫paintgo的ai让它随便画几幅画，告诉同学，你们学会了ai的风格，才能越接近印象派，台下学生早已将这一切视为常态。按照现在ai发展速度其实达到上面说的情况不会很远，ai完善，更新的速度真的太快了，那么多人紧急抵制也可以看出，放在两年前b站上还经常能刷到卖绘画课的广告，标语是学会后月入几千，谁能想到如今底层画师已经被冲击的体无完肤，连顶层那批人都要开始担心自己的未来呢？也许现在就应该开始考虑各行各业被ai取代的可能和一切版权的保护方式了，因为ai发展是必然，ai又离不开学习，而足够学习的数据必然牵扯到版权，几乎成了死循环，或许也只有让一个唯一ai归属于全世界每一个人，所有国家一起监管维护才能解决吧（瞎讲讲）顺便叠个甲，可能有人反驳说最近katego被围棋业余爱好者战胜了，实事是那个业余爱好者是ai研究方面的，找到了漏洞并且他自己也说，围棋虽然漏洞人人可用，但使用前提是围棋水平达到业余专业级别。训练一个普通人到这个级别或许要几年吧，katego修复这个漏洞，甚至培养一个没有这个漏洞的ai又要多久呢？;4;10;14;18388;0.0007613661083315206
17960;做高仿包和买高仿包的人多了去，可是要把高仿当正版明着卖给你你买吗？所以那些整天吵吵嚷嚷的说ai会顶替画师的你看看拿ai做商图的谁给你买单用ai后以前抽卡要648的现在30都会有人嫌你贵;7;28;35;18388;0.0019034152708288013
17973;ai无论画的多好，充其量也只是个画匠，因为人类的意志情感与思想是AI无法领会与驾驭的，而缺少了感性情感的画作，充其量只是一具木乃伊而已;5;4;9;18388;0.0004894496410702633
17982;有没有一种可能，ai生成的不是艺术品而是工业品，大多数画师画的也是工业品，而不是艺术品doge版权和法律会保护艺术家，不会保护工人;2;5;7;18388;0.0003806830541657603
17985;只有真正实现了共产主义人的自由而全面的发展。才能让人成为艺术的永恒载体。资本主义下艺术只能作为生产资料。而ai生产效率远高于人类。人类就注定要被磨成原料。当年的画家面对摄影技术时也是极力反抗的，可惜毫无意义。历史就是历史;9;5;14;18388;0.0007613661083315206
17996;人类的道德跟不上科技发展速度，科技先进东西，不代表全部就是好的;1;3;4;18388;0.00021753317380900588
17999;AI的所有产出物，不应该拥有版权。但通过AI提供的服务，应该具有服务费。如：智能导航，概念草图。原因在于AI诞生的过程中，人付出了劳动，这是价值的诞生，且这个”服务费“应当包括训练集的价值，训练集可以理解为矿产、粮食等商品即原材料，AI就是加工产品，AI工程师就是工人。所以在这个生产过程中，存在购买原材料，加工，销售（服务）。因此其产出的过程是一个服务的过程，是之前的劳动的转换，其产出物不应当具有版权，且其价值应当极低。;4;3;7;18388;0.0003806830541657603
18009;我的大脑是靠这两万张的在互联网上收集的图像训练;1;4;5;18388;0.00027191646726125733
18015;ai是把双刃剑合理的利用可以节省许多工作问题，但它目前展现出的都是取代并消灭人类的创造力;1;3;4;18388;0.00021753317380900588
18019;AI对于设计绘画行业的来说，通俗易懂的说就是外挂。类似我们打游戏使用外挂和别人不公平竞争，甚至窃取别人的劳动力和想法。就算我不是这些行业的，我也觉得AI现在太滥用了，应该立法规范使用范围。就比如AI搞的周姐色图，已经可以以假乱真了，之后造谣抹黑一个人不费吹灰之力，市场上将会充斥大量谣言和造谣。别以为AI一眼就能看出来，现在越来越真，有一天终究会以假乱真，而且难以溯源。用AI造谣毁灭一个人太简单了，因为互联网很多观众压根不关心真假，他们只会拱火和发泄自己的情绪。就如同央视主持人朱军被诬告那啥女性，他花了十几年时间证明了自己清白，有用吗？他的人生已经毁了。;2;5;7;18388;0.0003806830541657603
18022;AI会让一部分人越来越懒惰，懒得去思考去学习;7;23;30;18388;0.001631498803567544
18030;这评论区风向有些看不懂，为了保护艺术家去遏制AI？怎么不为了马车夫去禁止生产汽车？AI本身没有错，相反AI训练作品是非常积极的进步，让优秀艺术风格产生更多衍生和互动，丰富作品集。错的只是保护规则没有跟上，拿别人的作品训练应该取得原创许可，收益也应该分润。如今全球化信息高度融合，任何作品一经发布就立马能出现其他国家的网络，个人或地域公司无力实施法律手段维护利益，缺少强有力的全球化的知识产权保护机构。唉，人类;19;13;32;18388;0.001740265390472047
18050;那么问题来了：我开一家公司就专门招人进来画画，我拿这些员工的画去训练ai，那ai生成的画有没有版权呢？滑稽当然，我会事先告知应聘者你的画会被我拿去炼丹，工作合同上也会写得很清楚，换句话说这事完全基于双方自愿。并且我可以确保我的训练集中只包含我的员工画出来的画，那我炼出来的画能拿出去卖吗？滑稽你也别说什么招不到人，钱给得够多肯定有人干滑稽;6;2;8;18388;0.00043506634761801175
18060;没用的，ai完全可以靠自己生的图喂自己，已经是不可阻挡了。;17;3;20;18388;0.0010876658690450293
18084;支持Ai画手，人类根本不需要这么多艺术家。;4;5;9;18388;0.0004894496410702633
18089;我推荐大家可以去看一下国家发布的《互联网信息服务深度合成管理规定》，可以了解到国家对于该技术的理解。其中真人这一块是有明确规定必须获得被编辑个人本人的同意。现在只能说我们还是缺少相关法律法规，任重而道远。;7;58;65;18388;0.0035349140743963455
18099;假如有一张被保护的画，对应的文字描述是BFIX279（一个字母数字对应一个词）训练模式没有训练过这张BFIX279的画，但是它学过BDE12，ADF357，CI9，SX039和ACDS0135（这五张画都已授权给AI训练），那它完全可以推理判断出BFIX279是一张什么样的画作，即使AI根本没看到过这张画。;2;3;5;18388;0.00027191646726125733
18104;艺术这些精神层面的东东可以被ai取代的话，那么人会被机器人取代也不是不可能;27;3;30;18388;0.001631498803567544
18133;不要谈将来不要谈将来不要谈将来重要的事情说三遍。就看当前看眼下看现在ai自动驾驶，ai自动问诊，为了融资吹得飞起，但就问真到covid了，前面俩哪个做出过贡献的？现在ai绘图实质就是肆意掠夺数据抄袭坑小白甲方。拿着自己偷偷玩的确没问题，但要收钱那恐怕不行。法律问题没解决，使用ai的人素质也堪忧，即便是通过各种灰色手段，产出作品质量依旧低下。就冲着这些问题ai不被信任真的无可厚非。就好比二十八线城市五本毕业的大学生品德不咋地，平时偷鸡摸狗，突然某一天口嗨说一句：“我现在在学XXX，前途无量”，人家用人企业就得给你开个百万年薪了？显然不可能把？人都不行了ai还能有这种鬼畜特权？;1;6;7;18388;0.0003806830541657603
18135;大家真的会喜欢吃了吐吐了吃的东西吗？微笑微笑;5;3;8;18388;0.00043506634761801175
18141;想象一下ai合法化，你几年后看的动画，插画全是ai画的，到以后没有人类艺术家给ai训练，会发生什么;7;3;10;18388;0.0005438329345225147
18152;我觉得应该用发展的眼光看待问题，现代绘画的基础是大量的的手工画师，假如ai作画被广泛的接受以及应用，那必然使得现在传统的画师的生存空间被严重挤压，但同时也会形成新的艺画作创作者，他们会有完全不同的工作方式，像是ai程序员，ai指导师，甚至还会有专门给ai提供图片的绘画师，他们会想尽办法不断完善ai绘画的缺点，他们中的佼佼者一样会创作出令大众满意的作品，而且ai绘画明显会降低绘画的门槛，有可能会吸引更多的人参与到其中来。（前提是法律法规要十分完善）传统的画师的没落并不一定就会导致艺术的没落，ai的引入有可能会给艺术赋予新的创作方式，只要人类对艺术的追求不变，艺术就不会停止发展。当然这种全新的方式究竟能不能更好的带领绘画艺术的发展，是捷径还是弯路，现在都还是未知数。;1;4;5;18388;0.00027191646726125733
18154;我有个项目就是ai绘图的，我也不想搞，公司要弄的;1;6;7;18388;0.0003806830541657603
18158;我反对抄袭和侵权，有本事就让ai不吃图自己画出来;2;5;7;18388;0.0003806830541657603
18161;谁家珍妮机是尼玛盲盒笑哭;1;53;54;18388;0.0029366978464215794
18163;确实，当画画不再思考完全交给ai来处理，那么画画的意义其实就丧失了，画画主要是表达跟写小说唱歌一样，只是载体不一样。如果连表达都用ai来生成，时间长了大家都接受的话。也就达到了快餐时代的巅峰吧委屈;1;5;6;18388;0.0003262997607135088
18165;ai对行业影响的核心是对工作流程的改造，导致生产效率的大幅提升，单个产品所需劳动时间的大幅下降，在市场规模不变的情况下，导致行业从业规模的大幅缩小，最终造成稿酬降低或内卷加剧。侵权等只是行业初期的乱象，反对它不是真正的诉求，换个说法，如果有一天ai解决了所有法律问题，但依然导致大量画师收入下降，你是否能接受？;2;4;6;18388;0.0003262997607135088
18168;艺术品与创意作品真正的价值在于透过作品本身，我们所感受的艺术家以及创作者所付出的心血与灵感，这是能使人们共情的意识的积极的能动作用，带给我们精神与心灵上的愉悦，无论是电影，游戏还是艺术品;13;19;32;18388;0.001740265390472047
18182;一件事情，站队就有利益关系，既得利益者不为自己发声，难道会同情所谓的“敌人”。画师的利益是版权，饭碗，热爱AI的利益，是漫天要价的劣质绘画和难以沟通的美术诉求。永远不会有结果，都是生意，两边都有拥护者和反对者，不要掏钱支持任何一方。就算立法，另一方的利益永远都不会凭空消失;4;19;23;18388;0.0012508157494017839
18188;这就是所谓的降维打击了。历史的车轮滚滚而来，要么站在它的前面被碾成肉酱，要么站在后面成为它的一部分。反抗它就会被毁灭，无视它就会被遗忘。就算AI只能有现存百分之一的学习素材，也是够用的。如果画手选择不管不顾，那么百分之九十九都会被淘汰。如果选择把自己所有作品都封锁起来，那么恭喜，画师们在实质上就已经被淘汰了。毕竟，不能传播的作品还有什么意义？没有意义的作品还需要什么画师？万幸，与那场工业革命不同，二次元壁纸不是必需品，从业者也不会受到轻易导致死亡的反噬。;1;6;7;18388;0.0003806830541657603
18190;被伤害的不止有画师，cos图，建筑渲染图，摄影等等，只要是图片形式都可以喂进去笑哭;1;2;3;18388;0.0001631498803567544
18194;我觉的应该从AI绘画的原理来理解这次危机。AI是通过AI智能（卷积神经网络）来找到一种图像对应的特征（卷积核），也就是说，它是通过结果寻找特征来产生图像的，所以需要喂图和训练。这就暴露了一直以来我们对艺术的理解，我每次看一幅画，都不是只为了看最终的结果，而是看画师怎样一步一步描绘，这才是创造，这也是属于人类的思维，在于过程，在于对世界的观察，而不只是结果，不只是最终的一张图像。数字作品只是AI的一小步，以后数字孪生甚至能代替人。但它真的能代替人吗？肯定不能，我们的一生在于的是过程，在于的是通过环境与经历怎样形成了我们，而数字孪生能模拟的音容相貌和性格特点只是我们的结果。换一个思路，当我们能更规范的使用AI时，是否能真的让我们人类解放，回归到创作最开始的初衷，甚至是人最开始的初衷，去体验过程。;3;3;6;18388;0.0003262997607135088
18198;以前总说机器不会取代人因为他们没有艺术灵魂和创造力现在看来人类自己的艺术灵魂和创造力就在不停衰弱真到机器取代人的那一天时，可能人类自己的审美水平已经降了不少了;1;3;4;18388;0.00021753317380900588
18203;我想问一个问题，同样一副画面，只要作者栏一改，评价就会天翻地覆，这是你们追求的艺术吗doge;3;3;6;18388;0.0003262997607135088
18208;我一个没学过画画但一直很想画画的朋友就特别痴迷于AI作画，他练出来的图我一眼就能看出问题，他经常还喜欢发给我跟我讨论现在AI作画很厉害，这对于我这个刚入门的画师无疑是跳脸级别的嘲讽。他经常用来驳斥我的一个论点就是，他们虽然是用AI生成的图，但自己也付出了脑力劳动，并且强调人类就是喜欢偷懒的，AI只是提高了效率而已。但这显然不对，因为他所谓的脑力劳动只是输入关键词，摆好姿势，而真正画一张图你得从骨架，草稿，线稿，细化，最后才是完成。这其中不仅是脑力劳动，体力劳动也同样付出了很多，AI生成与之相比的确效率很快，但你真的觉得这是你“画”的吗？你所谓的脑力劳动，就好像是用手机点外卖一样，它与真正的厨子做菜，是一个东西吗？;7;4;11;18388;0.0005982162279747662
18217;逆天;6;2;8;18388;0.00043506634761801175
18225;当年汽车发明的时候很多马车夫也抵制了很多年;9;5;14;18388;0.0007613661083315206
18236;藏狐记得围棋Al刚出来的时候，还需要大量人类棋谱来做训练。不过，等发展到阿尔法狗2代时，通过自己与自己下棋，短短几天就击败了一代;2;3;5;18388;0.00027191646726125733
18239;遇到较真儿的人，可告掉你ai小鬼的命啊。;4;8;12;18388;0.0006525995214270176
18247;AI现在未来可以做什么？绘画，动画，写作，读心，办公，设计，配音等，那么，会节省下多少岗位的人力资源？资本不管你人类的创造力如何，资本只追求效率利润，那么，想着和AI斗之前，先想着怎么和资本斗吧。中国我也许不知道，但是欧美发达资本主义国家，这些在岗人员不敢斗的话，还是好好想想退路吧。;1;4;5;18388;0.00027191646726125733
18249;坚决维护画师版权利益，坚决支持AI艺术价值注这两件事才是一致的，不可能一边说AI没艺术价值，一边又要从没价值的东西里要求利益。否定AI艺术价值，混淆画师版权这个根本诉求，是愚蠢落后的。;19;24;43;18388;0.002338481618446813
18270;“好技术本应是可以不损害创作者权利的”;2;3;5;18388;0.00027191646726125733
18278;ai画画就是神经网络，没有人的思维，只是数字算法迭代，这技术发现啦几十年还是不完美，太多人吹过头啦，adobe的ps很早就用过类似东西，比如内容识别，现在的ai用起来非常繁琐，安装就劝退太多人，各种TAG不说，又是模型又是lora，弄半天算出来还问题漏洞一大堆，如果拿去商用修得不好就是笑话;3;16;19;18388;0.0010332825755927778
18284;现在各种私模的过拟合现象真的很严重，都是单独拿画师炼，用雷同来换所谓的画风优化。比如我用抹茶模型，白毛高概率出他画咩栗的那个卷头，用momoko模型画绿毛，高概率出原创角色缘的那个服饰。;2;9;11;18388;0.0005982162279747662
18288;没有人愿意成为原料，技术无罪，但使用者其行为不确定性太大，人人自危而版权意识薄弱。共勉;27;20;47;18388;0.0025560147922558192
18316;与其恐惧不如适应变化。ai对各行各业的影响都很大，不亚于第一次工业革命，并不是只有绘画圈受到冲击。现在最应该做的是制定相应法律，而不是抵制一项新兴技术。很多人还是没搞懂这个问题，盲目抵制。;54;15;69;18388;0.003752447248205351
18371;就算ai不限制，靠脑子和创意生存的画师还是不会消亡。那些靠精度吃饭的才是真正大危机。;3;7;10;18388;0.0005438329345225147
18376;AI画图总共就两个问题，一个是版权，一个是所谓打击行业。听到版权问题我都想笑，你和资本谈版权，谈得来吗？别人腾讯百度啥的家大业大，雇一些画师专门给他们画训练素材，很难吗？可能存在版权风险的只是目前大家都在用的开源的模型，别把人家法务当成吃干饭的。而打击行业，我只能说，时代的车轮滚滚向前，纺织机和流水线没有打击行业，而是把衣物价格一降再降，人人都能经常买新衣服难到不是好事吗？作为用户我只想说ai发展还得再踩几脚油门;18;2;20;18388;0.0010876658690450293
18396;没有人的文明，毫无意义现在这些所谓ai的所谓学习绘画，本质就是洗图，性质和洗钱没区别，洗完了的钱看着干净了它真干净么？洗的人干净么？这种ai的无底线滥用，就是践踏人权，就是反人类，他们还敢反咬一口？以绘画为工作的人，多是凭着信仰，靠热爱去工作的，工作赚那点儿p钱是为了养活自己画画的，那些圣人说什么工业革命解放生产力，只有底层拼接画匠才会失业，放（国粹）p，人家本事是第一批拿ai作品卖钱的头像拼接画小能手，支持ai的八成就是他们，解放个p的生产力，慷他人之慨解放你们盗窃的生产力是吧？真的失业是最可怕的么？对于喜欢绘画的人来说这种洗图ai打击的是绘画过程本身的价值，意义和乐趣，即使顶尖的画师，也会在自己海量低级替代品的干扰下失去热忱之心我是支持ai发展的，但是现在这种ai路子就是走错了，也没保护画师的方式和限制。现在差不多就到头了，ai公司差不多要去祸害下一个领域了，你们猜下一个会是谁呢？;5;5;10;18388;0.0005438329345225147
18405;看个乐，当年画家们认为摄像机抢了他们的饭碗，工人们觉得机器抢了他们的工作。假如他们的抵制成功了，我们今天就不是拿着手机在讨论这个问题。相反我们可能刚忙完农活正准备晚饭的食材，与千里之外的陌生人讨论同一个话题简直痴人说梦。每个时代都不缺乏标榜自己专业的短视专家，最终他们无一例外抱着自己的自负，最终都被时代抛弃了。;4;2;6;18388;0.0003262997607135088
18410;我只能说，总有些既不了解ai又不了解绘画的人在到处叫嚣ai绘画能取代画画真是丢死人了。不知全貌，但是使劲评价藏狐;2;2;4;18388;0.00021753317380900588
18421;打不过就加入吧，还搁这扯伦理，扯道德，扯xx的。道德是用来念经的。新的生产力工具就会有新的工作方式就会产生新的适应生产力变革的生产关系包括但不限于组织形态、社会意识等等。农村有农村的道德伦理，城市有城市的道德伦理。迎接ai的浪潮吧，未来一二十年不会用ai也许就跟不会用智能手机一样;11;3;14;18388;0.0007613661083315206
18433;AI“创作”只有商业价值，没有艺术价值。创作，本身就是拒绝同质化的活动，艺术创作有着其本质追求，源于生活而高于生活，这种追求本身就是反工业化的。ai基于大数据库下的流水线产物最终必然走向同质化，再大的数据库也是现存的数据库，这本身就不是创作，只是生产。所以，别来沾边儿OK;3;2;5;18388;0.00027191646726125733
18443;如果一直这样发展，就没有人愿意学基础绘画。如果全世界一张画都没有，Ai能画什么。;1;2;3;18388;0.0001631498803567544
18445;评论区有些歪了，AI的问题从来不在于技术好不好，而在于谁来用，怎么用。画师自己用，这就是快速成稿的工具，别人用就是剽窃的工具。打个比方，ai就是手术室里的镊子，你是医生拿来用，那就是工作用品，你是小偷，那就是偷钱的工具。而绘画领域只有小偷和医生。;1;4;5;18388;0.00027191646726125733
18451;做出AI的程序员首先就是革了自己和同行的命，那么继续革了你们的又有何不可？本人就是ML从业者，火车必定替代马夫，我也不例外;1;2;3;18388;0.0001631498803567544
18458;艺术绘画和商业绘画本来就是两回事，一个是表达自己的精神世界一个是满足客户的需求。想要艺术，就自己雕琢自己的画别急着想赚钱；想要商业，就面对工厂流水线生产的效率高于手工作坊的现实。真正该谴责的，难道不是逼着画师拼命赚钱、为版权打得头破血流还被资本家抢成果的生产关系吗？;1;2;3;18388;0.0001631498803567544
18460;无所屌谓，ai取代了画师的工作也能取代别的更多类型的工作反正到时候都失业只有资本家乐开花，一起饿死呗ai代替人活着好了妙啊;1;2;3;18388;0.0001631498803567544
18463;这是一个历史性的时期这是一个伟大的时代这是一个冲突与交流的时代这是一个充满机遇与挑战的时代没有硝烟没有炮火有的只是法官落下的法槌有的只是议员铿锵有力的游说有的只是艺术家们团结一致的自卫我不知道下一步会怎么改变但我知道伟大的时期终将落幕一切终将尘埃落定请君耐心等待历史会给出他的答案这就是21世纪是我们的时代;1;2;3;18388;0.0001631498803567544
18466;说到底利益冲突被，那么多跳脚的不就是蛋糕被动了了吗？我是喜欢Ai绘图的起码我现在觉得玩游戏真没有自己不停摸索词条模型画美图有意思，还有觉得艺术底层断代影响基石的也挺逗，既然你们觉得是拼凑的那为何还担忧艺术会被影响？喜欢的只会更加钻研两者结合，至于被淘汰的想必也不是那块料;17;2;19;18388;0.0010332825755927778
18491;前两天看了个帖子，是一个画师给自己的成品图加上了噪点，全图都是，加上以后几本用不了。然后有人基于别的ai算法，直接给那噪点去干净了。ai表示：你们是不是有病？？doge;1;2;3;18388;0.0001631498803567544
18493;AI碾过配音，翻译，数据推荐等行业的时候不见发声，到绘画就开始没灵魂，侵权，大量失业，审美退化，资本垄断了。早去哪了小电视汗;6;2;8;18388;0.00043506634761801175
18500;当年照相机发明确实让好多人失业了，有利有弊吧，现在吃这碗饭的肯定不高兴，长远来看ai绘画的出现是好事。;19;5;24;18388;0.0013051990428540352
18520;只能说确实画画的比下围棋的多呀，当年阿尔法狗出来可不是这样，现在下围棋都不用思考了，直接背棋谱就好给心心毕竟AI能给出标准答案，背就对了;11;4;15;18388;0.000815749401783772
18532;怎么总感觉外国人才干人事呢，ai没出来之前，国内没一点动静，novelai一出来我就想全国各种app的ai都会出来了，果不其然还得说自己原创的ai，研究多少年了。技术研发没见几个，搬过来立马裁员倒是冲在第一线，要不要脸呐。;1;2;3;18388;0.0001631498803567544
18534;捷径在那里，总会有人走的，希望能少点;1;2;3;18388;0.0001631498803567544
18539;ai的训练离不开原始的数据，而许多类型的原始数据的使用就离不开版权争议。就chatgpt而言，使用别人的信息文本即便是公开的）进行训练是否经过了原作者的许可还有楼上提到的copilot，其实和绘画方面的ai版权争议都是同质的。ai领域的版权问题无非两点，一是未经同意使用他人的数据训练是否正确，二是产出作品的版权归属问题。;1;2;3;18388;0.0001631498803567544
18547;快餐图实话说一般也看不到10秒钟，主流还是以短视频为主，画师是弱势小众群体，应当给于保护。板绘终将成为非物质文化遗产记录在于21世纪笑哭;9;2;11;18388;0.0005982162279747662
18562;哪有那么多事，投喂本身就是一种类似人类的学习过程，人类至今所有创作都不是空中楼阁，都有学习前人的地方，但ai的学习效率更强，生产力也更强，导致和旧生产关系产生冲突，这是生产力进步必然的结果，和原来很多手工业抵制机器生产一样，会取代他们依赖的生产方式所以去抵制，但结果怎么样大家都感受到了;1;2;3;18388;0.0001631498803567544
18575;本以为取代体力，没想到取代脑力。造化弄人;1;2;3;18388;0.0001631498803567544
18578;当年农民工匠马车纺织工裁缝酿酒师，哪个不比艺术家更值得被保护？;1;2;3;18388;0.0001631498803567544
18580;大家反对矿卡翻新是因为他是矿却当一手卖高价对于消费者来说ai作品同理;11;4;15;18388;0.000815749401783772
18597;AI绘图让我想起小说《诗云》，或许有一天算法强到能暴力穷举所有风格的所有图片;1;2;3;18388;0.0001631498803567544
18599;保护版权还得看欧美;1;2;3;18388;0.0001631498803567544
18606;为什么没有文字创作者出来呼吁？文字创作者们就想做AI的养料了吗？;10;2;12;18388;0.0006525995214270176
18625;我倒是在考虑一个问题，ai学习风格和初学者临摹画作有多大的区别，换句话说学习的过程是否是罪恶的？这个矛盾根本就不在与吃不吃图，有没有可能本身社会主流的生产关系就已经跟不上日新月异的生产力水平？如果认为ai的兴起不同于工业革命，那么这件事在本质上和工业革命的区别又在哪里;2;1;3;18388;0.0001631498803567544
18630;现在Artstation已经没眼看了，发图的大佬，好图，越来越少。;2;1;3;18388;0.0001631498803567544
18634;最后那句话其实有点问题，我问了很多学机器学习的前辈，一部分人确实是技术改变世界，但是更多的人回答我的是，机器学习是低成本的通用解，也就视频提到的副业和砖家，这一开始就是他们走捷径的目的，或许其中真的有一部人分考虑过画师考虑过作家考虑过很多，但是仍然是他们自己能力可望不可及的，有机器学习这个捷径，欲望驱使下是必然结果而且这东西吧我想了想，现在的AI代码都封装到很简单了，买显卡实名制？看代码实名制？跑AI联网验证？我觉得不可能吧，这东西感觉怎么拦都拦不住，毕竟哪怕CPU都能运行，但是你我都认为这种管的又太死了，不知道怎么监管才能恰到好处。;3;1;4;18388;0.00021753317380900588
18638;那大家可以去玩传统绘画，这个ai一时间跨不进来;2;2;4;18388;0.00021753317380900588
18641;ai真的把绘画这片少有的净土也弄臭了。只要不商用不提版权都好说藏狐;32;3;35;18388;0.0019034152708288013
18674;持中立态度吧，感觉其实就像以前写小说，我这边一发起点，那边就给我爬了。之所以引起这么大争论，只是因为画画这种事，在今年之前不被认为是会被盗版的，只能说是，我好多年前经历过的事了，无奈，但是没法。另外，感觉其实还好，小说被盗版了，那属于纯损失，画手的话，把Ai当个初稿工具，多多少少还能受益，而且和手工艺一样，高端市场不太会被冲击;2;2;4;18388;0.00021753317380900588
18677;为什么要有版权呢，是否以后快进到共享美学时代;14;1;15;18388;0.000815749401783772
18692;团结起来，把全人类的ai使用权送给图库供应商;1;1;2;18388;0.00010876658690450294
18697;人眼看不不出来“斗篷”的话，那写个算法去除人眼看不到的像素点，再训练咋样热词系列知识增加;1;1;2;18388;0.00010876658690450294
18699;不要做梦了。你但凡了解一点AI绘画的原理都不会觉得这玩意儿有用。stablediffusion讲白了就是一个VAE，就是autoencoder然后接一个Unet。Unet本身是抗干扰的，因为这个是卷积神经网络，多层的CNN天然就有图像平滑的效果。然后如果你要针对VAE的encoder做攻击，那其实太简单了，把你这些图加到训练集里面就完事了。不要想着用什么水印啊，加噪音啊对抗AI，AI只需要finetune一下，你们这些方法就立马失效。;1;1;2;18388;0.00010876658690450294
18703;《同时满足肆无忌惮和动力受阻的双人格人》;2;1;3;18388;0.0001631498803567544
18708;我也不希望被取代，关键无法停止人类进步的脚步啊，只要能提高生产力，就会被人类使用，每次工业革命都会被一部分群体抵制，但是都阻止不了，总会被资本用合法途径使用，打不过就加入，我觉得是个好选择。;8;4;12;18388;0.0006525995214270176
18717;没说到点子上。;1;1;2;18388;0.00010876658690450294
18720;up分析的太过于主观，ai问题你要发布在公共场合，很容易造成焦虑和具备煽动性;1;1;2;18388;0.00010876658690450294
18722;这些人是阻挡不了ai的发展的;1;1;2;18388;0.00010876658690450294
18724;誤導一堆，強盜邏輯。;1;1;2;18388;0.00010876658690450294
18727;虽然一部分的艺术家会因此陨落，却点燃了更多普通大众的艺术和创作之魂，一个新的文艺复兴时代正在极速逼近。无论好坏，敬逝去的艺术家们;33;20;53;18388;0.002882314552969328
18763;无非就是现在AI还没有完善而已还是个婴儿呢，一堆人先开始喊打打杀杀了，好像这个婴儿名叫阿道夫一样另外，AI出图难道就没有门槛？;16;1;17;18388;0.000924515988688275
18786;一旦被公司拿到这些素材，其他人画一个他告一个侵权，谁还会去画啊。ai影响了所有行业把任何艺术创作变成版权所有;1;3;4;18388;0.00021753317380900588
18788;AI画没版权？从几十张中选出一张再让画师以那张为形然后重新画一下不就是“人画”的。目前结局已定，就算所有画家不再上传画，光凭现在所有的画就可能让AI到达顶尖10甚至更高的地步。电子AI的时代已经开始了。;2;1;3;18388;0.0001631498803567544
18793;阅文的版权保护就很好。还有百度文库的反爬虫。让ai很难拿到图。从唐三开始，中国现在对版权的保护力度是很强很强的。;1;1;2;18388;0.00010876658690450294
18795;沉舟侧畔千帆过，病树前头万木春。新事物终将取代旧事物，剩下的都是时间问题。所有能数字化的信息未来肯定都能被AI掌握，资本向AI企业汇聚，绝大部分资本被数个甚至一个企业占据，资本主义社会发展到极致。这个过程很难阻止，这是资本主义的发展规律，就是阻止了ai肯定还有别的方式完成这一目标。不过现在AI深度学习其实已经到达设计极限了，到了需要新算法，新模式来突破从学习到创造的桎梏，我觉得未来是真正AI或许是以ChatGPT类似的语言AI模型为主脑，联合多种专业领域AI模型，打造出的超级AI，到那时如果价格合理，资本一定会抛弃手中的人力资本;1;1;2;18388;0.00010876658690450294
18797;ai不是拿别人的画去加工。我不觉得ai学习有问题。画确实是ai画的，模型学习的是特征，甚至是人类无法看懂的各个高低维度的特征，甚至是多个特征纬度的加权求和。人类的画也是学习模仿出来的，只不过少数人可能会有新的风格创造。ai除了不能无中生有，他的学习和人类学生可以看作相似，只是它对于熟悉的数据，不用思考可惜直接过网络得出，我不认为有罪。;18;1;19;18388;0.0010332825755927778
18816;直到万众一心;1;1;2;18388;0.00010876658690450294
18819;每个人都可以选择分享或者不分享作品，分享作品的人可以使用AI，不分享的人不可以使用，这样是不是合理一点，每个人都有选择的权利。;4;1;5;18388;0.00027191646726125733
18825;有了工业化纺纱机，人类设计衣服的能力下降了吗;8;1;9;18388;0.0004894496410702633
18847;能够被取代的艺术家不是艺术家，只不过是重复机械过程的手工业者，把他们从工作中解脱，去做更有意义的事情出来显然是好事审美判断不应该被客观上的可能性所限制和强迫，若选择不是越多越好，那一定是选项之外的东西出了问题追根到底，所有的创作，都只是多了一个在ai的基础之上进行的选项亦有可能是在比AI更高的层面之上进行。;5;1;6;18388;0.0003262997607135088
18857;感觉被威胁，担心被取代的是画匠而不是画家，真正的大师会引领艺术风格绘画流派，而不是相仿设法制止和他画风相近的人。你能想象毕加索起诉每一个抽象派画家抄袭吗？;5;1;6;18388;0.0003262997607135088
18866;淘汰了那么多职业，到了绘画就不行了？绘画高贵一些？;5;1;6;18388;0.0003262997607135088
18877;AI的话题其实就是科技进步导致的人工换代的老问题了，但是现实里机器代替人工需要很长一段时间来适应和发展，AI这种基于虚拟产业的东西发展起来太快了，目前已经到达了一个临界点，这时候需要的是一个控制而不是断绝，这应该是很多无脑挺或喷AI的人没有想过的。AI绘画的正确运用方式其实是大场景的生成，尤其是大世界那繁琐而重复的景象，比如森岭，湖泊，大陆，大海，甚至是星空。打个比方一本异世界小说，完结后光看文字你统计起来，可能主要角色都寥寥无几，基本上非必要的人物和场景统统都不会出现，不是有重要戏份的更是一笔带过，跟现实差距太大了，你以为作者不想搞得更详细吗？是没那个时间和精力，换成漫画或者更好理解。AI绘画能让各种打斗场景不再像是村口斗殴，灭世之灾真正体现出灭世感，让作者能够真正创造一个广大而充盈的自定义世界，而细节部分和重要关节，比如主角团和重要地标建筑等，则是需要人工进一步设计改进，这才是AI绘画理应走向的道路。;1;1;2;18388;0.00010876658690450294
18883;还是ai画的和原作太像了，有的几乎一模一样，相当于是有人把临摹甚至描图的图直接当做原作发出来了，你看原作者冲不冲;1;1;2;18388;0.00010876658690450294
18887;现在是AI初现原料好多，让人无所谓，当搅拌机多了，这些图一遍遍被炼而原料们被饿死了之后，大家都长一个样真的不是梦想。当然未来肯定不会这么极端，除了直接生成还有辅助绘画，AI辅助绘画把绘画的艺术和技术部分分离了，人出线稿AI填色或者画个差不多AI优化，可以做到虽然画风差不多但是好歹是个新玩意，这种操作不掘根但是在根边刨土，我不好说AI未来怎么样，但最好不是现在这样。;1;1;2;18388;0.00010876658690450294
18891;想要真正抵制ai绘画，什么都是假的，还灵魂，美国政府连有毒泄露都轻描淡写处理，你觉得他们会在意所谓的“灵魂”？有多少画师抵抗住加个零，不够再加的诱惑？他不要赚钱，不要生活？你真想让这股风吹过还无事发生，最有用的方法只有一个，证明ai绘画没有未来，没有价值，无利可图，不然你的任何抵制终归只能减缓，不能让其停下;1;1;2;18388;0.00010876658690450294
18893;说说我的见解。有句话叫物以稀为贵。在AI出现之前，优秀画作数量有限，创作一幅好的画能带来比较高的价值和个人魅力。一旦AI加入后，泛滥的AI画作会像地摊文一样迅速贬值。到头来，没人愿看画，那些只会用AI作画的人还是会像现在一样什么都捞不到，所以盲目地支持AI作图本身就是损人不利己的事。;15;1;16;18388;0.0008701326952360235
18910;技术不够就不要强行去分析图片好吗？整个视频就毁在最后半懂不懂的评论金亨泰ai生成改的图。后半段是对的前半段扣死细节和脖子过长就是错误的。首先这幅图的完成度就不高扣细节来说就是抬杠。第二脖子透视没问题但凡你自己去3D拿两个模型摆个角度跑一下都不会说出这种话藏狐;1;1;2;18388;0.00010876658690450294
18915;纺织工人砸织布机而已;24;1;25;18388;0.0013595823363062867
18940;无解现在很多小画师画的还不如ai被ai取代是迟早的是说劣币驱逐良币的到底谁才是劣币如果ai能解决版权问题那些凑数的小画师真可以退役了;1;1;2;18388;0.00010876658690450294
18945;qsj无产者联合起来;2;1;3;18388;0.0001631498803567544
18951;画画对我来说是学习之外为数不多的乐趣，个人也报了几个班来学绘画。最近也试了下ai绘画。很多画风确实能看到一些大佬的影子（记不得名字捏），接触ai是因为专业是城乡规划，在我的专业领域，ai能通过体块直接生成渲染图以带给设计师灵感我觉得是很利于生产力的方式。由于本人是个动漫爱好者，在试了下建筑渲染之后也就尝试了下ai绘制二次元。我的评价：不拿来盈利，自娱自乐还是行的，自己当当壁纸用确实不错（）但是别拿去碰瓷大佬，或者说ai发展到以后替代大佬。但是艺术肯定不会因为ai绘画而停止发展，但是确实会影响很多设计、绘画行业的低层次工作者（比如未来的我），但是成为行业大佬是需要时间的，循环下来行业大佬是否会在未来数量下降？;3;1;4;18388;0.00021753317380900588
18959;我不认为AI会让人类失去艺术创造能力，我反而认为AI反而会促进艺术，AI垄断了商用艺术，但从此以后依然愿意学习并自行创作的人将会更加纯粹，人会完全以内心的真实想法和纯粹的喜爱进行艺术创作，或许不一定能比得上AI，但人的艺术从此纯粹了;4;1;5;18388;0.00027191646726125733
18971;我提一嘴，ai绘画冲击市场后我觉得一些以前不画高价钱学不到的绘画技巧，会以更低的价格被大伙儿学到，应该也会促进大伙儿的绘画水平进步;2;1;3;18388;0.0001631498803567544
18974;怎么我连一个字我都发不出去啊？;1;1;2;18388;0.00010876658690450294
18977;我不明白有几个美术毕业的会从事本专业。像我一个小画手，低端画师，毕业已经上岸去体制内（市土木局）写资料。同班同学也都没从事本专业，有和我一样考编的，有考研的，有继承家业，甚至有销售。现在都在为生活忙碌着，没有画画了。在此之前美术专业和会计电子商务毕业就失业大部分。AI绘画冲击的新学生，减少这行的入坑数，转行其它的，加大其他行业的就业压力。;3;1;4;18388;0.00021753317380900588
18982;唉，无非是卢德运动的重演，到头来什么都改变不了;2;1;3;18388;0.0001631498803567544
18987;反正搞艺术的失业为了活下去肯定会去别的行业工作。到时候卷的勃勃生机的样子千万别叫啊。这点道理都想不明白就搁那边解放，以后被裁员惹，找不到工作惹，叫的又比谁都大声。;1;1;2;18388;0.00010876658690450294
18990;刘慈欣有一篇小说叫做诗云讲的是一个老师和一个如上帝一般的外星人讨论古诗的美老师认为只有人能把文字配列组合变成诗但是上帝却用机器无限穷尽了所有文字的排列组合然后再让系统检索出有用的;6;1;7;18388;0.0003806830541657603
19002;倘若AI技术继续发展下去能画的比人类好，那为什么不用AI呢？但目前我持观望态度，毕竟AI要真这么厉害那还至于跟画师抢饭碗？;1;1;2;18388;0.00010876658690450294
19004;生产力的提高和生产技术的升级会让人过的越来越好吗答案是会的就像骆驼祥子从人力拉车变成了滴滴司机和外卖快递小哥脱单doge当然你可以说那我的快递外卖越来越快了呀但是你自己的行业呢比起对技术的欢呼雀跃你还是要想想你作为无产者的劳动权益吧;1;1;2;18388;0.00010876658690450294
19009;ai只是工具，工具需要人去使用，需要人的思想去指导，思想才是魂，重复的劳动不是魂就像放几十年前，电脑绘画，素材复用，贴贴图，3d辅助可能都没办法让人接受，你画画不做到一笔一划，这里贴个贴图那里贴个素材，甚至背景太复杂干脆不画了直接贴一张渲染图，简直是在玷污艺术然而现在3d辅助，贴图，素材复用已经被广泛接受了;3;1;4;18388;0.00021753317380900588
19018;一项新的技术，过新过快的技术，没有法律，道德，使用主体的素质同步提升，注定会互相牵制，随时间慢慢制衡，但过程中个体损失很难挽回了;1;1;2;18388;0.00010876658690450294
19021;蒸汽革命，电器革命，信息革命，都有人觉得科技让人退化，然而事实上所谓的危机更是转机，时代大势所趋。抵制AI就是抵制科技，落后的结果造成的结果是啥？挨打相反AI给予人们打破历史怪圈的希望;1;1;2;18388;0.00010876658690450294
19023;照相技术出来的时候，画家们也抵制了吧;2;1;3;18388;0.0001631498803567544
19026;如果某位画师的艺术能被AI击败那某位画师的作品也不能称上艺术;11;1;12;18388;0.0006525995214270176
19044;在我看来，艺术被影响只是表象，设计类才是真的会被冲击烂。随着ai借由绘画敲开进入产业的门，人们会发现只要有足够的参数和模型，ai可以胜任所有设计类行业包括但不限于建筑，绘画，品宣。并且因为高效以及与大数据联动，他的表现一定会优于人工。不过ai受限于人，在人自尊的作用下设计大师仍是设计大师不会受到多大影响，但是行业中坚会收缩内卷化。;1;1;2;18388;0.00010876658690450294
19047;限制不了的，始终有人会用，ai大大拉低了部分创作下线;5;1;6;18388;0.0003262997607135088
19058;不是有没有灵魂的问题是ai生产本质只是基于已有素材库进行拼接的重复性劳动而素材库里的素材都是人类生产的创新内容后者是根前者只能算叶叶子想和根抢资源算是什么事？;5;1;6;18388;0.0003262997607135088
19064;就在昨天，我才因为ai绘画的问题跟一个程序猿从十一点吵到凌晨两点，结果对方的看法是艺术创作可以像流水线一样量产;6;1;7;18388;0.0003806830541657603
19077;ai冲击了艺术品高居不下的价格，触碰了那些艺术家的蛋糕。ai被群起而攻之也是可以想象的，挡人财路如啥啥啥。这群人的反抗给我一种卢德主义的反智感;1;1;2;18388;0.00010876658690450294
19079;建议发明一个ai论文软件，可以给不会写毕业论文的大学生们一键自动生成论文，既解决学生毕业问题，又解决导师完成任务问题，何乐而不为呢吃瓜;2;1;3;18388;0.0001631498803567544
19085;限制不了，一到两分钟就能生产一张高效且有质量的，而且看这个趋势，再过一两年就能把现在的缺陷弥补在大的生产力面前，这些都是徒劳的只能想想怎么出台并细化ai相关的法律，规范ai;4;1;5;18388;0.00027191646726125733
19093;我幻想中希望有这么一个东西，能向原创作品的数字信息里打上人类肉眼看不见的水印或其他反AI洗稿的印记，结果会导致AI图生图出一堆马赛克;1;1;2;18388;0.00010876658690450294
19098;当汽车被发明出来时，神父将其称为无马怪物，农妇吓得跪地祷告你们跟这些人有啥区别;26;1;27;18388;0.0014683489232107897
19126;自从我五年前高中时代看了《未来简史》和《今日简史》以后，我就已经知道这种天下大势不可逆转，现在里面很多预言都已经证实了，而我一直在为了这些做着准备。弱者惧怕变革，强者利用变革。;3;1;4;18388;0.00021753317380900588
19132;我只能说用ai画出来的东西都算是我画出来的脱单doge;3;1;4;18388;0.00021753317380900588
19136;up的背景音乐似乎侵权了吧？;17;1;18;18388;0.0009788992821405265
19154;可是很多底层画师，我们不是为了赚钱去画画的，我们是因为热爱去画画的。别说什么取代底层画师了;2;1;3;18388;0.0001631498803567544
19160;有没有一种可能，垃圾短视频泛滥的现在早就到你说的那种时候了tv调侃所以那句话怎么说来着，当什么什么的时候不闻不问，结果落到这玩意儿头上时已经没有人能帮忙了。我是觉得没啥担心就像现在的短视频，低技术力存在满足更多人但任然有去找高质量图画的。;1;1;2;18388;0.00010876658690450294
19175;额，问题是画家也是从临摹开始的，大不了都拿没有版权的素描，油墨画，自己的照片生成算了，不然艺考也是哪来的，让AI没有版权就能解决这个问题。;5;1;6;18388;0.0003262997607135088
19184;ai所带来的失业风潮也是事实，评论底下总有隔岸观虎的人;1;1;2;18388;0.00010876658690450294
19189;就我看来，ai绘画取代部分画师的趋势是不可阻挡了，这两天才有兴趣了解相关程序，让我惊讶的是ai绘画发展速度非常之快，很多现在的缺点和诟病之处可能在明天或者后天就被消灭了，祝大家好运。;1;1;2;18388;0.00010876658690450294
19193;一个搬运广播剧做blender不会画画的突然变成反AI战士，很难不让人怀疑是不是来蹭热度包装自己的;2;1;3;18388;0.0001631498803567544
19197;感觉大部分拿到ai的人都拿来生成黄图了呆;6;1;7;18388;0.0003806830541657603
19204;老哥，后续呢;1;0;1;18388;5.438329345225147e-05
19209;从大家的开源代码中学习，最终生成的copilot，在种种争议过去之后，已经有越来越多的程序员开始认可它了。因为它能提高效率。绘画也将是如此，尤其是各大公司的游戏组。;1;1;2;18388;0.00010876658690450294
19219;成果不能全民共享那又有谁站在它们那边;3;0;3;18388;0.0001631498803567544
19223;不考虑侵权的情况下其实很难考虑AI图像是否有版权啊？AI作图在原理上和ps之类的电子软件没有本质区别吧：你在ai上输指令，和在ps上开个文本框输东西然后导出，都是用户输入文字，算法生成图片，怎么能界定非人类创作的界限呢？如果ps里面有ai调光算法呢？;5;1;6;18388;0.0003262997607135088
19229;我不信AI不会创新等着吧;1;0;1;18388;5.438329345225147e-05
19231;我了解过一些计算机加密没有原密钥就不能复原，这个釉料是不是同理？;3;0;3;18388;0.0001631498803567544
19235;额，电子绘画这种商业性质的东西原来也叫艺术了嘛。。。;3;1;4;18388;0.00021753317380900588
19241;昨天跑了一张釉料图doge结论是没什么卵用，照跑不误;3;0;3;18388;0.0001631498803567544
19247;人类学习不比机器学习更高尚，技术本身也是无罪的。关键是监管，不能从技术上解决的就要从法律上解决。;2;0;2;18388;0.00010876658690450294
19250;这个声音听起来是AI生成的。。。一直有种奇怪的段落感，说话大喘气;1;0;1;18388;5.438329345225147e-05
19252;《著作权法》第二十四条在下列情况下使用作品，可以不经著作权人许可，不向其支付报酬，但应当指明作者姓名或者名称、作品名称，并且不得影响该作品的正常使用，也不得不合理地损害著作权人的合法权益：（一）为个人学习、研究或者欣赏，使用他人已经发表的作品；容易发生争议的是：1“为个人学习研究而使用”有人认为AI不是人，所以不能援引该条。但AI背后始终有操控它的人，AI的使用者学习研究原作风格的目的，不因其使用了AI工具而被否定。2“不得影响该作品的正常使用”在AI学习中没有直接涉及，典型的例子如“以学习的名义对作品进行垄断和排他性的占有，导致他人无法正常使用”3“不得不合理地损害著作权人的合法权益”该条比较模糊，如果认为AI学习使用类似风格对著作权人构成竞争，损害了著作权人使用原作品进行盈利的财产权，能否认为这是“不合理损害合法权益”呢？但就二十四条第（一）项的立法目的而言，本意就是认可“学习模仿而成为竞争者”是合法的，因为人类文明得以发展而不是原地踏步或从头再来，所依赖的就是学习、积累、继承前人的智慧和成果。如果认为AI学习、模仿、竞争不合理，那么人类学习、模仿、竞争为什么就合理？仅仅是因为AI学得特别快特别好，就从合理变成了不合理吗？;3;1;4;18388;0.00021753317380900588
19256;吃瓜律师画家教师这些偏向于思维思考的工作被ai直接击溃，纺织食品建筑这些偏向制造业的行业反而几乎没有受到影响真的很搞;1;0;1;18388;5.438329345225147e-05
19258;个人理解ai绘画和画师的画，比较类似于工业品和手工品;1;0;1;18388;5.438329345225147e-05
19260;如果艺术家自己用自己的或者得到版权的人的图像练成的AI创作出来的作品再加以或多或少的修改，这样是否拥有版权？;1;0;1;18388;5.438329345225147e-05
19262;开头的那个加噪点当时我就觉得不靠谱，图稍微压一下，不就全没了吗？果然现在发布了，要么噪点少，ai依然还能识别，要么噪点多，已经到了肉眼可见影响原画的地步，但是也依然有办法跑出来。甚至还有人直接做出了去噪的软件，这才几天啊，就把去年吹了这么久的防ai技术给破解了。;9;0;9;18388;0.0004894496410702633
19272;像不像年初战地一的赛博大战;1;0;1;18388;5.438329345225147e-05
19275;立法保护版权往往不是创作者受益;3;0;3;18388;0.0001631498803567544
19279;对于绝大部分人和（目前）社会需求中，即使是过度拟合也足够应对绝大部分问题。以文员表格来说，绝大部分表格都是在百度照抄，轻微修改。这种技术的诞生，生产出来的作品，有必要也必须表明生产品为ai生产品。但是道德下滑恐怕是注定了。;2;1;3;18388;0.0001631498803567544
19284;如果ai解放了一切劳动，那不就不用担心物质，而去追求向往的东西了吗？人的创作似乎在数学的解构下面临更大的挑战了。ai作画这个技术注定是无法被阻止的，我也支持。唯一需要考虑的就是法律权责划分了。巴不得ai能解放每一个行业。当然，从实业生产开始解放可能会更好？或者应该同步进行？;23;0;23;18388;0.0012508157494017839
19308;ai也是一种艺术，人类用数学的方法，计算机作为工具，就能实现对一切事物的学习和再创造，对人类自身的模仿，这就是一种艺术。但是现在的ai绘画原理上只是抄抄抄，确实不太行，希望以后能出现像alphago一样独领风骚的ai。打了很多字都删了，要说太多说不完了，希望以后能发明一个评论区ai能帮我把我说的话全部写出来;1;0;1;18388;5.438329345225147e-05
19310;我觉得只要把ai生成的强行标注就ok了，还有就是赶紧把手指什么的画出来，然后自动写本，将本内容画出来，我就可以用ai生成本子了，符合自己xp的本子多是一件美事啊;2;0;2;18388;0.00010876658690450294
19314;看这个视频，我想到了《银翼杀手2049》的女警长和女boss的一段剧情，大概就是这么美好的又先进的东西，你们却想扼杀它;1;0;1;18388;5.438329345225147e-05
19316;我的东西，我不想乱给别人用，难道是我的错吗？难过;1;1;2;18388;0.00010876658690450294
19320;作为一名AI模型，我认为不应该全面抵制AI，因为AI技术已经成为我们生活中不可或缺的一部分，并且为我们的社会带来了许多好处。AI技术可以帮助我们解决许多复杂的问题，例如医学诊断、交通管制、自然灾害预警等等。此外，AI技术还可以提高生产效率，改善环境保护和资源利用，提高生活质量等。当然，我们也需要关注AI技术带来的一些潜在风险和挑战，例如隐私泄露、算法歧视、就业机会变动等。因此，我们应该采取适当的措施来规范和监管AI技术的发展和应用，以确保其对人类社会的利益最大化。总之，我们不应该全面抵制AI，而是应该认真评估和平衡AI技术的好处和风险，并制定适当的政策和措施来推动其发展和应用。;3;0;3;18388;0.0001631498803567544
19324;好事，画师团体和公司们打的头破血流，真正为了探索这门技术的人从开盲盒发展到了动画电影，甚至以ai为核心的产业流水线。你们在为了名声和金钱争吵时，有人在和ai一起学习，真正推动ai绘画进步的人正毫无阻碍的前进。;67;1;68;18388;0.0036980639547531
19392;十年后可以告诉我吗，人类赢了吗？;3;1;4;18388;0.00021753317380900588
19396;支持up主，视频做的挺好的，就是节奏有点慢，内容有点硬核笑哭;1;0;1;18388;5.438329345225147e-05
19401;网易已经快实现ai化了，预计裁员至少60;1;0;1;18388;5.438329345225147e-05
19403;ai会得到最终的胜利，它的优势在缺陷面前不值一提，它能带来的利润太多了，这就像是没有万有引力号援助的地球，最终一定会被三体占领;7;1;8;18388;0.00043506634761801175
19415;就我爬出来的数据看，ai图似乎更容易在社交平台上传播。主要关注的ip是赛马娘，以20个账号，20006000粉丝级的基础，ai图达到万赞的时间只有人类画师的三分之一左右。原因我还没太想出来;1;1;2;18388;0.00010876658690450294
19417;你们画家可以将所有的绘画弄成不收费不让看就行了。吃瓜加油。用人力挑战科技，我相信你们的。;14;1;15;18388;0.000815749401783772
19438;对像素点的计算机语言进行加密篡改，这并非长久之计，只会演变成攻防战，还是得看法律怎么办，但不管怎么说，这个盒子打开了，也就关不上了;4;1;5;18388;0.00027191646726125733
19479;想一想工厂吧，机器越高级，生产力越强，需要的人力自然越少，那时候工人难道没有闹过吗，目前这情况也一样的，但是这对于生产厂商来说很好，节省了人力，还增加了生产力，但是你的工资可就没有这么高了，创作行业还会是高薪职业吗，商品的增加，价值就会相对减少，就拿游戏来说，未来可以以更短的周期，更少的成本进行开发，更新，定价比现在更低廉，那我作为一个玩家自然很开心，至于担心什么人类艺术岌岌可危，我就这么说，ai是个更加专业的工具，在专业的人和非专业的人手里，出图差距会非常明显。而美术把关的人自然也是专业的，而且会有越来越多的人出来科普那些不专业的人出的图哪里有问题，这难道不是全民提高艺术鉴赏吗，不想被时代抛弃的人，就努力提高自己吧，祝各位好运;4;0;4;18388;0.00021753317380900588
19487;没啥用，前沿技术除非被立法禁止，单靠某个群体来抵制效果约等于零，而ai绘图这玩意更是离谱，不少模型都在开源社区里，获取门槛相比其他技术低一个级别，你让全部国家都立法禁止才能有效果，还得是全部严格执行才有用;17;0;17;18388;0.000924515988688275
19508;反正公司已经没有原画岗位了。。。我也干脆准备转行去国外碰碰运气了;1;0;1;18388;5.438329345225147e-05
19522;上面都在说ai怎么怎么样，大众，怎么怎么样，我觉得吧，永远不要以自己的水平高估或者低估其中的任何一方才是关键。时代必然变化，我们也必须顺应，多少年前人们就已经在恐惧机器替代工人。迟早有一天现在所有的工作都会被逐一替换和重构，指望靠单一技术能活一辈子才是天真的想法。说实话，恐惧ai绘图，不如在技术成熟规范清晰后规范使用。经济实惠，多快好省的工具在商业环境下必然替代绝大多数落后产业。说白了，时代进步总是需要牺牲品的，这个人是你是我只是时间问题。;13;0;13;18388;0.0007069828148792691
19551;今天是绘画，明天是什么？;3;0;3;18388;0.0001631498803567544
19559;工业化本来就是这么回事，被代替有什么奇怪的，说不定以后把你们这些想法说成是精神内耗，人活着需要思考只是少部分时间。;11;1;12;18388;0.0006525995214270176
19574;目前还是没法细看，但已经一大堆ai接稿的了;1;0;1;18388;5.438329345225147e-05
19583;ai和画师从来没有矛盾有矛盾的是偷画师的图拿去喂ai的资本且不提ai的生图原理，资本用0成本几秒钟做出来的图让人花几百上千块买，谁会愿意？我个人是觉得拿ai生成点自己喜欢的图没问题，分享点生成出来的美图也没问题，但是好像有人拿着ai图说是自己画的还嘲讽普通画师，更甚者拿去约稿商用，这种人非蠢即坏他们自己开心就好蛆音娘卖萌;1;0;1;18388;5.438329345225147e-05
19595;图片打满水印，能防止被AI拿去用么？;1;0;1;18388;5.438329345225147e-05
19602;虽然很替你们难过，但AI一定是大势所趋，所以还是加油吧嘉然笔芯;1;0;1;18388;5.438329345225147e-05
19604;手机拍屏或成潮流。。。;1;0;1;18388;5.438329345225147e-05
19609;现阶段碍于制作，研发等成本，其他行业暂无AI大面积替代劳动力的情况，且有部分是现在劳动力成本低廉甚至溢出所导致。倘若基础生产力与根本劳动力不足，亦或者AI成本远小于人力成本的时候，AI势必会成为一个具有大好前景的存在。到那时，人只会越来越少了，因为活着的都是“过剩”劳动力，是被淘汰的旧零件。我们的悲哀在于大多数人们并没有产权意识和文化概念。也不在乎什么是人类文明而不是类人文明，而当他们也被取代的那一刻，方才会觉醒罢。想起了鲁迅先生书中的比喻，人血馒头固然是极好吃的，这热闹也是极好看的。;1;0;1;18388;5.438329345225147e-05
19619;我浅浅说个破解方法，拍照。;4;0;4;18388;0.00021753317380900588
19633;你觉得世界上有百分之五的懂艺术吗？;2;0;2;18388;0.00010876658690450294
19636;我有个疑问，人可以学习大师的画作，那么让ai也学习有什么问题？为什么要说侵权;3;0;3;18388;0.0001631498803567544
19648;AI绘图，大家听了都很兴奋，很兴奋（除了从业人员doge）;1;0;1;18388;5.438329345225147e-05
19660;神啊，你为什么不毁灭我们？;2;0;2;18388;0.00010876658690450294
19663;如果能把人脑记忆的图提取出，和ai训练包里应该是差不多的，都是别人的东西。;2;0;2;18388;0.00010876658690450294
19669;支持ai还不如支持取消版权法呢;1;0;1;18388;5.438329345225147e-05
19676;AI不是洪水猛兽，做好版权保护的基础上，让科技带来制作管线的革新，将人们从重复劳动中解放，更多的专心于创作。所以拥抱变化，拥抱未来。;1;0;1;18388;5.438329345225147e-05
19682;ia取代大部分人，这些人就能团结。ai取代小部分人，这些人会被孤立。;1;0;1;18388;5.438329345225147e-05
19700;1个月前都在用了，大部分公司早都跑通了。;1;0;1;18388;5.438329345225147e-05
19705;从长期来看，跟AI搞对抗，纯属吃饱了撑了，不求上进，跟美中贸易战没什么分别。当然，我也承认，艺术家的既得利益和预期利益，在一定程度上需要被保护。主要AI还是来得太猛了，一时没法适应，才出现激烈冲突的处理手段。;1;0;1;18388;5.438329345225147e-05
19707;这就像蒸汽机发明之初，帆船公司抱团反对蒸汽船一样。还是积极拥抱变化吧。;3;0;3;18388;0.0001631498803567544
19711;艺术机械化降低艺术成本，卷死小作坊;1;0;1;18388;5.438329345225147e-05
19713;手工业早该被淘汰了;1;0;1;18388;5.438329345225147e-05
19717;技术进步必然带来失业，历史上无数次上演的故事怎么就看不明白。你我都是代价本身;4;0;4;18388;0.00021753317380900588
19725;但是就算是这样，真的想自己画的人还是会自己去画的。现在说AI绘画毁了他们的生路的，多半都是有借自己的作品去牟取利益（物质的也好、精神的也好）的成分;10;0;10;18388;0.0005438329345225147
19740;我认为AI不会导致什么审美退化，思维退步。新的东西会产生，新的艺术会出现。以前超乎想象的东西不再触不可及。;14;0;14;18388;0.0007613661083315206
19762;一个孩子，站在十字路口，他学习到了汽车的样子、衣服的样子、人的样子、房子的样子、树的样子、鸟的样子，孩子回去以后基于学习到的东西后，把学习到的东西画在一副画上面，，所以，这个孩子错了吗？脸红脸红;3;0;3;18388;0.0001631498803567544
19772;你知道么，ai是能自主学习并开始自主创作的。不要和我说是模仿。所有的艺术前进都是在前人的风格画面上不断地极其缓慢的进步。举个例子，ai小说。这就好比，外卖员看了无数的大厨的厨艺，在不断的训练里学会了做饭做的还比所有的厨师好，因为这个外卖员他不会失误，而且能把所有的厨师的优缺点综合起来，最后变成了完美无缺的超顶级厨师。而且这个超级厨师是无数多，那么还会有人吃那原本的厨师的饭菜么？？;1;0;1;18388;5.438329345225147e-05
19775;当人人都可以用AI作画的时候，我们的社会势必会产生大量的绘画师群体，有助于我们整体审美的提升。它对于技的要求降低，对于艺的要求反而提高类似于工业革命的产生，解放的是人的双手，当然技术革命初期的阵痛必然产生，长久来说确是有利的。;26;0;26;18388;0.0014139656297585382
19821;社会主义的本质是解放生产力;3;0;3;18388;0.0001631498803567544
19835;残疾人就不配表达艺术了吗，一个残疾人艺术能力丰富，但因为身体残疾不能画画，ai对这些人来说，不就是好事吗;10;0;10;18388;0.0005438329345225147
19856;三百年前，随着工业技术的发展，手艺人变成了工人，三百年后艺术家为什么不能变成艺术工人。;13;0;13;18388;0.0007069828148792691
19872;如果机器制造被广泛认可了可以说人类就会迎来一次动手能力退化同时也证明了直接利益可以代替艺术追求以后各个领域的事件会越来越多人变成不会劳动没有追求的溺水猪的时代也就指日可待了。不太认同;5;0;5;18388;0.00027191646726125733
19883;人类之所以是人类便是那宝贵的想象力与创造力，而现在有人居然想将它让出来微笑;1;0;1;18388;5.438329345225147e-05
19894;小画家的末日;12;0;12;18388;0.0006525995214270176
19908;这个东西已经存在了，没办法扼杀掉了，人都是逐利的，被大规模广泛使用也是必然的，没有谁的岗位会被取代，喜欢的还是会去研究的，我感觉在不久的将来AI从文本到游戏都可以代理，这样设计游戏的成本将越来越低，那时的游戏电影我想应该会百花齐放;1;0;1;18388;5.438329345225147e-05
19910;我觉得ai反倒会让设计从业者更疯狂的去挖掘自我和追求创意性，在目前设计同质化如此严重的时代，设计从业者越来越不愿意动脑，就可以获得丰厚的利润，这部分人已经把自己沦为了复制机器，那么AI来代替无可厚非；如果把复制抄袭的门槛降低，倒逼设计和独创性，会促成更多设计师的寻找新目标。技术并不会杀死艺术，艺术一直都是与人性挂钩的。;1;0;1;18388;5.438329345225147e-05
19912;我一勺三花淡奶下去，大哥沉默了你这不是骗人的吗？要不你这店咋开不下去呢？;1;0;1;18388;5.438329345225147e-05
19917;欺负艺术家没文化，防御效果好坏不说，像这样搞，艺术还纯粹吗？;4;0;4;18388;0.00021753317380900588
19928;bgm是什么啊;1;0;1;18388;5.438329345225147e-05
19933;资本家并不是画师的敌人，开源社区才是。资本家和画师本质上都是认可版权吧，但开源社区满脑子只有技术，打破头也没想明白为啥我免费还会被人搞。当没人回答免费违法的问题时，开源社区就会成为对画师更恐怖的威胁;2;0;2;18388;0.00010876658690450294
19936;ai的学习过程和人其实是一样的，但是两者的不同在于人可以遗忘一些东西，ai则不能。就像学习绘画一样，人照着前人的画反复临摹练习，ai也用前人的画练习。但是区别在于，人每画的一张画，上面的笔触，颜色都是世界上独一无二的，在创作的过程中，永远无法画得和临摹作品各方面完全一样的效果，只能无限的接近。但是ai却可以一模一样的弄一张出来，缺少了遗忘的变数。我认为创新的变数就在于遗忘中。;1;0;1;18388;5.438329345225147e-05
19939;AI挺好的，对普通人来说可以满足很多;5;0;5;18388;0.00027191646726125733
19946;说一千道一万，就是AI绘画会抢了画师饭碗的问题;8;0;8;18388;0.00043506634761801175
19961;可不可以让艺术家给AI公司授权，然后用户生成图片会给出每个艺术家的风格占比，再通过算法得出商用需要付多少钱，自己玩不收费，如果拿去传播，则需要付费;5;0;5;18388;0.00027191646726125733
19969;我有个问题，既然人眼能够识别出这些“被保护”的图片，那么是不是理论上机器也能用相同的方式来识别出人眼看到的效果;5;0;5;18388;0.00027191646726125733
19979;我就问一下，如果有画师不画了去学人工智能了怎么办？现在AI画没有图层，不会画手脚。但大家都知道这个迟早能解决。现在AI全是计算机出身的人弄的，简单的说就是不懂绘画的知识，但如果艺术生转人工智能了，然后还成功了撇嘴撇嘴;3;0;3;18388;0.0001631498803567544
19988;AI的追上人类只是时间的问题;3;0;3;18388;0.0001631498803567544
19994;如果真正有独到的不可替代的价值，且被广泛认可，为什么会害怕被替代？实际上大家都是沉浸在幻想中自我满足罢了。可以用机器为什么要用人工，就凭人工更细，可以把稻谷收割得更干净吗。还是那个简单的道理，适应环境的人才能生存。;1;0;1;18388;5.438329345225147e-05
20000;主流观点是生成图像不是作品，极少有用“人工智能创作作品”描述这类生成物而更多用“人工智能生成图像”，版权法和著作权法对创作者的基本要求是自然人问题在于生成图像和训练集之间的独创性表达是否存在关联，将训练集的思想和表达区分后生成图像再次展现的到底是其中的具体表达（reproduction）还是思想（adaptation）如果国内能组织起一场开发者画师版权法学者之间的对话，应该能厘清很多可版权性和权属认定的问题;3;0;3;18388;0.0001631498803567544
20012;支持画家保护自己的画作，也支持ai绘画的发展，使用计算机程序的人没资格非授权使用他人画作训练，但是在拥有完整所有权的情况下，我们同样也没有资格去干涉程序员进行开发和训练，例如绘画和程序开发同属一个团队，那么出品的图片依然没有侵权嫌疑，甚至可以说是团队的共同作品，支持正义出图。但是对于那些私人盗图并训练ai出图的，必须追究责任，预防对于画师本人来说也是不可避免的。私人出图的情况有点复杂，难道不用于商业就可以随便训练ai了吗？;1;0;1;18388;5.438329345225147e-05
20019;AI学会了和环境交互，它也会自己创造人类已经走到末途了;1;0;1;18388;5.438329345225147e-05
20021;不大懂版权啊，但是如果大公司花钱请人绘画来训练ai模型呢？比如雇一个画师画很多成品并且用这些画训练模型，之后模型生成的画再让这个画师改，也可以使生产效率上升很多啊，这样的画还会有商业使用权吗;1;0;1;18388;5.438329345225147e-05
20025;现在在p站看铯图，看到一张好看的，打开一看，左下角几个粗字AI生成，好少看到真人画的了;1;0;1;18388;5.438329345225147e-05
20035;ai技术的奇点将近，现在的绘画界更像是捶死挣扎罢了，我本人已经做好被取代的准备（建模工作人员）;2;0;2;18388;0.00010876658690450294
20040;我觉得大部分人的角度都是从ai现在能达到的水平进行思考的，ai还在不断发展完善，未来ai能画出完美的画也不是没有可能，到时候真的就行业淘汰了笑哭;3;0;3;18388;0.0001631498803567544
20044;如果普及了，以后没有画师了，那ai绘画是不是也没了;3;0;3;18388;0.0001631498803567544
20049;ai进步不是挺好的吗;1;0;1;18388;5.438329345225147e-05
20056;纺织机和纺织工的问题又来了;3;0;3;18388;0.0001631498803567544
20063;ai绘画便宜？，那也要等垄断后再看;4;0;4;18388;0.00021753317380900588
20070;如果说ai学习画画的原理和人类差不多的话，人类画画会基于客观事物在大脑进行主观处理后再输出结果，AI也会这样的吗？;5;0;5;18388;0.00027191646726125733
20076;好吧，如果你就是想看一两个比较好看的，精致的图片的话，Ai确实不错，但如果你想要一些大师那样的，想要《格尔尼卡》或者《父亲》的话，就一定要用人的手来画不可;1;0;1;18388;5.438329345225147e-05
20082;科技艺术人类的未来，都在这场官司上了;1;0;1;18388;5.438329345225147e-05
20084;那怎么判定是不是ai只能纸面绘画吗毕竟ai可以离线操作再者纸面绘画画师直接临摹咋整他开投影仪描图咋整，禁不好反而只会增加无意义的工作量。我看应该尽快发展脑图外放，这才是真正促进想象力发展，而画师真正优秀的核心的清晰想象力这一块也能继续发挥优势;9;0;9;18388;0.0004894496410702633
20101;除非一波把AI按死，不然只要AI版权正规化开始，垄断也就开始了，把目前所有人可用的一个工具变成了只有大公司可用的工具，那时只会更惨;3;0;3;18388;0.0001631498803567544
20112;不慌，我能看见就能临摹，临摹出来放到ai里跑，玩的就是抽象脱单doge;1;0;1;18388;5.438329345225147e-05
20116;那个给图像加隐藏像素二维码的技术，其实图片随便调一下清晰度就没用了;12;0;12;18388;0.0006525995214270176
20129;Ai对不靠画画为生但喜欢画画的人可能有些帮助就像打辅助但对于以此为生的人就没有快乐可言了。;1;0;1;18388;5.438329345225147e-05
20132;AI绘图软件和chatgpt的境遇真是截然相反啊;20;0;20;18388;0.0010876658690450293
20156;可是AI模型的训练基底已经开源了，谁都可以本地部署，即使AI公司被制止了，谁能防得住个体用户侵权呢？;8;0;8;18388;0.00043506634761801175
20165;力量并不可怕，可怕的是它的主人逐风者希尔瓦娜斯;2;0;2;18388;0.00010876658690450294
20175;ai画风都统一了，看多了就腻了不是说不好看，不过本质是拼拼凑凑的，到头来还是会厌倦吧。;1;0;1;18388;5.438329345225147e-05
20177;与此同时，大洋彼岸的东方，3d外包收到了某大公司发出来的AI设计图;9;0;9;18388;0.0004894496410702633
20190;没用，只要我还能正常浏览图片，我就可以用拍照绕过原图;5;0;5;18388;0.00027191646726125733
20198;艺术可以说是人类最后的尊严，而AI正被用来尝试掠夺它。视频的三体剧版BGM用的还是恰到好处的，因为三体与之人类，正如当下的AI与之艺术家，尽管ai还未全面伸手于人类日常生活，但已然将首先形成对艺术行业的有力侵蚀。想三体与之人类400年，AI与之人类只需要短短几年，这种无力感不亚于影视小说中人类直面三体。与之相关的艺术类行业，也将早早的面临存亡之战，这场诉讼不仅是世纪之战，耸人听闻一点去说，这应该是人类与“雏形天敌”的首场战役。;7;1;8;18388;0.00043506634761801175
20209;所以只分发程序，用户自己生成自己看，问题不大;1;0;1;18388;5.438329345225147e-05
20213;告他，搞死他复制粘贴烂AI;2;2;4;18388;0.00021753317380900588
20226;我感觉照相机的出现对艺术造成了毁灭性打击，照相机使广大的肖像绘画家失去了饭碗，在此，我呼吁艺术家们抵制照相机，只有手工的画才算艺术。人类的艺术将死，如果不遏制照相机，那么这一天将会在不久出现，如果任其发展，很难想象20世纪人类还有艺术，这绝不是危言耸听，如果现在我们不联合起来，那么人类将会失去艺术，机器是不会产生艺术的，照相机必须被抵制。;12;2;14;18388;0.0007613661083315206
20239;有人在弹幕里写不理解为什么有画师支持ai，我帮着回答一下：燕雀安知鸿鹄之志。伟大的无产阶级革命导师恩格斯，是贵族。英勇无畏的无产阶级斗士切格瓦拉，是地主。总有人会为了广大人民群众的利益，不惜牺牲自己的，我们一般称其为理想主义者。有了ai绘画，普通人将不再需要苦学十载才能将自己脑海中的画面描绘出来，每个人都可以用一个极低的门槛去创作，让高岭之花不再高岭。虽然不及知识下乡让每个人都能看得懂文字那么伟大，ai至少也算得上人类向前迈出的一小步;1;1;2;18388;0.00010876658690450294
20245;该死的ai影响我卖绘画课呢奸笑;11;4;15;18388;0.000815749401783772
20257;只是机器破坏者毫无力量的反击;1;0;1;18388;5.438329345225147e-05
20261;人能学，ai不能学。ai学的太好了，太快了。;1;0;1;18388;5.438329345225147e-05
20263;呵呵，搞艺术的真幼稚，你猜AI破解你的软件只需要多久？;1;2;3;18388;0.0001631498803567544
20266;ai绘画会引领生产力进步;1;2;3;18388;0.0001631498803567544
20268;一个举世闻名的反AI画家在大街上宣传反AI的理论，路边的小孩问他：“为什么绘画AI出的时候有人反，自动驾驶出现的时候却没人反呢？”“因为自动驾驶是只进不出的分析产品，它是不会对人类造成竞争的。”画家心平气和的答复到。小孩很不解，于是问：“难道不会向司机他们造成竞争吗？”“因为除了我们画家以外的都不是人。”;12;15;27;18388;0.0014683489232107897
20283;英国工人砸纺织机;2;4;6;18388;0.0003262997607135088
20287;支持AI，让所有人都能拥有艺术;4;2;6;18388;0.0003262997607135088
20293;最后的挣扎而已;5;1;6;18388;0.0003262997607135088
20299;这些即便都成了，保护的其实也不是国内这些小画家的权益，所以对小画家有意见的也不用无脑到连这也反对，实际上如果ai未来要有更合理的应用前景的话，现在的这些纠纷以及正式的限制是必经之路。无论世纪之战的最终结果如何，这都是为了人类艺术末来与前景的战争;5;4;9;18388;0.0004894496410702633
20305;经过我学习ai绘画之后，我发现这玩意确实能给普通人带来便利，以前需要找画师完成的事现在我自己就能完成了。（画群头像，重绘身边的人或者物啥的）既省钱买满足了自己的需求。仅对于我个人而言我是希望这项技术能被认可和继续进步的，而且，我认为这项技术画师能比普通人操作的更好，画师去学习和使用ai也许是未来的一种趋势（仅个人观点）;61;10;71;18388;0.003861213835109854
20367;以前写小说的时候画张封面便宜的200，贵的1000，据说还会产生各种纠纷，反正对我这种社恐来说都是灵魂绘图bmp解决问题。要不就是读者用爱发电帮我搞定。现在么再也不用和别人打交道就有精美的封面了，撒花呲牙;15;11;26;18388;0.0014139656297585382
20383;我是极端的悲观主义者，人类是一种不可以被寄予厚望的生物，人性是不可以被信任的;3;57;60;18388;0.003262997607135088
20387;ai绘画对于新人画师的打击贞德特别大，尤其是有一定水平，终于跻身行业的新人。我身边好多新人同事都已经对行业前景绝望，甚至还有愚蠢的是，有一位水平偏差的同事，被老板明确指派去全职研究ai，属于是连画笔都没机会摸了。如果放任不管的话行业人才断代是必然的。;4;12;16;18388;0.0008701326952360235
20392;热评的人类过拟合是存在的，比如武内脸之类以及p站看过不少只会画一个角度以及表情的画师，萌系画风有的也是相当类似;32;1;33;18388;0.0017946486839242985
20427;像极了嘲讽最初的蒸汽机车的人，他们是永远也不会想到以后的高铁能跑多快的吃瓜;11;1;12;18388;0.0006525995214270176
20439;AI打击了很多真正热爱绘画的人，不仅削减画家的动力，还抢了人家的饭碗。甚至还有人用AI讽刺画家的努力。拿AI去接稿的人也层出不穷。即使它预示着一种技术的进步，但技术的滥用会人带来极大的困扰。拥抱拥抱拥抱;113;1068;1181;18388;0.06422666956710898
20553;跪了很早前就跟人讨论过了，没人抵制新技术，抵制的是资本，资本对创作的异化，他们在否定创作的价值。;91;1772;1863;18388;0.10131607570154448
20645;ai作图损害的不仅是画师的利益，还有真正想去欣赏作品的读者的利益，他以后需要去警惕自己看到的每一张图，分辨是不是ai画的;102;661;763;18388;0.04149445290406787
20748;科技的发展是为了解放人类生产力，不是代替人类的创造力。;78;402;480;18388;0.026103980857080704
20827;其实机器学习要用数据集都得获得授权允许才行不知道为啥画就这么随便拿来用;55;538;593;18388;0.03224929301718512
20883;有问题的不是AI，是擅自使用未授权的数据进行训练的行为;32;378;410;18388;0.022297150315423103
20916;对于画画的人来说，ai画出来的再好也是隔靴搔痒，并不能复刻自己心中的画面，不能代替自己创作。但是对于普通人来说，找人约稿和用ai跑图，其实并没有什么差别，最后他们到手的只差在那是ai想出来的东西又或者是画师想出来的东西，更不用说也许再过不久ai就会画得比所有人都更快更好。自己喜欢画画，希望能靠创作吃饭，但是又清楚地知道虽然ai不能取代自己创作的价值，但这份价值却可能永远不再被市场所认可，每每想到这一点，真的对未来会感到焦虑，对自己眼下的努力感到怀疑。;7;193;200;18388;0.010876658690450293
20924;讲个我的故事，我是学刑事技术的，我有个导师80岁了，是新中国第一批刑技人才，他们那个年代，指纹比对是一项非常尖端的专业技术，需要鉴定人员细心、眼神好，定力高，通常是警校里成绩最好的10的学员才有资格去做指纹检验技术，那时候所有的指纹档案都是一张一张纸质的小卡片存放在档案库里，每次需要比对指纹寻找罪犯的时候，他们就会按地区、人际关系等用小推车从档案室推出一车档案，然后几个鉴定员在房间里坐着用放大镜一份一份找，最厉害的鉴定员一天能看500份档案，破了很多案也得了很多奖，日本同行来交流的时候都是服气的，你猜后来怎么着？美国人发明了电脑自动指纹比对系统，人眼再快能快得过cpu？再后来指纹技术就跌落神坛了呗，那我导师失业了吗，完全没有，他只觉得轻松多了，因为刑事技术不止只有指纹鉴定一项技术，还有工具痕迹，枪弹痕迹，犯罪心理，微量物证好多好多，他觉得终于可以从工具人一般的工作里解脱出来，去做其他他觉得更有意义的工作了，他确实也有一些同事，这辈子就只会这一个技术，其他新技术不会不学不练，就硬钻牛角尖，那怎么办，只能调去户籍科躺平等退休了。一辈子只钻研一项技术并不是人类的极限，尤其是如果你还要靠工作来谋生并且没有国家给你兜底的时候，最好还是不要把鸡蛋放在一个篮子里。AI是不是属于侵权我觉得不好界定，人类画手在学习阶段通常也是通过临摹现有作品进行训练，目前的法律也并没有阻止人类的临摹行为，惩罚的只是不正当的商业竞争行为。同时画手这一职业的离散性非常大，你们甚至没有一个正规的行业工会来代替你们集中维权，连300年前的纺织女工都有工会的男人们帮她们砸烂蒸汽机，所以我觉得你们这个行业的生态先天不太健康，抗风险能力可以说是几乎没有，所以你们行业在未来与AI对抗的前景我不是很看好，人生还很长，尽早转行并不丢人，或者可以考虑打不过就加入，利用自身优势提早研究优秀模型或者描述语法，以期待如果未来模型收费制到来的时候能挖到第一桶金。每个行业都会有钻牛角尖的天命工匠，有的人能成神，有的人死超鬼，作为羚羊，你们只需要跑得比最慢的那只更快就可以活下来;107;245;352;18388;0.019142919295192518
21032;看过很多评论就会发现画手和看客之间真的有壁插画方面，我在网上看到的大部分的作品都是既有故事性又有观赏性。画手会认真思考怎么通过节奏疏密和视觉引导让人看到画面的重心，会根据人物设定选择构图和元素，人物和场景之前相互呼应，会推崇更加概括的表达而不是繁复的刻画。但是就像更爱用ai生成大xiong美女的使用者一样，大部分看客对于画面的要求就是好看就行（），我爸妈那辈直到现在都觉得画画的最高境界是像照片所以画手跟ai使用者的辩论根本就是鸡同鸭讲，是完全没办法互相理解的。;8;150;158;18388;0.008592560365455732
21041;一群连美术基本功都没有的外行人，写了几个标签生成了几个图就敢自称画师了;3;103;106;18388;0.005764629105938656
21047;纺织工会抵制纺织机，马车夫会抵制蒸汽机，不过历史告诉我们都是徒劳，大部分人的创作实际的技法其实也是模仿和抄袭前人？只不过因为是手画的就不算抄袭？真正认定侵权的是内容，是构图，是内容的表达，AI只是工具，真正决定审美的是电脑后面的脑;8;16;24;18388;0.0013051990428540352
21057;关于AI绘画会不会破坏环境。我作为从业者之一的个人感想是，不会但是又会。个人中文水平不高，请谅解。不会的原因是，不管AI再怎么产出优质的作品最后都需要由拥有基础审美观的人进行调整，我这里指的审美观不是个人的审美喜好，而是一些基础的知识（透视，颜色，等等），就像一幅半成品在普通人的眼里就已经很漂亮了，完整了。但是在拥有基础审美观的人眼里又是不一样的感觉。所以用着靠打几个关键字产出半成品还沾沾自喜的AI画师不用过多少时间就会被淘汰，最后这个市场还是会留下真正有实力的人。会的原因是，画师会变成精英职业，AI完全破坏低端市场，导致新人画师在还没吸取足够经验进入中高端前就会饿死。还有什么观点欢迎补充。;25;414;439;18388;0.023874265825538393
21083;真正该抵制的不是新的技术，不是AI，而是利用AI和新科技剥削人民的资本。;36;118;154;18388;0.008375027191646726
21120;今天在一支AI视频底下看到有人要tag和模型，有人评论纠正说私模不能公布。这些人明明知道私模是自己调试的劳动成果，不能随便公布，那被喂进去的那些图片算什么？明明也是别人的成果啊。;3;83;86;18388;0.004676963236893626
21124;科技进步要和伦理道德一起同步，克隆人现在依旧被禁止。现在关于ai的法规还不完善。;11;72;83;18388;0.004513813356536872
21136;技术无罪，但是以技术之名侵犯他人著作权的人有罪。;1;34;35;18388;0.0019034152708288013
21138;让人心凉的不是ai出现减少了工作岗位，而是不明白为什么人会拿这个当笑话嘲讽画师，画画人每天工作9点回去还要自己学习努力肝到凌晨，每一分每一毫都是用体力肝的，他们没有攻击任何人。这个社会也许真的大部分的人是冷漠的，别人好的时候咬牙切齿，别人危机的时候喜笑颜开;1;24;25;18388;0.0013595823363062867
21140;我不会画画，我还没什么感觉如果有一天AI把我的职业取代了，我应该会很急;13;94;107;18388;0.005819012399390907
21154;断人财路如同杀人父母，不好评价，毕竟饭碗被抢，不生气是不可能的，我只能说世界怎么样你就怎么样，如果真的淘汰了画师，画师也只能接受，没有的话也好，说明人类的创造性ai不能替代，至于版权就没必要说了，大部分人都没有版权意识，画派和灵感什么的也不能说属于版权吧藏狐希望up能继续热爱画画;3;32;35;18388;0.0019034152708288013
21158;刀没砍到他们身上罢了，这些人就会隔岸观火甚至幸灾乐祸，有没有想过，如果真的被ai取代的大部分画师下岗了，他们为了生存会去卷其他的行业，怎么确保你们自己所在的行业不被波及呢，今天ai取代画师，明天就有可能取代你，在这场劳动力与ai斗争的战役里赢的只有资本，谁也跑不掉。;20;102;122;18388;0.006634761801174679
21179;最近chatgpt能写很多代码了，我怎么没见程序员出来抵制啊？它输出的代码按你说的也是纯纯别人的劳动成果啊？但是周围人已经各种开始用它来辅助工作，提高生产力了。这是因为相比于程序员，画画这个行业技术迭代太慢了，你让画师们换个别的绘画工具都难的很，你还要让他们去学着用ai提高自己的效率？干程序员的一直都知道，技术的进步是不可避免的，浪潮来的时候，你只有跟着走，而不可能挡住浪潮。绘画行业上一次革命可能还是从实体转向数字化，其实也没多久，只是这些年来数字化绘画的技术没有那么多突破而已，让一些人习惯了这种方式。你想过在数字化绘画出来后，那些长时间练习实体绘画的人怎么想的吗？你以为他们的抵制能阻挡数字化浪潮吗？就像无人驾驶是司机们集体抵制就能扼杀住的技术吗？好，你说版权问题，这确实是重要的，需要出台法规完善，但是你要说ai输出的图完全没有意义，就是拼接，那不好意思，实话说，绘画圈子里大部分人估计在干的就是和ai一样的事情，网上找找参考图，用自己的绘画技能糅合一下完事，这种糅合是技术，但是和上个时代如何用实体画板颜料绘画是一样的，只是技术，而没有包含多少创作。会被chatgpt取代的程序员，就是那些平时只会复制粘贴的码农，真正平时做实际需求，解决实际问题的人，只会感觉这个东西帮助我减少了无效的敲代码时间。同样的，会被ai取代的画师，就是那些平时复制粘贴的人体ai，真正在做事的，你的工作会被这么容易替代？当然，技术进步，生产力解放，必然伴随因为需求短期不足而导致的劳动力失业问题。但是这是好事，更多有想法但是没基础画技，没基础代码能力的人，能表达自己的创作意图，这是人类整体的进步。这也是必然的事，所以个人应该做的是跟上浪潮，而不是因为个人利益受损了就逆流而行，那只会彻底被抛弃。;29;65;94;18388;0.0051120295845116384
21209;其实对比隔壁音乐ai的发展就能看的出来，新型ai音乐的训练集都获得版权且ai出的音乐会避免与训练集中的相同。这么一对比ai制图的发展实在是太野蛮了。但不可否认，这个是未来。只要用过stablediffusion逛过抱脸就能感觉到这个领域到底有多生机勃勃。本来ai制图可以像ai作曲一样柔和推进的，，，;9;132;141;18388;0.007668044376767457
21219;不明白为什么要叫“ai绘画”明明没有绘画过程，用算力生成的图为啥不叫ai制图而叫“ai绘画”;6;101;107;18388;0.005819012399390907
21226;我就设想过一个故事，科技发展完全不惜代价，完全不在乎道德。生物学家研究更致命的病毒，工程师研究更恐怖的武器。全世界都在疯狂的发展科技。cpu算力不够就拿人脑做处理器。;13;83;96;18388;0.005220796171416141
21240;全部都是打着解放生产力的旗号，自己想不劳而获分红，然后还要踩一脚画师，把画师逗逼上死路，然后ai被大公司资本垄断，所有人都得交保护费。他们管这个叫生产力解放，我不敢苟同。;17;116;133;18388;0.007232978029149445
21258;我认为在谈论这个问题的时候，首先要做的就是明确一点，你们画画到底是为了什么？如果是为了表达自己的内心世界，表达自己的情感，研究高深的绘画技巧，那么ai的出现对你们来说其实并没有太多的影响，毕竟ai再发达也不能够代替你表达自己的思想。但如果画画是为了赚钱，为了养家糊口，那就不要说什么画画的灵魂，说什么艺术。因为你画画本质上是在生产产品，ai的出现确实会抢了你们的饭碗，并且ai还会抢更多行业，更多人的饭碗，包括我的，这是现行制度之下的必然结果。不过我个人还是会更加乐观一点。毕竟生产和消费是挂钩的，如果所有人都失业了，没钱了，那么资本家生产出来的产品也就卖不出去了。;41;54;95;18388;0.0051664128779638895
21301;ai无法取代艺术，但ai可以飞快取代商品，只会生产商品不会生产艺术的画师，和ai又有什么区别呢？ai是工具，画师是工具人罢了，工具人被真正的工具取代不是很正常吗？;21;35;56;18388;0.0030454644333260824
21323;虽然我不喜欢罕见，但是罕见这两句话还挺好玩的（乐）;4;130;134;18388;0.007287361322601697
21328;绘画不会被摧毁被摧毁的只是绘画中会被ai替代的那一部分如同曾经的庞大肖像画艺术被摄像机摧毁一样你喜欢画肖像画依然可以画只不过市场供求关系决定很大一部分肖像画的消费人不再需要肖像画来彰显个人地位或者记录，所以你很难继续靠这所谓的艺术维生，但如果你真的在意的只是艺术那没什么能摧毁你的艺术ai只会摧毁你现有的惯性依赖的赚钱手段;39;43;82;18388;0.00445943006308462
21368;画师和AI根本就不是工人和编制机器的关系，工人自己编制那羊毛都是自己收的，AI呢？AI那羊毛是踏嘛抢的别人的，那能一样吗？;13;86;99;18388;0.0053839460517728956
21382;不本身国内美宣就已经跟艺术不沾边了，纯画匠。很多画师的确就是落后生产力。以前报过图形科学一门课，老师上来也就是找素材拼接3d辅助，在本就很缺乏创造力的行业，这种被ai取代是百分百的;1;24;25;18388;0.0013595823363062867
21385;艺术创作都被AI替代了，那其它领域还远嘛？如果若干年后AI什么都会了，那人活着还有什么意义，人的价值何去何从呢？这是个问题。也许会有极少数精英人类不受影响，但大多数普通人就只能沦为弃子了。;11;45;56;18388;0.0030454644333260824
21397;AI是人工绘画的附属品我只能说。AI为什么能画好？因为用了顶级画师用了二三十年沉淀出来的艺术作品训练。如果AI真的代替人类画师，那么在没有新人类顶尖画师推陈出新的情况下，只能模仿以前顶尖画师却无法超越顶尖画师，人类的审美会被AI束缚住。那个时候绘画这门艺术就失去了意义而成为了商品。就像女性卖卵一样不该成为商品的生命成为了商品，AI也会把不该成为商品的艺术成为了商品。说到底AI只会模仿而不会自我更新。AI和画师的关系就像mc和母牛世界一样。要想让AI彻底代替人类画师首先要让AI能思考，不过要是AI能思考那恐怕离人类自取灭亡也不远了吃瓜;8;37;45;18388;0.002447248205351316
21407;我觉得各位画师在抵制AI前，先入手正版ps吧，否则用版权意识抵制AI站不住脚啊;12;29;41;18388;0.00222971503154231
21420;画师？有。画匠？有。但更多人只是在花瓣百度下载图片进行缝合。ai只不过比他们缝合得更快罢了。车轮不可挡，希望各位尽快找到正确的姿势来面对新的浪潮，而不是无能狂怒。我也是个商业美术，并没有站着说话不腰疼。;6;53;59;18388;0.0032086143136828365
21427;ai出现的好处就是能给充满饭圈气息的画师juan带来冲击;4;29;33;18388;0.0017946486839242985
21432;希望那些支持ai的人以后自己的职业也被ai代替呲牙呲牙呲牙;59;120;179;18388;0.009734609527953013
21492;ai让约稿变成了“图价值1元，灵魂价值999元”的东西百变星瞳大笑;5;29;34;18388;0.00184903197737655
21498;那就不得不请AI老师给我们唱一首《真没抄》了;1;33;34;18388;0.00184903197737655
21500;AI科技发展的底线是不能用于剥削，毕竟科技是把双刃剑，应该用于创造价值。;1;32;33;18388;0.0017946486839242985
21502;我觉得ai撕下了嘴臭又没本事的底层画师最后一块遮羞布，才会恼羞成怒，事实上一个画师如果竞争不过ai只能说明不行。ai在精度和整体质量完全比不过人的，况且这种东西不是你抵制就能消失的。还有创作的价值，ai完全不在乎艺术和价值，它在乎的是应用型。;6;31;37;18388;0.002012181857733304
21509;扣了好多字又全都删掉了，说点别的算了你们画师从绘画的角度看这件事情，我觉得你们的观点都是对的，但我作为一个搞电子兼涉及软件的，我从一开始就没把ai画跟什么“艺术，绘画”之类的东西看齐，就像学生时期会用CSDN的代码做参考，喜欢上github上看看别人开源的代码和程序，改进一下魔改一下做出更适合自己的东西，这从“程序”的角度来说是再正常不过的事情了。那些拿ai跳脸的，卖ai画的确实离谱，希望能有更好监管;7;52;59;18388;0.0032086143136828365
21517;其实说简单就是AI绘画影响画手收益了，所以要抵制。反过来想AI绘画有利其他人，所以支持。;3;40;43;18388;0.002338481618446813
21521;AI没有真正的创作，但确实比不少人的画要好，这可能是最伤人的地方;5;22;27;18388;0.0014683489232107897
21527;阿b专门在下面推ai绘画的广告辣眼睛;2;46;48;18388;0.0026103980857080703
21530;如果AI改进到不需要画师的图就能自己生图呢，到时候画师还是有损失，但是道德制高点就没了;13;15;28;18388;0.0015227322166630412
21544;体力工人常态化的现代性的危机脑力小资们就不管不问，等时代的大锤降到自己头上，就开始口吐芬芳，说别人怎么不来帮忙，我只能说干的漂亮，我也是美术专业的，我就鼎力支持AI绘画。;96;58;154;18388;0.008375027191646726
21641;画师抵制AI我只能称之为伪善要不抵制全部技术产物，全部靠人力生产。要求技术发展绕开自己领域，保住自己职业。是很自私的想法;29;37;66;18388;0.003589297367848597
21672;画手ai怎么都比普通人ai强吧;15;22;37;18388;0.002012181857733304
21689;Ai请叫做生成。不存在ai绘画的。他没有资格。一个小偷把作案工具升级了。人们不会思考这个工具是否会造福人类。小偷只在乎能偷更多的钱，这是人性。;4;21;25;18388;0.0013595823363062867
21694;看了下评论，发表下我的观点（注定这个观点在这个视频下会成为异端，有异议请文明回复）首先先说表面上画师们控诉最多的矛盾抄袭问题，确实ai在以一种人类没法比拟的速度在学习。注意，是学习。ai的学习方法和人类的学习方法其实是几乎一致的。很多画师也是对很多成功的画师的画作进行临摹，学习，然后在创作，这和ai几乎没有任何区别，没有人会因为某个人的临摹太多某某画家的作品导致风格太相近而被控诉，只要不是完全抄袭，这点我认为是ok的而且从目前我接触的ai模型，这些图片确实是通过算法原创出来的，而且越发精致，精确，部分优化较好的模型已经全无半年前的“没有灵魂”至少在我一个外行看起来是这样的真正的矛盾点其实是ai可以在极短的时间内，完成上述工作，作为ai绘画爱好者我亲眼见证ai在仅仅半年时间，在众多模型制作者的努力下，画面也越发精致，说实话这才是矛盾的所在，就是时间和成本的级高效率，这也确实损害了画师的利益。因为其出图哪怕有缺陷，但是100张图出一张完美图也只要不到一小时，而同样的图要一个画师几天甚至数月时间，所以我也能理解画师的抵制态度;34;23;57;18388;0.003099847726778334
21729;说到底，就暴露出一群行外人对行内人指指点点的丑相热词系列害;5;25;30;18388;0.001631498803567544
21735;偏题一下，我觉得AI绘画四个字本身就很扯，绘画作为艺术应当是人的创造，把绘画和AI放一起很刺眼;9;46;55;18388;0.002991081139873831
21745;希望后期画师进到你们职场，抢你们位子的时候，别在那里叫也别到国家那里叫“什么社会岗位又不够了，竞争是真的大呀之类的”我们寻思着，我们渴望新技术的出现不是为了创造出岗位吗？岗位没了是不是有点本末倒置？还有说是淘汰低端画手的，我寻思你是脑袋被门夹了吧？这AI有人脸识别哪个是低端，哪个是高端吗？想下不都可以用吗？还淘汰，笑死等私人约稿这个行业没了，你就知道了。没有任何限制的东西可以带来什么后果。还有你那充满理想的幻想;27;70;97;18388;0.0052751794648683925
21773;你想让不会画画的人有头像，你怎么不给没钱的我印钱啊;10;37;47;18388;0.0025560147922558192
21784;AI发展也扯下了一部分小资的遮羞布，他们一般认为自己的工作比体力劳动者高级，但现在却发现他们是更容易被取代的。;26;113;139;18388;0.007559277789862954
21811;我只能说我会在绘画上坚持走下去，如果我最后失败了请不要嘲笑我的无能。;8;19;27;18388;0.0014683489232107897
21820;简单一个道理，卢德运动中工人们成功阻止了机器生产吗？当时的工人在英国有多少占比各位可以去查一下，那么画手能阻止AI吗？答案显而易见是否定的，那么当AI进一步进化后，摆在普通非职业人面前的就是一个更省事更方便更便宜的工具，请问普通人为什么要拒绝呢？当一场运动失去基础时画手就已经输了。;23;35;58;18388;0.003154231020230585
21844;小明学了很久的武功，很努力，也很认真，但是水平一直上不去，在江湖里一直都是背景板。突然有一天，隔壁卖猪肉的小王说要和他切磋。小明大笑，说“你是什么水平我是什么水平，我练了这么多年，每一招每一划都是我努力习得。”然后小王掏出一个兵器，三下五除二打趴了小明。小王说“我这个兵器叫ai，自动学习自动出招。你练这么久不如我ai训练3天。”小明急了，为什么呢，我练了这么久比不上机器？我“传统武术”，高贵的脑力劳动，我这个叫艺术。你那个又是什么？然后就躺在地上撒泼打滚，又是ai学习前人武功是侵权，ai武功没有灵魂，ai武功出现了练武的人要失业。小王只觉得好笑，回家给不能习武的女儿打了一套拳法，继续卖猪肉去了。;6;20;26;18388;0.0014139656297585382
21851;无所谓，我就是一个想要画自己想画的东西的小画家，我就是想画我喜欢的角色，我管你有没有ai，不是我自己画的东西就没意义，因为我学画只是因为我想亲手创作点什么，而不是像流水线工人一样打螺丝;2;53;55;18388;0.002991081139873831
21854;事先说明，我不是在怼你，我认同你所剖析的行业现象，并且也认为你的观念是合理的。然后，我想要和你探讨一下，关于AI绘画的事情。我是高三美术艺考生，大学打算学动画。起初，我在b站刷到关于AI的各种视频时，最开始是很抵制AI的。后来我也发现，AI是没必要抵制的，应该抵制的是人。他们侵权了，从道德意义上来说，这个对于我们创作者来说真的很让人愤怒。但是我想了想，我们又能做什么？这就是时代的大趋势。而且说的难听一点，道德本身就是某一集体为了维系某一种利益而宣扬出去，用来控制人来满足某种价值需求的“高级枷锁”我们抵制AI的根本原因是它侵占或着有侵占我们的市场的趋势，所以我们会通过强调“维权”“版权”这一道德来平衡AI带来的冲击。这就是客观，完全从大环境的角度不站边的冷漠的分析。回想一下，当年英国将工业布匹运往印度，直接导致印度的纺织艺人失去市场，类似的事情和当今的AI何其相似？英国人为了让布卖的好一点，会不会抄袭好看的布纹？那么印度人说了什么吗？他们只会说，真实惠，好看还便宜资本家的贪婪，还有市场对于性价比的考量，才是这场冲突的跟脚而总结规律，归根结底，真正的问题出在“人”。我们国家的文化市场就是一个道德底线非常灵活的地方，符合自身利益什么都能干得出，无论是群众，还是画师，或是资本家，天下乌鸦一般黑。道德底线这个东西是会随着利益的改变而调整的，而道德这个东西，不是我们创作者能决定的，而是市场和资本。所以，AI持续侵权的现象，是不会因为我们画师的意志而被遏止的，路人只会看热闹，相反，我们越愤怒，他们越开心。而AI的出现，则代表着文化作品的粗制滥造和质量不足，这会导致一个不可避免的结果，文化输出力下降，群众审美意识下降，逐渐向着失去思考能力趋近。这就是奶头乐这个时候，就要看上面的意思，关于AI这件事就会出现两种考虑，1发布关于版权的法律法规，严格要求创作性质。但是这就有一个问题，一旦对文化产品，精神产品进行控制和干预，那么就很容易出现一些极端现象（不敢多说）2大量画师自身改革，提高自身画面的内涵，提高审美，输出带有情感而AI无法理解的作品，反向提高市场的艺术鉴赏力，做到求奢容易入俭难嗯，关于这个话题，我发了一个视频出来，里面详细讲了我对于AI的看法和画师未来吊打AI的方向，可以请你帮我看看吗？评价一下我的观点，毕竟你才是专业的画师给心心;4;14;18;18388;0.0009788992821405265
21859;其实，一个学习绘画商用价值被粉碎的时代，恰恰是绘画大规模进入心性价值的开端;2;16;18;18388;0.0009788992821405265
21862;大白后半段的攻击力我非常认可，ai生成那种很意识流的插图倒没什么反感，问题是现在搞这个的全都在惦记铯图和擦边现在刷个蓝p三分之二都是这种东西真的看得我羊尾;2;49;51;18388;0.002773547966064825
21865;印刷机毁了中世纪抄书员这个圈子，论抄书员为什么要抵制印刷机，机器打印出来的文字是没有灵魂的;109;62;171;18388;0.009299543180335
21975;那么，你是在抵制ai绘画这个技术，还是在抵制那些用ai绘画的人？这么说起来铁匠也好，停车场的保安也好，最后都是被科技取代，他们是不是也该起来抵制，因为科技所以自己没饭吃了，是不是科技就不该进步？;1;18;19;18388;0.0010332825755927778
21977;画师真的太难受了这半年都沉不下心去创作;2;38;40;18388;0.0021753317380900587
21980;不要把ai当敌人，当工具不好吗;5;12;17;18388;0.000924515988688275
21986;大白，b战是最大的盗版网站，9999的视频内容素材都是没有版权，鬼畜文化本质都是侵犯肖像权和名誉权。有什么为什么，因为既得利益，因为没砍在观众头上。我不是为盗版辩护，我只是想说“向来如此，便是对么？”我会时刻提醒自己是盗版文化的受益者，并以此为耻。;2;20;22;18388;0.0011964324559495323
21989;唉现在都有所谓的ai画师，插画师（它们自己贴的标签）了，昨天都看见有个在一个绘画大佬面前贴脸贬低哦哦，还有个用ai绘画卖钱的;1;21;22;18388;0.0011964324559495323
21992;我觉得最大的问题主要是ai喂的那些画基本上没受到过原作者的同意。。。如果是同意的话我觉得这没什么，想用ai就用吧。。。比如说你愿意用自己画的大量的画放进去玩一玩，也不是不行。但是如果没有经过同意，凭什么拿别人的东西？不是纯纯的强盗行为，侵权行为吗？这一点我特别不明白。;14;14;28;18388;0.0015227322166630412
22008;有多少人，头天晚上还对着手机上的chatgpt流口水呢，转天就到这视频底下对着ai绘图破口大骂，我们通常管这种人叫精神分裂。;28;104;132;18388;0.007178594735697194
22037;投降了，我不仅要学ai，还要使劲钻研，使劲卷，未来ai真能商用的时候我帮你们把ai价格压缩到一张一块钱以内，我还要让我自己的咒语付高价才能使用，让那些学ai的知道ai造图师也没饭吃酸了酸了;3;32;35;18388;0.0019034152708288013
22041;机器取代人力造成失业，是社会生产力发展的自然现象。被取代的人（即失业的人）会越来越多，就业机会的诞生跟不上就业机会的消失。;6;12;18;18388;0.0009788992821405265
22048;笑哭我今天也发了一天动态说明生成类ai为什么要抵制，奈何工业革命派和历史车轮派总是叫不醒的，他们最善于将工业革命这种物质生产的机器技术革命，这种确确实实能提高物质生活水平的革命偷换概念成ai绘画，确不曾思考过科学伦理问题，按照他们的逻辑，所有能用于提高生产力的技术（无论好坏）如果都是不能加以人类伦理道德制止的话，那么克隆技术带来的人体器官“生产力”是不是也不应该立法限制他的使用？;9;30;39;18388;0.002120948444637807
22058;拿工业革命来对比的人简直是别有用心;1;17;18;18388;0.0009788992821405265
22060;大胆地预测一下，不过几天绘圈就会跟LOL之前锤脚本一样兴起一波锤AI的风气;6;21;27;18388;0.0014683489232107897
22067;不要宏大叙事好吗，，，现实就是，我想把我对前女友的回忆画下来，要么出大钱请人画，要么自己花巨额时间从零开始学。要么就是花二三十个小时学AI绘画买个二手3090。你要我怎么选，啊？不选AI，等出图那天，我喜欢的女孩说不定都成两个孩子的妈了，，，你要我怎么办，我能怎么办啊;7;19;26;18388;0.0014139656297585382
22075;所以，ai永远不可能是所谓的“艺术”毕竟不是人类创作的;1;16;17;18388;0.000924515988688275
22077;事实上来说，人们只能去适应AI的时代，例如棋类ai的出现，棋手们也只能去学习AI的思路，永远都无法超越Ai，我们要看到，现今用AI训练棋手的水平已经远远的超越了前辈，一味的抵制是没有任何作用的，适者生存;10;19;29;18388;0.0015771155101152925
22088;我们常说，在中国，字幕组就是盗火的普罗米修斯，将希望的火光带给人间。可是随着越来越多的国外当代流行影视作品被引进，可供盗火的机会自然越来越少。很少有人思考过，除了做普罗米修斯之外，字幕组其实还有另一个选择，另一片广阔的天空：公有领域。不一定非要学普罗米修斯去盗火，还可以学燧人氏光明正大地取火。版权期限和公有领域的存在，真正代表了版权这一概念的根本目的：为了大众的利益。然而，视频门户网站以版权为理由下架字幕组翻译的公有领域作品，实际上是试图将大众利益重新锁回柜子里，这才是真正违背版权初衷的行为。;72;12;84;18388;0.004568196649989123
22161;支持AI。我觉得把别人的画放进程序里学习和放进脑子里学习没有区别。普通人学画也是从学别人开始的。你说大众不关心画师，那电动车挤压燃油车的时候，你关心过燃油车产业吗？触屏机取代键盘机的时候，你可怜过键盘机公司的员工吗？技术进步就是进步，反对也没用。我觉得现在这个技术处于一个发展期，还能产生一些争议。等之后AI在市场中的位置确定了，到时候接纳AI就是必然的了。;7;11;18;18388;0.0009788992821405265
22169;挺感慨的，前几年的ai画出来的东西大家都是当笑话看的，结果这么短的时间里突然进化到这种需要大家一起来抵制的程度，再过几年会变成什么样真的不敢想热;9;47;56;18388;0.0030454644333260824
22180;其实看了这么多ai问题，我在想一件事，假设某一天ai真的能产出与人类画师一模一样分辨不出来的作品，那到底还有必要分辨吗，还是说人类画师反而会把纯手工创作当成一种招牌，像现在很多纯手工的制品一样;3;14;17;18388;0.000924515988688275
22184;现在一些社畜画师做的工作不就是纯纯流水线吗？工具人本身就应该被更高效的工具给取代，市面上的名人书画难道被赝品影响了价值吗？或者说ai又影响了大佬们对于原创的创作质量？都没有吧;13;15;28;18388;0.0015227322166630412
22198;抵制已经没有意义了，不只是美术，基本上各行各业又有ai的身影;3;8;11;18388;0.0005982162279747662
22202;你的配音就是用的AI技术吧;2;20;22;18388;0.0011964324559495323
22205;只不过相信我，随便发泄吧。你的心情可能会好很多。这也会有正面影响。特别是这种意识流行业。反正就发泄吧。毕竟也没什么用。因为你不能证明侵犯作品。法律终究还是不保护思想的。更别说人家是真的神经元推理又不是引擎。我建议。虽然说没用。但是我建议你在做视频，你们只要多查点资料。去这个行业的相关的比较靠谱的地方去找资料。比如说github起码不会把一些最基本的概念弄混。比如说不知道gpt是一个神经推理算法。;21;10;31;18388;0.0016858820970197955
22227;我拧螺丝很完美，既不会太松也不会太紧拧坏螺纹然后手电钻出现了，它比我拧的更好，但是用手电钻的人还是我。我抵制这个手电钻，这个手电钻虽然提高了我的工作效率，但是扼杀了新手练习拧螺丝的技巧。;13;12;25;18388;0.0013595823363062867
22241;工业革命的时候手工工人也是这么想的;9;16;25;18388;0.0013595823363062867
22251;我觉得技术本身没错，是利用技术背后的人的问题，归根结底还是道德问题，但是这造成的问题我强烈建议上升到法律问题，能有法律去规范使用者;1;20;21;18388;0.0011420491624972808
22254;织布机毁了整个织布工的圈子，论织布工为什么要抵制织布机;13;18;31;18388;0.0016858820970197955
22269;感觉有点儿莫名其妙的熟悉感，我是个车迷，车圈里面关于传统油车和新能源电车的对立也跟现在的AI作画和画师手绘一样。新能源车低廉的后期成本和十几万就可以堪比高性能车的动力，极好的静谧性都沉重的打压了传统燃油车的市场。现在车企都在做新能源车，有乐趣的传统燃油车越来越少，全都在停产，以后都要全面转型新能源，那些车再也不能换代改款了，他们本该继续延长的生命周期就因为新能源车的出现而被迫停止。对于传统燃油车车迷来说痛心程度绝不亚于视频里讲的这类画师，但是气完了悲伤完了也就完了，改变不了这个进程的，也只能还趁着现在再说一句生命不息，燃油不止吧。至少目前来看，画师还能继续创作，但燃油车已经明确知晓以后再也不会有了，且行且珍惜吧;2;9;11;18388;0.0005982162279747662
22273;AI圈他们觉得自己调出来美的图是自己的，还用调出来的图来排名比赛，靠调出来的图挣钱谋利。这就好比百度搜图随便用，我搜出来就是我的，这种盗用以后没有办法分辨或抵制是很可怕的。;1;12;13;18388;0.0007069828148792691
22278;我的评价是不在乎。连围棋都被薄纱了有人抵制吗？AI绘画根本不在乎你抵不抵制，已经有许多人用才是事实。;1;8;9;18388;0.0004894496410702633
22280;拒绝技术只会让人被淘汰，就这样;12;15;27;18388;0.0014683489232107897
22293;我是游戏美术一名，我很佩服发明绘画AI的创始人，但我不觉得这群来跳脸的小鬼能拿ai炼出什么像样的艺术品，其实画画到了后期技法的影响并不大，最重要的是作品能不能表达你对这个世界的理解是怎么样的，能不能通过作品表达出你的情感。如果你的见识和脑洞能让ai通过缝合也能准确出你的情感，那么我承认你是艺术家;2;17;19;18388;0.0010332825755927778
22297;搞得好像其他行业这些年没有换代没有被入侵一样，有些人还说什么你们迟早和画师一样，有没有一种可能是画画反而是晚受侵害的呢，义正言辞的要别人反对，其他行业失业时你们站没站出来呢？现在不过是画师哭得响罢了;4;32;36;18388;0.001957798564281053
22304;你即便说服了别人，首先那群人绝对不会是ai设计的从业人员，其次商业投资不会对手无寸铁的弱者屈服。再者，人是冷漠的，他们不关心你的未来。对于大多数人而言ai是一个便利的工具，而在ai之前，在他们看来画师也不过是一个概念，并不是具体的人，转而言之，在他人眼里画师与工具其实并无二致。只是作为当事者，你有权利保持愤怒。;3;16;19;18388;0.0010332825755927778
22310;我只知道，一些画手画的好差，在高热度圈子里薅富婆们羊毛，约一张图几千元，那还不如用ai;11;15;26;18388;0.0014139656297585382
22322;藏狐ai只能叫制图，不能叫“绘画”，既没有创作过程也没创作思路，叫好的都是不画画的。扪心自问一下随便打几个标签，然后把别人的图喂进去切碎缝合，完事选几张自己看得入眼的就发到网上，这个“作品”跟你有多大关系？作为在职画师我们是感到饭碗受影响但更多是感到被资本侵权剥削以及职业侮辱，纺织机能提高生产力让生活变好，这个东西发明出来意义是为了什么？，可能职业不同你没法感同身受但你想想看，连想象力思考能力都可以被电脑程序“代替”，那还有什么东西是可以不被资本取代的;2;7;9;18388;0.0004894496410702633
22325;就目前的节奏而言，AI绘画对商业画师影像不大，但对于不会画画的人来说却拥有了一个免费获得自己喜欢画的工具，这肯定会影响到私人约稿的圈子，这波AI绘图的争吵就是想要白嫖和想要赚钱两拨人对立，其他人看看就好，该用用，该画画，AI和网店一样，法律监督迟早会跟上的;3;16;19;18388;0.0010332825755927778
22331;希望用ai绘画的素材库都是自己画的再见;3;10;13;18388;0.0007069828148792691
22335;有个很好的解释，如果ai能做到不侵权，那么训练ai所需的巨量图片的版权费不可能让现在人人都能玩ai生图。所以现在每个用ai生图的人都在偷，都在抢，都欠被盗取图片的人的钱。哪怕是用ai自己修图，ai能做到细化就因为它是在没有支付版权费用下盗取别人图片训练出来的算法模型。从资本让ai生图从侵权开始，这个技术就不是无辜的了，他的原罪就是开发者赋予的。;1;9;10;18388;0.0005438329345225147
22337;感觉AI绘画，不亚于制造克隆人，而且还是那种贩卖活人身上的，未经同意强行割下来之后去拼接出的克隆人小电视发愁;1;20;21;18388;0.0011420491624972808
22339;雖然說請你們盡快轉換跑道這話跟幾年前Learntocode差不多，但我自實在看不出來畫師未來有甚麼贏的可能性，這跟音樂00Nasper學習版是一樣的情況，法規跟不上侵害的速度，隨便一個人花兩個小時就能批量生產四五年以上天賦驚人水準畫師的底線，還能客製。道德上你們是絕對正確的，但這個不改變除了你們群體外每個人都想蒿你們羊毛的人更多。;4;9;13;18388;0.0007069828148792691
22344;生产力的解放永远要比垄断好，被第一次工业革命纺纱机取代的棉纺工人貌似也没说啥，流水线上拧螺丝的工人也没抱怨机械臂抢了他的饭碗，被狗干碎的柯洁也服气了。关于版权问题请自行查询相关法律条款，如何注册知识产权，不服就去告，北美不少讼棍集团等着接这种单子。目前阶段ai的创作应该不能用于商用吧？从二次元手游原画到电影场景设计，我倒是没见哪里爆出来用ai进行概念设计的。评论区说有人丢了饭碗，那是谁丢的饭碗？一张草稿卖大几百的“绘画小能手”？一味地抬高门槛圈地自萌证明不了某些“创作”的价值，就像炒作天然钻石的奢侈品商家，极力的诋毁被广泛应用于工业生产的人工合成钻石。在有能力可以去跑抽象赛道，和上了年纪的毕加索跑一个赛道，ai可搞不了这玩意。话说回来，我的专业是土木工程，如果有一天ai可以自行设计能够适应复杂自然环境的建筑，并保证稳定性和安全，我很乐意见到这种现象，不过还是那句老笑话，ai不能坐牢，所以我大概率也不会失业吧，毕竟得有人签字背这个锅。;5;4;9;18388;0.0004894496410702633
22350;评价是不如狠狠的用担心画画这种终究要人用手才能满足的事情消失多少是杞人忧天了同样人们追求美好的愿望是无穷的周遭的一切美术产品都可以因此而得到快速的不断的便宜的翻新;10;6;16;18388;0.0008701326952360235
22361;请各位观客友善评论，认真观看完视频再发表言论，我们不否定ai进步等客观事实，作为画师我们只是在为ai侵犯版权问题愤慨;1;8;9;18388;0.0004894496410702633
22363;同意up虽然我不靠画画吃饭，但是我很喜欢画画，我觉得绘画就是一个人的自我衍生，把自己的审美、感情体现出来的一个载体。AI绘画是建立在大量优秀画师已完成作品之上的东西，所以以后绘画行业会出现断代吗？因为比较年轻的画师都比不过AI，行业不需要稚嫩的画师，最近甚至出现了大游戏使用了AI做插图的情况辣眼睛一言难尽;1;9;10;18388;0.0005438329345225147
22365;很多画师画画之前会找各种参考，这也是侵权吗？;16;5;21;18388;0.0011420491624972808
22382;首页通知书脱单doge我想说的是对于0基础又想看图的人来讲，约稿或者自己学习绘画哦成本是远远大于玩AI的，而且现在并没有任何一条法律规定后者犯法。所以大多数人用脚投票都会去用ai藏狐;7;7;14;18388;0.0007613661083315206
22390;你要说侵权，那我们一开始去临摹他人的图学习绘画其实也没什么两样，而且ai是直接通过开源消灭了需求而非通过买卖抢占市场。说白了侵权不过是画师在饭碗理据上的遮羞布，说到底也只是抢了饭碗。你玩盗版游戏的时候可在乎侵不侵权。;4;9;13;18388;0.0007069828148792691
22395;道德哪有重要呢难过;1;7;8;18388;0.00043506634761801175
22397;热知识：就算不用AI跑图，游戏美术这个行业本身就是抄来抄去脱单doge;9;12;21;18388;0.0011420491624972808
22407;然而Controlnet已经是非常实用的画师辅助ai工具了，以后的发展只会越来越快越来越方便tvdoge;4;7;11;18388;0.0005982162279747662
22413;有点破防的感觉hhh不过拿画手的图喂ai这个行为需要规范;6;7;13;18388;0.0007069828148792691
22421;觉得AI抢了自己饭碗的，还是资本主义思想。AI根本无法代替人进行创新性工作，只是会帮人完成重复的劳动，如果你认为你的的价值只体现在这些无意义多重复的劳动上，那肯定会被取代的。;7;7;14;18388;0.0007613661083315206
22429;唉，最近听说白夜极光的美术用ai画cg，又有某大厂因为ai，大规模对原画进行裁员，不禁百感交集。原画现在本就是个内卷严重的行业，现在又有ai进一步挤压就业空间。如果说我们以前算原画民工，一些不断为资本生产素材和贴图的机器，若干年后我们又是什么呢。资本市场也许需要的不是生产力低下的原画师，正如原画师的终点也不是只相信效率的资本市场。ai的图终归只是素材的堆叠，设计上几乎没有百般推敲出的设计感和辨识度，但是在同人作品的表现上又拥有原画师难以达到的效率。我讨厌ai，但我也心怀些许期望。我希望，ai可以取代原画师们在市场的压迫下，百无聊赖地画着不知何时堪用原画素材的机械劳作。我希望，有朝一日，国内的原画师们可以“被迫”脱离资本的效率约束，真正自由地表达自己的设计理念，让ai成为一种解释自我的工具。真正破坏原画行业的也许不是ai，而是原画师们把自己的未来，都赌在了一个只相信生产力的市场。我们离开市场就会饿死，ai迫使我们离开市场，这就是矛盾所在。;1;7;8;18388;0.00043506634761801175
22431;无所谓，我拥抱一切ai技术发展，哪怕它的发展不太风光。因为这东西满足我机械飞升的所有前提。;7;8;15;18388;0.000815749401783772
22439;画师怎么赢得了名校毕业的软件工程师呢？;2;8;10;18388;0.0005438329345225147
22442;画师内部也不团结啊已经有很多美工在使用ai了;5;7;12;18388;0.0006525995214270176
22448;你这画了五六年也就那样吧？你看我这张滑稽;1;6;7;18388;0.0003806830541657603
22450;这玩意根本不可能取代人的工作，还有可能会增加职位，真有用的东西早就投入到生产线上了。你要说有圈外人拿着ai嘲讽真心实意画画的人影响了环境和氛围，我作为一个不画画不买画的说句心里话，“绘圈”这个词给人的刻板印象本来就是好坏参半。ai还会作曲打游戏写文章呢，就你这圈子节奏最大。;2;6;8;18388;0.00043506634761801175
22456;我看一些研究说的是ai的基本算法还是之前那一套，现在画得好是因为接入了海量图库的数据，变成娴熟的拼贴工;13;27;40;18388;0.0021753317380900587
22470;AI撕破了小布嘴脸，等着再完善完善，你就知道劳动者的心理了嗑瓜子嗑瓜子嗑瓜子;12;7;19;18388;0.0010332825755927778
22484;但你无法阻止AI的普及和进步，比起如何抵制，还是想想如何共存吧;4;5;9;18388;0.0004894496410702633
22489;侵权喂图道理上应该抵制，但现实就是完全无法阻止。ai绘画也是无法被约束的，基于模型本地就能出图，目前ai画的一些细节都存在问题，但已经能作为一张很好的大关系底图，我只要在上面重新描一遍它就变成了原创图了。在不久的未来，要是ai解决了画手以及各种衔接处的错误，那时候甚至就不需要画师再对其改错了;2;8;10;18388;0.0005438329345225147
22492;看到有弹幕有人说工作被抢了气急败坏我就觉得无语。原本绘画是需要深度学习的一种东西，深度学会一种画风要付出的时间经历都是以年为单位的，而且画一张图也是要长时间输出的，现在，一个没有人任何绘画基础的人，只要手动动键盘，甚至词汇都是百度翻译的，输入一段话，几分钟就出了一张高精度的绘画。最扯的是这张图还是用别人的图迭代来的。;5;6;11;18388;0.0005982162279747662
22501;我最近在尝试用stablediffusion生成图片，但我不是画师，我是个程序员。GPT模型也可以生成正确率很高的代码，而这些代码都是他从别人的代码那里学到的。现阶段的模型还无法拓宽素材的边界，但确实可以成为效率工具。但我认为这就是新时代的又一台“珍妮”纺纱机，在利益面前，我们无法阻碍技术的发展。;2;7;9;18388;0.0004894496410702633
22504;历史告诉我们，虽然会有人不喜欢，有人抵制，但是科技的魅力是人类无法抵制，可能你这辈子都会抵制他，但你的下一代，或者下下代，终将会接受;6;8;14;18388;0.0007613661083315206
22511;自己画的烂又想画好本来就难受，再想到现在的努力以后会被一张显卡替代就更难受了;1;9;10;18388;0.0005438329345225147
22514;艺术生被理科生吊打难道不是应该的？;9;3;12;18388;0.0006525995214270176
22524;为什么抵制因为他不叫“绘画”，over。;2;3;5;18388;0.00027191646726125733
22527;有人说ai是资本的体现，有碍于创造，我否认。相反ai能让人们的创造力更好的体现，比如我作为一个拥有好故事或游戏玩法的人，但我没有足够的编程和美术知识来完善我的想法，这时候ai的作用就体现出来了（已经有up开始用ai来制作互动视频的人设图了）。反过来如果我是画师，想给自己的角色写出动人的背景和人设，就可以用写作ai（虽然写作ai还不太智能2333）ai给了每个人创造的机会，接下来将会是一个灵感涌现的时代。;9;6;15;18388;0.000815749401783772
22537;很多人说ai只是会取代底层小画手，真正有实力的不会受影响，但哪个大画师不是从小画师慢慢爬上来的？ai直接在他们成为大画师之前就取代了他们，总有种杀掉羽翼未丰的雏鸟的感觉再加上未来可能的ai创作的同质化作品的泛滥而可能造成的审美降级，哪里来培养新一代“指导ai的画师”;3;5;8;18388;0.00043506634761801175
22541;抵制有用吗？显然没用，人家该做还是做，这玩意儿刚出的时候真的就是几天几夜睡不着觉，（现在已经跑路了，，反正就大学画了四年，考公去了）我还卧底了很多AI群（想看一下这玩意儿的风向和发展），，就感觉现在画画的反而成众矢之地了，，群里基本上都是对画画人的不满和嘲讽，而画画群都是那种焦虑痛苦（毕竟价值被剥夺了）这两天又爆出了什么15k的画稿不如ai（确实啊，人体都没学好，给100都嫌多，不过这也是行业底层被拿出来和ai比），无语，唉，看着ai群里那些七八百接出去的商稿，不得不说有的玩的厉害的AI确实可以接（价值都是人类创造出来的），却是那些ai人去收取，唉，继续画，只会越画越难受，生活并不如意的我，没有太强的信念，唉，也只能厚颜无耻的说，把画画当兴趣吧，不要再投入了进去，不要再涉及任何金钱的东西了，能喂饱自己的前提下，再去画点什么，至少自己画的时候还不会折磨，还能享受一下自我对话的感觉。大哭，世上最没用的东西就是气结，看着好朋友23岁（初中班里倒数第二），靠自己挣的钱。买了一辆20万的车，隔三差五拉我去，我不敢进的馆子吃饭，一消费就是大几百几千，一度怀疑自己是不是从一开始就是错的？;1;4;5;18388;0.00027191646726125733
22543;说的好对感谢发声抓狂AI就是吸画师的血。劣币驱逐良币;1;5;6;18388;0.0003262997607135088
22546;那我来说说我的看法1首先有人将ai算法与人的学习能力混淆，二者有很明显的界限，首先要明确的一点就是绘图ai并不是那么高级的ai，之所以说学习大概率只是方便糊弄外行人罢了，绘图ai只是侵犯画师个人权利的碎尸拼贴工具，它本身没有人类的学习能力，评论区有人故意混淆二者含义2先进生产力是指促进人类的解放和全面发展的工具，并不是新的技术就可以称为先进生产力，我看评论区似乎也有人用这种看起来高大的词给ai戴高帽，如果像评论区里有人说的ai是像核弹一样人类无法完全掌控的东西，那么在ai发展尚未成熟的现在没有必要去使用，因为没人会把技术尚未成熟的核相关技术拿去使用，这样只会害了自己3如果ai是可以为人类完全掌控，那么掌控者是谁呢？作为以消除剥削为目标的我们真的是在掌控ai吗？很显然这还是被少数人垄断，一开始是免费的，后来收费，这种事情我想已经无数次上演，且目前随意拿走画师的图喂ai，我称之为圈画运动，资本血腥的原始积累4如果这次画画被干掉，那么这种东西只会在背后力量的推动下逐渐伸向各种领域，画画是人的一种表达，人对世间的事物进行反思后选择创作的结果，是人思想领域的一部分，思想质量的高低某种程度上会影响人的生活。5或许有人是不在意别人被剥削的，他们只想消除对自己的剥削，转而压迫别人，评论区鼓吹ai混淆视听的大概率就是既得利益者，我不知道你们有没有仔细看过条款，因为有些ai条款里写着由用户承担责任，也就是说他们赚钱，风险由用户承担，算盘打的隔老远就听到了6拿起笔都做不到的人谈创作是可怜的，因为他们不知道什么是真正的创作，就算把所有工具都给他们准备好也不会进行创作，就算有ai制图也无法创作，于是倒卖ai制图的二手贩子应运而生;9;21;30;18388;0.001631498803567544
22557;我们先来回顾一下版权这个产物诞生的初衷再回想下前面拿着资本说事的评论。版权（copyright）的概念源自复制（copy），它是从机械复制时代的艺术作品传播角度来制定的。版权体系并不把版权视为天赋人权、自然权利，而是采取工具主义的思想，只将它视作鼓励艺术家进行创作的公共政策而已。虽然英美法系国家为了适应《伯尔尼公约》也都加入了精神权利，但在保护著作人精神权利上都保持相当暧昧的态度。在英美法系国家，精神权利时常被从版权中分割出去，与版权一样有保护期限的限制，并且大多可以主动放弃。而著作权（authorsright）的理论基础源自康德对作者（author）的论述，它将作品上升到作者人格的延伸，甚至可以说是作者灵魂的体现。著作权体系是从天赋人权、自然权利的角度出发，将著作权视为对作者人格的保护。著作权可以说是一种比较浪漫化的概念，早期著作权甚至会要求作品中需要带有作者人格的烙印方可证明其独创性。哪怕著作财产权可以转让、有保护期限，但代表其人格的著作人格权却是被永久保护的，且不可转让、不可放弃。;1;7;8;18388;0.00043506634761801175
22561;完全可以理解画师的的心情。这个东西让价值贬值了。但是抵制和发展目前来看不会有什么交集，很简单，这个技术是开源的。开源算法没有某个公司会对此负责，所以暴风雨总会来的。;2;10;12;18388;0.0006525995214270176
22565;我看很多公司都在搞ai实习，理性看待ai就是个工具，人家公司同样可以用自己草图给自己产出。同样是公司让游戏外包画低端点说也无非就是找参考套模板，而ai渲染水平并不比外包公司差，特别是二次元很多作品宣传的脸都基本一毛一样。既然ai存在了就没必要扯东扯西了，画画人也不过是游戏打工人的一部分，做产品的话外包公司抄袭的也不少，游戏公司既然敢用ai自然知道怎么人为修改。从商品上来说ai是工具，因为ai的设计确实效率非常高，而且比大部分画师画的牛逼，很多绘圈吹画师强于ai的视频我也看了，说实话大部分中低画师确实就渲染而言不如ai，只是不如ai风格商业。很多画师有太多自己的习惯。像akizone等少部分强的二次元画师比ai强而且细节。但一定要说ai可以用，但只能是工具，直接把ai产出的东西拿来用我是觉得不行的，顶多就是当个大致参考。不能因为ai而让设计师没有自己的大脑。;3;8;11;18388;0.0005982162279747662
22569;最近白夜极光那个画师不就是，只能说不亏是当年干过那种事的人，现在立马用上用新技术换个方式来吸血微笑;3;8;11;18388;0.0005982162279747662
22573;最痛心的就是创作者辛苦创作最后却只能得到一句“不如ai”捂脸用从他们身上挖下来的东西嘲笑他们这种行为本身就是对那些创作者的亵渎;4;5;9;18388;0.0004894496410702633
22580;我不懂什么艺术不艺术，我只晓得ai画出来的好看，低费，快捷雫嘻嘻;5;5;10;18388;0.0005438329345225147
22589;主要ai不是尸块拼接，是真的在学习，和人一样。人工神经网络都发展了有八九年了吧，为啥现在才抵制。早就有的趋势。;3;5;8;18388;0.00043506634761801175
22593;当有一天，ai把你学习了5年做出来的劳动成果，不经过你同意，直接给你偷了拿去5分钟就喂给ai然后做出来的东西还比你好，就不会有这么多人说风凉话了。只是还没轮到自己，直到某一天，ai能吃到自己的饭碗了，你不一定不反抗。;2;4;6;18388;0.0003262997607135088
22596;为什么非要强行把原本就值十几的普通茶壶交给人工去干呢？流水线上生产的茶壶影响手工紫砂壶一把上万了了吗？;2;5;7;18388;0.0003806830541657603
22599;可能有点偏，不抵制恶意使用AI工具的人，反而去抵制作为工具的AI。反向版“非我也，兵也”思考;2;6;8;18388;0.00043506634761801175
22603;个人认为，现在比起十年前画师们的水平明显提高了很多，也发展出了许多不同的流派风格。ai的滥用肯定会让很大一部分想成为优秀画师的人望而却步，而少了大量画师研究新画法、新流派，哪怕ai未来解决了人体光影等问题，没了画师的创造力，ai也只能原地踏步。拿来玩玩可以，但真让ai抢了画师饭碗，最后的结果就是多年以后，我们依旧只能看着今天的素材拼接出毫无新意的“新作品”，这无论对画师还是我们这些观众而言都是最坏的结局。;1;10;11;18388;0.0005982162279747662
22605;评论区某些人极大地丰富了黑名单看到有人说ai让创作的门槛降低了，但是我不认同，输入咒语然后在里面挑张感觉好看的图出来那不叫创作，更有甚者特地找与出来的图相似的角色发到角色tag里就为了满足自己的虚荣心。对于很多喜欢画画的人来说创作一副画的过程是非常愉快的，虽然听起来很奇怪但是画画人画画的时候有把自己的一部分加进去的，这也是为啥很多人喜欢搞oc和搞同人，画画是很多人表达自我的方式，而ai制图又被某些人吹捧并以此来打压画师，这不仅侮辱了画师也玷污了创作的过程，生气是理所应当的希望某些人有点同理心别一天到晚小嘴叭叭地吹ai踩画师，ai的素材库都是人画的，儿怎么可以踩蝶呢;5;10;15;18388;0.000815749401783772
22611;ai有好有坏，但对于画画5，6年的画师而言，这是画师用时间换来的努力，有点不理解那些用ai的人去嘲讽画了5，6年的画师，真的是挺无语，50步笑百步，麻了捂脸;1;5;6;18388;0.0003262997607135088
22614;我很期待两年后，五年后，从业人又是什么态度，今年是它出现在大众视野的第一年，回顾从年初，到年尾，再到跨过2022，不同阶层的从业者和还未进入向往的学习者思维想法的变化真的蛮有感触doge2023;2;6;8;18388;0.00043506634761801175
22617;Ai绘画就是一坨，应该解放生产力的东西被用来窃取他人劳动成果，美名其曰技术进步。藏狐;1;8;9;18388;0.0004894496410702633
22619;我知道你很痛苦，但我也认为这个技术的确是非常自由非常有创造性的。如果选花时间金钱去研究这个技术和花几百块买画手的画，我选择ai。;7;17;24;18388;0.0013051990428540352
22627;刚看到了ai制图出的猫咪，假若有一天ai制图出的猫咪质量远远超过所有的宠物博主。一方需要准备宠物的饲料，照顾打理宠物，要购置昂贵的摄影设备，学习许多摄影的知识理论，要花许多的精力时间与金钱。而另一方只需要宅在家里穿着睡衣，直接电脑点一点键盘敲一敲，只需要一点点的时间，几乎是0成本就能远超真宠物。想拍宠物视频给大家看的博主将不复存在了，这只是其一，还有摄影师、模特之类的。我感觉简直乱套了，许多兴趣爱好乃至职业都会变得极其可笑;4;8;12;18388;0.0006525995214270176
22632;我计算机专业兼学画画，报班都花了小万把块钱，当ai出现的时候我都觉得自己能够坚持走下去，但是群里日常基本就是每日必谈ai，加上一些所谓的《创作家》贴脸输出，我真的在厌恶他们为什么把吃人说得理所当然，所有学画画的或者其他人，你们想想当一个人做了一件努力而不讨好的事情是有多么可怕，一旦这种恶毒的侵权思维狂潮没过真正的画画，那无论是画画的还是不画画的，都是人类史上最大的悲哀;6;5;11;18388;0.0005982162279747662
22641;说来我也挺感叹的，据我所知最早的AI绘画是一张12年画的猫脸，但那时候很糊。那时候根本没想到现在的AI绘画技术突破了这么多，最近甚至还有能攻克人体和手的超强插件。真的，这个趋势根本拦不住，虽然我在用AI绘画但是很担心以后学画画的人会越来越少，因为画画本身就要花好几年的时间甚至报班。现在代替所有画师还不至于，但我可以肯定AI在堵死这条路，并且以后能坚持下来的人只会越来越少，甚至断代。所以我现在也挺担心那些靠板绘吃饭的画师，唉;2;5;7;18388;0.0003806830541657603
22644;ai只是一个辅助工具而已，却有人想把它作为人工的替代品，这种人要么是学不明白画画想一步登天的，要么就是觉得牺牲一部分人的利益为自己创造便捷是件正确的事;1;5;6;18388;0.0003262997607135088
22647;首先你的风格也不是你独创的也是侵权得来的，所以我们跟AI是没有区别的。;2;5;7;18388;0.0003806830541657603
22650;不喜欢二次元ai，我喜欢赛博coser，感觉比真人干净多了兔年吉祥東雪蓮哈哈兔年吉祥東雪蓮哈哈兔年吉祥東雪蓮哈哈;2;6;8;18388;0.00043506634761801175
22654;说实在的，从创作上说，你的作品对比ai画的，其实并没什么独特和创造性doge;1;5;6;18388;0.0003262997607135088
22656;这不就和裁缝机和手织的区别吗，生产力的进步当然会阻碍一部分简单劳动力的赚钱，但是不会影响行业顶尖的人;8;4;12;18388;0.0006525995214270176
22668;白老师上首页咯是这样的ai现在在疯狂进步，，感觉未来的趋势就是ai变成市场。;4;6;10;18388;0.0005438329345225147
22673;ai代替人的劳动力是迟早的吧，我只希望代替人产出的价值能服务于众。个人觉得ai的发展算的上是时代的一大步，往后可以代替脑力工作，汽车出来时车夫就必然会被淘汰。当个爱好，好好活着就行，不期望时代能给画师留有生存空间，实在不行回去种田了，自给自足笑哭笑哭笑哭即便是ai支付学习者的版权，也没法改变画师生产空间被挤压的问题，因为ai压根不屑于用中低端画师的图。。。。;4;3;7;18388;0.0003806830541657603
22681;评论区说那么多有多少人是画师啊？反正刀没看到你头上你不知道疼呗，学习？你以为到时候你还有机会学习吗？;2;8;10;18388;0.0005438329345225147
22684;马云当初也不是零售业人士，但是他把零售业几乎连锅端了。抵制也只是暂时的，除非国家立法。只要市场有需求，这东西就会发展。两条路吧，要么它成为画师助手，要么成为画师对手。。。心存侥幸会死的很惨。。做好最坏打算。;1;5;6;18388;0.0003262997607135088
22687;现在你先跳脚吧，10年20年之后ai必干翻这类行业;6;4;10;18388;0.0005438329345225147
22695;侵权不侵权不是空口说的，直接看法律好吧。希望up能告诉我ai触犯哪条法律，从而导致侵权了？其次就算训练，要如何证明ai用了你的图训练呢;45;5;50;18388;0.0027191646726125733
22741;ai现在不去用在搬砖这样的基本工作，怎么想着现在就进军绘画这样这么主观的工作了？辣眼睛还是说都有进军？;3;10;13;18388;0.0007069828148792691
22747;那些会下围棋的AI，围棋技术比人类强了一大截了，难道它们不也先是学习棋谱而来的吗？就算你用非商用的图片，最后越来越会绘画的AI也一定会出现的。技术是会进步的，你说AI绘画h那你说它们的素材库就没有这样的东西吗？你不画h的东西，消费者也不会看，跟AI绘画别无二致。技术本身是无罪的。如果你说ai抢了你饭碗然后你就生气了你去骂这是不对的。历史的浪潮总是要筛下一些人的。再说你说AA会话让创造的价值一点也没有，这也是不对的。你的意思是说比有比人类更强的AI棋手出现，那么就没有人来下棋了吗？事实上围棋这几年发展的比之前好多了。;6;11;17;18388;0.000924515988688275
22754;实际上就是把人类画师的饭碗给抢走了，而且是用别人的作品拼出来的。;1;5;6;18388;0.0003262997607135088
22758;我觉得ai作画也算是一种生产力发展吧，不过这生产力发展也带来了生产关系上的矛盾，某些人拿ai作画去抄别人的画来卖，来剥削画家之类的。如果ai作画是画家所有，或者说是劳动者所有的生产工具，那画家不是反而可以用这个来提高自己的作画生产力吗，所以说我觉得可能是生产关系出矛盾了无语;9;3;12;18388;0.0006525995214270176
22768;那你描摹别人的画，是否涉嫌侵权了？这种事很难说吧，哪一个人不是从学习别人开始的，难不成学习就算侵权。;4;5;9;18388;0.0004894496410702633
22773;不同赛道，ai绘画对2d绘画的冲击应该不大，毕竟是没灵魂的。最受影响的应该是cos区，写实ai绘画已经完全能冒充cos。。还出图效率贼高。下面是昨天训练一天的模型跑出来的结果httpsb23tvBV1Xb411X7uB;1;5;6;18388;0.0003262997607135088
22775;主要ai侵权实至名归，为什么有人会厚着脸皮去打ai原创的标签;2;5;7;18388;0.0003806830541657603
22778;像不像当年实体经济大嘛线上经济抢了他们的生意说着要抵制淘宝京东tvdoge;1;5;6;18388;0.0003262997607135088
22781;ai的出现其实就是一种更低门槛的工具出现了。电子绘画在技术，手法和上手难度本来就更加容易，ai只是将这个门框拉的更低，价值贬的更廉价的工具，就像人力逐渐被机器取代一样;5;5;10;18388;0.0005438329345225147
22787;画师学习绘画的时候，看了其他人的画。把一些技法构图学走了，算不算抄袭？搜索素材，各种花卉纹路、建筑物、交通工具机械，变形用到自己的画里算不算抄袭？;2;4;6;18388;0.0003262997607135088
22791;视频包括很多评论都让我感到很搞笑，就像迎接水滴的2000响飞船一样滑稽。这轮的ai才刚开始呢，就像人类创造的第一团火，带来的影响将会辐射全社会全行业。这画师就跟菜市场的大妈一样还在讨价还价呢，就这群知识水平的低下的，带着一群知识水平更低下的粉丝最爱bb赖赖;1;6;7;18388;0.0003806830541657603
22793;AI好像只会画意义不明崩坏和大乃纸辣眼睛;6;5;11;18388;0.0005982162279747662
22800;出现那种好笑的情况，隔壁画手被质疑AI疯狂发过程证明，每次约稿都要声明己不是Ai，然而另一边写歌的p主老师用的AI绘画，然而被评论区说认同许可，觉得怎么画根本不重要;5;9;14;18388;0.0007613661083315206
22806;科技基本就是为资本服务的，那些嘲讽画师不如AI的不过是自卑感溢了出来，当那天资本带着AI入侵了各行各业甚至因此他们而失业时，他们会被率先饿死，因为他们不如up那种有一技之长。但又话说回来，画师出路确实因为AI越走越在窄，要么开发出自己的画风，要么是自己整治一些画圈的乱子，要么是和更多人合作做出点什么，否则最后依然会饿死藏狐;4;7;11;18388;0.0005982162279747662
22811;说真的圈外人别笑，ai拿绘圈试个水，以后是小说，作曲作词藏狐大家一起遭殃，谁也别笑谁藏狐;3;4;7;18388;0.0003806830541657603
22815;现在都有公司开始自己用了，悲;2;5;7;18388;0.0003806830541657603
22819;抵制这玩意取得的成效跟躺床上什么也不干是差不多的;1;9;10;18388;0.0005438329345225147
22822;只许你们垄断才不叫剥削吗;10;6;16;18388;0.0008701326952360235
22835;就像当年英国的手工织女不曾会想到，如此复杂的织布技术会被没有感情一口一口吐蒸汽的钢铁所取代。;8;5;13;18388;0.0007069828148792691
22845;ai只是工具而已，只有把自己定位为工具的画师才有被替代的焦虑，与其与生产力发展作对不如去运用它，毕竟最后人类会生存在一个面包与牛奶不愁，知识与技术共享的世界;1;5;6;18388;0.0003262997607135088
22847;理论上，为了钱而绘画，本身就是对绘画这一艺术的异化。;1;4;5;18388;0.00027191646726125733
22850;有同学用ai画的画交作业结果取得了比全班几乎所有人都要高的分数，我们费时费力原创比不过他几秒钟生成一张，真心寒，这就是你们要的动力嘛？呆呆呆;4;5;9;18388;0.0004894496410702633
22855;而且，AI真能毁绘画，大佬是比不过，但萌新，初阶呢，直接把这部本人砍死了七七八八，以后谁还学，都后继无人了;1;4;5;18388;0.00027191646726125733
22859;我觉得根本不用这样抵制。用过就知道本身需要微调和再创作的。而且美学根本还是要学习。不如说可以解放灵感。;1;4;5;18388;0.00027191646726125733
22861;ai已经把画师们逼到这种程度了？;2;4;6;18388;0.0003262997607135088
22864;那些把火柴跟打火机用来给AI绘画与画师绘画打比方的人，完全没搞明白，这两件根本不是一回事，打火机是为了方便人类，就比如一些缝纫机啊什么的，说什么当初工业机器被工人抵制来给AI绘画打比方，但是这些东西的创造都是为了方便人类的生活，但是AI绘画根本不是啊，这种东西是会把人的创造价值以及意义消磨殆尽的，艺术这种东西本来就是人把这幅画创作出来被赋予意义，对于画师来说精心创作出来的一幅画是有成就感的，AI绘画本身没什么问题，也许每一个工具诞生出来都没什么问题，有问题的始终是人无语;8;5;13;18388;0.0007069828148792691
22873;每个行业都砍到了，不止你们。估计永远也砍不到的就是足球了;1;3;4;18388;0.00021753317380900588
22875;这么一个小小的非必需品，社会上很多人都觉得无足轻重的玩具，这样的东西改变生产形式这样的小事，为什么被人认为上升到了科技进步？先得解释一下，插画摄影等等生活非必需品，它的量越大、门槛越低、标准越模糊，它受到市场规制规制的力度也会越大。也就是说首先劳动者不会轻松。（举例）有没有发生这个事的区别也就相当于一天一百块出一张和一天一百块出一千张的区别。其次老百姓会很快厌倦，即人人都难免受到环境影响而改变自己的价值观。就像吃饱饭这个概念曾经份量相当重，而在各种食物产量提升而且不再限量的今天，除了老人以外再也没人在乎吃饱饭这个概念了。上面两条要讲的是：不论是圈外人还是圈内人，大家都是同样的局内人，互相攻击毫无意义。所谓科技进步只是幕后主使美化自己欲望的谎言，只要和自己的生意伙伴对比一下就知道，这样冠冕堂皇的理由在生活中根本就不存在。那么若想要享受到工具的便利，真正需要做的是把工具和幕后主使们强加给工具的多余属性剥离开。说这么多只想提醒大伙，大伙进一步互相理解才是真正的进步，而不是一个小玩具改变形式这样狭隘的事情，希望大家意识到。;4;4;8;18388;0.00043506634761801175
22883;这么说吧，ai绘画也只是工具，最终画面效果还是看个人审美，你不理解什么是美的，不会画出来你也就没有深入了解美的本质，到最终生产出的也只是一些末流作品tv白眼;1;3;4;18388;0.00021753317380900588
22886;等封杀ai，ai违法;1;3;4;18388;0.00021753317380900588
22888;就怎么说呢，我不会画画，但是作为消费者AI可以以极其低廉的价格快速给我大量出图，很难不接受这种新技术吧？而且从一开始的异形变成现在几乎能以假乱真，这项技术也证明了他的实力和潜力，这已经不是几个创作者联合抵制就能压下去的东西了，改变不了就只能适应咯。;2;6;8;18388;0.00043506634761801175
22892;我是覺得，Ai除非真的有了自我思考、人格、意識、自我創造力等等，不然取代畫師根本不可能，Ai最終的定位很簡單，就是畫師在初期草稿、甲乙方溝通、部份靈感參考的輔助工具罷了，實際應用上還是不如板繪手繪來的靈活自由精細，因為不是親自用手畫，可控性完全不能比，所以手繪板繪永遠不會被這種東西取代，而最終Ai也只是部份畫師拿來輔助手繪板繪的工具罷了;3;3;6;18388;0.0003262997607135088
22898;我总觉得这种ai对于社会行业发展弊大于利，绘画围棋什么的。它们带了了什么，对我们生活有什么大的帮助？让大量从业者离开，没有了工作。就论绘画，最后只会断层就剩下最顶级的，然后呢他们不是成长过来的吗。最后没人会选择绘画这种事物，然后ai停滞不断重复作品，行业恢复不断轮回。当然这都是我瞎想的，但我持悲观态度。围棋ai什么更是无用，你们可能会说又不是只有这些事物供我们为之热爱。但是人类发展到现在创造了多少，没有那么多。我觉得这些科技人员搞错了方向在这个有着如此之多缺陷的世界，有更多需要的革新的。不应该如此粗暴地冲击绘画这样的行业。;3;3;6;18388;0.0003262997607135088
22903;非画圈，纯科学爱好者圈，我们圈内认为al绘画挺好的。;1;3;4;18388;0.00021753317380900588
22906;我觉得现在的AI发展已经不会因为某一个人的态度而改变整体的形式了。;1;3;4;18388;0.00021753317380900588
22908;只能希望尽快出台相关法律治治ai大哭;4;6;10;18388;0.0005438329345225147
22913;所以只要一个模型的所有训练样本全是拿着版权买来的（或者通过别的办法对方被自愿给的），那这个模型就是合法的，我说得没错吧;1;3;4;18388;0.00021753317380900588
22915;究竟什么是艺术呢？是创作的过程吗？或者只是制造名为“艺术”的商品？你说它内在有价值，可别人只看中它的外在价格。绘圈被毁？和他们又有什么关系，他们只需要一个画图机器。抵制这玩意，很难;8;4;12;18388;0.0006525995214270176
22925;画师群体一盘散沙，我的建议是尽快推动立法，禁了将私人图拿去训练模型的事儿虽然去世画家的作品和企业公开素材库还是能拿来训练，但至少比你们发视频吐槽来的强网络上发声抵制真没用，下游用户抵制才有用捏，怎么抵制拿什么抵制都没搞明白怎么整的过资本啊我的评价是趁早转行快点润;9;3;12;18388;0.0006525995214270176
22935;这玩意提高效率，快速升成草图然后进行改进变成自己的画风，驾驭工具，而不是一味地吐槽吃瓜;2;4;6;18388;0.0003262997607135088
22938;现在的ai可离谱了，最近那个赛博COSER看的我一愣一愣的，按二次元ai短板挑毛病根本找不出来。亲眼见证了分享图的网友转来ai图，到多条转发ai图包，到名片相册塞ai图。好可怕;4;8;12;18388;0.0006525995214270176
22944;很可惜，抵制技术是无用的，就像工业革命砸机器的工人一样，时代的大势所趋无可阻挡;1;3;4;18388;0.00021753317380900588
22946;有个小问题就是有些人觉得ai学习和人学习是一样的，我确实不怎么了解这方面，我一直认为ai就是大数据拼图，如果是大数据拼图的话，那侵权问题就显而易见了。而我认为人的学习可以逐渐发展出不同的理解然后逐渐脱离开自己学习的那个对象。我到觉得ai做不到创新，不然被取代的就不止区区一个绘画行业了有懂哥的话可以说明一下吗;3;4;7;18388;0.0003806830541657603
22951;资本：嗯嗯嗯，对对对，你说的太有道理了，所以我们来制定一个更好的规则吧。doge;1;3;4;18388;0.00021753317380900588
22954;对于《恶意诋毁创作价值》这句话，有点过分解读了，ai必定是大势所趋，大厂三四个月前就已经开始使用了，商人不会在乎《艺术家》的死活，如果能有更快的方式赚到钱，出项目，减少成本，资本家何乐而不为呢。工业革命时候也有一大批机器顶替了人类手工的工作，我想这应该是类似的性质，所以再怎么呼吁，再怎么抵制都是没有用的，还是好好利用让自己生存下去。;1;4;5;18388;0.00027191646726125733
22957;织布工人很急;1;2;3;18388;0.0001631498803567544
22959;与其争论AI能否取代画师工种的小问题，不如多想想AI对真实的照片影片的深度学习后产生的乱象前有售卖AI生成的炼铜照片，后有拿AI合成图像搞诈骗捂脸说实话，比失业吓人;2;3;5;18388;0.00027191646726125733
22965;你在扺制AI绘画前，先把你手上的绘板丢了;20;4;24;18388;0.0013051990428540352
22986;我也来说一些，我不信你这个花了N年时间学习，使用AI创造一幅画的时候，会跟一个只会使用AI的门外汉是一个级别。你所掌握的，对于美术的概念，你自己美术造诣的诠释，都将会体现在你得创作内容上。你画的每一个动作，都有这样去画的意义，是创作思想的表达。即便是使用AI，你也是发令人，你脑子里有货一个门外汉，他能做的就只是模仿，他如果不去学习艺术，永远做不到原创你说AI可能是侵权的温床，这确实可能，但这是另一件事，是AI可能带来的结果却不是AI应该被低质的原因你可以花几年时间去学习、练习你得绘画能力如今出现了新一代的绘画工具，你却放弃了学习，选择抵制;5;3;8;18388;0.00043506634761801175
22993;如果宅男用ai绘画满足“一己私欲”，那么构不成什么风浪。单如果用这些画谋取利益，那就彻底变味了。娱乐的立绘和谋生的工作完全是不可逾越的差距，前者满足娱乐，后者直接关乎身家性命;1;4;5;18388;0.00027191646726125733
23002;ai绘画显然是进步的，我为了兴趣学过绘画，但是画一张图可能要画十个小时，草稿到精细线稿，再二分上色等等，每一步都不简单。但是用ai我可以很快的产出我喜欢的角色的图片。但是ai绘画确实某种意义上侵害了画师的权益，但是版权怎么补偿呢？全球这么多画家，要补偿就得一个一个补呗，与其浪费很多时间去达成所谓的公平而丢弃效率对画师是重要的，但是对研究者是不值得的，还不如直接拿了图训练，训练出来的模型给人类带来的利益是远远大于画师被侵害的利益的。只能说画师比较倒霉，科技发展的同时并不一定是所有人受益的;2;5;7;18388;0.0003806830541657603
23007;思考有些宝崽刷这么多生产力，进步啥的，不讲这些虚的，你花钱找人约稿人家给你ai拼的图就问你愿不愿意付款吧。;6;3;9;18388;0.0004894496410702633
23015;完蛋，我发不出长篇评论（;4;3;7;18388;0.0003806830541657603
23020;怎么说呢，我画画完全是因为热爱，本职也不是职业画师，所以也不是以赚钱为目的。但是我非常反感现在都ai绘画和风气，痛恨ai的合成物，ai它就是拼凑画师们的作品，大家现在看到的高质量ai图都是那些大佬画师的作品拼出来的。一旦这种东西放纵不管，告诉你最打击的就是大家的创作积极性，国家所提倡的保护知识产权就是保护创新何尝不是这个道理。还是那句话，不要等到大家的创作积极性被磨灭殆尽，才意识到事情的严重性。依我看还是要国家法律和大家共同抵制，任重道远啊;1;2;3;18388;0.0001631498803567544
23024;我目前最希望的是ai制图能大规模应用在动漫领域上，人工和ai结合先由人画出草图，然后ai迅速添加光影等效果，最后人工修正成品，或者先人工快速制作低质量3d，再由ai3渲2，然后人工修改成品，这样如果使用得恰当能大幅节约时间成本，目前动画行业也有点衰退的感觉，很多番都能明显感到贫穷，如果ai能带动动漫行业发展，能让整个动画领域，任何作品都是高质量甚至高帧数的话，那基本上是最好的情况了;1;2;3;18388;0.0001631498803567544
23026;人类思想的过程都被ai取代了，干脆人都别活了，ai以后就是新人类啦tv白眼;3;3;6;18388;0.0003262997607135088
23032;而且顺带告诉你一下。怎么样彻底解决你说的有些时候过于相似的问题呢？简单。升级，gpt4的能力会更多。也会更强。或者说拉参数。这个AI被设定成尽量靠近人所感觉到的东西。如果你想要些特别的。可以去把参数拉高一点。会画的比较奇特，这就更可怕了。解决你口中的问题的。反而是继续升级这个AI。用上更恐怖的神经元引擎。说到底。跟一个开元的神经元算法，说什么商业逻辑，我觉得是一件很可怕的事。大概就是完全不相关的事。毕竟他就只是个神经元算法。一个高效的模拟人脑计算的推理算法。就这么一个推理器。所以说跟你们整个行业都没关系。只是这对于你们来说太可怕了。无解的。还是放弃。至少能在这个无解的地方少点麻烦。;3;5;8;18388;0.00043506634761801175
23038;没有没有可能一开始ai是直接拿照片训练画画;2;2;4;18388;0.00021753317380900588
23041;我的观点是，最能体现人创作价值性的东西，不应该被ai所替代和滥用，这属于是不断压榨人最后的价值，也会使事物的本身失去原有的意义，通俗点就好比过度赛博化了。;1;3;4;18388;0.00021753317380900588
23043;但是画师比AI贵好多哦，AI能搞定的我还是倾向选AI藏狐;1;3;4;18388;0.00021753317380900588
23045;我是画手，其实被ai取代我并没有不能接受，但是ai用的是非法的是手段取代画师，那我不认可。然而得利者却和看戏者都抛弃道德在支持ai;3;3;6;18388;0.0003262997607135088
23049;ai绘画的原罪在于画的还不够好;1;2;3;18388;0.0001631498803567544
23051;httpswwwbilibilicomvideoBV1KG4y1Q7Exspmidfrom44441listcardarchiveclickvdsourcede201eb188765d8ba3b304c2dd762ed2doge建议某些只知道珍妮机的小盆由先看看这个视频;1;2;3;18388;0.0001631498803567544
23058;但是ai绘画作为玩具来说真的很完美，只要别到画师脸上跳脚就行了吧（;1;3;4;18388;0.00021753317380900588
23061;如果我是一个游戏制作者，只要能不用人，我肯定会选择ai美工，因为游戏制作到了后期成本的大头就是美工。;2;3;5;18388;0.00027191646726125733
23064;其实商用不了，现在的AI绘画已经不可能成长了，那些赛博小鬼只不过是拿出理论，实际上，要喂图的数量很庞大，AI绘画只是个笑话;5;3;8;18388;0.00043506634761801175
23070;AI不是人，没有思想，但是它的使用者是人使用的人未经别人同意吸收别人的画，滥用拼贴，还进行商业交易，难道不是侵权？辣眼睛疑惑翻白眼;5;2;7;18388;0.0003806830541657603
23077;这有几个前提第一你能真的确定这个AI的训练集里有相关画师著作并且进行举证而非臆测第二中国AI作品著作权完全不受保护而这在18年腾讯的腾讯诉网贷之家著作权案里并不成立虽然说现在仍没有明确的成文法对于这方面的规定但也侧面说明AI绘画版权未必完全不受支持扯皮估计是要要命的最重要的那么多被侵权的画师赶紧找一个起诉一次侵权现在就缺一个AI制图版权上的一锤定音判例我倒是真的想看第一个螃蟹的下场省得吵来吵去早点散了;1;3;4;18388;0.00021753317380900588
23079;只能說很慶幸還是有很多消費者不買帳AI圖只願意買人畫的圖但這可能也只是時間的問題;1;3;4;18388;0.00021753317380900588
23081;考公务员吧在那以前。;1;2;3;18388;0.0001631498803567544
23084;我可以接受我不吃这碗饭，但我真的很可惜后面来的人想从跑道中间穿过的想法。如果你研究过教育你就会发现其实关于人类如何认知陌生知识方面是一直有争论的，人与机器的差异在于有些感受是超理性的。这里我就提一个素描的例子，你们认为光垂直射向物体表面到光与物体表面平行，在角度转变的过程中人的视线观察的明度是线性变化的吗。我的经验是很多人都认为它是线性变化的，实际情况它不是，包括一些在行业里干了很多年的依然也会拿的是错误的理论。但是最神奇的一点是，他们画出来的素描关系是正确的，因为他们不是通过理论来绘画的，而是通过用眼睛观察和用心智感受。就像一个人用错误的游泳理论，正确的浮在了水面上，他并不理解自己是怎么做到的，但他依然做到了。连人自己都没研究明白自己，没有正视人类感受的独特性，只觉得人是所谓电信号的集合体，只在的商业生产体系里在劳资关系中才能实现生而为人的价值。那我相信人类的未来必然是悲惨的，且绝不是因为ai，而是人用这套叙事规则漠视了人类创作的可能性，只觉得它是一种抽象元素的再组合。我最后说一句，绝大多数脑力劳动者都是要倒霉的，只要你没有真的去探索那个绝对意义上的创造力。而且那样的创造力最终也是会被商资收买的，因为你的存在价值就是换着花样给人累计资本，你的创造力跳不出这套商资的叙事框架。;1;3;4;18388;0.00021753317380900588
23086;ai绘画不是反而对画画的人有好处吗，为什么那么多人抵制;4;3;7;18388;0.0003806830541657603
23091;ai没法自己生成新的画风吧，比如你训练一个ai，只给它几十年前古早漫的素材，它能生成一个现在流行风格的图吗？我担心的是如果将来画师行业被ai取代，那么ai没有新素材，就没有新画风了，到时候圈外人也要难受了，因为现有的画风大家都看腻了，ai又没法自己创新，真人也都被卷没了有人可能会说画风的更替都是顶尖大佬才能完成的，ai卷不死他们所以问题不大，那我想问大佬一出生就是大佬吗？他们也是画渣过来的啊，你这ai直接在入门阶段就给人劝退了，哪来的大佬呢？退一万步讲，就算到时候还有人愿意学，他不差钱，学这个就是爱好，然后他把自己的作品发网上，没几天他的画风就被ai学会了，这谁能接受？;8;3;11;18388;0.0005982162279747662
23100;放心，下一步就是音乐了微笑，尤其是网红神曲，很快就可以快速量产，成本极低，量大管饱;4;3;7;18388;0.0003806830541657603
23105;话说AI画是从谁手里跑出来的？那个网站的开发者没出来说话吗？已经算窃取他人的了吧？;2;2;4;18388;0.00021753317380900588
23111;正确的把绘画作为爱好的我还在琢磨3D辅助结果AI已经薄纱我了想当主业的编程也受到了影响怕不是我还没进社会就要失业了笑哭;3;2;5;18388;0.00027191646726125733
23115;只要画师们搜集1年ai挖自己作品产出图的证据，也可以自己搞。并且这一年中因为ai的抠图侵权行为造成了实际的经济损失。一个集体诉讼，要求ai公司因侵权进行赔偿。ai绘图就完了。就行ai音乐一样，音乐发行商抓到扣的证据一告就完蛋。所以还得看西方画师们什么时候告一把。这事儿陪审团肯定站劳动者这一边，99的概率赢。我觉得ai绘图肯定要完。;2;3;5;18388;0.00027191646726125733
23118;ai应该是帮画师减轻压力的工具，而不是资本家剥削画师劳动力和收割消费者韭菜的道具。;3;4;7;18388;0.0003806830541657603
23122;个人觉得，AI确实像你说的那样侵犯了画师，同时，它的存在消灭了一大部分画师，但我认为有利有弊，它排除了许多低创力画师直接拔高下界，但是，也是主动地促进画师们提高上界，或者像不同方向发展，比如说星空这种艺术画作，和抽象画等等，而且再某些方面也许会帮到画师。我觉得和码农触类旁通吧，有喜有忧，并不能说AI的出现就能取缔大多数码农，至少目前还是这样;8;3;11;18388;0.0005982162279747662
23132;你说的对，但让大家只是去表达自己的不满作用不大。现在ai最大的问题是使用的人，ai就像把枪，除非从源头管控ai的使用，平台限制监管ai图，不然很难改变现状。;3;2;5;18388;0.00027191646726125733
23136;我推崇ai不妨碍我自己各种练画，至于跑图拿出去跳脸，我是不理解这是个什么心态;1;3;4;18388;0.00021753317380900588
23138;ai促进了生产力。矛盾在于cap的教育体系是让你成为特异化的人，ai解放了生产力，但被解放的人在cap下是失业的特异化螺丝钉人。在哪之前美术工人们不也就是人肉ai吗？给ai输入的prompt不就想老板对肉人ai说的需求吗？美术工人在cap的生产关系下生产活动中的东西真的有艺术性吗？工作中创作的过程是审美化的过程吗？绘画的过程中有大量折磨性的劳动，特别是当画的不是自己喜欢的东西时，是老板要求的东西时。在消费决定生产的关系中蕴含了毁灭cap的力量，ai就算替代了99的人，但是生产出来的大量的东西谁消费呢？ai是能解决生产但又不会消费，解决办法就是按需分配的计划性的生产。但cap不会同意呀所以当下画师们要积极的和ai相结合，掌握和切近自己生产劳动中重要的生产工具，就像用sai用的习惯也要学学ps。去学英语。去攒钱弄台电脑。去学会本地部署stablediffusion。绘圈乌烟瘴气，常说的版权，可是你给老板画画的时候，版权也不是你的啊版权不是维护你利益的，是维护cap的。;18;4;22;18388;0.0011964324559495323
23158;侵权只是好用的说法，十个人类画师至少有九个在学画画时候临摹过别人的作品，难道这些也是在侵权？;18;2;20;18388;0.0010876658690450293
23178;up视频最后那段现在ai相关视频可以看出，除了性与爱或者可爱的外表他们其他都不在乎，吾王亚瑟阿尔托莉雅潘德拉贡即便是TV版也无限散发着他的魅力是那些丑陋的东西可以描述的？;2;2;4;18388;0.00021753317380900588
23182;妮姬和白夜极光这两个游戏已经开始用ai做图了，不好说;6;3;9;18388;0.0004894496410702633
23189;ai绘画确实是生产力的进步，但是该领域侵犯原作者权益的问题应该引起重视并加以规范。;2;2;4;18388;0.00021753317380900588
23201;我只想看到低成本ai绘制皮肤然后一堆人648氪金我真是笑死。;2;6;8;18388;0.00043506634761801175
23204;评论区看到有个作曲的说只要ai好看就可以，巴不得ai作曲出来自己可以写曲子更快，反正不是自己的钱被偷了就行。我只想说快了，到时候你自己花好几天作的曲被别人喂了ai，自己明明一点流量没有一点钱都赚不到，结果别人拿着有你歌曲成分的ai曲子赚个百千万，即使你听起来感觉很像自己写的，你能告他吗？不能。到时候你就知道哭了哈欠;2;5;7;18388;0.0003806830541657603
23207;靠AI绘画跳脸的，就像玩游戏开外挂，还要嘲讽你玩的不如他的右键起飞，笑死;1;4;5;18388;0.00027191646726125733
23209;就连绘画AI都能威胁到了，还有什么互联网行业不能被威胁到的？其他行业嘲笑数字绘画行业不是幸灾乐祸，而是五十步笑百步而已OK其他行业都死的死残的残，大家都失业在呆着，然后猛然看见CG绘画也岌岌可危，所以他们才在网上喊得那么凶，就觉得“哎呀那你们也有今天啊”喜极而泣他们也就那样;4;3;7;18388;0.0003806830541657603
23214;他侵犯了你的作品吗？关于这点建议你去github查找gpt3，你可能会在这里找到更多的资料。在这里。你可以阅读他的算法来确定他有没有对你的作品进行抄袭。在我看来并不。他是一个万能的神经推理引擎。因为它模拟人脑的推断过程，说说啥也能干。比如说最近的chatgpt还有这个画图。明明是毫不相关的东西，就是因为他基于人脑推理的万能性，所以说在多种AI上面均有使用。也许你可以去上面查询相关资料。并扩充你的知识库。;8;2;10;18388;0.0005438329345225147
23224;tv皱眉求求鼓吹ai的人不要再搁哪儿说什么节省成本节省成本了，让你家里人一个月的工资从9k减到2k做在多做3个人的活儿也是客观上减少成本，都是资本在调控分配，毕业搁这儿当精神老板同调事不关己高高挂起，社会毒打你你有抱怨这个不行那个不行，可长点心吧。;1;6;7;18388;0.0003806830541657603
23226;特别特别支持博主看见评论区有写人说的话我真的想说，我认为绘画是一种艺术创造，用ai绘画就是把别人的灵感创意碾碎糅合在一块，永远领会不到精髓，也永远没有灵魂，最多就是满足某些人拿来意淫的需求罢了;1;5;6;18388;0.0003262997607135088
23234;支持用ai代替画画的，咋不去支持用ai写文去代替搞学术研究呢？嗑瓜子;2;1;3;18388;0.0001631498803567544
23237;纯粹的抵制ai绘画这个技术近乎是种失败的决定;4;3;7;18388;0.0003806830541657603
23242;与其说是抵制ai，不如说是抵制垄断。以前有便宜电脑便宜板子，再下载个盗版软件，自己就能画画了。但以后ai成熟了，没ai都画不了画，虽然说目前有免费下载的ai，但企业里才有算力更强、数据库更大的ai，画师不进企业就没有办法接触这个工具，没有办法生产出与企业相同水平的作品，那就意味着企业把这个生产工具垄断了。纺织工人之所以会反感珍妮机，是因为珍妮机并不是人手一台;12;2;14;18388;0.0007613661083315206
23259;十年前的绘画风格和现在完全不相同是因为审美在进步，有新的画风被一批一批的画手们生产出来，符合时代审美的那样一些画才出现了。可ai如果打破了这个平衡，最可怕的一种场景是，永远停滞不前的美术风格和死掉的血液，因为它只会拼接画风，并不会生产画风。想象一下如果二十年前ai轰击了市场，那现在的插画风格可能还停在美少女战士那种风格，而不会出现如今百花齐放的场景。当然大画师还是会有，但很多小众的美丽的画风将会消失。;5;2;7;18388;0.0003806830541657603
23266;ai画的东西就很。。。平常，没有那种眼前一亮或者眼前一黑的感觉，没啥意思;1;2;3;18388;0.0001631498803567544
23269;简单地说，获得一张过得去的二次元图的社会必要劳动时间降低了。;1;2;3;18388;0.0001631498803567544
23275;AI侵权的逻辑我思考了半天都没想通思考，AI的学习过程和人的学习过程应该是差不多的吧，要不然甲画师学习了乙画师丙画师丁画师等人的作品，然后再自己画一幅画，这算侵权吗，真要从外观上看又看不出来是抄袭的;5;2;7;18388;0.0003806830541657603
23283;现在所谓的ai根本不是真正意义上的ai，因为它根本不具有思维能力，它只是缝合像素快，它无法画好手，就是因为它实际并不理解它所画的东西，只是大数据让它把对应像素堆砌成这样，而不是人就应该有人体骨架结构。同样的，有些所谓画师就是和这些ai半斤八两，因为他们也连最基础的人体都没搞定就在那画商稿，看着人体崩坏的版权绘，真的还不如ai画的没崩的辣眼睛;3;2;5;18388;0.00027191646726125733
23293;白夜极光出事了;2;2;4;18388;0.00021753317380900588
23296;很现实的，你抵制ai，老板抵制你。;1;2;3;18388;0.0001631498803567544
23301;未来的趋势：普通人学会用ai就行，学会搞ai可能会更好。比如画画吧，你手中的画笔，颜料是你搞出来的吗，还不是用别人生产的东西。;1;2;3;18388;0.0001631498803567544
23306;两方争论半天，其实矛盾的核心是他们的基本世界观不同，矛盾点在他们的预设前提的两种不一样理解：AI绘画是否会创造更多就业？;1;2;3;18388;0.0001631498803567544
23309;我这么说可能有点难听啊，普通人肯定是哪个好用用哪个撇嘴;1;2;3;18388;0.0001631498803567544
23314;我学美术的，感觉身边学美术的一些人完全意识不到ai的影响，好崩溃;4;2;6;18388;0.0003262997607135088
23324;有个核心问题，艺术是否归属于艺术家，如果是，ai就该抵制，如果不是，就没理由抵制。没人规定车床车出来的工艺品，侵权了隔壁大爷手工锻造的，也没人规定，你先做出来了别人就不能模仿。事实上，好的画师一直在被人模仿，只是这个过程被ai加快了速度。这次阵痛是技进步的必然性，每次都如此，只是这次轮到了画师;5;2;7;18388;0.0003806830541657603
23330;想知道发明ai这些人都是啥想法啊无语还有那些不画画然后用ai还一把出在那说风凉话的好烦囧;6;2;8;18388;0.00043506634761801175
23338;我们自己国家不会禁止这件事的。毕竟资本家。别的国家，小日早在2016年开始禁止ai绘画，已经是在国际法律上禁止了。一发现就坐牢。然后米国那边今年开始发表ai绘画无版权保护。我们自己国家根本不会理这事。我想我应该会被喷或者被举报了。;3;2;5;18388;0.00027191646726125733
23342;但你的画，你脑子里面的概念也是源于其他人类创造者的产物也是源于人们对自然界事物的分类啊。你这个不算是侵权吗？如果说ai学习的方式和人脑学习的方式是相似的，那针对ai的，放大侵权定义的逻辑，对于人类也都是适用的。没有任何一个人可以在不接触人类文明的情况下发展成当今人类某个领域的现代水平呀。那你如果说ai侵权，那任何在人类社会有最基础成就的人，他都是侵权呀。;10;2;12;18388;0.0006525995214270176
23357;围棋选手用ai来提升自己，程序员付费用ai帮自己写代码，为啥绘画圈子就是抵制呢热;30;2;32;18388;0.001740265390472047
23388;已经考虑转行了，最后我只想说没关系的，都一样;3;2;5;18388;0.00027191646726125733
23395;ai就是创作h的东西，创作具体的其他事物，比如动物可能吗？;3;2;5;18388;0.00027191646726125733
23399;AI看图学习是不合理的人类想学画画得付费报班，AI直接有几十亿张免费作品供它学习，这是不公平的;1;2;3;18388;0.0001631498803567544
23401;画师抵制AI是理所当然的，因为AI绘画正面冲击了大部分接需求画画的画师们的工作，而且虽然AI使用的并不是很多画师们所相信的存图拼画这种技术，但目前AI绘图的训练与发展确确实实是基于画师们的劳动成果上的。但与此同时，未来AI创作职业取代大部分人工创作职业也是理所当然的。这就像有了word和打印机之后，抄写员这个职业必然会被替代一样，不论资本多么罪恶与不道德，但“工作”总归是来源于它，而资本肯定会选择成本更低效率更高的AI。但纯粹的画师这一职业在AI面前注定的失败不代表画师们的失败，也不代表着画师们应该举手投降。画师应该继续抵制AI，这样可以减缓失业那一天的到来，同时，我建议画师们也应该积极学习如何使用AI产出图片，因为未来AI代替画师们之后，仍然会需要操作AI产出图片的人，而拥有专业美术知识的画师们显然是更优秀的操作者，因为画师们可以告诉AI使用什么构图，画出哪些元素，用什么配色、光影来画出更优秀的作品，同时画师们找出并优化AI作品上的瑕疵的能力也是没有相应绘画技术的人难以取代的。另外，我还有一个提示，那就是免费AI绘画软件如今虽然遍地开花，但这种免费的状态是不可能持久的。免费只是因为目前还没有明面上对应的市场利益产出。未来AI绘画正式出现在明面上的市场上后，AI绘画软件一定会开始像PS、AE一样作为生产软件收费，并出现对应的软件或运算服务供应商。而此时这些商业公司训练AI使用的素材肯定得正经花钱买了。或者他们会直接雇佣一些画师当他们的“AI画风训练师”。同时，大量买入这个吃螃蟹的AI软件公司的股票或者对应基金，也是一种躺赢方法。;2;2;4;18388;0.00021753317380900588
23405;没有人的绘画毫无意义;8;2;10;18388;0.0005438329345225147
23414;就说为什么这么清楚生病原来我早看见并嘲笑过了“过去几周来，这支歌风靡整个伦敦。它出自音乐科的一个下属部门，是他们专为wchn者量身打造的众多口水歌曲中的一首。这些歌词，完全没有人工介入的痕迹，全部由一个叫做谱曲器的设备机械拼凑而成。可那位妇人却视此等垃圾为天籁之音，居然唱得有板有眼。”乔治奥威尔《1984》;6;2;8;18388;0.00043506634761801175
23422;等到ai抢它们饭碗时，就知道难受了;1;2;3;18388;0.0001631498803567544
23424;作为消费者我一点不觉得ai技术有什么不好的，ai创作不管是艺术图还是图我都很喜欢。我还想让它发展快一点应用到我喜欢的游戏领域提升npc智能或者制作组工作效率之类的;1;2;3;18388;0.0001631498803567544
23426;已经结束勒，ai画画已经比大多数人厉害啦怪我咯翻白眼;1;2;3;18388;0.0001631498803567544
23428;一个令人激动的未来用人类最尖端最先进的技术，淘汰费时费力的古老技术。让复杂的简化，古老的更新，降低进入门槛，该进博物馆的进博物馆。无论阿尔法狗，绘画ai，chatgtp，还是别的什么，这是一条很好的路线。虽然我自己也业余写点短篇小说，也曾为此费心费力。但要是ai出来一瞬间超过我的话那还是挺开心的。因为这会有利于我表达很多曾经绝对没有希望表达的想法。人们已经可以随便使用手机，实现照相方面的表达欲望了，但在文学，绘画，音乐等需要多年积累的方面还极其困难。未来大概只需要练习一下审美，就能成为所谓的大艺术家。ai这事本质上其实很简单人类文明知识库的观摩权，学习权，究竟能不能分享给电子程序？这个问题只有人民能解答。在我国，对最广大人民群众有利的那就是好。在外国，投票最多的就是正义。结果简直是不言而喻的。所以有时也不由感慨这就是历史的车轮;1;2;3;18388;0.0001631498803567544
23431;真是笑死人，一句话，版权不是天生的自然物，没有侵权是客观存在的事实，某些人嘴皮子扯破也改变不了的现行法律下合理的事实;10;2;12;18388;0.0006525995214270176
23442;有一说一ai对于创造者来说那就是打击性的但是对于资本来说那就是至高无上的新科技对于ai的界限及规则目前没有明确定义但是我尝试着使用了ai之后我觉得他以后会是一个好的工具（对于画师而言）接触了lora等知识以后我发现如果画家把自己作品的图喂给ai训练生成自己风格的图并且不共享模型那么他会是你风格下仅有的工具还能减轻了负担（but上面是我自己想的我并不知道如果ai用了画师自己所用的模型会不会进入大数据共享）感觉模型和无模型的ai是两个概念;3;2;5;18388;0.00027191646726125733
23450;我很讨厌ai作画，他让我之前做的很多努力都成为了无用功，除非彻底封杀ai作画，否则说什么都是没用的。但我觉得这是不可能的，因为就像你对烟民说吸烟有害健康，他们就会不抽了么？有些东西一旦开始转动，就停不下来了崩坏3思考;1;2;3;18388;0.0001631498803567544
23452;人无法阻止科技发展带来的影响，就像当初摄像机取代绘画的那部分写实作用一样，AI能快速生成好看的图，也可以用于商业（版权问题迟早会被解决，因为效率太高了），这在一定程度上可以取代部分电绘商业插画，所以后面在谈到绘画回归的就是人了，当技法不再具有稀缺性，媚俗的商业插画可以被轻易产出，绘画终于去除了技能的属性，回归到情感表达或者其他领域了（当然，还没有那么彻底，动画，漫画还没被大幅影响，对于艺术领域来说这都只是工具）;7;2;9;18388;0.0004894496410702633
23466;提醒一下把历史车轮这个词挂在嘴边的大伙，这个词真正代表的含义是重蹈覆辙原地踏步，指类似的事循环往复也就是相当于人迟早会死这样的概念。认可这个词的意思相当于认可以前犯过的错现在就该再犯一遍和人迟早会似所以我很赞同人早点去似这样的结果论消极观点，我想大伙实际上没有那么多思想危险的人，只是搞错了词汇的含义。;8;2;10;18388;0.0005438329345225147
23475;我现在是高中生，大学想学动画专业，梦想是一个人硬刚重力井，但是真的怕这么发展下去，再过十年用不着动画师了，AI都可以做动画了看不清未来无语无语无语无语;3;2;5;18388;0.00027191646726125733
23480;没有灵魂的画，才会担心被没有灵魂的ai取代吧;7;2;9;18388;0.0004894496410702633
23488;写了一大堆，然后想了想，劝人遵循规律不是个好活，CTRLA，DELETE，溜了。;2;2;4;18388;0.00021753317380900588
23500;你抵制想要得到一个什么结果呢？显然AI绘图不可能就这么停止了。只能希望利益分配能给所有人一个满意的结果。残酷的现实是，就像机器人取代装配工，就像纺织机取代纺织工人，一部分画师也会被取代。;1;2;3;18388;0.0001631498803567544
23502;我的美术总监在让我们学和使用ai，安排了一个人专门学习整理现有完善好用的ai软件，然后给我们培训分享。。然后我一个朋友去年毕业今年在找原画工作，看到ai生成的图塑造完成度这么高，都怀疑自己是不是要来这行了囧;3;2;5;18388;0.00027191646726125733
23508;不管怎么样，我都觉得人的艺术创作的最深层最精髓的那部分是不能被ai替代也不可能被ai替代的，说的具体点就是人的创作灵魂是不能轻易被ai学去的，即便ai的作画技术再高超，我也能感到ai作画生硬的地方，具体说不上来，因为我不画画也不搞算法，;3;2;5;18388;0.00027191646726125733
23512;除非是联合起来打个官司给侵权者和资本家上一课，不然的话市场大多会更偏向于廉价的ai，要么或者是提升自身实力，ai有些东西还是学不来的，要么就是全部群众联合起来制定一个公约，让每个人都自觉遵守，不过我个人感觉这个是比较难的，最现实的目前还是提升自身实力，主要是如果ai真的卷起来了，资本家一定会选择相对来说可以获益更高的选择，到时候指望那群人体谅画师是不可能的，画师们也不能把每个让电脑上本地部署的ai给删掉，要凭借公众底线自觉抵制更是困难，所以感觉还是提升硬实力比较可行，毕竟ai这三四个月来的进化速度;1;2;3;18388;0.0001631498803567544
23514;红利是带血的，下一次刀不是架在别人而是自己的脖子上就知道感同身受了;1;2;3;18388;0.0001631498803567544
23516;现在人们嘲笑那些维权绘师的行为就像是嘲笑过去砸机器的手工艺者一样，丝毫不会考虑当事者的惊恐。只不过刀不在身子上就乐罢了喜极而泣辣眼睛;1;2;3;18388;0.0001631498803567544
23522;我以前在群里问ai是不是只会画涩图啊？能不能画一些像海贼火影这些动漫封面的东西可是却没人回答我也不知道是没有还是不知道反正他们就是整天发好多ai涩图在群里各种各样的唉;3;2;5;18388;0.00027191646726125733
23526;没有用，阻止不了，除了画画，难道别的不是吗;4;2;6;18388;0.0003262997607135088
23531;虽然这是科技的进步，但是我依然还是站在画师的立场上;2;2;4;18388;0.00021753317380900588
23539;侵权这个很难说，在用户端，ai就是可以无中生有，不过当然也是开发者用众多画师的作品喂出来的结果，但你又有什么办法呢？连自己的画有没有被开发者训练时抄袭都不知道，就好比有公司发明了个人形机器人，大家都知道这个机器人外形抄袭了自己的外形，然后有些人说你这个机器人外形和我一样，不能抄袭我，但你有什么证据指明抄袭的是你的外形而不是其他人的外形呢，或者我花钱买个人让他授权给我行不行？即使版权制度完善，那资本也会花钱买版权来训练，而训练后的结果就是用户不用模板图不用其他人的图，文字描述就能生成想要的图。一言蔽之就是邮递员能抵制短信、电话的问世吗？up还是没搞清楚ai绘画到底是什么，对于社会和商业意味着什么，只停留在ai抄袭了人类的知识成果，画师职业受到威胁这种的程度;1;2;3;18388;0.0001631498803567544
23542;以前的AI绘画确实很明显是剪切缝合，但现在AI到底怎么制造出那些毫无剪切痕迹的画，实际上连编写它的程序员事先也没想到效果会这么好，其中的机制连它爹程序员也没有完全弄清楚，就好比人类实际上也没搞懂自己的人脑的运行机制，但是并不影响完画师们大喊“AI就是全靠缝合，而我们人类的脑子就不是缝合”;2;2;4;18388;0.00021753317380900588
23554;要搞清楚，大画师抵制AI，本质是抵制AI公司没给钱。不如我也来猜猜AI绘画的未来：AI企业开始给知名prompt画师付费，画师开始抢着把画卖给AI公司。而有一批一直喷AI的二线画师发现，自己的画儿更难卖了，也只能沦为低附加值的大prompt画师作品的搬运工。其实AI本质是一种突破个人风格的工具，AI的作品距离商用，始终需要一个真人画师在审美和细节的把关，AI的普及只会让用户和甲方的平均审美水平要求上升，画师和普通人的差距事实上被拉大了，就好像专业摄影和照相，技术越发展，专业和业余差距越大。建议画师朋友们，真正开始使用起来AI，然后再看是不是要跟风批评。不要等风向突变了，才发现自己落后时代一大截，到了那时候就会发现，如今那些喷AI的，或者是一种不理智的决定，或者其实是另一种特别理智的决定。;2;2;4;18388;0.00021753317380900588
23557;ai绘画可以，但不允许用ai绘画的产物去挣钱;1;2;3;18388;0.0001631498803567544
23563;我觉得这在法律上是一个很有意思的话题，众所周知我们的《著作权法》规定以个人学习为目的使用他人作品属于合理使用，如果随着技术的发展，人工智能深度学习的过程是对人脑学习的模拟，那机器的这种“学习”算不算《著作权法》中所规定的“学习”呢思考不过，《著作权法》中的学习强调的是“个人学习”，那么这个法条是不是潜在地就排除了“以商用为目的的机器学习”。总之，用他人作品来训练ai这个行为在法律上似乎还处于灰色地带，我甚至找不到一篇相关论文保卫萝卜哭哭保卫萝卜哭哭;1;2;3;18388;0.0001631498803567544
23566;觉得ai就该淘汰画师的人，你考虑过ai和人的学习成本哪个更高吗？ai可以不吃不喝，短短几个月就能达到一个人勤苦10年才能达到的水平。请问以后人类是不用学画画了吗？那些已经投入了数年心血和金钱的人就活该放弃自己几年学习的东西去转向一个自己完全不熟悉且不一定有出路的行当吗？;15;2;17;18388;0.000924515988688275
23584;兴趣也是需要一些东西维持的，以前还有观众会看画师的图，得到认可，就会让人完成一张图之后有成就感，让人开心，可以用画画赚钱，但平时也会画一些摸鱼图，这属于兴趣。以后可能慢慢的就少了，大量的ai图涌入平台，且ai的水平都非常高，观众也许就不太关注画师了，毕竟大部分观众对于图的要求就是好看，而不是过程。可能会有人说还不是你画的不够好，但是各种行业真正能卷过ai的又有多少呢。不说了，这方面越想越让人叹气，ai确实画的很好，感觉很无力;1;2;3;18388;0.0001631498803567544
23587;我觉得AI画出来的图是没有灵魂的。。撇嘴;17;2;19;18388;0.0010332825755927778
23605;懂得都懂，不懂的难以解释，人类的创造能力ai根本学不到。怪我咯;1;2;3;18388;0.0001631498803567544
23609;up主的主要观点在于ai绘画侵权了，评论区扯东扯西，真是小学级别阅读理解都评论区大多数好。;2;3;5;18388;0.00027191646726125733
23612;画师磨练需要经年累月的练习。但是以目前ai进化的速度来看，这个行业基本不会有新人能够存活了，在努力区的画师，比如我。被替代也是很快的事。开始学画画的时候信心满满，觉得我再怎么愚笨，只用不断的努力和练习。多年之后我一定会是个很厉害的画师。现在我的梦想破灭了。如果我继续画很多年，我可能真的会成为很厉害的画师。但是那个时候，谁还需要画师呢？或者说，我根本也坚持不到那个时候，就已经饿死了。;8;2;10;18388;0.0005438329345225147
23623;国家应该立法禁止AI绘画商用;1;1;2;18388;0.00010876658690450294
23626;不会真有人喜欢块拼出来的东西罢;1;2;3;18388;0.0001631498803567544
23628;ai绘画出来我第一时间想到的就是一人之下毕游村篇那帮被村长弄成异人的普通人问肖哥您练了几年啊那段剧情辣眼睛;2;2;4;18388;0.00021753317380900588
23632;刚才突然想到，要是有一家大公司靠着一定的资金约稿很多图，同时也买下了图片可以被AI学习的那种权利（我感觉还是有人会有人同意贩卖的），然后靠着这些训练的成果再来卖他们做出来的AI绘图软件，是不是就没办法了;1;2;3;18388;0.0001631498803567544
23634;ai侵权所以抵制都随你，但ai无灵魂所以抵制就有些难绷了;3;1;4;18388;0.00021753317380900588
23638;人类学习是不是也算抄袭？;1;1;2;18388;0.00010876658690450294
23640;先去搞清楚什么是人工神经网络，在去了解ai绘画原理，在再这大放厥词谈抵制;1;1;2;18388;0.00010876658690450294
23642;我不想失业;1;1;2;18388;0.00010876658690450294
23644;设想一下，如果使用chatgpt的技术，通过导入大量“无版权”的网络小说，便可以生成各式各样的网文，那么会有写手着急吗？我想哪怕是最烂级别的网文写手，也不会觉得这种技术对其创作有甚影响。然而放在绘画领域，却有好多画师对于ai作画义愤填膺，这能否说明他们对自己所谓的艺术性、创造性的自信，甚至不如最烂级别的网文写手呢？;8;1;9;18388;0.0004894496410702633
23653;老实说，人类也画不出自己没有见过的东西，学习绘画找参考是很重要的一个环节，那ai学习的方式本质和人类没有区别;3;1;4;18388;0.00021753317380900588
23657;侵权问题没说到点子上;1;1;2;18388;0.00010876658690450294
23659;而且这玩意儿吧，他迟早得升级，指不定哪天就不需要你们的图片，现在只是过渡。;2;2;4;18388;0.00021753317380900588
23662;侵权是不可接受的，但如果它雇佣画师团队最后还是能达成类似的效果，AI绘画是不可逆地打破了你们画师共同体持存的幻想;2;1;3;18388;0.0001631498803567544
23666;你有点极端了;2;1;3;18388;0.0001631498803567544
23669;不是画手哈，和美术相关，个人感觉ai势不可挡，拥抱ai，让它变成辅助自己的工具比如自己喂图加快生产效率等;1;1;2;18388;0.00010876658690450294
23671;非常厌恶，这种侵权缝合抄袭怪根本不会创新也不会设计，所以我也不会玩白夜极光了，ai合成稿都敢收二游最重要的就是图还这样搞，ai合成的也配磕198吗，以后皮肤卖一块钱算了;4;1;5;18388;0.00027191646726125733
23676;如果能整顿行业必然是最好的，不是熟人我都不敢越高，画师小圈子太复杂了。我单单就想买张画，能整出这么多事情。还是用AI吧，反正非商用自娱自乐我自个开心得很。至于商用？那只能明确的说，AI不会代替商用，永远不会。;6;1;7;18388;0.0003806830541657603
23683;但是我看ai工程师不是这么说的;3;1;4;18388;0.00021753317380900588
23687;我倒觉得因为虚拟终究是虚拟，这些东西是机器容易被替代的，只有回到现实才能进步，现充画家成为最终赢家藏狐;3;1;4;18388;0.00021753317380900588
23691;所以说。你到底是把它纠结于一个行业问题还是技术问题，还是版权问题？3选1。能回答吗？yesorno;9;1;10;18388;0.0005438329345225147
23701;但是ai绘画或许也给画师带来了新的机会，毕竟ai画的东西有很多瑕疵，还是得人类画师去改正，就像巧克力工厂里被机器搞失业的人后来找到了修理机器的职业。另一方面，画师也可以把自己的图喂给ai，训练自己的模型（比如lora）而不需要公开，也可以这样提高自己的效率;8;1;9;18388;0.0004894496410702633
23710;那怎么办呢我觉得ai发展已成现实而且肯定会继续发展怎么办啊qwq难过;4;1;5;18388;0.00027191646726125733
23715;那最后我们应该如何抵制呐？总不能像打地鼠一样冒个头打一个吧？有什么一劳永逸的方法吗？;2;1;3;18388;0.0001631498803567544
23718;ai绘画客观上大幅降低了成本，能满足市场需求，就像羊吃人的灾难一样，ai绘画也必然会吃掉画师，因为ai绘画不需要你了解绘画，了解绘圈，了解画风，了解画师，了解艺术，光影色彩，甚至免费一秒出图;1;1;2;18388;0.00010876658690450294
23720;抵制也没用;1;1;2;18388;0.00010876658690450294
23722;好骂另外模型好萌脱单doge;1;1;2;18388;0.00010876658690450294
23724;这个视频有点纯宣泄了没太看明白up主的论点。我还是不太明白ai侵权侵了什么权模仿前人的构图配色创意吗？可是人类学画画不也得学前人的画作吗？ai磨灭创作的价值性？可是当你创作的是消费品，而不是具有突破性的纯粹的艺术品的时候，你不就该有这个觉悟了吗文艺复兴那会儿的画家就已经把这点事想明白了吧ai让画师失业？人家搞翻译的、写文案都没说啥呢绘画好歹还是一个艺术行当，是一个需要人类的创新能力的复杂劳动呢这行业还能有学外语的焦虑吗？最后套个盾，我不是来吵架的，我是真心想知道画师圈子里是怎么看待抵制ai这个事儿的;1;0;1;18388;5.438329345225147e-05
23728;举个不恰当的例子，当每个人都能通过某些非常廉价的方式得到钻石的时候，钻石的价格就不可能像现在的市面的价格一样高了。doge;1;4;5;18388;0.00027191646726125733
23731;不就是一个大英博物馆嘛。自誉为文明与进步，背后全是侵略与掠夺受害者的鲜血吃瓜;1;2;3;18388;0.0001631498803567544
23733;这东西来的特别不道义，吃着画师的饭，还砸画师的饭碗;2;2;4;18388;0.00021753317380900588
23739;这不是吃人血馒头的大众吗？虽然刽子手不是他们，但他们是围观者，催着刽子手赶紧等着吃人血馒头的人。任何行业都是这样，不是刽子手害了行业，而是大众。;1;2;3;18388;0.0001631498803567544
23741;对于圈子外的我来说ai确实震撼;3;2;5;18388;0.00027191646726125733
23745;绘圈还用得着别人毁？;2;8;10;18388;0.0005438329345225147
23749;讲个笑话ai替代了高等劳动是时代的进步，窘苦的摆信仍然生活在低等繁重的劳动之中星星眼;1;1;2;18388;0.00010876658690450294
23753;自己不去拥抱新的技术不去了解ai背后的原理和算法固步自封不去使用ai那你活该被淘汰ai渗入整个产业是迟早的事顺者昌逆者亡ai首先淘汰的就是你这样的画师;7;7;14;18388;0.0007613661083315206
23768;捷豹原话，第一版阿尔法还能看出是在模仿人类棋手，升级版的就已经完全看不懂阿法狗的下棋思路;4;1;5;18388;0.00027191646726125733
23775;有没有可能ai画师是更好的选择呢？辣眼睛辣眼睛，你抵制ai不如用ai然后修一修。不是更好？辣眼睛;3;0;3;18388;0.0001631498803567544
23781;说的很好确实有很多训练数据是有版权问题的但是能决定职业画师生死的根本不是普通人资本家会用脚投票的Ai又便宜又快画师成本更高出图更慢沟通也没有那么便捷虽然更有创作性和想法但是资本什么时候在乎过这些呢？就像ChatGPT火爆一样大公司开心得不得了以后客服全部下岗换成Ai省钱又高效还方便管理普通人就算拿来玩玩又能决定什么呢？doge;7;1;8;18388;0.00043506634761801175
23789;问题来了，任何一个人类画师在学习画画的时候难道没有学习成百上千前辈的画作吗，难道人类画师就能每一笔每一画都全部原创吗？AI只是学习的量级比人类高了亿点点，本质上和九成九的人类画师是一样的，就是一名画匠，相信我九成九九的人类画师都不是能够引领潮流为绘画领域再开一道的人，而如果人工智能的涌现理论真的成立，未来人类的创造力有可能都不如AI。珍妮纺织机在现世的时候，织布的家庭主妇们会不会痛斥珍妮纺织机只能产生单调的布料？打字机现世的时候，抄写员们会不会痛斥打字机没有灵魂？无他，利益尔。;2;1;3;18388;0.0001631498803567544
23796;doge有没有一个可能，对于很多人来说，想看自己喜欢的角色，花钱去约稿但是结果不尽人意，甚至不如AI呢;2;1;3;18388;0.0001631498803567544
23799;反正已经能检测到论文是不是gbt写的了我觉得这个给绘画也是需要的只要是被某些人商用，那这群某些人就应该被拷打。说回论文gbt，真的要规避也不是不行，你写一部分你的然后让gbt接一部分然后你改，这是我听说的最多的方法（好没必要啊，那还不如你认真去把东西完成呢，要么不写要么认真写）然而都选择了gbt了，能多认真呢？绘画也是，ai绘画应该是使用者用着玩的，结果变成这样了还特么商用，真的初生啊难过;1;1;2;18388;0.00010876658690450294
23806;up说的挺好的，但是有个奇怪的问题我想问一下，就是你说未经允许输入数据库，那人类学习画画的时候看别人作品学习算不算输入数据呢笑哭如果以后真有那种从电影小说里的有自主意识的ai，这个怎么界定;8;1;9;18388;0.0004894496410702633
23817;打不过就加入;1;1;2;18388;0.00010876658690450294
23821;有些人大锤不砸他身上，他一辈子都不会知道这个道理，就纯纯那啥辣眼睛;1;1;2;18388;0.00010876658690450294
23823;至于我为什么需要这个AI？我不需要理解，我不需要任何理由。因为对于我家加起来4个T的硬盘来说。给一个可能有用可能没用，才10GB的。对于我的硬盘来说毫无压力。;7;1;8;18388;0.00043506634761801175
23831;没有人的绘画就是没有意义的;1;1;2;18388;0.00010876658690450294
23836;ai绘画是从根本上断绝了绘画领域的新鲜血液，这样下去艺术界迟早会没了未来;2;1;3;18388;0.0001631498803567544
23844;感觉除了立法很难抵制;1;1;2;18388;0.00010876658690450294
23846;好像很多人就抓着ai剪切拼图不放，ai训练再吃图也和抄袭侵权不沾边，最多你说你的图不能用于商业行为所以不能拿去训练，那公开图多了去了不差这几幅。以及一个很简单的道理如果你觉得ai无法取代人作品的艺术性和创造性那你在怕什么呢？如果他可以取代人的创造性艺术性那就更好了，真正的生产力大进步，取代就取代了，更何况ai离真正取代人还有很长路要走。你视频一边不屑别人ai产出“黄色废料”，一边又在说被挤占价值，多少有点搞笑的;6;1;7;18388;0.0003806830541657603
23853;chatgpt大家喜欢的原因1是它能代替一些没什么太多乐趣的文字编辑工作2大家好奇它能对自己的话有什么程度的理解。chatgpt在很大程度上没有侵犯人们的创造性劳动，而这个领域是人类一直引以为傲的。同时你对它各种发文也在激发个人的创意去问各种问题试图难住它。AI绘画则不然，直接生成创造性劳动的成果，其实对于那些喜欢创造性劳动的人来说，削弱了某些信念，甚至会产生无意义感。而且我觉得创造性劳动对于人来说是一个非常重要，必不可少的一部分，现在遇到这种东西，厌恶是肯定的。而chatgpt处了上述所说，还有一些令人期待的用途，比如可能产生更智能的搜索工具，可以带来很多对生活便利，降低枯燥劳动的可能。;3;1;4;18388;0.00021753317380900588
23864;抵制是没有用的，照现在的发展趋势，不只是绘画，其他大部分行业也会渐渐的被AI取代，因为AI掌握在资本的手里，资本眼里只有利益没有人性;2;1;3;18388;0.0001631498803567544
23869;问题是，没有人一开始就是核心画师，拿兰斯和多娜多娜的画师“鱼介”来举例，他刚入行的时候也只是打下手，慢慢的才摸索出自己的套路。你们都说“啊呀，都是打压小画手，影响不了大手子的啦”那么请问在座的各位，你们觉得有多少人能顶着AI的压力能在极低的工资水平中存活下来，直到钻研出自己的风格成为不可替代的画师呢。大家都是来赚钱的，总不可能为爱发电吧为爱发电也得有经济基础吧换句话说，AI从根本上把大多数想要学习美术，一美术为谋生手段的人打死了“AI是无法影响到真正喜欢美术的人的，要么你不了解绘画，要么你蠢”;1;1;2;18388;0.00010876658690450294
23871;我觉得，AI绘画的用户和画师，这两波人本身是没有什么矛盾的，各自整各自的就完事了。只要，AI绘画的用户不要去恶意抨击画师，画师也不要去歧视AI绘画的用户就可以了，真的没必要双方互相厌恶;1;1;2;18388;0.00010876658690450294
23880;有情绪是难免的，作为经历过数码革命，至今一直靠摄影吃饭的摄影师，也算有经验了，谈一下我的观点，无意引战。1，ai绘画带来的是技术革命，发展了生产力，是社会发展的必然。ai绘画替代的是较低价值的重复劳动。2，绘画创作属于文创，文创的关键是文化和创意，不是技术。ai不能实现思想和逻辑的创新。3，从历史来看，技术进步推进生产力发展，同时技术也是阻碍生产力发展的因素。如同胶片被存储卡替代，摄影普及发展了；宝石颜料被合成颜料替代，绘画普及发展了。;4;1;5;18388;0.00027191646726125733
23887;AI好东西啊游戏开发成本明显降低，开掉几个虚高的原画师，可以买好多块4090。;1;1;2;18388;0.00010876658690450294
23889;虽然我不是靠画画吃饭，但我还是好心疼所有的画师们。;1;1;2;18388;0.00010876658690450294
23891;逆大势没用的，不如试着去接受，学习ai绘画，毕竟ai绘画也是要用人的;6;1;7;18388;0.0003806830541657603
23898;ai不是时代的进步恰恰是最大的阻力抹杀画师行业后人类在绘画行业中会永远止步不前;1;1;2;18388;0.00010876658690450294
23902;最后还是没有侵权，AI根本就没有版权;1;1;2;18388;0.00010876658690450294
23905;没关系的，大家都退出绘画，就让ai拼，再牛逼他还能拼出啥来。拼出创新？而且也不光冲击绘画，大家都能给自己ai还买皮肤干嘛，30秒一张的免得费图，非花1500那个买？l;1;1;2;18388;0.00010876658690450294
23908;ai又不是人类，为什么要遵守人类的法律;2;1;3;18388;0.0001631498803567544
23915;我觉得反对的不是ai这个技术，而是不规范的市场。就像摄影的出现也并没有抢走冷军的饭碗;2;1;3;18388;0.0001631498803567544
23919;说到底是机械的绘图元素缝合这种“绘画方法”永远只能被动创造而不是想人类一样主动创造艺术辣眼睛;1;1;2;18388;0.00010876658690450294
23926;不用扯那么多什么哲学伦理，什么工业革命，什么技术进步，都在混淆视听偷换概念罢了我就问一个问题，你用ai出的图，我拿过来，放ai里跑一次，这图就是我的了，你认同不？你认同就行;1;1;2;18388;0.00010876658690450294
23932;能抵制的从来只有无监管的AI制图商用而已，作为技术的AI制图是没有办法去抵制的。退一万步说，AI制图本身威胁的也是哪些拼图工具人画师而已，真正有创作能力的画师哪怕画的方块人火柴人你也能体会到他的创意，优秀的画师又为何不可以用自己的作品喂出极具个人风格的咒语呢？至于说整个商用画师大盘，我只能说人要学会利用工具。打不过就加入dogeAI画的再好，他也是没有灵魂的。;1;1;2;18388;0.00010876658690450294
23936;回归纸质时代傲娇;1;1;2;18388;0.00010876658690450294
23939;AI最后也只会变成好用的工具罢了，用我画师朋友的一句话，AI作图的野蛮生长对绘画行业的冲击是难免的，但是AI终究是没有创造力的，无法精确满足甲方的修改需求，AI作图只是在抽卡罢了。就好比画漫画，AI无法制作出连续有逻辑有张力的画面，AI到最后也只会变成好用的工具罢了。;1;1;2;18388;0.00010876658690450294
23946;抄袭缝合说明还没有自我意识笑哭他要是真能自己创作，在座的各位的非高级脑力工作估计都会被对应AI替代。估计评论和弹幕都会被替代、、、、;1;1;2;18388;0.00010876658690450294
23954;像极了照相机发明后抵制相机的画家们，AI绘画当然会给这个行业带来重大影响，但也不会完全被取代消失。相机的发明基本替代了写实的画风，同时也推动了印象派抽象派这类相机拍不出来的场景。AI绘画也是一样它可以学习画风，但不能创造新的风格（本质都是神经网络不会自主创新），它的发明又会让绘画朝新的方向发展;1;1;2;18388;0.00010876658690450294
23957;如果不喂图，ai能有虚空算法，那随便，那人家是真科技啊，但现在所谓的弱AI，这种程度的算法不就是量化PS裁缝吗？不关AI是否该存在的事，先把喂图的部分解决了。ps：要不这样，你喂了谁的图，这张稿费必须和养分图的原作者分成，切养分原作者不愿意被喂，就不准喂。脱单doge;6;1;7;18388;0.0003806830541657603
23966;说白了，ai落到自己身上的时候，有些人就开始把“这是社会发展的必经之路”这种话从美谈转变至声讨了;2;1;3;18388;0.0001631498803567544
23982;已经转战纸绘了;1;1;2;18388;0.00010876658690450294
23984;别想了，这东西属于是时代潮流，是科技发展的政治正确，国家目前都在想办法提高国内的人工智能研发进度好赶上欧美国家，画师即便全部都抵制也是无痛无痒，国内靠画画吃饭的人估计连总人口1都不到，不靠画画吃饭的或者不画画的根本就无所谓ai。;3;1;4;18388;0.00021753317380900588
23988;部分画师画的还不如ai，质量比不过所谓的灵魂有什么用，不愿意接ai带来的改变也没实力提高自己的水平到顶尖画师水平，被淘汰也是正常。;4;1;5;18388;0.00027191646726125733
23993;没什么想说的，就想看看当AI侵犯到他们自己头上的时候，看他们抵不抵制AI调皮;7;1;8;18388;0.00043506634761801175
24001;作为一个圈外人我觉得在这里发泄不满的画师也许继续提升自己会是更好的选择呢？至少ai这几个月大概是有些进步的;4;1;5;18388;0.00027191646726125733
24009;我更好奇这个系统到的创作者到底是出于什么目的去发开发这个系统的，总不能说他总是出单纯出于要让人类技术进步公开这个系统，然后去让所有人研究吧？我不是很明白保卫萝卜哭哭;5;1;6;18388;0.0003262997607135088
24021;它的能力不是凭空变出来的，它需要画师的作品来拼接，现在的问题是有谁允许谁愿意将自己的心血切碎了喂给AI再变成商品？创作者甚至连选都没得选耶它如果真的能取代人类的绘制和设计，也能取代别的行业替人做人做的事，这是时间问题如果默许它存在什么都替人干是迟早的哪怕侵权或者其他问题，付钱的那方可不介意这些，AI能发展进化，你一个人类的肉体能在这点时间内进化和它们竞争吗？那机器和AI顺便替人类活一下吧;1;1;2;18388;0.00010876658690450294
24025;我个人认为，AI侵占艺术领域，是那些喜爱剽窃和那些对艺术，文化没有追求的庸俗之人的狂欢，是全人类艺术悲哀末路的开始。世界上大多数人都是逐利者，人性如此，可是AI的盛行让利益的欲望越放越大。那些本就不多的有灵魂的闪光终究会被淹没在欲望的泥潭里就好像三体里描述的一样，人性这种东西最终都会使事情走向悲哀的结局。;1;1;2;18388;0.00010876658690450294
24027;新技术肯定碾压旧人力，只能说影响到的只有90的人罢了，那些行内顶尖大佬根本无所谓，只不过中低阶段的画师可能就没钱挣咯吃瓜而且你说这个就别谈什么艺术，这玩意跟艺术不沾边，有人讨厌这个东西就是挤压普通画师的生存空间罢了，就是有了这个东西挣不到w了;11;1;12;18388;0.0006525995214270176
24039;现在是画圈，以后就是其他行业，ai进入行业，中低层的商业价值就会削弱，新人也不愿意入行了，而熬成大佬又要多少年？想想真的可怕;1;1;2;18388;0.00010876658690450294
24041;调参数真的是画画吗，只剩下个审美，以后指着一堆数据说这个是画画我可高兴不起来，还扼杀了新画风还有人类审美的变化;1;1;2;18388;0.00010876658690450294
24043;AI真的应该加以限制而不是任由普通人免费使用。因为这个东西真的会取代很多行业的中低端技术，但是哪个大神不是从新手开始的？你想让大学生毕业之后在家苦修10年再出来找工作吗？;6;1;7;18388;0.0003806830541657603
24053;为作品买单的普通人更愿意为便宜、量大、高质的AI图买单就已经足够打击我一个新人画手了，感觉我学一辈子都达不到AI的高度，毕竟AI的进化速度等于所有人训练速度的总和。小电视汗;1;1;2;18388;0.00010876658690450294
24055;不用那么焦虑，ai取代不了画师，细节太差了，这波扩散模型上限也就到了，只能给私人当玩具，没法商用，倒是随着完善，可以帮画师减轻负担，ai绘画最近几个月都没有进步;8;1;9;18388;0.0004894496410702633
24066;AI威胁的可远远不止是绘画，配音，写文，书法，设计，这些AI都可以做到，到时候那些有名声的作者或cv只需要卖一个风格版权或者声音版权就可以赚的盆满钵满，那其他苦读十好几年专门往这个专业发展用这个专业吃饭的人呢？他们才刚努力出头，他们没办法一下子名声，他们该怎么办？AI威胁的永远不只是绘画，这把火会烧到所有人身上，只时间问题罢了，AI是在消磨艺术行业的新鲜血液，非要搞的世界上只有一群打代码的理工才满意;2;1;3;18388;0.0001631498803567544
24069;人类创作和ai绘画绝对不能在一个赛道上，人创造ai，有心人利用ai，接着互相抵制这才是比较正常的结局，现在就有一个东西和ai绘画特别像，同样是重点在人类艺术而不是单一生产劳动上，同样是一样投入了ai，那就是围棋界，我不能说ai怎样，但是ai需要被界定界限，现在阿尔法狗已经无敌了，大家都是比谁能背他的解法多，谁背的多谁赢，和从前的博弈相去甚远，而同样的，我也不认为人类能赢过ai绘画，将创作和人类独有的感性变成笑料，变成效率，这是很悲哀的事，从现状来看，我不认为ai绘画能在辅助人上有很大的作用，让人类老师教远远比ai更灵活，他带来的只有竞争和更多的节奏;1;1;2;18388;0.00010876658690450294
24073;无可避免的事，绘图AI并不是实体，你从很多大学都普及盗版软件都能看出来法律约束这种东西的传播是不现实的。对于这种东西运用的约束更不现实，图画讲死了在AI看来就是一些像素点，不可能进行加密，普通人没画师圈子那么深，随便爬一些数据画一些想要的图用作私人用途压根管不到。用作商业用途呢？本身抄袭这种东西本身就不容易被法律约束，未来“像某一风格”来定罪更是困难。这种东西已经不是大家搬个小板凳坐一起来辩论能解决的事，是只能接受的事。;1;1;2;18388;0.00010876658690450294
24080;up有没有想过如果将来不需要人类的画作就能出画，或者只需要很少的画作。那时候该怎么抵制呢？吃瓜;4;1;5;18388;0.00027191646726125733
24089;一个小问题是，程序员们也并没有抵制chatgpt啊，反而还都在卷ai编程，真要实现ai编程的话大部分底层码农也得失业，但这并不会阻止大家追求更高的生产力啊;5;1;6;18388;0.0003262997607135088
24107;这个行业，直接蛋糕总量大缩水，总体不需要那么多从业者了。;2;1;3;18388;0.0001631498803567544
24112;客观来讲，AI取代大多数人工的潮流是不可阻挡的，启蒙运动以后“进步”作为一种信仰深植于人类文明之中，对效率无止境的追求使人类热衷于创造各色新式工具来优化生产而无所谓这个过程是否要由人参与。老实说，不论绘师如何抗议，最终失败的结局也已经是注定的了。;2;0;2;18388;0.00010876658690450294
24117;技术的发展必然带来生产关系的变化。抵制侵权行为，而非技术。未来经过了规范化的AI合法的接受训练后产出的图片也是合法的，是合理的。有需求就有市场，这个是没问题的。;8;1;9;18388;0.0004894496410702633
24126;只能表示画画以后没法商业化了，只能作为一种爱好文化传承下去，我个人觉得这是未来科技发展路上的一条必经之路。就像手工业当初在工业化面前，最终都会被淘汰出局。现实点的就是转行吧。;1;1;2;18388;0.00010876658690450294
24129;感觉受影响的主要还是刚开始学习绘画和约私稿这方面，商业领域的话大毛有吐槽过一句话：甲方的要求人都听不懂，你能指望ai理解？;1;1;2;18388;0.00010876658690450294
24131;现在是ai作画，明天就是ai写歌，后天就是ai制作电影，可能大家都得完蛋，无论是普通人还是资本，有了ai公司不需要这么多人，大堆人失业，个人有了ai能自己创作也不需要买公司产品，公司也得倒闭，结果就是要不提前实现共产，要不就是矛盾爆发，人类自己毁灭自己。;7;1;8;18388;0.00043506634761801175
24140;先说一个前提，我不是画师啊，一个业余的摄影爱好者，我看最近这个玩意画的就离谱，真的像照片了。之前看他画二次元，画油画什么的还没感觉，现在真是吓一跳。作为一个摄影爱好者唯一值得庆幸的是摄影的定义就是要基于现实的，画得再像真的也还是画笑哭;3;1;4;18388;0.00021753317380900588
24144;那么多作品，一个一个去问创作者同不同意他拿去给AI学习，得浪费多少资源，AI还练不练了，况且，就像看书一样，你还问作者愿不愿意给你看是吧微笑，AI只是工具，又不是不允许会绘画的人用，不会画的照样只是凑个热闹;1;0;1;18388;5.438329345225147e-05
24147;首先现在ai不会自己出图，是必须要有人在后面设定一些关键词，然后渲染，重复这个过程几十上百次，人在后面选出他觉得完美的图片。但是，后面的人如果没有自己的创意、想法，出来的图总是千篇一律。如果一个专业的游戏动画人设工作者，是不是能靠ai快速的绘制出自己脑中所想，然后在认为的加以修改呢？;1;0;1;18388;5.438329345225147e-05
24149;我甚至是学外语的，但我还是认为ai应当尽快取代基本的翻译工作。按照普遍常识，ai取代翻译对我的影响可比ai取代画师的影响大多了罢，是直接砸饭碗罢但我并没有很多画画的同僚那般悲观，也不急着像圈外人一样开香槟。首先是ai的水平不足为惧，即使ai的翻译在不远的将来达到很高的水准，译者的工作一般也“不是翻译”，普通外语应届生应聘一般是看你的学习能力和情商，说白了是看你的大学，如果只要个翻译官那老板大可在淘宝买一个人来用ai是没有“对接客户的需求”的能力的，现在没有将来也不会有，chatbot那个水平也做不到。ai的能力实际上和普通外语应届生的能力不是一条道上的，吃的也不是一碗饭，不如说要是ai会翻译了那反倒会给我节省很多的麻烦。画画从业者，我相信是一样的道理，老板需要的归根结底是对接客户朦胧的需求然后画出来的能力，而不是哐当一下ai十万张图怼上来让客户自己挑其次是ai现在的发展方向。ai翻译虽然我不太懂，但我完全不看好它作为人类替代的前景，翻译是错一个字就有可能造成损失的行业，而不懂语境甚至不理解语法的ai，你永远得提防它哪一天语出惊人，我就看过个Illbedammyoudidit，给翻成“我死定了，都是你害的”，人耳当然也可能听错，但人脑永远不会理解错这里的语境说回ai画画，它的逻辑，就像ai翻译一样，违反了画画需要的一切步骤无论现在ai画的多好看，很多人忽略了现在这个模型它永远是“平的”，或者说光影全是错的画画不能画平，从形到体到色块是画画根基的步骤，用一个色块拟合模型来生成画面是我听过的最愚蠢的事情，就像蒙着眼睛开枪祈祷能上靶一样平面的拟合是无法表达正确的光影的，是不可能的事情，只有ai画画前先给自己建个模把光打了，它才可能涂抹出正确的光影（差不多就是人类绘画的步骤了）。现在的ai就像个一无所知的色彩大师，空有好看的色彩，但根本不能看久了。ai在实现我所设想的“先建模再打光”之前，以我的愚见我认为它永远只会是个玩具而不是趁手的工具，说真的还不如自己去blender渲染一个好看。;4;0;4;18388;0.00021753317380900588
24156;AI并不是学会画画，而是学会画人类输入的内容背后的逻辑，但AI存在的问题是，AI并不理解真实世界，这里必须需要人为干预，才能确保结果是人类需要的。AI就像是截取了人类的一段学习回路，输入学习数据，进行操作，回路就会输出学习结果，这样的感觉。AI在某些只需要这种回路的领域非常擅长，而在这种回路占用较少的领域则完全不擅长。目前来看AI学习还是太过于僵硬了，最多只能做到变成人类的挂件。而人脑则要复杂的多，并不基于某一种原理，而是多重思路同时起作用。相比之下，基于一种原理而发展的AI就会显得笨笨的，但在某一方面又特别厉害。;2;0;2;18388;0.00010876658690450294
24159;学习不商用啊;1;0;1;18388;5.438329345225147e-05
24161;确实是商用的问题，其他的个人用用我觉得也没什么。但我觉得你我他抵制也没用，感觉各行业都会被逐渐蚕食。打不过就抓紧琢磨以后怎么混吧。毕竟现在还有时间完全悲观;1;0;1;18388;5.438329345225147e-05
24163;我认识的有一个画师已经把自己的图喂给ai然后参考生成的ai图笑哭;2;0;2;18388;0.00010876658690450294
24166;无所谓，ai最后取代的是普通人类;4;1;5;18388;0.00027191646726125733
24172;说的还可以，但是没什么卵用。;1;0;1;18388;5.438329345225147e-05
24174;单纯讨论，你杠你对。我以前是学围棋的，因为围棋高考加分。最后16年围棋不加分了就放弃了。当时我们老师是这么说的：电脑永远不可能下的过人类，因为围棋太复杂了。后来大家都知道了。围棋班数量锐减，整个行业都是一个低迷的状态。但是我不觉得这是一个坏现象，我从中看到的是ai进步了，科技发展了。确实对吃这碗饭的人很不友好，但是这东西确实先进。个人认为，为啥那些名画具有艺术价值。是因为在当时的条件下，创作出这幅画是非常不容易的。但是随着ai绘画的逐步增强，这就对画画的艺术性要求更苛刻了。目前ai还是只能停留在一键涩图的水平，除非画的真的很涩，我一般还是上Pixiv自己找图看脱单dogeai侵权这个你在淘宝买了一个盗版的绘画教程，或者说你自己发了个免费的绘画教程，结果你的学生画出来的画和你差不多，你说它侵权了吗？脱单doge;4;0;4;18388;0.00021753317380900588
24180;doge现在想想非常有意思，恩提法打着数字版权能报天价炒作，而很多画师的版权作品被随意的丢进AI数据库里碎石;2;0;2;18388;0.00010876658690450294
24184;技术总会到达他的彼岸，技术不是中立的，在技术面前，是否应该问自己，我们自身的价值何在？;2;0;2;18388;0.00010876658690450294
24187;你说的是ai绘画的使用者，跟ai绘画本身有什么关系？技术无罪，有罪的是人;2;0;2;18388;0.00010876658690450294
24190;换个角度，ai绘图可以帮画师完成一些低技术力的工作，反而增加了画师创作的效率。IG社就弄了个实验ai辅助的项目。;1;0;1;18388;5.438329345225147e-05
24192;我觉得ai绘画是高级助理，本质上还是整合工具，好好加以利用可以提高效率，但是反面嘛，就是容易蒙蔽很多人的眼睛，包括一些画师和观众;4;0;4;18388;0.00021753317380900588
24197;我就喜欢三条腿四个奶的美女ai分分钟给我一堆好像很少有画师画这种题材;2;0;2;18388;0.00010876658690450294
24200;不管这些东西，我主要是干编程的，自己画画越好就越开心，一般人谁能靠画画养家糊口啊;1;0;1;18388;5.438329345225147e-05
24202;不止画画，很多都要被取代，大势所趋，不要怨天尤人，别人都说了，打不过就加入;2;0;2;18388;0.00010876658690450294
24205;ai的发展对一些行业的格局有着或多或少的改变。不能说ai可以替代某些行业，但是ai会“优化”很多行业。chatGPT，GitHubCopilot，ai绘画等人工智能的不断发展都在对一些行业进行优化。卢德主义断然是不可取的，努力提高自己的价值，不被科技的进步所淘汰才是比较优的应对方法。说是这么说，难啊捂脸;1;0;1;18388;5.438329345225147e-05
24208;自己喂ai自己都图，然后让ai帮助自己快速提高完成度，自己再修改呢？;8;0;8;18388;0.00043506634761801175
24217;看到老福特上高级ai整的那些图好高级啊辣眼睛连手都生成的很好。本来画画是爱好想要深修一下但是，看见ai生成一张图比我扣无数细节都有用，突然就不想费劲去提升所谓画技了。反正比不过ai，画点整活的图挺好。;1;0;1;18388;5.438329345225147e-05
24221;与其说AI是一个先进生产力，不如说是一个资本。进入现代，绘画作为一个行业，为了追求利润不可避免的追求资本，为了逐利肯定有投资的甲方和画师乙方嘛。然而AI打破的是这种甲乙关系，甲方可以不在通过乙方的生产获利，这只是互联网金融的本质而已。所以AI对绘画这件事来说，只是让画手回到了前文艺复兴时代。吃瓜;1;1;2;18388;0.00010876658690450294
24224;差不多得了差不多得了;2;4;6;18388;0.0003262997607135088
24232;不懂就问，以目前ai的发展，没人知道明天，后天，一年后会什么样，但感觉最终会取代所有底层劳动者的工作，到时候还会有人愿意从底层做起吗？其次，资本家会那么好心肠吗，人能干的ai也行，ai还可以24小时，那为什么还要用人呢？几天的工作，ai几分钟就行了，资本家为什么还要给你发那么高的薪水呢？最后那时候的中国的社会福利，供给关系是否能保证大众的生活呢？毕竟大楼问不问要看地基，地基不稳，大楼也很危险;1;0;1;18388;5.438329345225147e-05
24240;笑死，那些麻瓜觉得现在AI算法只会针对画画？chatGpt等AI只会让更多的人失业，什么律师、会计、教师包括程序员都已经不是什么铁饭碗了囧。相较于现在，AI（机器）是否准许拥有学习权这是个很大的法律漏洞，我认为学习权是独属于人的，把学习权交给AI比乱放核武器威胁更大。;5;0;5;18388;0.00027191646726125733
24246;ChatGPT和ai绘画群友基本天天都在跑着玩啊，作为一个开源项目这无疑很难抵制还有最近的“赛博coser”也可以去了解一下我算ai绘图支持者，毕竟我只看图不看人（俗称非利益相关者）另一个方面，就是在有人夸赞ai绘图时会被指责没有审美，这也算非利益相关者不会站画师一方面的原因之一我是计算机相关专业大一生，这种发展无疑是有利于我这类人的生存的，从利益角度上，我也算支持者，总的来说，对一切抱有中肯的看法（视频没看着，要打游戏了;1;0;1;18388;5.438329345225147e-05
24260;买了板子，犹豫练不练捂脸;1;0;1;18388;5.438329345225147e-05
24264;嘶，突然有个设想啊，如果ai发展到十分牛逼的地步了以至于人类什么都不用干的地步的时候，那富人和资本家就有本事在这里面构建一个完全服务于自己的社会，那这个社会秩序也就变得和现在完全不同，ai全部服务于富人和资本家，那普通人呢？如果有机会话会去试着逃离这片全是ai的地方嘛？毕竟全是ai可以做好的世界普通人真的连个小石头的价值都比不上，如果普通人可以集体逃离这个地方那然后重新构建新社会重来嘛？藏狐然后成立政府和机构限制ai发展，但估计仍有不少人会去怀念ai，因为自己也想体验ai服务于自己的好，然后那批原来在ai世界的富人和资本家再向这批怀念ai的人伸手，然后普通人社会再次被ai渗透？然后出现暴力对抗什么的，然后又有不少人不得不离开这个社会再想办法去另一个地方构建新社会？然后慢慢的普通人要么是全寄了然后资本家和富人里面再分出穷人和富人，要么普通人成功逃离并在新社会下逐渐和原来ai世界的那批人分化成两个种族啥的，或者第一批逃离的普通人就成功逃离后和ai世界的人分化成两个种族啥的。。。wc我感觉这好像还真能写个故事，还是说这个故事已经有了？;1;0;1;18388;5.438329345225147e-05
24270;ai绘画没有内核啊;1;0;1;18388;5.438329345225147e-05
24282;普通人和好的艺术创作者差别最大的是审美，很多艺术创作者虽然创作的东西达不到内心的审美高度，但是也知道什么是更美的。普通人对于美比较盲从，主观地认为自己所认识的美就是美，其实只是被环境塑造，没有主动学习，也缺乏美学教育。以前互联网流行大家觉得精英文化可以被破除了，实际上永远无法消解;2;0;2;18388;0.00010876658690450294
24288;两块钱的瓷碗并没有影响青花瓷买到几千万，我觉着ai的出现正好可以让绘画重归艺术;1;0;1;18388;5.438329345225147e-05
24290;问题是画风在法律上并不算是侵权;2;0;2;18388;0.00010876658690450294
24293;流水线并不影响手工艺品卖高价;1;0;1;18388;5.438329345225147e-05
24295;真的很害怕感觉自己的理想会变成笑话舆论风气也都偏向ai那边感觉未来黑暗灵魂出窍;1;0;1;18388;5.438329345225147e-05
24299;简单总结up观点：1深度学习绘画拟合训练集都是未授权，就是抄袭，就是侵犯创作著作权2绘圈和大众的观点是割裂的，绘圈看重的东西大众不会看重导致观点分歧3AI绘画是对人类自由创作价值的剥夺，画师要站出来捍卫这个价值4没有画师可以独善其身，没有幻想乡可以逃避，最终都会面对;1;0;1;18388;5.438329345225147e-05
24308;AI画漫画AI写作，AI建模，再3D彩色打印机直接成型，以后要饿死多少人;3;0;3;18388;0.0001631498803567544
24318;你就不能学一下怎么用ai画得更好吗疑惑;1;0;1;18388;5.438329345225147e-05
24321;我今天刚从其它地方听到一个对抗神经网络技术，就是用来鉴定ai的，等科技再发展一下人类和ai的作品就能分开了，到时候应该也能有平行的赛道和更完善的保障措施，就像分开绘画和摄影一样，不过需要耐心等待和争取权益doge;2;0;2;18388;0.00010876658690450294
24328;决定权不在行内或者行外，在于甲方觉得性价比合不合适，如果原本648，现在ai绘画68，你买不买？;1;0;1;18388;5.438329345225147e-05
24333;最后的结果可能是画师都不画如今热度很高ai喜欢抄的二次元了，开始画一次元，而且ai抄了必须付版权费那种，我也不知道以后的艺术形态是怎么样，可能很抽象doge;2;0;2;18388;0.00010876658690450294
24336;有个疑问，如果画师拿自己的画训练出来的东西跑ai算侵权吗思考;2;0;2;18388;0.00010876658690450294
24342;其实让我说ai厉害，不如说是cuda厉害;1;0;1;18388;5.438329345225147e-05
24344;ai绘画就像照相机，只不过照的是二次元罢了。;2;0;2;18388;0.00010876658690450294
24347;看到有人在说ai围棋的例子，围棋这个例子其实不太对，因为ai围棋是在有人控制，在有裁判的情况下被合理使用的，人机对弈也是推动棋手门向上学习的工具，在观众层面观众因为人机对弈的噱头让这项运动获得更好的收视率，在棋手层面棋手们反过头来学习ai的对战下法和开局思路棋手们也提升了自己。但是ai绘画就目前这个没有裁判没有规则野蛮生长的情况来看，更像是那些网络围棋室里运用ai作弊，运用ai打高胜率号的人，这些人普遍也就业3业4左右的水平，却运用ai作弊来为自己获得不属于自己的成就感，这就对棋室里那些本本分分下棋的棋友门不公平了。再谈回到ai绘画上来，目前的ai绘画处于一种野蛮生长的状态，出产的作品更是根据使用者的道德高低来定义用途，那么这对于那些本本分分自己一笔一划来创作的画手门，就是一种伤害，ai绘画并不是需要抵制的一个项目，他更多的是需要管制需要规则需要裁判，这个也是从这项技术从最开始开源以来作者们就没有考虑过得事情。我认为ai绘画最终最好的结果是在有管制有规则有裁判的前提下，人类画师通过创作ai训练的专用数据库（画库）卖给需要训练ai的人来训练ai创作绘画，人类画师也可以自行创作自己的艺术作品来谋利，ai绘画在这种规则下也可以创作作品来谋利又或者个人运用其来进行自娱自乐创作，不过ai的绘画作品需要标注清楚是ai作画并标明使用训练的数据库作者，这样才是画师和ai绘画双赢的结果，人类画师会为了更高的绘画水平更好的创意创作提升自己，一些不良的或低水平的画师也会因为ai的加入淘汰又或者不得不提升改变自己。调转回来说，如果只是让这个技术野蛮生长下去，那么有一天最后一位画手因为这种野蛮生长也放下画笔的时候，难道我们的人类的美术画风和创作思想就只能停留在他放下画笔的这一天了吗？;4;0;4;18388;0.00021753317380900588
24358;说得好。十年内AI会影响所有脑力劳动者。搜索：Altmancognitive2023兔年;2;0;2;18388;0.00010876658690450294
24362;我也是画画的，我看到的更多是你站在一个小手工业者、小资产阶级的法权的立场，而不是作为创作者，扪心自问一下，我们从资产阶级那里窃取利益，不为专业软件支付一毛钱，又对别人使用自己的作品作为解构素材跳脚，不是很可笑吗;7;0;7;18388;0.0003806830541657603
24377;很难定义这个侵权啊比如一个刚毕业的画师学习大师的画，然后画出了不一样的自己风格的画，这肯定不是侵权吧AI现在是喂进去大师的画，能生成不一样的画，而且越来越少了大师的影子，多了自己的风格。试问，这样子的AI算侵权吗？;4;0;4;18388;0.00021753317380900588
24383;有些人总拿代码那个ai举例，说基本简单的代码可以直接生成很方便。但是有没有想过，那个ai只是生成了你所需要的整个程序里的一个“零件”，而ai绘画是基本一键成品？如果ai绘画只是一键细化草稿、一键勾线、一键配色，尚可能拿来对比，我也很欢迎ai只是帮我勾勾线，但是这玩意是直接一键成品，最多改点小bug，这张图作为一个“项目”就已经完全结束了，相当于编程ai一键完成整个程序开发微笑;2;0;2;18388;0.00010876658690450294
24389;为什么前面很多高赞评论没有了辣眼睛很多科普做的挺好的;1;0;1;18388;5.438329345225147e-05
24392;抵制有什么用人工智能取代人工是必然的事情总不能为了不被取代就不发展如果智能了吧你可以说你比AI画的好比AI更有创意所以你更有价值但却不能因为画的和AI一样甚至不如AI就去抵制AI毕竟CG发展那么多年也没完全取代掉实体绘画AI最终也应该像现在的绘画软件一样只是个工具而已去抵制一个让绘画更加便捷的工具是为了什么呢这就好像出了一个比现有绘画软件更加便捷功能更多的CG软件你却硬要坚持用功能少的图个啥呢;1;0;1;18388;5.438329345225147e-05
24394;ai会取代大部分的互联网行业，计算机行业。这一部分人数量是庞大的。到时候这些多余的人该怎么生存呢？只能零元购了;1;0;1;18388;5.438329345225147e-05
24403;问大家一个问题，对于用ai画的图做壁纸这件事大家怎么看。这几天换了一个ai画的壁纸，我觉得特别好看就分享跟我朋友，然后她把我臭骂一顿TT;4;0;4;18388;0.00021753317380900588
24408;无所谓，反正死的就是一帮没自己风格的小画师兔年;1;0;1;18388;5.438329345225147e-05
24420;把AI绘画公司的技术人员个人信息公布;6;0;6;18388;0.0003262997607135088
24428;ai的出现必挤压各行各业的生存空间，等发展到一定程度恐怕人类就是真的什么都不用做了，一切处在由富人资本家所掌控的世界下藏狐普通人拿什么反抗呢？;5;0;5;18388;0.00027191646726125733
24442;ai现在已经展现了它恐怖的学习速度，再过不久，说不定人就很难分辨出来了;1;0;1;18388;5.438329345225147e-05
24451;画师最重要的是创造性，脑中的图可以直接浮现出来而不需要长时间构图多好。给ai喂自己风格的图，训练ai，脑中构思新图，绘出框架，ai补完，减少机械劳动，最后人工修图。节省的时间去精进，去学习不断提升。;4;0;4;18388;0.00021753317380900588
24456;我觉得AI绘画不是坏事，但它缺少法律的管制;1;0;1;18388;5.438329345225147e-05
24460;可以政府发钱购买呀，反正产品AI生产出来很多。。都不用工作白吃白喝天天玩，出去旅游不香吗？;1;0;1;18388;5.438329345225147e-05
24464;科技解放了生产力，但是无法代替人类的创造力。工业革命，解放了物质生产力，机器生产机器，解决了吃穿用的问题智能革命，解放了虚拟生产力，智能生成智能，解决了看听学的问题创造力包含但不限于艺术，创造力的表现是多种多样的。就像工业生产无法替代美食烹饪，手工制作，裁剪缝纫等等。那么我可以说，智能生成同样无法替代电子音乐，数字艺术，电子竞技等等。;2;0;2;18388;0.00010876658690450294
24468;如果画师平时工作也用AI呢;2;0;2;18388;0.00010876658690450294
24472;当未来的一切，除了人，都被ai所代替，所有的一切都成空，还有什么意义doge;1;0;1;18388;5.438329345225147e-05
24481;用汽车和马车打比方不好，汽车马车都是可操控性比较强的载具，而且汽车操控性还提升了。AI绘画之于画手更像是，壳模铸造与雕塑家的关系。本身的性质就是冲着替代你来的，和AI结合更像是雕塑家变成车间数控值班员。而且把原来的从业者都平移嫁接到新岗位上是不可能的，可容纳就业的岗位很可能骤减到原来的几十分之一，画画的寄了，完犊子了。;4;0;4;18388;0.00021753317380900588
24492;很简单，AI绘画想要进不需要画师提供素材，把画师群益搞惨了AI就没有巡逻素材可用了，自己把自己把的路走死了，所以只有和画师共存AI才能进步。;3;0;3;18388;0.0001631498803567544
24500;关键就是要减少工作时长，增加工资，创造出新的画风，形成双赢局面。;2;0;2;18388;0.00010876658690450294
24503;看到一个老哥的评论深有感触。再说说我的看法，如果在座各位抵制Ai绘画是为了抵制资本对人价值的异化，那么首先需要改变的，是当今以发展金钱为主导的社会现状。工厂为压缩成本，使用机械代替工人，通过中介剥削体力劳动者。与公司为压缩成本，通过Ai剥削艺术从业者，是一样的事。“对于资本而言，如果有百分之十的利润，他就保证到处被使用；有百分之二十的利润，他就活跃起来；有百分之五十的利润，他就铤而走险；为了百分之一百的利润，他就敢践踏一切”。如果无法改变，怎么无论如何抵制，Ai绘画终将取代多数画师;1;0;1;18388;5.438329345225147e-05
24506;是真不了解美术行业，所以想问一下画师。你们的盈利方式具体是哪些呢？个人约稿的话感觉也不是个很大的市场喜极而泣，商业约稿的话那么具体用途是哪些呢？真心求解答;2;0;2;18388;0.00010876658690450294
24512;可能只有画风非常风格化的画师才不容易被取代;1;0;1;18388;5.438329345225147e-05
24515;如果艺术领域被ai占领的话那其他的领域也快了吧。;2;0;2;18388;0.00010876658690450294
24530;很快绘圈也会像围棋圈一样，一潭死水，毫无生气，不管你是al小鬼还是画师。;2;0;2;18388;0.00010876658690450294
24541;我问一个问题绘画有价值的是什么？是画面本身的色彩线条，还是画师的辛苦汗水？;7;0;7;18388;0.0003806830541657603
24557;建议所有人开启一键收费模式，结束互联网的免费时代呲牙;3;0;3;18388;0.0001631498803567544
24562;未来的画师可能不得不学习ai了;5;0;5;18388;0.00027191646726125733
24571;美术生如果失去工作，会发生很可怕的事情;1;0;1;18388;5.438329345225147e-05
24573;如果解决了数据集授权问题，比如一次性买断然后自己出个模型，这样的ai画师还抵制吗？;4;0;4;18388;0.00021753317380900588
24581;本来大家都以为Ai会最先替换最简单最基础的费时间的重复劳动，结果反而别的领域还是基本上完全的一塌糊涂，却先到创作类的领域上作妖了。;2;0;2;18388;0.00010876658690450294
24587;up这个观点是真心这么想吗，我说个见解吧，人活着是不是要吃饭，那种地是不是每个人的权利，那谁剥夺了我们种地的权利呢？其实不是剥夺，是因为少部分人种地让大部分人有饭吃，所以我们不用种地。生产力进步，短期是会让一部分从业者事业，但不可否认它是生产力进步吧;2;0;2;18388;0.00010876658690450294
24594;以后会不会变成这样。喜欢ai的和喜欢ai的一起玩儿，喜欢板绘的和喜欢板绘的一起玩儿。就好像板绘出现后，手工的油画、版画、国画之类的也在发展，并没有因为板绘出现而消失。现在基本上板绘和手工绘画就是两个圈子。未来ai作画和板绘也会成为两个圈子？或者板绘逐渐摸索出更适合自己的存在方式？;1;0;1;18388;5.438329345225147e-05
24599;如果我们不用抢占资源，如果不用以他人的幸福为代价获得幸福，如果新事物的到来没必要火急火燎的，那什么新事物不都挺好的;3;0;3;18388;0.0001631498803567544
24604;AI真的很大程度上打击了我画画的动力x本来就没人看我画画而且我画的也丑，还好身边总有人支持我LucaUnpogLucaUnpog;1;0;1;18388;5.438329345225147e-05
24664;我感觉思考还不够深入。其实现在ai没必要再依赖画师了，完全可以通过生成观众评价微调使得ai自我迭代。所以这里会有一个问题。用手绘图拟合的模型生成的ai图作为训练数据，拟合出的模型生成的ai图，算不算侵权？绘画界还没有那么开源协议这种东西。所以这个问题就很不好解决。;2;0;2;18388;0.00010876658690450294
24668;想问一下ai绘画算二创吗怎么说就是人设投给ai绘画然后绘画算二创吗之前未定出了这种事之后我在想是不是二创;1;0;1;18388;5.438329345225147e-05
24672;思考AI作图确实争议很大呢。如果AI退出二次元绘圈，那行不行呢？;1;0;1;18388;5.438329345225147e-05
24684;觉得可以接受AI的人，就只配接受抖音那样生产的大众流水线文化，只配看不用思考就能入脑的玩意，艺术的未来怎么样他们才不关心;1;1;2;18388;0.00010876658690450294
24688;吵架有意思吗？建议线下真人快打doge;1;0;1;18388;5.438329345225147e-05
24695;你可以拿ai来改啊，不知道你激动什么。而且你们绘画生还想着所谓的艺术，而不是赚钱，那99的绘画生都要饿死。明明是对你们绘画生加ai更加有利，竟然觉得ai抢了你们的工作。毕竟大多数人都是想自己搞着玩的。你说那些拿来恰钱的，那你如果水平比他们好那就用ai加手改卷啊，什么行业不卷？不卷就等着被淘汰吧咯。;140;0;140;18388;0.007613661083315205
24843;所谓科技进步，就是用少量的人完成多人的劳动力，至于侵权资本家才不在意;2;0;2;18388;0.00010876658690450294
24849;被AI取代是必然的，但是可以给AI当助手，帮AI更好的完成美术创作。虽然你不甘心，但是当你喝口水酝酿如何绘画时AI已经画完了，而且是画了4幅。;4;0;4;18388;0.00021753317380900588
24859;太有趣了，这个视频几乎和controlnet同一时间出现，ai绘图（生成式模型）一方在不断精进提升技术，另一边却在不断抱怨。正如从脚蹬子升级到汽车，不是机器取代了人类，而是旧的纯体力劳动转移到了以机械生产自动化，工程控制等新的生产力。同样的，那些指着AI生成破口大骂的人，你们面对的不是冰冷机器的入侵，而是一个完整的工业体系，包括了集成电路，计算机科学等各个领域的不断发展和背后工程师和科研人员的努力，当然还有无数参与到人在回路过程的使用者以及对这些产出喜闻乐见的活生生的人;5;20;25;18388;0.0013595823363062867
24865;画师学习作品并模仿画风：可以ai学习作品并学习画风：侵权;56;53;109;18388;0.00592777898629541
24923;评价为关我屁事。;1;2;3;18388;0.0001631498803567544
24925;商业就是这样的结果，没啥好搞抵制，就是这样，大众就是这样的垃圾审美。你们这些画师还好意思说？画得真的好，但都去做垃圾抽卡2次元手游，怎么不做3A游戏，或者游戏性更好的单机游戏了？因为抽卡手游能赚钱。玩手游的还嘲笑做单机的不赚钱，遵从大众审美，迟早被大众打脸，没什么好说的了，被代替是代替不了的，只是少很多低端工作，大量减员罢了，画师多一个工具，就像用3维辅助绘画，身就是偷懒加非个人眼力技术问题，但是工作就是怎么快怎么来，慢慢就接受。;6;5;11;18388;0.0005982162279747662
24932;数学家应该抵制计算器;4;3;7;18388;0.0003806830541657603
24937;一想到看美图的时候全是ai画的就要养胃了;1;9;10;18388;0.0005438329345225147
24939;如果有更多厉害的画师一起去抵制就好了，很多人都已经从反对变成ai可以用的态度了乃琳Queen麻了;14;74;88;18388;0.004785729823798129
24954;诶，刚才刚和一个支持ai贬低画师的人吵了一架，而且还因为嘴笨没有吵赢，给大伙丢脸了;8;94;102;18388;0.00554709593212965
24964;吃瓜;6;3;9;18388;0.0004894496410702633
24971;期待那个齐扔器;4;52;56;18388;0.0030454644333260824
24976;可以的，就是两个rt有点恐怖doge;2;7;9;18388;0.0004894496410702633
24979;有张图ai画错了doge，多出来一个;3;5;8;18388;0.00043506634761801175
24991;信任呢;1;0;1;18388;5.438329345225147e-05
25046;百度网盘不放吗？;3;0;3;18388;0.0001631498803567544
25062;省流;4;168;172;18388;0.009353926473787253
25067;看见个人就周姐周姐。蚌埠住，关键也不像啊。而且到处刷;14;69;83;18388;0.004513813356536872
25113;你是我看到的第一个不在简介放分享链接的;1;5;6;18388;0.0003262997607135088
25115;ai的尽头果然是周淑怡;2;5;7;18388;0.0003806830541657603
25119;为什么ai只会画女的;4;1;5;18388;0.00027191646726125733
25125;艹，周姐;1;1;2;18388;0.00010876658690450294
25127;什么执行官;1;2;3;18388;0.0001631498803567544
25144;这不周淑怡吗;2;7;9;18388;0.0004894496410702633
25171;来点机娘;1;2;3;18388;0.0001631498803567544
25173;扩展这里为什么跟你们的不一样，是什么东西没下载吗;3;3;6;18388;0.0003262997607135088
25177;大佬，我想问一下，就是我用本地端生图为什么经常没有图片出来;1;0;1;18388;5.438329345225147e-05
25179;感觉你被限流了;2;0;2;18388;0.00010876658690450294
25184;等包;4;0;4;18388;0.00021753317380900588
25189;图包，，我要图包。。。;1;0;1;18388;5.438329345225147e-05
25191;图包在哪呢？;1;0;1;18388;5.438329345225147e-05
25198;为什么这期没有图包啊;2;0;2;18388;0.00010876658690450294
25244;奶奶，爸爸妈妈为什么要离开我们，去战场上啊，在家里不是更安全吗？他们知道如果不去，就没有家了。。。。。。;37;4378;4415;18388;0.24010224059169022
25282;划过黑夜的流星过于耀眼，以至于人们认为白昼已经到来;40;2595;2635;18388;0.1432999782466826
25323;住的一定是最勇猛的士兵，最勤劳的工人，最奉献的科学家;88;3200;3288;18388;0.17881226887100282
25412;有没有一种可能，资本固然可恨，但并非前辈们的努力就是徒劳，但凡知道缅北和墨西哥是什么样也能清楚保卫萝卜白眼;36;940;976;18388;0.05307809440939743
25449;这大楼里想必住着那些特别勤奋的人吧;28;900;928;18388;0.05046769632368936
25478;可是我走不进这些高楼大厦，甚至连工作都没了;15;454;469;18388;0.025505764629105938
25494;战士的鲜血变成了资本的高楼，这是为什么？;41;619;660;18388;0.03589297367848597
25536;实际上很多老兵的后人努力一辈子也换不来一套房;42;426;468;18388;0.025451381335653687
25579;前辈希望看到的，是一个没有压迫，没有饥饿的新中国。;1;127;128;18388;0.006961061561888188
25581;先烈们知道住进去的不是自己村里的父老乡亲们会开心吗？藏狐藏狐;22;190;212;18388;0.011529258211877311
25604;你要不猜猜他们最终能不能住进这房子里;27;186;213;18388;0.011583641505329563
25632;说着资本不好，又想成为资本;43;190;233;18388;0.012671307374374592
25676;和前苏联一样，最美好的都上了战场，果实被后方窃取;40;466;506;18388;0.027517946486839244
25718;看着视频，有点感动，有点欣慰，有点迷茫。感动是因为先烈的付出，欣慰是因为真的有大楼。迷茫是因为这么多栋大楼，有哪一层是属于我的呢？热热热;1;98;99;18388;0.0053839460517728956
25720;这长城防住了谁;5;91;96;18388;0.005220796171416141
25726;《妄想跨越阶级》;1;115;116;18388;0.00630846204046117
25728;“用我们的血肉筑成我们新的长城”;2;49;51;18388;0.002773547966064825
25731;对不起了，我要觉醒了;11;54;65;18388;0.0035349140743963455
25745;苏联后期背叛了苏联人民;12;37;49;18388;0.002664781379160322
25758;评论区什么鬼情况疑惑;87;46;133;18388;0.007232978029149445
25848;看完起鸡皮疙瘩了;1;12;13;18388;0.0007069828148792691
25850;AI都懂，一些“人”却不懂无语;13;40;53;18388;0.002882314552969328
25864;广厦千万见，天下路灯俱欢颜;2;14;16;18388;0.0008701326952360235
25867;up你幸亏是发在b站这种地方，换到抖音快手说不定你会被说成：侮辱先烈。真的喜欢b站的评论区环境。满满的正能量。而且“思想及其先进”的人少doge给心心;7;13;20;18388;0.0010876658690450293
25880;住着民族企业家;4;15;19;18388;0.0010332825755927778
25886;那是打工人的吗？;54;23;77;18388;0.004187513595823363
25941;我觉得网络的风向开始变化了吃瓜;2;23;25;18388;0.0013595823363062867
25944;评论区什么大型左左发电现场吃瓜作业写完没啊;8;31;39;18388;0.002120948444637807
25955;无论怎样都有人不满意，也许毁灭才是终极价值;1;9;10;18388;0.0005438329345225147
25959;高楼是现代集成的产物，而有些人觉得高楼就单纯是压榨的，你自己创业开公司，只要不是门面的，难到不租写字楼？我真服了，70的高楼都是各种企业办公的，你干脆说你看不惯商业发展算了;2;8;10;18388;0.0005438329345225147
25964;这评论区真是越来越看不懂了辣眼睛极端二极管到处都是;1;23;24;18388;0.0013051990428540352
25966;白流了;1;19;20;18388;0.0010876658690450293
25970;所以呢，这是想表达这些战士牺牲后变成了我遥不可及的房贷，和买不起的房子？;19;19;38;18388;0.0020665651511855556
25991;最勤劳的工人一定住在里面吧呲牙;10;9;19;18388;0.0010332825755927778
26002;人们不恨资本家，人们只恨自己不是资本家;1;9;10;18388;0.0005438329345225147
26006;一句话概括评论区：超大型左翼自由搏击评论区;4;95;99;18388;0.0053839460517728956
26011;我看到了一群门外汉，从来没学过前辈思想的门外汉，一群不成熟的人，在幼稚的争吵。别问为什么，因为我也是其中一员，稍有自知之明罢了;4;6;10;18388;0.0005438329345225147
26016;他们的后代和他们守卫的人能住进去吗;1;8;9;18388;0.0004894496410702633
26018;住大房子的是能指挥这些最勇猛的战士、最勤劳的工人和科学家们的人;1;12;13;18388;0.0007069828148792691
26021;血白流了;2;7;9;18388;0.0004894496410702633
26024;里面住的谁？;1;7;8;18388;0.00043506634761801175
26026;愿中国青年都摆脱冷气，只是向上走。不要听自暴自弃者的话。能做事的做事，能发声的发声。有一份光，发一份热。就令萤火一般，也可以在黑暗里发一点光。不必等候炬火。;1;7;8;18388;0.00043506634761801175
26030;你是懂讽刺的;1;5;6;18388;0.0003262997607135088
26035;（？）评论区我咋没看明白（皱眉）;6;11;17;18388;0.000924515988688275
26047;这么宏伟的建筑，住的一定是最勇猛的士兵，最勤劳的工人，最奉献的科学家吧打call;1;4;5;18388;0.00027191646726125733
26051;看这评论还以为进了贴吧;1;4;5;18388;0.00027191646726125733
26058;可是英雄们牺牲换来的胜利被;10;12;22;18388;0.0011964324559495323
26070;我记得中间好像是抖音吧，怎么变成哔哩哔哩了难道说哔哩哔哩也有这特效吗怎么弄啊;2;2;4;18388;0.00021753317380900588
26073;不，这不对，原图中间的那个ai绘画没有b站的标志，为了缅怀而缅怀完全没必要，把其他平台的图片或者有意义的内容强行和b站沾上关系，让别人认为这是b站做出来的反而令我感到恶心;1;2;3;18388;0.0001631498803567544
26076;胜利果实的窃取滑稽;1;5;6;18388;0.0003262997607135088
26079;所以AI画出来的东西跟原画有半毛钱关系吗;1;3;4;18388;0.00021753317380900588
26084;这幅画很奇妙，有人看到了前辈用生命换来如今的繁华，有些人则看到了这繁华中的“吸血蛀虫”。而我，我看到了一群二极管骂另一群二极管。;1;3;4;18388;0.00021753317380900588
26091;1万一平，首付10万;1;3;4;18388;0.00021753317380900588
26093;我觉得AI绘画有什么理想，我觉得他的意思就是说这些军人们为我们带来了新的城市;3;3;6;18388;0.0003262997607135088
26099;资本的错？我当场哈哈大笑喜极而泣喜极而泣喜极而泣;11;3;14;18388;0.0007613661083315206
26117;铲平了土地，建起了高楼，让里面住进了敌人;1;5;6;18388;0.0003262997607135088
26119;觉醒了调皮;2;4;6;18388;0.0003262997607135088
26123;要是让他们知道资本家占领了大片土地，这些地方都不是平民住的。那就不是最好的ai绘画了;4;6;10;18388;0.0005438329345225147
26130;不看评论就知道二极管大战;1;14;15;18388;0.000815749401783772
26136;触发关键词了属于是吃瓜;1;2;3;18388;0.0001631498803567544
26140;各位，我想问大家一件事。我们老一辈如果成功了，然后呢？然后呢？我们有了高速发展的未来，没有字笨，然后呢人都是为了欲望为了享福，我们的信念的底层信仰就是过上好日子，可是好日子难道不是欲望吗我们不应该拘泥于欲望这种东西，不然永远只是货币的怒哩啊人类绝对可以创造出高于“交易”“货币”的“东西”然后共同生活，真正意义上的无忧无虑啊这是另一种层次另一种维度的东西。不要老是想着老一辈成功了，我们就可以自己动手自己住大楼，那是这个星球和国家不接受不认可的也不要说什么勇士和龙。我们要真正意义上的跨越出“利益”这个词。我们现在不管做什么都跟利益挂钩。哪怕是情感这个东西，懂吗各位你们一天想着住高楼，我们就多一天苦难啊。;3;2;5;18388;0.00027191646726125733
26151;最可爱的人给心心;2;2;4;18388;0.00021753317380900588
26159;他们的身体换来如今繁华的高楼大厦;9;2;11;18388;0.0005982162279747662
26175;很符合我对往左的想象;1;2;3;18388;0.0001631498803567544
26178;此身七尺，愿为国之柱石，起广厦万千;1;2;3;18388;0.0001631498803567544
26183;值得三连，这正是祖辈所期待的不是吗？;7;2;9;18388;0.0004894496410702633
26191;评论区什么情况，反正这风气实在是疑惑;2;4;6;18388;0.0003262997607135088
26195;有的人忘本了大哭;1;4;5;18388;0.00027191646726125733
26197;这个是什么b站功能呐谢谢;1;1;2;18388;0.00010876658690450294
26199;这不是抖音的那个ai绘画吗b站偷过来了？;1;1;2;18388;0.00010876658690450294
26201;求一下背景音乐是什么给心心;1;1;2;18388;0.00010876658690450294
26203;这个AI绘画在那啊;1;1;2;18388;0.00010876658690450294
26205;请问这个转AI的是什么软件？;1;1;2;18388;0.00010876658690450294
26207;UP用的什么AIdoge;2;1;3;18388;0.0001631498803567544
26210;他们一定不知道房价这么便宜，呲牙他们一定不知道房价便宜又没有公摊呲牙;1;3;4;18388;0.00021753317380900588
26213;什么马屁？你能站着活着这是他们命换来的;1;3;4;18388;0.00021753317380900588
26216;评论区互掐，不符合哪方观念群起而攻之或单挑，的亏现实中都是songsong，只gan在网上发泄;1;5;6;18388;0.0003262997607135088
26218;原本个人理解是先烈用身躯换来日后和平繁华的都市，结果评论区全在评判资本，其他当今山河无恙类的视频底下咋没人刷呢辣眼睛;2;3;5;18388;0.00027191646726125733
26221;吃瓜评论区的觉醒哥是真的好笑嗑瓜子;40;4;44;18388;0.0023928649118990647
26262;白流了;8;3;11;18388;0.0005982162279747662
26298;可怜万千;1;1;2;18388;0.00010876658690450294
26310;我们以后该走哪条路？;1;1;2;18388;0.00010876658690450294
26329;弹幕都好好的，评论都是什么东西啊。自己过不下去隔着阴阳谁呢，把你送去乌克兰，人都没了空房子现在估计挺多，自己占一个不就好了。疑惑疑惑;13;9;22;18388;0.0011964324559495323
26344;6;5;1;6;18388;0.0003262997607135088
26350;让开这些房子只配一线明星住;1;3;4;18388;0.00021753317380900588
26354;怎么修成这样的;1;1;2;18388;0.00010876658690450294
26361;开心吗，你们的后代买不起doge;1;1;2;18388;0.00010876658690450294
26386;都哪个国家有公摊面积呢？OK;1;2;3;18388;0.0001631498803567544
26389;不配拥有他们;1;2;3;18388;0.0001631498803567544
26391;住大房子的一定是最勇猛的战士最勤劳的工人和科学家们吧;2;2;4;18388;0.00021753317380900588
26394;另一种角度思考就会变得非常讽刺;1;2;3;18388;0.0001631498803567544
26403;这本来就是资本的工具你们在想什么;4;2;6;18388;0.0003262997607135088
26412;一定是资本的错;2;2;4;18388;0.00021753317380900588
26415;我们哔哩哔哩终于变成抖音和快手啦快发个视频庆祝一下，立即领五块钱红包点赞拜年纪2022摸鱼喵白色情人节555白色情人节爱了爱了白色情人节yyds白色情人节在吗白色情人节老婆赛高白色情人节就这白色情人节恰柠檬白色情人节好耶白色情人节牛哦白色情人节贴贴白色情人节拳头硬了白色情人节好兄弟;2;2;4;18388;0.00021753317380900588
26436;这bgm可是日本的;2;1;3;18388;0.0001631498803567544
26442;它们配不上他们;1;2;3;18388;0.0001631498803567544
26457;它们没收你们的武器，试图用和平稳定掩盖矛盾，你们试图觉醒可一切都是徒劳，批判的武器终究比不过武器的批判，新年前夕打响第一枪边境集合有胆你就来;1;2;3;18388;0.0001631498803567544
26476;可住的可不全是他们的后代;1;0;1;18388;5.438329345225147e-05
26495;白流了大哭;2;0;2;18388;0.00010876658690450294
26499;更讽刺的是最讽刺的事被当“成最好的ai绘画”，认知水平无法理解的二极管只能打出一句“触发关键词了”;4;0;4;18388;0.00021753317380900588
26508;可他们头上都是晴天白日啊;2;0;2;18388;0.00010876658690450294
26512;就叫菜狗好了up这个ai绘画是哪的;1;0;1;18388;5.438329345225147e-05
26526;是什么人住在里面;3;0;3;18388;0.0001631498803567544
26531;有没有想过换其他人也行的。;1;0;1;18388;5.438329345225147e-05
26535;手机怎么弄;1;0;1;18388;5.438329345225147e-05
26540;我想问问BGM是啥;1;0;1;18388;5.438329345225147e-05
26542;我记得这个ai绘画是dy的吧，你这是把b站图标p上去遮住了？;1;0;1;18388;5.438329345225147e-05
26546;B站，你要是生成的不好，我就看不起你;1;1;2;18388;0.00010876658690450294
26551;外面高楼四起就是最好的答案;1;0;1;18388;5.438329345225147e-05
26569;b站也出ai绘画了嘛嗑瓜子;2;0;2;18388;0.00010876658690450294
26625;冒昧的问下bilibili有ai绘画;3;0;3;18388;0.0001631498803567544
26629;b站ai绘画在哪找啊？;2;0;2;18388;0.00010876658690450294
26639;什么软件？;1;0;1;18388;5.438329345225147e-05
26653;同志们，他说我们是太阳，他让我们好好读书，我们不能忘记他的教诲。;4;1;5;18388;0.00027191646726125733
26658;0010的脚笑哭;5;61;66;18388;0.003589297367848597
26664;图包，发下，一键三连换;6;10;16;18388;0.0008701326952360235
26671;求图包;2;2;4;18388;0.00021753317380900588
26674;求问用哪些关键词才能生成日式风格的建筑？;1;1;2;18388;0.00010876658690450294
26682;三连求图doge;1;0;1;18388;5.438329345225147e-05
26684;发下图包呗已三连dogedoge;1;0;1;18388;5.438329345225147e-05
26691;已已赞，已投币doge私;1;0;1;18388;5.438329345225147e-05
26693;已三连，已三连，图包吃瓜;1;0;1;18388;5.438329345225147e-05
26697;求图包星星眼;1;0;1;18388;5.438329345225147e-05
26699;求图包;1;0;1;18388;5.438329345225147e-05
26701;以三连图包分享一下;1;0;1;18388;5.438329345225147e-05
26704;什么软件;1;0;1;18388;5.438329345225147e-05
26706;图包啊打call;1;0;1;18388;5.438329345225147e-05
26708;三连求图;1;0;1;18388;5.438329345225147e-05
26710;三连求图;1;0;1;18388;5.438329345225147e-05
26712;三联图包星星眼;1;0;1;18388;5.438329345225147e-05
26714;已三连求图包;1;0;1;18388;5.438329345225147e-05
26716;三连奉上，求图包;1;0;1;18388;5.438329345225147e-05
26725;三连求图;2;0;2;18388;0.00010876658690450294
26732;三连求图;1;0;1;18388;5.438329345225147e-05
26735;日常热词系列三连;1;0;1;18388;5.438329345225147e-05
26739;别再发啦大哭手机和电脑储存不够了大哭;5;5;10;18388;0.0005438329345225147
26747;已三连，求图包;1;1;2;18388;0.00010876658690450294
26755;都挺好看的，遗憾的是都是大头像，要是半身或者全身图就更棒了妙啊;1;0;1;18388;5.438329345225147e-05
26759;加油打call打call打call，顶顶顶打call打call;1;0;1;18388;5.438329345225147e-05
26761;三连支持打call打call;1;0;1;18388;5.438329345225147e-05
26763;已赞，收，来包;1;0;1;18388;5.438329345225147e-05
26765;图包分享谢谢微笑;1;0;1;18388;5.438329345225147e-05
26767;垃圾电脑根本不敢开到这么高，昨天晚上搞1600x800电脑跟烧开水一样doge;4;166;170;18388;0.009245159886882749
26772;看的着急;2;19;21;18388;0.0011420491624972808
26775;up爆肝一夜，先眯一会等一下上传图片;9;61;70;18388;0.0038068305416576026
26785;自己不喜欢但是能挣钱的叫做工作，自己喜欢但是不能挣钱叫玩物丧志;17;34;51;18388;0.002773547966064825
26804;对精灵没有抵抗力，盔甲更是如此，更别说穿盔甲的精灵，简直戳我XP，已三连关注，求UP主壁纸，多来些穿盔甲的精灵星星眼星星眼星星眼;3;19;22;18388;0.0011964324559495323
26810;链接httpspanbaiducoms1BTpx1doOc2xmAnjNuopRgpwd4fjh提取码4fjh复制这段内容后打开百度网盘手机App，操作更方便哦;4;8;12;18388;0.0006525995214270176
26817;加油;1;1;2;18388;0.00010876658690450294
26821;帅;1;1;2;18388;0.00010876658690450294
26826;这手指好奇怪啊doge;1;1;2;18388;0.00010876658690450294
26832;UP用什么软件做的啊;2;0;2;18388;0.00010876658690450294
26835;三连了，用什么软件做的？;2;0;2;18388;0.00010876658690450294
26873;能放小红车嘛脱单doge;4;0;4;18388;0.00021753317380900588
26882;时代的洪流不可逆转，画师被淘汰看来也是必然的;9;0;9;18388;0.0004894496410702633
26900;为什么有六根手指啊，精灵都这样吗疑惑;1;0;1;18388;5.438329345225147e-05
26903;这是AI画的？太神奇了，除了手基本以假乱真。。。这么下去会不会原画师失业啊;3;1;4;18388;0.00021753317380900588
26908;说淘汰画师不能理解，ai算法全靠图库支撑，没有画师们画的画ai怎么画doge以后加强ai不是要继续加图。;1;0;1;18388;5.438329345225147e-05
26924;怎么用ai画画，我想给大家画点好康的;1;0;1;18388;5.438329345225147e-05
26942;盲猜，AI绘画这样迅速发展的话，后面AI动画也不远了doge。;2;0;2;18388;0.00010876658690450294
26949;拿去不用谢doge;1;0;1;18388;5.438329345225147e-05
26952;兄弟太素啦来点荤的搭配下;1;3;4;18388;0.00021753317380900588
26957;顶你，顶你吃瓜吃瓜吃瓜;2;1;3;18388;0.0001631498803567544
26961;求链接大佬已三连星星眼;1;0;1;18388;5.438329345225147e-05
26963;灵魂出窍我就喜欢这么正经的古风;1;0;1;18388;5.438329345225147e-05
26965;你用的模型是什么？推荐推荐;5;0;5;18388;0.00027191646726125733
26971;一定要坚持创作哦;1;0;1;18388;5.438329345225147e-05
26975;求图包;2;0;2;18388;0.00010876658690450294
26978;异形生物工程;1;0;1;18388;5.438329345225147e-05
26980;我发布了一篇笔记，快来看看吧;1;172;173;18388;0.009408309767239505
26982;三连加关注小老弟带你上高速吃瓜链接httpspanbaiducoms1vuYfylJXYvF7a0fRnO1rApwd1csr提取码1csr复制这段内容打开百度网盘APP即可获取;31;51;82;18388;0.00445943006308462
27014;AI不会画手的原因就是，大部分色图只有扔子;2;143;145;18388;0.007885577550576462
27017;还是有点幼态，出几期成熟的，比例可以夸张点的;7;49;56;18388;0.0030454644333260824
27025;期待3D区能看到这样的高质量作品热热;3;53;56;18388;0.0030454644333260824
27029;保留了一部分的手指，这样才能让你知道这是AI画的doge;1;34;35;18388;0.0019034152708288013
27033;已打卡灵魂出窍灵魂出窍灵魂出窍;1;38;39;18388;0.002120948444637807
27037;链接挂了，已投币。up有空重发一个呗，阿里百度都行。;2;0;2;18388;0.00010876658690450294
27094;真的不是我要看的，是系统推我的，我只是想了解一下AI绘画。我发誓与赌毒不共戴天生气生气生气，以证清白。;3;1;4;18388;0.00021753317380900588
27099;好像没封面那张;1;0;1;18388;5.438329345225147e-05
27114;自觀自在;1;0;1;18388;5.438329345225147e-05
27119;有这技术给兄弟们看这个妙啊;2;0;2;18388;0.00010876658690450294
27129;不错不错，两个圆圆的;2;4;6;18388;0.0003262997607135088
27132;必须三连，但是立求多多更新，三连大大的有雨画晴天;1;0;1;18388;5.438329345225147e-05
27134;没硬币了，点赞，收藏了先doge;1;0;1;18388;5.438329345225147e-05
27142;其实我很好奇，你为什么不直接让画师照着她们的人类形象来画，现成的模板都摆在那边。;13;1254;1267;18388;0.0689036328040026
27156;我从来都没有在手机上点过有关小马宝莉的任何东西，上周开始我做了个测试，那就是时不时口头提一些小马宝莉的相关话题，然后今天我的B站推荐上出现了这个视频藏狐;21;763;784;18388;0.04263650206656515
27178;上期做的不是很好，没有注意到许多细节，根据观众们的意见，决定重置一次，这次把发色型瞳色细节加入进去。出图太慢，调试也要很多次，up已经看了不少猎奇图了，精心选出一些还不错的图，只求喜欢的观众给一个小小的点赞，要原图的观众私信我，;7;783;790;18388;0.04296280182727866
27186;AI“画”的美少女怎么说呢，最致命的一点就是刻板印象，感觉都是套个模子的产物，想当然觉得美少女就该是这副模样然后就把每个角色的特点全埋没了总之，依旧不看好;34;819;853;18388;0.0463889493147705
27221;好吧，ai最大的特点是画擦边h和涩图，最大的缺点就是画手，ai的画中就没有过正常一点的手;11;585;596;18388;0.032412442897541874
27233;更符合亚洲人审美的拟人doge;2;407;409;18388;0.02224276702197085
27236;我以前年纪小不喜欢看小马宝莉感觉这是小女孩看的，现在这马眉清目秀的喜欢;5;383;388;18388;0.02110071785947357
27242;AI还是适合萌系人设;1;159;160;18388;0.008701326952360235
27244;说真的，有没有人觉得柔柔的AI画，像那个，芙蕾雅捂眼;1;18;19;18388;0.0010332825755927778
27246;爷童年给心心现役守夜冠军;1;29;30;18388;0.001631498803567544
27248;师姐的prompt真的很难调保卫萝卜哭哭保卫萝卜哭哭保卫萝卜哭哭;3;116;119;18388;0.006471611920817925
27253;稍微说句实话吧，小马拟人，会喜欢的可以肯定绝对不是爱马仕（雾doge;2;82;84;18388;0.004568196649989123
27256;真的会有男生看小马宝莉吗微笑微笑微笑;14;29;43;18388;0.002338481618446813
27271;热知识：暮光闪闪日配和雷电将军日配一样都是泽城美雪调皮;16;86;102;18388;0.00554709593212965
27289;这紫悦越看越像少女版雷神脱单doge;2;24;26;18388;0.0014139656297585382
27292;有没有人和我一样一直把苹果嘉儿和云宝当成男的了。;1;16;17;18388;0.000924515988688275
27294;哪里有这么好用的拟人化星星眼;1;2;3;18388;0.0001631498803567544
27296;没有书记和崔嫂吗;1;2;3;18388;0.0001631498803567544
27298;紫悦是最贴的doge;2;17;19;18388;0.0010332825755927778
27301;这些角色能跑3200m吗？脱单doge;1;20;21;18388;0.0011420491624972808
27303;MinaDog乐天;2;5;7;18388;0.0003806830541657603
27306;木香awa;1;1;2;18388;0.00010876658690450294
27315;为什么AI会知道这是母马？;1;3;4;18388;0.00021753317380900588
27320;我小时候一直以为云宝是男的;1;5;6;18388;0.0003262997607135088
27327;第一个你不说，我都以为是柔柔。;1;7;8;18388;0.00043506634761801175
27332;都把小马宝莉拟人化了速度把赛马娘拟马化傲娇;2;3;5;18388;0.00027191646726125733
27339;将军？;1;4;5;18388;0.00027191646726125733
27341;老汤姆宇宙无敌帅;3;7;10;18388;0.0005438329345225147
27345;这年头，猫，什么的就算了，连马都不放过了惊讶惊讶惊讶惊讶捂脸捂脸;1;4;5;18388;0.00027191646726125733
27350;体验完同学给的小马宝莉的黄油，觉得这个太逊了脱单doge;2;2;4;18388;0.00021753317380900588
27358;话说有没有人玩过钢4的小马宝莉模组;2;2;4;18388;0.00021753317380900588
27381;这个紫月的话怎么感觉有一点臭鼬加雷电将军的感觉呀。笑哭;1;2;3;18388;0.0001631498803567544
27386;AI：你是否在找《小马国女孩》;1;2;3;18388;0.0001631498803567544
27392;小时候一直觉得云宝、苹果嘉儿都是男的;1;1;2;18388;0.00010876658690450294
27394;我寻思着官方不是有原型（拟人）动画吗？思考;1;1;2;18388;0.00010876658690450294
27396;我就想问一下作者你看过小马宝莉和小马国女孩吗，好多错误啊;1;1;2;18388;0.00010876658690450294
27398;背景音乐是什么？;1;1;2;18388;0.00010876658690450294
27400;挑染的tag是啥？highlights？;1;1;2;18388;0.00010876658690450294
27402;为啥我跑imgtoimg，脸老是炸;2;1;3;18388;0.0001631498803567544
27405;ai是真的厉害，量大;1;1;2;18388;0.00010876658690450294
27407;手呢？doge;1;1;2;18388;0.00010876658690450294
27436;我虽然没追过小马，但是我陪我妹的时候基本把每集小马都听过了tvdoge虽然内心觉得看小马好幼稚但还是忍不住点二创视频tv大哭;1;1;2;18388;0.00010876658690450294
27446;云宝是男的呀捂脸疑惑疑惑疑惑疑惑疑惑疑惑疑惑;6;1;7;18388;0.0003806830541657603
27459;有没有跟我一样是eaw才入坑的;1;1;2;18388;0.00010876658690450294
27463;UDsLying;1;1;2;18388;0.00010876658690450294
27489;校园爱情友情日漫不就有了嘛dogedogedogedogedoge;1;1;2;18388;0.00010876658690450294
27558;可以求图吗AI画的很好看星星眼;1;1;2;18388;0.00010876658690450294
27567;各位要冷静啊，他们是马和人类有生殖隔离，不要再想那些有的没的（为什么我的印度绿卡还没下来？）doge;1;1;2;18388;0.00010876658690450294
27577;不会男生看过小马宝莉的就我一个吧？;1;1;2;18388;0.00010876658690450294
27590;烨小麟;1;2;3;18388;0.0001631498803567544
27602;别老是在无关的地方刷原神好吗，老是给原神招黑有意思吗，弹幕里的那几个;1;1;2;18388;0.00010876658690450294
27612;果然跟寿屋小马系列差的不是一点半点，角色毫无特色，看了之后根本没法留下任何印象。;1;0;1;18388;5.438329345225147e-05
27617;这ai喂了多少抹茶，，，;5;192;197;18388;0.01071350881009354
27623;真的好像抹茶，，，;2;25;27;18388;0.0014683489232107897
27626;望月；绘画作为一只娱乐方式y要能在过程中感受到自己的价值，享受其过程也为结果感到高兴如果画画没有了这些东西，如果画画感受不到这些东西也无所谓的话，那么是不是越来越多人会开始觉得自己绘画是毫无价值的无意义的呢？这是我目前一点点的想法，这种由人类来画画的文化会不会衰退呢？如果是新入门想现在开始画画的人，是因为看到之前的人享受画画的过程产生的想法，但对于一开始就使用ai绘画的人来说，一开始就使用ai作画的人肯定会有增长，这样的话，那些到现在为止一幅一幅画的，能够从画中感悟到，“原来积少成多才是绘画享受的地方的这部分人”我想肯定会有减少吧，因为用AI就能画了，如果成了这种工作交给AI就没问题了的情况，对于工作者来讲那画画的重要性不就下降了嘛，对于那些认真绘画的人来说，这部分人也会减少吧，如果变成这样的话，那这个文化和我们创作的，对于这个从古至今流传积垫的绘画文化真的是有益（进步）的吗？我反而觉得是种退步，为了简单化事物而研究新的技术，虽然我能理解这种正当使用技术的想法，但我觉得人类应该不局限于此吧，如果不需要的技术就不去研究，在某个阶段需要对此进行选择，我认为是不是也应该有个到底这些需不需要的阶段，好好考虑一下吧，是否真的需要AI绘画呢？怎么做才是正确的，看到这些的人又该如何反应，如果什么都不想就对其进行称赞，一不留神绘画文化就此消亡的可能性也是有的，既有可能是真的需要的，也可能不需要的，我觉得每个人都应对此进行思考，差不多这样的想法我的；绘画需要环境韩国大佬金政基的出门靠的就是他在行业内的磨练出来的技术;3;39;42;18388;0.0022840983249945617
27630;艺术创作从来都不是“只需要找个有卵子的肚皮提供精子”就完事，弄懂了这个道理，才会明白为什么创作者们都会强烈地抵制AI创作。;3;19;22;18388;0.0011964324559495323
27634;这是蜡笔模型么，想问下打什么关键词可以稳定画出脖子以上的头像啊，我用蜡笔经常画的全身，是不是和尺寸也有关系星星眼星星眼星星眼想问问部分关键词;9;17;26;18388;0.0014139656297585382
27644;虽然有些放大看还有点错误但真的很好看;4;22;26;18388;0.0014139656297585382
27658;或许ai的存在有一定意义;6;1;7;18388;0.0003806830541657603
27669;我想要吃肯德基是的同志望月；绘画作为一只娱乐方式y要能在过程中感受到自己的价值，享受其过程也为结果感到高兴如果画画没有了这些东西，如果画画感受不到这些东西也无所谓的话，那么是不是越来越多人会开始觉得自己绘画是毫无价值的无意义的呢？这是我目前一点点的想法，这种由人类来画画的文化会不会衰退呢？如果是新入门想现在开始画画的人，是因为看到之前的人享受画画的过程产生的想法，但对于一开始就使用ai绘画的人来说，一开始就使用ai作画的人肯定会有增长，这样的话，那些到现在为止一幅一幅画的，能够从画中感悟到，“原来积少成多才是绘画享受的地方的这部分人”我想肯定会有减少吧，因为用AI就能画了，如果成了这种工作交给AI就没问题了的情况，对于工作者来讲那画画的重要性不就下降了嘛，对于那些认真绘画的人来说，这部分人也会减少吧，如果变成这样的话，那这个文化和我们创作的，对于这个从古至今流传积垫的绘画文化真的是有益（进步）的吗？我反而觉得是种退步，为了简单化事物而研究新的技术，虽然我能理解这种正当使用技术的想法，但我觉得人类应该不局限于此吧，如果不需要的技术就不去研究，在某个阶段需要对此进行选择，我认为是不是也应该有个到底这些需不需要的阶段，好好考虑一下吧，是否真的需要AI绘画呢？怎么做才是正确的，看到这些的人又该如何反应，如果什么都不想就对其进行称赞，一不留神绘画文化就此消亡的可能性也是有的，既有可能是真的需要的，也可能不需要的，我觉得每个人都应对此进行思考，差不多这样的想法我的；绘画需要环境韩国大佬金政基的出门靠的就是他在行业内的磨练出来的技术;4;2;6;18388;0.0003262997607135088
27674;我要是说比抹茶的好看会不会被打;4;7;11;18388;0.0005982162279747662
27679;今天用ai跑了一下涩图，真的厉害，但有时候也真的能让你想把眼睛扣了，邪神的时候可以参考《阿萨谢尔在召唤》里的那玩意儿热;3;1;4;18388;0.00021753317380900588
27685;浅问一下模型脱单doge;2;0;2;18388;0.00010876658690450294
27700;大佬们有没有类似画风的画师推荐一下啊;1;0;1;18388;5.438329345225147e-05
27702;大佬，这个模型是放在lora文件夹还是sd文件夹啊，为啥我用这个模型一点用都没有;1;4;5;18388;0.00027191646726125733
27719;致我们热爱向往的;4;88;92;18388;0.005003262997607135
27727;一家三口那个好吓人笑哭笑哭;22;2337;2359;18388;0.1282901892538612
27750;ai经典三条退tv坏笑;9;1248;1257;18388;0.0683597998694801
27760;我的把自己放上去变二次元美少女了，可我一男的妙啊;19;453;472;18388;0.025668914509462692
27780;那个紫脸小女孩，会不会是打掉或流产的胎儿一直跟着夫妻俩吓;10;715;725;18388;0.039427887752882314
27791;思考万一ai眼中才是真实世界而人类眼中的是被层层加密叠加幻觉展现出的样子;34;961;995;18388;0.05411137698499021
27826;那个推着婴儿车的一家四的那个小女孩脸变成了紫色，看着有点慎人啊;6;262;268;18388;0.014574722645203394
27833;这个ai的想象力确实比人类强笑哭;17;225;242;18388;0.013160757015444856
27852;如果我告诉你们，我们班的合照被Ai整成了一个美女，你们要咋说？喜极而泣喜极而泣喜极而泣;2;12;14;18388;0.0007613661083315206
27855;LosAngelz宝贝快看这个，笑死我了哈哈哈哈哈红红火火恍恍惚惚笑哭;2;14;16;18388;0.0008701326952360235
27858;我算是看出来了，AI就是个基佬，对肌肉男情有独钟滑稽，和我一样的xp;3;250;253;18388;0.013758973243419622
27862;默默en这不来看看doge;3;9;12;18388;0.0006525995214270176
27866;那个灵异事件图完全没有小女孩的影子啊，为什么ai硬生生加了一个进去，其他人的脸也正常，多的那个脸色也不正常;5;82;87;18388;0.0047313465303458774
27874;七待7斯蒂芬杰哥;1;2;3;18388;0.0001631498803567544
27879;imjulie6;1;3;4;18388;0.00021753317380900588
27881;哎问一下最后面的音乐叫什么名;1;1;2;18388;0.00010876658690450294
27888;什么软件呀;3;2;5;18388;0.00027191646726125733
27896;谢邀，第二名本人围观笑哭;1;2;3;18388;0.0001631498803567544
27898;xxburner哈哈哈哈哈哈哈哈;1;1;2;18388;0.00010876658690450294
27902;我想你我等你笑死我了;1;2;3;18388;0.0001631498803567544
27905;CTL111厉害;1;1;2;18388;0.00010876658690450294
27907;没人能说出来是什么软件，那就不是ai，应该是有人创作过的;2;1;3;18388;0.0001631498803567544
27914;有些有点恐怖呀哈哈蛆音娘吃瓜群众;1;2;3;18388;0.0001631498803567544
27924;我也试了一张，给我画得巨帅无比笑哭直接拿来当微信头像了;4;1;5;18388;0.00027191646726125733
27933;点开前没想到那么搞笑doge;2;1;3;18388;0.0001631498803567544
27937;这啥软件妙啊;12;1;13;18388;0.0007069828148792691
27951;欧玄猯来看这个，这是真乐;6;2;8;18388;0.00043506634761801175
27958;谁老抢我昵称好久没笑这么大声了哈哈哈哈哈;2;1;3;18388;0.0001631498803567544
27961;其实我不叫沉沉doge;2;1;3;18388;0.0001631498803567544
27964;杏仁小麦茶我真笑麻了;2;1;3;18388;0.0001631498803567544
27967;我是笨蛋璇小合小合没烦恼润的很快微笑辣眼睛喜极而泣;6;1;7;18388;0.0003806830541657603
27977;别打扰我困告;2;1;3;18388;0.0001631498803567544
27986;AI绘画美少女，但我是男的笑哭;1;0;1;18388;5.438329345225147e-05
27996;什么软件;1;0;1;18388;5.438329345225147e-05
28010;你这个是什么软件？;1;0;1;18388;5.438329345225147e-05
28013;什么app;1;0;1;18388;5.438329345225147e-05
28043;这个是什么软件做出来滴;1;0;1;18388;5.438329345225147e-05
28045;羡羡只想白嫖哈哈哈;2;0;2;18388;0.00010876658690450294
28056;正版御九;1;0;1;18388;5.438329345225147e-05
28076;莲花花c;1;0;1;18388;5.438329345225147e-05
28083;莫帝莱菲真的好好笑啊doge;1;0;1;18388;5.438329345225147e-05
28092;捡猫被猫咬挺好玩;2;0;2;18388;0.00010876658690450294
28097;东方翠瓜笑死我了;1;0;1;18388;5.438329345225147e-05
28106;黑色山羊花今天的风不止一点喧嚣;3;0;3;18388;0.0001631498803567544
28115;这是什么软件画出来的，推荐一下;1;0;1;18388;5.438329345225147e-05
28117;九熙的最后一根腿毛;1;0;1;18388;5.438329345225147e-05
28137;和美颜有啥区别。。;1;0;1;18388;5.438329345225147e-05
28158;艾奥妮啊有点好笑;1;0;1;18388;5.438329345225147e-05
28163;笑死我了怎么看咱的图片都算正常的啦花凉不太热;1;0;1;18388;5.438329345225147e-05
28175;啥软件呀？;1;0;1;18388;5.438329345225147e-05
28190;点进来之前没想到这么好笑;7;0;7;18388;0.0003806830541657603
28219;好帅的大佐doge;1;0;1;18388;5.438329345225147e-05
28221;ai美女我以为是各显神通，满天星。逛一圈下来，实际上是各种版本的周淑怡辣眼睛;9;126;135;18388;0.007341744616053948
28231;众所周知，b站人均未成年dogedogedoge;1;28;29;18388;0.0015771155101152925
28233;AI的尽头都是周淑怡啊;1;23;24;18388;0.0013051990428540352
28235;大佬出点大ip人物会火;2;11;13;18388;0.0007069828148792691
28238;某站有句话：唯有GHS才是推动科技生产力进步的阶梯doge脸红;1;8;9;18388;0.0004894496410702633
28240;有点东西哈吃瓜;1;3;4;18388;0.00021753317380900588
28242;好多周淑怡。。。;4;2;6;18388;0.0003262997607135088
28247;为啥封面是周淑怡？;2;2;4;18388;0.00021753317380900588
28250;全是表情包，这有啥好看的笑哭;1;2;3;18388;0.0001631498803567544
28252;有几张有点像姜泰莉，但又说不出来哪里像doge;1;2;3;18388;0.0001631498803567544
28254;多来点带马赛克的，我兄弟喜欢看doge;1;2;3;18388;0.0001631498803567544
28256;请问没穿衣服的？doge;1;1;2;18388;0.00010876658690450294
28260;已打卡灵魂出窍灵魂出窍灵魂出窍;1;1;2;18388;0.00010876658690450294
28262;啥时候压缩包不能在线解压时我再下载doge;1;1;2;18388;0.00010876658690450294
28266;已关注投币，网盘链接在哪领取doge;1;0;1;18388;5.438329345225147e-05
28268;当着干嘛？;1;0;1;18388;5.438329345225147e-05
28282;BGM是啥doge;2;0;2;18388;0.00010876658690450294
28285;这是ai绘图吗;1;0;1;18388;5.438329345225147e-05
28287;好多表情包;1;0;1;18388;5.438329345225147e-05
28290;文件已删除;1;0;1;18388;5.438329345225147e-05
28294;这不是真人吧，看着有点怪;1;0;1;18388;5.438329345225147e-05
28296;赞了，等私信啊吃瓜;1;0;1;18388;5.438329345225147e-05
28298;热词系列三连热词系列三连热词系列三连;1;0;1;18388;5.438329345225147e-05
28300;打call打call;1;0;1;18388;5.438329345225147e-05
28302;求图？;1;0;1;18388;5.438329345225147e-05
28304;我觉得最可怕都是，全球最顶尖最聪明的一群人在那拼命研究AI各种可能性，资本和市场已经开始慢慢接受了这种新技术（比如openAI）。以前人们谈论AI还是感叹阿尔法狗Go的棋艺，但是现在的AI已经开始融入到我们都生活中了。可能现在看觉得没什么，或许未来某个时间点，AI技术积累到一定程度，估计能成为加速社会发展的引爆点，而这一天不会太远。歪嘴;89;1277;1366;18388;0.0742875788557755
28394;我一直觉得可以如果有技术大佬，可以直接从源头解决笑哭因为AI闪烁是因为每次都把一帧作单独的图片来生成，少了动画的连续性，如果让AI“理解”什么是连续，哪些是该稳定保留，就是一个新的解决问题思路，可惜不知道怎么实现;66;774;840;18388;0.04568196649989123
28462;当年要是有这技术，恶之华也不会那个画风了;3;25;28;18388;0.0015227322166630412
28467;这个还是本身模型就很偏二次元的情况下，基本上就只能当个滤镜与其期待ai将3d模型或写实影片转为二次元连续动画不如期待ai渲染;9;139;148;18388;0.008048727430933217
28477;道理我都懂，但我为什么不直接看第一版的mmd呢;8;19;27;18388;0.0014683489232107897
28486;感觉，这种3d用ai转2d依旧是3d状态啊，甚至三渲二的建模动画反倒更像2D，所以，不明白这种ai动画的意义何在藏狐;20;108;128;18388;0.006961061561888188
28507;很期待啊，只要这个问题解决了，效率会指数级提升;22;85;107;18388;0.005819012399390907
28530;没有意义，还不如整个跨时代的3渲2管线;2;14;16;18388;0.0008701326952360235
28533;只要人类不放弃太空，随便怎么发展ai;1;8;9;18388;0.0004894496410702633
28535;可以边缘强化嘛？或者导出线稿？这对于工业流程来说非常重要;6;20;26;18388;0.0014139656297585382
28542;准备失业了;7;24;31;18388;0.0016858820970197955
28552;和手绘比起来质量太差了，AI最多就只应该用来给帧数较低的手绘动画补帧，或者帮助手绘稿上色，让动画师工作量减半才能对大限度在保证质量的情况下发挥AI在动画界的用处;6;13;19;18388;0.0010332825755927778
28563;这不还是抖得不行吗笑哭而且感觉越来越模糊;2;5;7;18388;0.0003806830541657603
28566;话说ai能够理解近大远小和焦距么，比如这个视频里，我想在不动原始素材的情况下把焦距改成对着后面的背影的话，可以实现么藏狐;9;1;10;18388;0.0005438329345225147
28576;帧混合？思考;2;3;5;18388;0.00027191646726125733
28579;这个是deficker么doge;1;2;3;18388;0.0001631498803567544
28583;教程呢？;1;0;1;18388;5.438329345225147e-05
28585;催催教程脱单doge爱你;3;0;3;18388;0.0001631498803567544
28589;up用的是哪个ai软件，突然很感兴趣哦呼哦呼;1;0;1;18388;5.438329345225147e-05
28594;点赞过500了呀，兄弟;1;0;1;18388;5.438329345225147e-05
28611;我超，上次发视频还是17年doge;1;1;2;18388;0.00010876658690450294
28614;日本不是就有那种很厉害的3渲2吗，好几部电影都是那种;1;1;2;18388;0.00010876658690450294
28640;感觉要失业了;2;1;3;18388;0.0001631498803567544
28662;其实问题就在2D后每帧画面AI重画后都有明显差别，导致跳帧问题，解决办法其实是有的，第一帧率需要120帧，第二帧与帧的关系是过渡过去不能是硬切，以这个代替动漫里的过渡帧doge。;1;0;1;18388;5.438329345225147e-05
28678;求BGM;1;0;1;18388;5.438329345225147e-05
28680;晚上做梦选谁好呢？真是烦恼啊doge;4;24;28;18388;0.0015227322166630412
28685;吃瓜up这质量真高;1;8;9;18388;0.0004894496410702633
28688;以后小说，每个新人物都有图滑稽;1;8;9;18388;0.0004894496410702633
28691;想看修女脱单doge;3;5;8;18388;0.00043506634761801175
28696;自从关注了龙哥身体一天不如一天了doge;1;3;4;18388;0.00021753317380900588
28698;不够富有也不慷慨doge;1;3;4;18388;0.00021753317380900588
28701;链接呢打call;1;3;4;18388;0.00021753317380900588
28703;up牛批，求图;1;2;3;18388;0.0001631498803567544
28705;我要6楼doge;1;2;3;18388;0.0001631498803567544
28707;希望能出点2k分辨率当壁纸用;2;2;4;18388;0.00021753317380900588
28717;三连走起打call;1;1;2;18388;0.00010876658690450294
28722;赞赞赞赞赞赞赞赞赞赞赞赞赞赞赞赞赞赞赞赞赞赞赞赞赞赞赞赞赞赞赞赞赞赞赞赞赞赞赞赞赞赞赞赞赞赞赞赞赞赞赞赞赞赞赞赞赞每当我觉得上一期超赞的时候up又来一期更养眼的太棒了啊啊啊啊啊啊啊啊啊啊啊啊啊啊啊啊啊啊啊啊啊啊啊啊啊啊啊我si了跪了;3;1;4;18388;0.00021753317380900588
28726;脱单doge;1;1;2;18388;0.00010876658690450294
28730;吃瓜吃瓜窒息感扑面而来;1;1;2;18388;0.00010876658690450294
28733;好兄弟热词系列三连;1;2;3;18388;0.0001631498803567544
28736;龙哥出品，必属精品;1;1;2;18388;0.00010876658690450294
28738;皮肤质感真的绝了;1;1;2;18388;0.00010876658690450294
28742;貌美如花绝世无双;1;1;2;18388;0.00010876658690450294
28744;如果直接让ai画涩图会怎么样吃瓜;3;1;4;18388;0.00021753317380900588
28748;给心心;1;1;2;18388;0.00010876658690450294
28750;个个美如花花;1;1;2;18388;0.00010876658690450294
28755;连接呢;1;1;2;18388;0.00010876658690450294
28757;脱单doge;1;1;2;18388;0.00010876658690450294
28760;doge;1;1;2;18388;0.00010876658690450294
28764;让我先来，我是草履虫UP牛掰;2;1;3;18388;0.0001631498803567544
28773;打不开阿下载后，;1;0;1;18388;5.438329345225147e-05
28775;链接分享没了;2;0;2;18388;0.00010876658690450294
28787;是ai画的？不是ai画的都很怪怪的么？;1;0;1;18388;5.438329345225147e-05
28794;这是电脑壁纸吗，UP能搞点手机的吗吃瓜吃瓜;1;0;1;18388;5.438329345225147e-05
28802;前几张看着咋像某爽doge;3;0;3;18388;0.0001631498803567544
28806;还是你懂我doge;1;6;7;18388;0.0003806830541657603
28808;貌美如花绝世无双;1;3;4;18388;0.00021753317380900588
28810;硬币给上;1;2;3;18388;0.0001631498803567544
28812;已三连脱单doge;1;1;2;18388;0.00010876658690450294
28814;脱单doge你还是懂的脱单doge;1;1;2;18388;0.00010876658690450294
28816;小电视赞解压码多少doge;6;1;7;18388;0.0003806830541657603
28823;有百度链接吗;1;1;2;18388;0.00010876658690450294
28825;求;1;1;2;18388;0.00010876658690450294
28827;星星眼星星眼星星眼技术又进步了;1;1;2;18388;0.00010876658690450294
28831;ai绘画不能画站立的全身图吗;1;0;1;18388;5.438329345225147e-05
28834;重开真的很疼陛下这是奴婢今天为您挑选的美味佳肴doge;2;0;2;18388;0.00010876658690450294
28837;换我我也撅doge;148;3416;3564;18388;0.19382205786382423
28986;先辈的影子开始被ai当成头纱了，然后头纱又被ai当成长发，最后手术成功doge;10;1780;1790;18388;0.09734609527953013
28997;十分甚至九分的好看打call;5;629;634;18388;0.03447900804872743
29003;学无止境，我们这些家长也学着上哔哩哔哩琢磨琢磨安孩子们喜欢看什么样的内容现在看来我就放心了，哔哩哔哩风气很好，全都是爱学习的好孩子，很有学术氛围，帮助孩子们茁壮成长孩子们将来一定能成为祖国的栋梁;7;427;434;18388;0.02360234935827714
29011;还好我好的快，不然看到二次元纸片就威力呲牙;2;235;237;18388;0.012888840548183598
29014;来，那几个刷赛琳娜的，头伸过来，我给你们加个buff阴险;6;84;90;18388;0.004894496410702632
29021;可以撅，臭一点也没关系dogedogedoge;1;54;55;18388;0.002991081139873831
29023;被撅了二十次，林檎撅掉了所以变性了是罢（悲）;1;86;87;18388;0.0047313465303458774
29031;伪娘（大喜）快让我雷普罢（急迫）;2;1;3;18388;0.0001631498803567544
29043;不明白为啥要叫他先辈脸红;1;2;3;18388;0.0001631498803567544
29046;李定平Offical;2;1;3;18388;0.0001631498803567544
29049;我才是王败寇;1;1;2;18388;0.00010876658690450294
29055;变成赛琳娜了（喜）;1;2;3;18388;0.0001631498803567544
29069;我是第1145个赞（喜）;1;13;14;18388;0.0007613661083315206
29080;谷歌的文字Ai的图;1;5;6;18388;0.0003262997607135088
29082;我在此扬言不但要撅先辈，还要食先辈的特制酱料食的一滴不剩（大喜;1;5;6;18388;0.0003262997607135088
29140;小淼淼哦耶耶;1;0;1;18388;5.438329345225147e-05
29174;我可以从第一张撅到第二十张doge;1;0;1;18388;5.438329345225147e-05
29194;这是什么软件？;1;0;1;18388;5.438329345225147e-05
29225;让AI去隔壁小日子学习学习，以后一举击垮小日子的某颜色电影产业，让世界人民更容易看到海量高质量片子;12;329;341;18388;0.01854470306721775
29238;ai绘画就像鬼片，给你好看的吸引你的注意，然后冷不丁的给你个恐怖的画面。;15;253;268;18388;0.014574722645203394
29254;完了，以后可能会有逆天评论。长的不如AIdoge;5;208;213;18388;0.011583641505329563
29260;很聪明，只要避开手就好得多;14;191;205;18388;0.011148575157711551
29275;不够涩;16;100;116;18388;0.00630846204046117
29292;网骗几率大大提高打call打call打call;1;60;61;18388;0.0033173809005873395
29295;家人们，自觉三连拿取。链接：httpspanbaiducoms1Go7KQtUxYmuD8DxKms7YApwdlgzu提取码：lgzu;15;34;49;18388;0.002664781379160322
29311;太恐怖了笑哭以后既然有ai绘画以后也会有ai视频机器人，然后长这样，像ChatGPT一样和你对话，谁会喜欢真人啊，ai比人类好看，也更理解人类，无敌;6;24;30;18388;0.001631498803567544
29318;我狠狠的关注你了，希望明天你能出点我想看的那种脱单doge脱单doge;2;17;19;18388;0.0010332825755927778
29321;有这个技术只做这个可惜了doge;1;9;10;18388;0.0005438329345225147
29324;说是真人拍照我都信;2;6;8;18388;0.00043506634761801175
29327;炸一看有点像凤姐笑哭;1;5;6;18388;0.0003262997607135088
29329;原来AI也是有感情的后边的就不给好好画了或者说是调皮doge;1;4;5;18388;0.00027191646726125733
29331;只要不画路人我们还是好朋友。;1;4;5;18388;0.00027191646726125733
29333;以后感觉像《银翼杀手》里的虚拟女友也不遥远了doge;1;4;5;18388;0.00027191646726125733
29335;新的一期出来啦，花嫁主题，衣服少，赶紧去看吧BV1Gb411D7Jv;2;3;5;18388;0.00027191646726125733
29338;能说一下prompt吗，想复刻一下doge;7;3;10;18388;0.0005438329345225147
29346;想问问有没有ai真人帅哥，咋全是女生;1;2;3;18388;0.0001631498803567544
29348;看你够不够下饭野马绝不认输进来看二次元的三次元老婆;2;2;4;18388;0.00021753317380900588
29351;0054这俩点什么意思;1;2;3;18388;0.0001631498803567544
29353;为什么这头发那么油？;2;2;4;18388;0.00021753317380900588
29356;画的跟日本人似的;2;2;4;18388;0.00021753317380900588
29359;主播，能问一下为啥您的图片这么清晰，而我的却感觉脸有点糊的笑哭;2;2;4;18388;0.00021753317380900588
29362;这么感觉有点像wantingwar呢;1;2;3;18388;0.0001631498803567544
29365;你火了，我说的;1;2;3;18388;0.0001631498803567544
29372;好真实啊微笑，另外ai能画那种涩涩的东西吗脸红脸红脸红;1;1;2;18388;0.00010876658690450294
29374;哎，以前升级电脑是为游戏，现在升级是为画画;1;1;2;18388;0.00010876658690450294
29377;说实话我首页3个三次元ai绘画cos视频，脸都长得一模一样一起看来看久了没什么意思;1;1;2;18388;0.00010876658690450294
29379;up你的衣服和裙子请问是什么prompt？我总是炼不出现实存在的这种衣服谢谢啦向晚喜欢;1;1;2;18388;0.00010876658690450294
29381;用了哪个lora;1;1;2;18388;0.00010876658690450294
29383;头身比例不协调啊;1;1;2;18388;0.00010876658690450294
29385;真假难辨雾月辰ovo;1;1;2;18388;0.00010876658690450294
29390;喂的三上？;1;0;1;18388;5.438329345225147e-05
29397;跟我室友的女朋友真的好像，这视频不能让他看到tv偷笑;1;0;1;18388;5.438329345225147e-05
29401;关键词都是哪些;1;0;1;18388;5.438329345225147e-05
29404;兄弟求问用了哪些lora;1;0;1;18388;5.438329345225147e-05
29407;大佬的negativeprompt是什么喜欢喜欢喜欢;1;0;1;18388;5.438329345225147e-05
29410;背景是p上去的吗;1;0;1;18388;5.438329345225147e-05
29414;模型是什么;2;0;2;18388;0.00010876658690450294
29417;有群没up;1;0;1;18388;5.438329345225147e-05
29422;这是哪个模型啊，哥们三连了给个名字星星眼星星眼;1;0;1;18388;5.438329345225147e-05
29424;模型可以分享一下嘛兄弟;1;0;1;18388;5.438329345225147e-05
29428;不错，这是用的哪个lora呀;1;0;1;18388;5.438329345225147e-05
29432;求模型;1;0;1;18388;5.438329345225147e-05
29434;求工具？;1;0;1;18388;5.438329345225147e-05
29440;怎么下载图;1;0;1;18388;5.438329345225147e-05
29446;真人AI逃不过的两大loraJapan和korean;1;0;1;18388;5.438329345225147e-05
29449;已三连，求问脸是哪个lora;1;0;1;18388;5.438329345225147e-05
29451;这是用的那个模型呀;1;0;1;18388;5.438329345225147e-05
29456;这是用的什么模型呀？;1;0;1;18388;5.438329345225147e-05
29470;用什么软件呀;1;0;1;18388;5.438329345225147e-05
29472;周姐的（脱单doge）;1;0;1;18388;5.438329345225147e-05
29479;这是ai根据语言描述画的吗？怎么描述ai能画出这么好的呀;1;0;1;18388;5.438329345225147e-05
29481;这个AI绘画是用什么工具来训练的？;2;0;2;18388;0.00010876658690450294
29484;1：09;1;0;1;18388;5.438329345225147e-05
29488;AI败给了手;1;0;1;18388;5.438329345225147e-05
29493;思考是不是世界上真有人长这样啊;1;0;1;18388;5.438329345225147e-05
29496;能把男的画成女的吗还是单纯虚构一张脸;1;0;1;18388;5.438329345225147e-05
29498;痴chi途KPC123;1;0;1;18388;5.438329345225147e-05
29500;不是我喜欢的完美类型doge，还有上升空间;1;0;1;18388;5.438329345225147e-05
29502;可不可以AI去衣服doge;2;0;2;18388;0.00010876658690450294
29505;up用的模型名字能发不;1;0;1;18388;5.438329345225147e-05
29512;交出lora;1;0;1;18388;5.438329345225147e-05
29514;能学吗脱单doge;1;0;1;18388;5.438329345225147e-05
29524;涩涩的有没doge;1;0;1;18388;5.438329345225147e-05
29526;啥显卡练的？;1;0;1;18388;5.438329345225147e-05
29538;你说就是有没有那种艺术的doge;1;0;1;18388;5.438329345225147e-05
29540;问一下tag;1;0;1;18388;5.438329345225147e-05
29543;有这技术就让兄弟们看这个dogensfw呢？;1;0;1;18388;5.438329345225147e-05
29546;AI人不错，但是太保守了吃瓜;1;0;1;18388;5.438329345225147e-05
29549;穿太多;1;0;1;18388;5.438329345225147e-05
29553;给你个三连，看看你还有什么压箱底的好东西吃瓜;1;0;1;18388;5.438329345225147e-05
29556;这是ai换脸吧吃瓜;3;0;3;18388;0.0001631498803567544
29560;为什么大部分的al画都是这张脸？;1;0;1;18388;5.438329345225147e-05
29562;芝芝？;1;0;1;18388;5.438329345225147e-05
29564;图太多了，几张就够了;2;0;2;18388;0.00010876658690450294
29567;up你都用了哪些lora？;2;0;2;18388;0.00010876658690450294
29570;我发现，AI除了手指耳朵，可能还不会画扣子，至少，扯掉的概率很大吃瓜;2;0;2;18388;0.00010876658690450294
29573;周姐;1;0;1;18388;5.438329345225147e-05
29575;什么软件啊;1;0;1;18388;5.438329345225147e-05
29577;一眉道人是吧;1;0;1;18388;5.438329345225147e-05
29579;关注了，要涩涩的doge;1;0;1;18388;5.438329345225147e-05
29582;UP，请教一下。你这是以图片做骨架以图生图吧;1;0;1;18388;5.438329345225147e-05
29584;真人吧喜欢;1;0;1;18388;5.438329345225147e-05
29586;UP主加油;1;0;1;18388;5.438329345225147e-05
29588;求图星星眼;1;0;1;18388;5.438329345225147e-05
29590;3连等图包;2;0;2;18388;0.00010876658690450294
29593;果真还原人物细节和拟人还得靠人，现在的AI还没有达到能够还原细节的时候;6;374;380;18388;0.020665651511855558
29600;ut和同人的人物ut和同人的sans脱单doge;1;250;251;18388;0.013650206656515118
29602;dustsans病娇大姐姐dogedogedoge;5;193;198;18388;0.010767892103545791
29608;AI不能画出人物的一些性格设定，所以说我们还可以活一会doge;1;153;154;18388;0.008375027191646726
29610;horror大宝贝的永恒的猎物感觉还差点气质。;2;92;94;18388;0.0051120295845116384
29613;残暴脖子上有条七匹狼是什么鬼;1;78;79;18388;0.004296280182727866
29616;我认可你的画技，但你不会代入角色的情景感知联想，而是在闭门造车啊笑哭;9;37;46;18388;0.0025016314988035677
29626;硬核一点：把警笛衫、六根骨头、世界衫、救赎衫娘化一下;7;27;34;18388;0.00184903197737655
29636;热词系列知识增加大哭大哭大哭大哭大哭大哭大哭大哭大哭大哭;4;9;13;18388;0.0007069828148792691
29641;冲了;2;9;11;18388;0.0005982162279747662
29645;恐惧的外套不应该是深蓝色的么？为什么是黑色的热词系列知识增加;2;8;10;18388;0.0005438329345225147
29648;真出了草;1;8;9;18388;0.0004894496410702633
29650;什么网站或软件;2;7;9;18388;0.0004894496410702633
29654;晚上做梦又有素材了;1;5;6;18388;0.0003262997607135088
29657;残暴的第三张不还原doge;1;5;6;18388;0.0003262997607135088
29659;是我的错觉，还是怎么着？为什么恐惧有一种拉普兰德的感觉？星星眼;1;4;5;18388;0.00027191646726125733
29662;Xun佳;1;2;3;18388;0.0001631498803567544
29668;up是用的哪个ai;1;2;3;18388;0.0001631498803567544
29674;看到封面已经开始生气了，捏嘿嘿阴险;1;1;2;18388;0.00010876658690450294
29699;doge？;1;0;1;18388;5.438329345225147e-05
29727;《但凡加个骷髅关关健词》;1;0;1;18388;5.438329345225147e-05
29733;尘埃脸怎么有点像雷泽呀？;1;0;1;18388;5.438329345225147e-05
29760;尘埃的图能发动态吗？三连了球球了tv难过;1;0;1;18388;5.438329345225147e-05
29772;fell大宝贝的图，呜呜我身为画同人的fell厨被Ai的图美哭了啊可恶啊;1;0;1;18388;5.438329345225147e-05
29776;史诗脸上的疤我不是很认可;2;0;2;18388;0.00010876658690450294
29780;什么软件;1;0;1;18388;5.438329345225147e-05
29789;ai绘画真的太棒了，就是有时候比较惊悚，什么裤裆里钻出第三条腿（真的腿）什么的笑哭笑哭笑哭;6;23;29;18388;0.0015771155101152925
29797;支持爱心;1;4;5;18388;0.00027191646726125733
29799;脱单doge;1;5;6;18388;0.0003262997607135088
29801;喜欢喜欢;1;2;3;18388;0.0001631498803567544
29805;辰宝越做越好了捏;1;5;6;18388;0.0003262997607135088
29808;这是用哪套的模型呀，前几天刚接触，感觉画的跟鬼画符一样笑哭;3;2;5;18388;0.00027191646726125733
29817;现在才有空笑哭;1;0;1;18388;5.438329345225147e-05
29824;但是能提个意见吗横版图能做169吗现在这个比例当电脑壁纸有点难受;1;0;1;18388;5.438329345225147e-05
29834;个人很喜欢120的;1;0;1;18388;5.438329345225147e-05
29846;接着删。以后别想在我这拿到一张图;6;43;49;18388;0.002664781379160322
29874;省流;8;169;177;18388;0.00962584294104851
29883;新人UP需要大家多多支持，感谢每一位看视频的小伙伴打call点赞三连更多好玩的正在创作中doge老规矩图包送上，有几张实在发不了的一起打包了，喜欢的自取哈链接httpspanbaiducoms1EIH6gAkK7xZfDi0NN1GmQpwdp8ea提取码p8ea;43;314;357;18388;0.019414835762453776
29927;老夫一生行善积德，该有此福报吃瓜吃瓜;6;70;76;18388;0.004133130302371111
29934;酒色竟令我如此憔悴，从今日起，戒酒;3;68;71;18388;0.003861213835109854
29938;这蹲姿非常不优雅却有另外一种刺激。语言能力有限;7;63;70;18388;0.0038068305416576026
29946;60年起人类的精英是一台洗衣机把自己送上了月球，60年后你用上千万台洗衣机算计看色图。doge;3;34;37;18388;0.002012181857733304
29950;好是很好，就是那个猪有点讨厌。doge;3;16;19;18388;0.0010332825755927778
29954;咳咳doge;1;16;17;18388;0.000924515988688275
29956;希望古风多来点肚兜的星星眼;7;24;31;18388;0.0016858820970197955
29964;这ai水平，多少低端画师要失业了啊。感觉和当年工业革命失业的工人一样笑哭;8;14;22;18388;0.0011964324559495323
29973;首页来的我这号什么成份doge;2;12;14;18388;0.0007613661083315206
29976;ai怎么还不会画手指啊;3;12;15;18388;0.000815749401783772
29980;你猜我拿手机干了什么doge;1;8;9;18388;0.0004894496410702633
29982;看多了你会发现，还是画师牛逼，ai感觉太雷同，;1;8;9;18388;0.0004894496410702633
29984;我高低下载来看看挡住了什么doge;1;8;9;18388;0.0004894496410702633
29987;这种智能绘画是输入关键字生成的吗doge我要拳击，运动，美女，高马尾;7;6;13;18388;0.0007069828148792691
29995;请你相信搞美色是第一生产力我翻了一下你以前的视频，有的甚至只有100多的播放量，自从你开始搞美色之后，播放直接破万我们都是与赌毒不共戴天的呀;2;10;12;18388;0.0006525995214270176
29998;这是在拉屎吧doge;2;10;12;18388;0.0006525995214270176
30001;那个是怎么回事？连君子都防？疼;3;5;8;18388;0.00043506634761801175
30006;ai作画，其他都好，就是手指，会出现断指的情况，，，手指会飘去其他地方;2;2;4;18388;0.00021753317380900588
30010;好家伙，把我们当外人呀，三连就算了吧;5;5;10;18388;0.0005438329345225147
30016;老夫一生行善积德，该有此福报吃瓜吃瓜;1;4;5;18388;0.00027191646726125733
30019;正在蹲旱坑，看到这组图真是太爽了;2;8;10;18388;0.0005438329345225147
30023;古风什么时候发明的高跟鞋，这个是不懂;4;8;12;18388;0.0006525995214270176
30029;省流没逼;1;9;10;18388;0.0005438329345225147
30037;给坤儿放个假吧原神哼;1;4;5;18388;0.00027191646726125733
30040;又是你啊doge，怎么不把背景设置成在厕所里啊？doge，真没意思;3;7;10;18388;0.0005438329345225147
30046;原图没有猪吧doge;1;1;2;18388;0.00010876658690450294
30048;有这技术就给兄弟看这个脱单doge，行吧，这个就这个，今晚用这个脱单doge;1;1;2;18388;0.00010876658690450294
30051;你三连没了，我跟你讲没了生气生气;1;1;2;18388;0.00010876658690450294
30054;这个是什么工具啊生成的妙啊;1;1;2;18388;0.00010876658690450294
30057;这些婆姨圪蹴的也好看保卫萝卜哇;1;4;5;18388;0.00027191646726125733
30059;这是什么ai;1;3;4;18388;0.00021753317380900588
30061;什么工具做的呢;2;1;3;18388;0.0001631498803567544
30064;画个杨超越吧;1;1;2;18388;0.00010876658690450294
30066;有这工具不整点副业？;1;2;3;18388;0.0001631498803567544
30068;我都不敢发这种笑哭笑哭笑哭;1;1;2;18388;0.00010876658690450294
30070;解不了压啊，支持，再来点肚兜喜欢;1;1;2;18388;0.00010876658690450294
30072;难怪有人喜欢去偷窥吃瓜;1;2;3;18388;0.0001631498803567544
30074;拿啥喂的，能不能给兄弟分享一下;2;3;5;18388;0.00027191646726125733
30077;你小子有这技术就给兄弟们看这个？傲娇;1;2;3;18388;0.0001631498803567544
30079;帮你们看了，小猪猪就是一个苦茶子，没有你们想要的妙啊妙啊妙啊;2;2;4;18388;0.00021753317380900588
30082;我有3D版脱单doge脱单doge脱单doge;4;1;5;18388;0.00027191646726125733
30089;你可知为何古代的女像只有站和坐？下次你给搞个劈叉？辣眼睛;2;1;3;18388;0.0001631498803567544
30093;“窗外雨声滴滴哒哒三天三夜都还在那下”;1;1;2;18388;0.00010876658690450294
30107;动图呢？滑稽;2;1;3;18388;0.0001631498803567544
30118;这个开腿蹲是真的带劲吃瓜;1;1;2;18388;0.00010876658690450294
30120;半壶纱那么清心寡欲的歌居然被用在这样的视频上，实属败笔傲娇;2;2;4;18388;0.00021753317380900588
30128;up主已三连，再发一次链接包吧大哭;2;0;2;18388;0.00010876658690450294
30131;交上三连;1;0;1;18388;5.438329345225147e-05
30135;死活蹲不下去啊，求关键词救命啊，大佬;1;0;1;18388;5.438329345225147e-05
30137;大佬，关键词，死活试不出来;1;0;1;18388;5.438329345225147e-05
30143;还有没;1;0;1;18388;5.438329345225147e-05
30145;就这还想三连？大哭;1;0;1;18388;5.438329345225147e-05
30147;老哥，我真怕失去你啊;1;0;1;18388;5.438329345225147e-05
30150;有这技术还不造福兄弟们妙啊;1;0;1;18388;5.438329345225147e-05
30157;孙先生，你说她们这样蹲久了不累吗？滑稽滑稽滑稽;1;1;2;18388;0.00010876658690450294
30162;关注了，求私发;3;0;3;18388;0.0001631498803567544
30167;有词条吗，我试试;5;0;5;18388;0.00027191646726125733
30175;壁纸引擎叫啥，快;1;0;1;18388;5.438329345225147e-05
30179;原图发一下updoge;1;0;1;18388;5.438329345225147e-05
30183;来人，把那猪头拖出去斩了辣眼睛;1;0;1;18388;5.438329345225147e-05
30185;好看，投币了微笑;1;0;1;18388;5.438329345225147e-05
30187;直接3连，UP主有空一起拉屎。;1;0;1;18388;5.438329345225147e-05
30191;BGM不是《宫门雪》，大家不是很认可啊doge;1;0;1;18388;5.438329345225147e-05
30196;请问up是用的哪款ai呀;1;0;1;18388;5.438329345225147e-05
30201;加钱，我想看点其他的doge;1;0;1;18388;5.438329345225147e-05
30204;热词系列肥肠自信这东西怎么画。有教程吗;1;0;1;18388;5.438329345225147e-05
30207;拿走了，谢谢updoge关注了;1;0;1;18388;5.438329345225147e-05
30210;海南加里奥;1;0;1;18388;5.438329345225147e-05
30214;这是啥软件，我有个朋友想钻研一下doge;1;0;1;18388;5.438329345225147e-05
30216;什么作画软件;1;0;1;18388;5.438329345225147e-05
30218;可以考虑发在动态啊doge;1;0;1;18388;5.438329345225147e-05
30220;三连了，继续保持脱单doge;1;0;1;18388;5.438329345225147e-05
30225;今天第一个三连给你了;1;0;1;18388;5.438329345225147e-05
30227;就喜欢你这样痛快的三连了;1;0;1;18388;5.438329345225147e-05
30233;喜欢是吧;3;0;3;18388;0.0001631498803567544
30238;有？防君子？doge;4;0;4;18388;0.00021753317380900588
30244;小红车是不是有账号;2;0;2;18388;0.00010876658690450294
30253;用什么模型啊？;1;0;1;18388;5.438329345225147e-05
30255;有nsfwseethrough版本吗doge;1;0;1;18388;5.438329345225147e-05
30263;把衣服去掉脱单doge;1;0;1;18388;5.438329345225147e-05
30267;mid？还是？;3;0;3;18388;0.0001631498803567544
30271;这是用什么软件画的，我想画个小说封面脱单doge;4;0;4;18388;0.00021753317380900588
30277;你点赞没了;1;0;1;18388;5.438329345225147e-05
30279;为啥评论问up用什么软件，up就不回嘞doge，其实我也想问，发出来大家一起乐呵呗;2;0;2;18388;0.00010876658690450294
30302;已三连，多来点星星眼;1;0;1;18388;5.438329345225147e-05
30306;up，拿来做小说封面没有问题吧脱单doge;1;0;1;18388;5.438329345225147e-05
30309;吃独食是吧;1;0;1;18388;5.438329345225147e-05
30311;机器工具人听歌识曲;1;0;1;18388;5.438329345225147e-05
30314;下载地址呢，亲;1;0;1;18388;5.438329345225147e-05
30318;奶牛;1;0;1;18388;5.438329345225147e-05
30320;有原图吗笑哭想看看;1;0;1;18388;5.438329345225147e-05
30322;求关键词是？;1;0;1;18388;5.438329345225147e-05
30324;原作者是谁啊;2;0;2;18388;0.00010876658690450294
30327;能分享一下关键词吗，已三连doge;1;0;1;18388;5.438329345225147e-05
30329;手还是不行，但是有几个不仔细看已经看不出来了，ai恐怖如斯;2;0;2;18388;0.00010876658690450294
30332;很难不支持;1;0;1;18388;5.438329345225147e-05
30334;好看滑稽;1;0;1;18388;5.438329345225147e-05
30336;现在除了卖那么一点点没有什么好东西;1;0;1;18388;5.438329345225147e-05
30338;虽然没意义，就是爱看，为啥？;1;0;1;18388;5.438329345225147e-05
30340;画的什么鬼？第35秒那是长了两只左手？笑哭笑哭笑哭;3;0;3;18388;0.0001631498803567544
30344;西瓜肚漾水的都收集了上百张嘞，切抠鼻抠鼻;1;0;1;18388;5.438329345225147e-05
30346;多搞点星星眼;1;0;1;18388;5.438329345225147e-05
30348;滑稽很懂;1;0;1;18388;5.438329345225147e-05
30350;有群吗？;1;0;1;18388;5.438329345225147e-05
30352;来个趴阿婆主;5;0;5;18388;0.00027191646726125733
30358;兄弟加油;1;0;1;18388;5.438329345225147e-05
30360;喜欢;1;0;1;18388;5.438329345225147e-05
30378;这是用的啥lora模型啊;1;0;1;18388;5.438329345225147e-05
30384;太太的情况不一样啊太太是自己知道并且同意了。如果画手自己不知道的情况下突然发现自己的画被人偷偷喂了ai肯定生气啊;21;1925;1946;18388;0.10582988905808136
30406;脸还可以，但是手doge;2;623;625;18388;0.03398955840765717
30409;主动把自己图喂AI真是。。。;74;2664;2738;18388;0.14890145747226452
30484;一下子从5000的稿子变成500的;28;519;547;18388;0.029747661518381555
30513;笑哭妈耶，第一次见到主动喂画给ai的太太，大部分见到的都是那种知道自己作品被投ai很激动很生气的，巨佬果然不一般星星眼;59;1107;1166;18388;0.06341092016532521
30573;AI没有老师的画风好看保卫萝卜哇;4;180;184;18388;0.01000652599521427
30578;对不起，但我这次真觉得ai赢了，不露手的话真的很好看，怎么说呢，氛围感;34;343;377;18388;0.020502501631498804
30613;老师的画好有风格;3;20;23;18388;0.0012508157494017839
30620;这个画风好眼熟啊，是给《长街》画实体书封面的老师吗？;1;1;2;18388;0.00010876658690450294
30626;没有攻击的意思哈，老师你这眼镜怎么画的有点怪啊，就是有时候眼部下垂的很厉害，很怪，有点吓人，有的长在了不太对的地方总的来说很好看，但是我觉得要不您还是练练人体面部结构吧，毕竟有的画的真的不太对劲藏狐;3;42;45;18388;0.002447248205351316
30630;我觉得al的比up原来的好看（主观看法）原来的五官也太离谱了。;3;40;43;18388;0.002338481618446813
30634;不好意思，提个意见，外行没学过画画，但是觉得up画的眼睛太奇怪了，眼睛好像和其他部位不在一个世界里。;1;35;36;18388;0.001957798564281053
30636;ai绘画会对你的画做的唯一的事就是拿去碎尸拼成一张新的图，然后你的画变成别人画的画啦星星眼;12;317;329;18388;0.01789210354579073
30652;up的画技额不太怎么样啊来古注意;2;27;29;18388;0.0015771155101152925
30655;有些人智商不在线理解不到里面的逻辑，AI能干碎普通画师因为喂的是数十名大触的图生成的，可不是AI自己凭空生成的捏，一线画师干碎普通画师很奇怪吗？你喂谢特给AI看能不能干碎普通画师呗抠鼻抠鼻还AI抢饭碗，敢用AI的图你让公司把所有稿子的版权费结一下再说饭碗问题吧，真是笑的我，都2023了还有人法盲成这样。;4;4;8;18388;0.00043506634761801175
30660;AI好强哦呼;1;4;5;18388;0.00027191646726125733
30668;就是说整些丑图喂给ai，最好写道程序自动喂。是不是可以把ai能力就可以打下来了妙啊;8;3;11;18388;0.0005982162279747662
30687;发涩图给ai会怎么样保卫萝卜哭哭;1;3;4;18388;0.00021753317380900588
30690;不太明白怎么画手自己乐意喂ai也要被说啊;22;8;30;18388;0.001631498803567544
30713;一些较为熟练使用ai绘画的人已经足够干碎你了;29;4;33;18388;0.0017946486839242985
30745;你这脸太哈人了;1;20;21;18388;0.0011420491624972808
30747;不相上下吧;1;7;8;18388;0.00043506634761801175
30756;我们现在看的AI都是国内的，主打二次元，格局太小，国外AI化作美术性，甚至艺术性，真的没得说，所以你们才瞧不起AI，但现在你看看国外，那个是人，那个是AI真的分不清;1;1;2;18388;0.00010876658690450294
30759;说实话UP我感觉你的画的眼睛好别扭（自我感觉别喷）;1;38;39;18388;0.002120948444637807
30762;画风识人当时被封在学校的时候，在朋友那里借了两本课外书看，一本《宠溺》和一本《逆藤》，然后我说这两本书的封面应该是一个老师画的，就去找了后面的画师，然后就看到了gua老师这个名字。当时还和朋友想了好久gua怎么读哈哈哈哈。没想到能在b站看到有两书封皮之源的卡密;1;2;3;18388;0.0001631498803567544
30780;ai是取代不了人类的，ai的画风没有特点，有特点也是人类给它喂的，ai永远都做不出真正的艺术，永远都不会创新，就算你以为它创新了，实际上它还是缝合怪，只不过缝地细了点，你没认出来而已微笑;1;0;1;18388;5.438329345225147e-05
30789;感觉ai的那种图片都一个样，雾蒙蒙，然后那种就是看上去就是ai的感觉;1;0;1;18388;5.438329345225147e-05
30792;悄咪咪小声地问问，您是小说《偏爱》封面的那位画师大佬吗？;1;0;1;18388;5.438329345225147e-05
30804;ai没有大大画的灵动原先色彩的光泽也没有表现出来;1;0;1;18388;5.438329345225147e-05
30815;还是紫色头发好康;7;182;189;18388;0.010278442462475527
30823;斗破三大遗憾：萧炎和云韵我和美杜莎你和法玛吃瓜吃瓜吃瓜;17;199;216;18388;0.011746791385686317
30841;叫我死云韵身上把;1;34;35;18388;0.0019034152708288013
30843;幻维捏的最好的还得是美杜莎和云韵，熏儿怎么捏都差点意思，美杜莎的傲气和云韵的忧郁建模把握的刚刚好，但是熏儿的大家闺秀就是感觉差意思，可能我对这种无感吧;2;34;36;18388;0.001957798564281053
30846;我只爱云韵酸了;1;16;17;18388;0.000924515988688275
30850;要的自取doge;3;13;16;18388;0.0008701326952360235
30854;幻维数码只会捏女的;1;12;13;18388;0.0007069828148792691
30910;能问问这是哪个ai吗;2;0;2;18388;0.00010876658690450294
30914;封面交出来doge;1;0;1;18388;5.438329345225147e-05
30917;已三连，求图支持;1;0;1;18388;5.438329345225147e-05
30919;建议发到wallpaper给心心;1;3;4;18388;0.00021753317380900588
30925;萧炎没和纳兰嫣然在一起，很遗憾;1;0;1;18388;5.438329345225147e-05
30927;我小医仙后续出场建模一定要改改藏狐;1;7;8;18388;0.00043506634761801175
30929;让你去当斗破苍穹的美术指导多好，那群人把薰儿弄的还没有路人好看;2;0;2;18388;0.00010876658690450294
30932;还得是云韵;1;0;1;18388;5.438329345225147e-05
30934;我都要;1;0;1;18388;5.438329345225147e-05
30936;想她;1;0;1;18388;5.438329345225147e-05
30938;这种3d立体感，真棒;2;0;2;18388;0.00010876658690450294
30941;up主，求图;1;0;1;18388;5.438329345225147e-05
30943;二连能换个图包吗脱单doge;1;0;1;18388;5.438329345225147e-05
30945;求图啊;1;0;1;18388;5.438329345225147e-05
30947;三连了，求图;1;0;1;18388;5.438329345225147e-05
30949;三连了，求图包脱单doge脱单doge;1;0;1;18388;5.438329345225147e-05
30951;求图;1;0;1;18388;5.438329345225147e-05
30953;画的太好了求图包已3连;1;0;1;18388;5.438329345225147e-05
30955;来个图包;1;0;1;18388;5.438329345225147e-05
30957;第二张熏儿的脸有点尖了哦;1;4;5;18388;0.00027191646726125733
30959;已关注三连了，秋图包脱单doge;1;0;1;18388;5.438329345225147e-05
30961;已三连，求图;1;0;1;18388;5.438329345225147e-05
30963;已投币，求云韵的图;1;0;1;18388;5.438329345225147e-05
30965;三连求图，真的挺赞;1;0;1;18388;5.438329345225147e-05
30967;给你投币，插个眼镜。等你链接分享图;1;0;1;18388;5.438329345225147e-05
30969;三连，求图星星眼;1;0;1;18388;5.438329345225147e-05
30971;Up加油求第一张图;1;0;1;18388;5.438329345225147e-05
30973;已三连，求图包;1;0;1;18388;5.438329345225147e-05
30975;已三连，跪求图包脱单doge;1;0;1;18388;5.438329345225147e-05
30977;图图图图图图;1;0;1;18388;5.438329345225147e-05
30979;丢。都没有up猪好看脱单doge;1;0;1;18388;5.438329345225147e-05
30981;都是我的脱单doge脱单doge偷笑;1;0;1;18388;5.438329345225147e-05
30983;有没有图包啊，或者来个封面;1;0;1;18388;5.438329345225147e-05
30985;求图包嗑瓜子;1;0;1;18388;5.438329345225147e-05
30987;没有图包没有链接差评;1;0;1;18388;5.438329345225147e-05
30989;太好看了吧;1;0;1;18388;5.438329345225147e-05
30991;求图想做壁纸;1;0;1;18388;5.438329345225147e-05
30993;这不是我老婆吗喜欢嘟嘟;1;3;4;18388;0.00021753317380900588
30995;关注投币了，求壁纸;1;0;1;18388;5.438329345225147e-05
30997;等一个图包脱单doge;1;0;1;18388;5.438329345225147e-05
30999;已投币，要主图还有萧薰儿的图万分感谢;1;3;4;18388;0.00021753317380900588
31001;三连换封面doge;1;0;1;18388;5.438329345225147e-05
31003;三连求图包打call;1;0;1;18388;5.438329345225147e-05
31005;图图;1;0;1;18388;5.438329345225147e-05
31007;投币关注了想要电脑壁纸;1;0;1;18388;5.438329345225147e-05
31009;反推词是什么，刚开始用;1;3;4;18388;0.00021753317380900588
31011;萧薰儿画的一般dogedogedogedoge;5;2;7;18388;0.0003806830541657603
31019;求图包星星眼;1;0;1;18388;5.438329345225147e-05
31021;我爱薰儿萧炎;1;5;6;18388;0.0003262997607135088
31023;一键三连，求图喜欢喜欢喜欢喜欢喜欢;1;0;1;18388;5.438329345225147e-05
31025;三连换图doge;1;0;1;18388;5.438329345225147e-05
31027;up求图包呀，以点赞投币，真的太好看了;1;0;1;18388;5.438329345225147e-05
31029;我太博爱了，好看的我都喜欢星星眼;1;0;1;18388;5.438329345225147e-05
31031;俺的图图呢;1;0;1;18388;5.438329345225147e-05
31033;斗破只有一个美杜莎女王，斗罗也只有一个朱竹清支持;1;0;1;18388;5.438329345225147e-05
31035;脱单doge;1;0;1;18388;5.438329345225147e-05
31037;up求图包呀，真的太好看了;1;6;7;18388;0.0003806830541657603
31039;求图;1;0;1;18388;5.438329345225147e-05
31041;三连了，求图星星眼给心心;1;0;1;18388;5.438329345225147e-05
31043;薰儿的好看;3;0;3;18388;0.0001631498803567544
31047;我也不一样，我直接问在哪做的;3;0;3;18388;0.0001631498803567544
31051;滑稽滑稽滑稽我还是喜欢那种插图滑稽滑稽;1;0;1;18388;5.438329345225147e-05
31053;求图;1;0;1;18388;5.438329345225147e-05
31055;支持了能发个原图？星星眼;1;0;1;18388;5.438329345225147e-05
31057;其他都还可以，雅菲画得一般般啊;1;0;1;18388;5.438329345225147e-05
31059;薰儿大哭大哭投票这么少萧炎哥哥不开心萧炎不哭不哭薰儿在我心里永远是最棒的;1;1;2;18388;0.00010876658690450294
31061;都挺好的，雅菲和小医仙第二档;1;0;1;18388;5.438329345225147e-05
31063;兄弟，投币点赞了，求图，拿来做电脑壁纸;1;0;1;18388;5.438329345225147e-05
31065;热词系列三连求图包;1;2;3;18388;0.0001631498803567544
31068;除了小医仙每一个都好爱，星星眼星星眼星星眼;1;0;1;18388;5.438329345225147e-05
31070;三连了，求图大哭大哭;1;6;7;18388;0.0003806830541657603
31072;我就不一样了，我求bgm。;3;0;3;18388;0.0001631498803567544
31076;已三连，求图喜欢;1;0;1;18388;5.438329345225147e-05
31078;三连了求图吃瓜;1;0;1;18388;5.438329345225147e-05
31080;求封面打call;1;0;1;18388;5.438329345225147e-05
31082;求图星星眼;1;0;1;18388;5.438329345225147e-05
31084;厉害了;1;0;1;18388;5.438329345225147e-05
31086;up三连了求图;1;0;1;18388;5.438329345225147e-05
31088;已三连，求图星星眼;1;0;1;18388;5.438329345225147e-05
31090;up主私发一下图图字词;1;0;1;18388;5.438329345225147e-05
31092;三连，求图星星眼;1;0;1;18388;5.438329345225147e-05
31094;UP，三连了，求云芝的封面图和竖屏图星星眼星星眼星星眼;1;1;2;18388;0.00010876658690450294
31096;我同学会画画，不知道是不是这种画，一张几百块钱。;1;0;1;18388;5.438329345225147e-05
31098;点赞了;1;0;1;18388;5.438329345225147e-05
31100;求原图;1;0;1;18388;5.438329345225147e-05
31102;我大老婆韵儿;1;0;1;18388;5.438329345225147e-05
31104;图图包星星眼呲牙;1;0;1;18388;5.438329345225147e-05
31106;AI越来越牛了;3;0;3;18388;0.0001631498803567544
31110;非常精致非常好看希望来点天行九歌的;1;0;1;18388;5.438329345225147e-05
31112;三连了求图吃瓜;1;0;1;18388;5.438329345225147e-05
31114;第一张可以做个动态壁纸滑稽;1;0;1;18388;5.438329345225147e-05
31116;麟儿;1;0;1;18388;5.438329345225147e-05
31118;小电视赞;1;0;1;18388;5.438329345225147e-05
31120;一位靓仔点赞路过;1;0;1;18388;5.438329345225147e-05
31122;UP加油，求云芝的图星星眼星星眼星星眼，;1;0;1;18388;5.438329345225147e-05
31124;求图doge有链接吗？;1;0;1;18388;5.438329345225147e-05
31126;求开头脱单doge;2;0;2;18388;0.00010876658690450294
31129;求封面，up主doge;2;7;9;18388;0.0004894496410702633
31132;UP加油，求云芝的图星星眼星星眼星星眼，;1;5;6;18388;0.0003262997607135088
31134;横看成岭侧成峰，远近高低各不同doge不知此图真面目，只愿身在此山中脱单doge;5;117;122;18388;0.006634761801174679
31140;在某软件看的ai涩图，那涩图，哦哟啧啧啧dogedoge;19;98;117;18388;0.006362845333913422
31160;现在的AI图就身材多样化差了点，别的都行了啊。还是国风美女好看啊，瞬间感觉手里的二次元和HS2有点不香了笑哭;4;65;69;18388;0.003752447248205351
31165;我每天都看美女套图，不带重样的，专家说看美女延年益寿脱单doge;2;8;10;18388;0.0005438329345225147
31168;又大又圆又白我说的是碗里的汤圆。doge;2;23;25;18388;0.0013595823363062867
31171;有没有原图，大佬;2;0;2;18388;0.00010876658690450294
31174;恭喜你离百大又近了一步;1;11;12;18388;0.0006525995214270176
31176;还以为我眼花了doge确实在动;1;5;6;18388;0.0003262997607135088
31178;求图求求了好不好嘛拜托拜托给心心;3;1;4;18388;0.00021753317380900588
31183;为什么我搜索不到;1;0;1;18388;5.438329345225147e-05
31186;给心心;1;0;1;18388;5.438329345225147e-05
31188;小红车找不到啊;2;0;2;18388;0.00010876658690450294
31191;吃瓜;1;0;1;18388;5.438329345225147e-05
31193;可以问一下用那个软件做的吗;1;1;2;18388;0.00010876658690450294
31196;什么小红车，我不懂小红车，老夫为人正派岂会，，，dogedogedogesteam启动中。。。OK;1;1;2;18388;0.00010876658690450294
31203;感谢喜欢;1;0;1;18388;5.438329345225147e-05
31206;貌似帧数不是很高？有点卡顿的感觉;1;0;1;18388;5.438329345225147e-05
31208;已三连求文件;1;0;1;18388;5.438329345225147e-05
31212;吃瓜竟然找到组织了doge;1;0;1;18388;5.438329345225147e-05
31214;打call;1;0;1;18388;5.438329345225147e-05
31218;doge支持一波;1;0;1;18388;5.438329345225147e-05
31222;手机版的复制不了up你的么;1;0;1;18388;5.438329345225147e-05
31224;好兄弟，三连换14高清壁纸脱单doge;1;0;1;18388;5.438329345225147e-05
31227;我电脑都没有;1;0;1;18388;5.438329345225147e-05
31229;没小红车咋办啊呆;7;2;9;18388;0.0004894496410702633
31237;可以给个原图吗给心心;1;0;1;18388;5.438329345225147e-05
31239;小红车关键字搜什么呀;1;0;1;18388;5.438329345225147e-05
31241;别忙这图是动的？在变小变大;2;1;3;18388;0.0001631498803567544
31246;喜欢AI你做的好啊继续继续;1;0;1;18388;5.438329345225147e-05
31248;三连支持加油好久没看到你的新图了打call打call打call;1;0;1;18388;5.438329345225147e-05
31250;就一个，继续制作啊;1;1;2;18388;0.00010876658690450294
31253;我的手不受控制点了关注。喜欢;1;1;2;18388;0.00010876658690450294
31256;在wallpaper上的关键字叫什么微笑;1;0;1;18388;5.438329345225147e-05
31258;能不能整点xx的;1;0;1;18388;5.438329345225147e-05
31261;实在是太大了，我喜欢星星眼;1;0;1;18388;5.438329345225147e-05
31263;这个壁纸软件要给钱的啊笑哭;1;0;1;18388;5.438329345225147e-05
31265;UP，能在发一次吗？提示Freespaceleft下载不下来;3;0;3;18388;0.0001631498803567544
31269;不太懂，wallpaper怎么拿图啊，搜标题里的吗疑惑;6;0;6;18388;0.0003262997607135088
31276;小红车就是wallpaper吧思考我涉世太浅，是真不知道;1;1;2;18388;0.00010876658690450294
31281;有女孩子长这么大吗？;1;0;1;18388;5.438329345225147e-05
31285;谢天谢地，这次终于成功了之前露一小半就被锁定退回了;1;6;7;18388;0.0003806830541657603
31287;有不有链接星星眼doge;4;5;9;18388;0.0004894496410702633
31292;加油;1;2;3;18388;0.0001631498803567544
31295;求图包;1;1;2;18388;0.00010876658690450294
31297;UP主加油看好你噢;1;1;2;18388;0.00010876658690450294
31301;使命召唤蛋老六;1;1;2;18388;0.00010876658690450294
31303;创世纪未来科技企业没链接就动态上图，不然火不起来的;1;1;2;18388;0.00010876658690450294
31305;现实中，真的有这么大的吗？真没见过笑哭;1;1;2;18388;0.00010876658690450294
31308;如果能再表演个才艺就好了，卷死那些只会搔首弄姿的网红们;5;127;132;18388;0.007178594735697194
31314;图包来了打call打call通过百度网盘分享的文件：AI作画第四期链接httpspanbaiducoms1J5hLznC1w4Qj5R51lwhMXwpwdjzer提取码jzer复制这段内容打开百度网盘APP即可获取;7;67;74;18388;0.004024363715466608
31327;第一张简直太完美了，软件加你没找到这张，提示词是啥啊;1;0;1;18388;5.438329345225147e-05
31329;用这个是不是要收费;1;0;1;18388;5.438329345225147e-05
31336;怎么保存;1;0;1;18388;5.438329345225147e-05
31340;up主，你是小红书的是吧;1;1;2;18388;0.00010876658690450294
31342;都喜欢怎么办;1;1;2;18388;0.00010876658690450294
31345;请问up，可以画点没衣服的么我好这口脱单doge;3;1;4;18388;0.00021753317380900588
31436;还是不会画手部喜极而泣;3;4;7;18388;0.0003806830541657603
31440;无界AI相比灵境，哪一个更好呢？;1;6;7;18388;0.0003806830541657603
31445;Ai作图胸都那么大有点审美疲劳啊。;1;6;7;18388;0.0003806830541657603
31460;手脚永远是硬伤，很难有画的好的;1;0;1;18388;5.438329345225147e-05
31465;我将你作品的描述复制粘贴，然后修改了一些，结果生成了很奇怪的东西，跟我描述的差很多，而且很难看笑哭;2;0;2;18388;0.00010876658690450294
31471;这样完美的女人，果然不存在吗？笑哭;3;6;9;18388;0.0004894496410702633
31475;第三张第四张图片没有，下了你的ai软件也没有啊;2;0;2;18388;0.00010876658690450294
31481;人类被碾压了;2;0;2;18388;0.00010876658690450294
31486;不能直接发图片吗？;1;0;1;18388;5.438329345225147e-05
31489;三连两币投喂呲牙;1;2;3;18388;0.0001631498803567544
31492;有没有模型和提示词啊兄弟;1;0;1;18388;5.438329345225147e-05
31494;第二张挺好看的笑哭，其它总感觉没有神韵;1;1;2;18388;0.00010876658690450294
31496;这up主能处，给我三连投币星星眼星星眼星星眼;1;3;4;18388;0.00021753317380900588
31500;大佬，想要涨粉和硬币，建议视频后再发动态哦打call打call;1;0;1;18388;5.438329345225147e-05
31503;下巴太尖了，很少有人长这样子;1;0;1;18388;5.438329345225147e-05
31505;有没有横屏的，我想给我电脑当壁纸星星眼;1;1;2;18388;0.00010876658690450294
31507;为什么你们的AI绘画这么美，我的AI绘画一把渣;2;5;7;18388;0.0003806830541657603
31511;AI画画的脸型貌似都是瓜子脸，总有一点遗憾;1;0;1;18388;5.438329345225147e-05
31513;ai能制作动作片吗;1;1;2;18388;0.00010876658690450294
31519;up的Ai手处理的都不错啊星星眼;1;1;2;18388;0.00010876658690450294
31522;up大大，有些图没有，三连求图打call;1;0;1;18388;5.438329345225147e-05
31535;为啥有些图片链接里没有呢笑哭;1;0;1;18388;5.438329345225147e-05
31537;raiseerrOSErrorWinError1931不是有效的Win32应用程序。ErrorloadingDeasyHelpernovelainaifunovelainaifupythonlibsitepackagestorchlibcudnnadvtrain648dlloroneofitsdependencies请按任意键继续怎么回事;7;143;150;18388;0.00815749401783772
31545;upup，蔡徐坤图片上传没反应怎么办呀;14;165;179;18388;0.009734609527953013
31560;nudeloiltearsbedroomshywetlonghaircute，不用谢doge;26;160;186;18388;0.010115292582118773
31587;整合包链接来啦大笑：httpspanbaiducoms1GZurBpJiGn4bjPpZJSxbyQpwddcok提取码：dcok;14;91;105;18388;0.005710245812486404
31602;a卡好像用不了，显示缺少Nvidia驱动酸了;7;49;56;18388;0.0030454644333260824
31610;httpswolfchentoptag脱单doge脱单doge;7;43;50;18388;0.0027191646726125733
31618;pythonexe系统错误无法启动此程序因为计算机中失apimswincorepathl110dll尝试重新安装该程序以解决此问题。这是什么情况？8G以下点这里，也打不开;7;56;63;18388;0.0034261474874918425
31627;没事，替代吧，等过个几十年高端画师死绝了，绘画就是ai的天下了，继续替代，艺术属于ai，大势所趋，我倒是想看到人类一切都被ai取代然后全民躺平的那一天;16;29;45;18388;0.002447248205351316
31645;谢谢up，我的能产图了，虽然有点慢不过很牛逼了，就是不知道非二次元风格咋弄;2;13;15;18388;0.000815749401783772
31649;无法访问此页面囧;5;9;14;18388;0.0007613661083315206
31655;再补充几个常见问题：目前软件支持N卡，A卡的同学暂时用不了哦；长时间无反应的应该是内存和显卡配置跟不上，需要耐心等待。16系列显卡产图时间约为：23分钟，30系列几秒到1分钟不等，取决于显存和具体的CPU型号;9;16;25;18388;0.0013595823363062867
31665;网页打不开;7;11;18;18388;0.0009788992821405265
31673;为啥标签网站寄了;3;9;12;18388;0.0006525995214270176
31678;棒，最近也在了解AI绘画，之前都是点赞，这次三连嗷;1;25;26;18388;0.0014139656297585382
31680;找不到指定路径？;6;6;12;18388;0.0006525995214270176
31689;那个黑框是干什么的？？？;1;1;2;18388;0.00010876658690450294
31693;英伟达1660s的显卡能运行吗？微笑;2;1;3;18388;0.0001631498803567544
31696;系统找不到指定的路径。请按任意键继续怎么解决;1;2;3;18388;0.0001631498803567544
31704;产一个图要1分半钟，有没有更快的方法;4;3;7;18388;0.0003806830541657603
31710;up我打不开网页，显示永久迁移走或者是检查自己网络连接;1;4;5;18388;0.00027191646726125733
31715;哥，一点开自己版本的就显示系统找不到指定的路径。请按任意键继续怎么解决;6;5;11;18388;0.0005982162279747662
31723;Failedtoloadmodel;1;1;2;18388;0.00010876658690450294
31730;我这说“请按任意键继续。”，是什么情况;3;1;4;18388;0.00021753317380900588
31734;我电脑没有显卡笑哭;3;1;4;18388;0.00021753317380900588
31740;1050ti能用吗思考;2;1;3;18388;0.0001631498803567544
31745;AMD的显卡用不了吗tv大哭;3;2;5;18388;0.00027191646726125733
31753;为什么绘画完了没图片出来啊;2;1;3;18388;0.0001631498803567544
31757;为什么我产出是全黑图片？;1;1;2;18388;0.00010876658690450294
31759;这个能改缓存位置吗，用的时候c盘嘎嘎掉脱单doge;1;1;2;18388;0.00010876658690450294
31761;是win7版本以下的（包括win7）的全都不要指望了，版本问题压根打不开的;4;1;5;18388;0.00027191646726125733
31766;找不到指定路径是啥意思酸了;1;2;3;18388;0.0001631498803567544
31769;up为什么我会显示一个按任意键继续然后一按就没了;6;1;7;18388;0.0003806830541657603
31776;画了好多涩图，真好doge;3;1;4;18388;0.00021753317380900588
31780;下载完解压说文件损坏大哭;5;2;7;18388;0.0003806830541657603
31786;一点生成就关机了藏狐;3;2;5;18388;0.00027191646726125733
31790;星空大佬的版本tag限制75个这个咋提升大佬;3;3;6;18388;0.0003262997607135088
31794;已三连，百度网盘差评;3;2;5;18388;0.00027191646726125733
31798;下载的压缩包文件损坏喜极而泣你们下载会出现这种情况吗？;1;1;2;18388;0.00010876658690450294
31802;禁止使用AI作画，AI作画在毁灭这个世界（画渣）大哭;5;1;6;18388;0.0003262997607135088
31808;toolsmikuacaff635bcbe95e5b343d115c7fc8refaff无内鬼，来点网页版ai绘画脱单doge;1;2;3;18388;0.0001631498803567544
31814;为什么我的是按任意键进行继续呢？;1;0;1;18388;5.438329345225147e-05
31833;问一下各位，我是英特尔的卡，我打开后显示缺少NVIDIA驱动，但英特尔的装不了英伟达的，咋整？思考酸了;1;0;1;18388;5.438329345225147e-05
31836;图片不出来怎么办;1;0;1;18388;5.438329345225147e-05
31852;3080出图也好慢，将近一分钟一张才出来笑哭;1;0;1;18388;5.438329345225147e-05
31877;我是美术生，这玩意真他妈牛逼，舍友已经计划掀起波兰了;1;0;1;18388;5.438329345225147e-05
31887;A卡怎么用;1;0;1;18388;5.438329345225147e-05
31895;已成功，要老婆的找我doge;1;0;1;18388;5.438329345225147e-05
31904;有没有人下载好的发给我我百度网盘要下载120小时大哭;6;0;6;18388;0.0003262997607135088
31916;用手掌抚平。“你知道我是谁吗？”他说，好像答案很明显。“我不确定，”她诚实地回答。她以前见过他，但那只是一闪而过的红头发和白皮肤，瞬间就消失了。他看起来一点也不面熟。事实上，她会发誓他不是人类。但话说回来，他确实说过他是上帝。“我想是的。”他热情地笑了笑，尽管她什么也看不见，但她知道他对她的诚实感到高兴。似乎他想确保他们从一开始就相互理解。“我叫塔纳托斯。你可以叫我死神。”她的心开始怦怦直跳。“你是来带走我的灵魂的？”他大笑起来。他的笑声在房间里回荡，使她有点不安。“多有趣的问题啊不，我不是这样做的。嘿嘿嗨;1;0;1;18388;5.438329345225147e-05
31919;一直说Python已停止工作然后卡那不动;1;0;1;18388;5.438329345225147e-05
31925;好玩脱单doge;2;0;2;18388;0.00010876658690450294
31940;为什么手部的绘画总是残的;2;0;2;18388;0.00010876658690450294
31949;弹出一个请按任意键继续怎么回事傲娇傲娇有无人说说;5;0;5;18388;0.00027191646726125733
31961;这个A卡是不是不能用啊（悲灵魂出窍）;2;0;2;18388;0.00010876658690450294
31967;那个规模和步骤什么意思，数值少会出现少个人，少个腿，多了会出现一堆腿，满屏星星点点的;2;0;2;18388;0.00010876658690450294
31971;这手有问题咋办啊？;4;0;4;18388;0.00021753317380900588
31977;显卡是什么;1;0;1;18388;5.438329345225147e-05
31980;不错吃瓜话说开头是什么;2;0;2;18388;0.00010876658690450294
31983;那种图片也有吗蜡笔小新哇哦;8;62;70;18388;0.0038068305416576026
31992;描述到底怎么写，生成的人不是多腿就是多手的，写实风格简直是恐怖片;7;36;43;18388;0.002338481618446813
32001;为什么你的有衣服思考;11;19;30;18388;0.001631498803567544
32013;NansExceptionAtensorwithallNaNswasproducedinUnetThiscouldbeeitherbecausetheresnotenoughprecisiontorepresentthepictureorbecauseyourvideocarddoesnotsupporthalftypeTrysettingtheUpcastcrossattentionlayertofloat32optioninSettingsStableDiffusionorusingthenohalfcommandlineargumenttofixthisUsedisablenancheckcommandlineargumenttodisablethischeckTimetaken507sTorchactivereserved53985828MiBSysVRAM81668192MiB9968大佬们，有遇到这情况吗？怎么搞？求指点，显卡2060S;1;8;9;18388;0.0004894496410702633
32015;Up我想问问为什么你的图会显示在生成过程中的变化，是在设置里调的吗脸红;1;5;6;18388;0.0003262997607135088
32020;问下，怎么生成高分辨率的吖，3060ti一选1080p分辨率就卡图，加载出来的图，相当于从胸部开始又重复画了一次很诡异，求解;3;0;3;18388;0.0001631498803567544
32024;求问up主给的tag是啥星星眼;1;1;2;18388;0.00010876658690450294
32027;听说电脑用这个画图相当于在挖矿，不知道是不是真的;4;1;5;18388;0.00027191646726125733
32032;基础模型知道放哪里，就想知道lora模型放哪啊？;3;7;10;18388;0.0005438329345225147
32041;感觉更像是给个模型，搞了个换装？很多图连身上的痣都没变，啥时候可以拜托模型的限制。;1;2;3;18388;0.0001631498803567544
32045;up用的什么软件？有教程吗？;19;1;20;18388;0.0010876658690450293
32071;请问需不需要用vae啊打call;2;0;2;18388;0.00010876658690450294
32079;请问，这个模型去哪里弄？;2;0;2;18388;0.00010876658690450294
32084;请问你是怎么进行关键词描述的？;1;0;1;18388;5.438329345225147e-05
32096;图包在这好兄弟们拿图给个三连吧doge通过百度网盘分享的文件：秀色可餐表版链接httpspanbaiducoms1gZLMYHVD5CIgbfu2M8sApwd1315提取码1315复制这段内容打开百度网盘APP即可获取;9;48;57;18388;0.003099847726778334
32106;好消息是，这期的里版做好了doge;270;46;316;18388;0.017185120730911465
32377;涩图看多了，这次带来点清纯唯美的doge，什么？你问我这期有没有里版？doge;3;12;15;18388;0.000815749401783772
32382;已三连，求里版脱单doge;1;6;7;18388;0.0003806830541657603
32384;还有吗？？？;1;1;2;18388;0.00010876658690450294
32386;已三连，求doge;1;1;2;18388;0.00010876658690450294
32388;我我我;1;1;2;18388;0.00010876658690450294
32390;三连了，求里啊脱单doge;1;1;2;18388;0.00010876658690450294
32392;三连啦，up看看我;1;1;2;18388;0.00010876658690450294
32394;三连了，现在还有吗？tvdoge;1;1;2;18388;0.00010876658690450294
32396;热词系列三连求里;1;1;2;18388;0.00010876658690450294
32398;已三求里脱单doge;1;1;2;18388;0.00010876658690450294
32400;不懂就问，那个铝板早就下载好了结果不支持此类文件，打开还有离线下载怎么搞？;2;1;3;18388;0.0001631498803567544
32403;已热词系列三连，求里doge;1;2;3;18388;0.0001631498803567544
32405;已经三连了，现在要还有吗？doge;1;1;2;18388;0.00010876658690450294
32407;已三连求里;1;1;2;18388;0.00010876658690450294
32409;已三连，求里版doge;1;1;2;18388;0.00010876658690450294
32411;已三，求;1;1;2;18388;0.00010876658690450294
32413;三求里;1;1;2;18388;0.00010876658690450294
32415;热词系列三连求里;1;1;2;18388;0.00010876658690450294
32417;现在还来得及吗;1;2;3;18388;0.0001631498803567544
32419;你以为我在求里吗？没错脱单doge;1;3;4;18388;0.00021753317380900588
32421;已热词系列三连，求里版;1;1;2;18388;0.00010876658690450294
32423;已三连，求里版;1;1;2;18388;0.00010876658690450294
32425;点赞投币了，求里版。;1;1;2;18388;0.00010876658690450294
32427;三连求求里版脱单doge;1;1;2;18388;0.00010876658690450294
32429;投币了，懂？热词系列三连;1;3;4;18388;0.00021753317380900588
32431;热词系列三连求里版;2;1;3;18388;0.0001631498803567544
32435;三连要里还来得及吗;1;1;2;18388;0.00010876658690450294
32437;三连求里版doge;1;1;2;18388;0.00010876658690450294
32439;又刷到了，没人给up投币我来;1;3;4;18388;0.00021753317380900588
32441;doge球图包;1;2;3;18388;0.0001631498803567544
32443;大半夜的你干嘛;1;4;5;18388;0.00027191646726125733
32446;三连求里;1;1;2;18388;0.00010876658690450294
32457;已三连，求滑稽;1;1;2;18388;0.00010876658690450294
32461;已三连求里;1;1;2;18388;0.00010876658690450294
32463;已三连，求里版;1;1;2;18388;0.00010876658690450294
32468;已三连，求里版;1;1;2;18388;0.00010876658690450294
32472;已三连求里;1;1;2;18388;0.00010876658690450294
32477;三连求;1;1;2;18388;0.00010876658690450294
32479;已三连求里版;3;1;4;18388;0.00021753317380900588
32483;热词系列三连图;1;1;2;18388;0.00010876658690450294
32492;以三连tvdoge所以;4;1;5;18388;0.00027191646726125733
32508;三连求doge;1;1;2;18388;0.00010876658690450294
32510;刷到六次了，就来个里版吧热词系列三连;1;1;2;18388;0.00010876658690450294
32516;三连了，求里脱单doge;1;1;2;18388;0.00010876658690450294
32543;已三连，求里版脱单doge;1;0;1;18388;5.438329345225147e-05
32555;热词系列三连懂？doge;1;0;1;18388;5.438329345225147e-05
32577;总感觉有些地方怪怪的，比如说手和脚还有身长。;1;0;1;18388;5.438329345225147e-05
32587;以三，求里脱单doge;1;0;1;18388;5.438329345225147e-05
32589;三连求里;1;0;1;18388;5.438329345225147e-05
32591;三连求里;1;0;1;18388;5.438329345225147e-05
32593;已三连，求里脱单doge;1;0;1;18388;5.438329345225147e-05
32595;已三连来点正经的;1;0;1;18388;5.438329345225147e-05
32597;已三连，求里版;1;0;1;18388;5.438329345225147e-05
32599;热词系列三连求里;1;0;1;18388;5.438329345225147e-05
32602;热词系列三连求里版;1;0;1;18388;5.438329345225147e-05
32614;已三连，求里版doge;1;0;1;18388;5.438329345225147e-05
32617;已三连，求里版doge;1;0;1;18388;5.438329345225147e-05
32619;三，里脱单doge脱单doge;1;0;1;18388;5.438329345225147e-05
32621;已三连热词系列三连，求里版;1;0;1;18388;5.438329345225147e-05
32623;已热词系列三连;1;0;1;18388;5.438329345225147e-05
32629;已三连，求里版;1;0;1;18388;5.438329345225147e-05
32631;已热词系列三连，求里版;1;0;1;18388;5.438329345225147e-05
32633;已三连，求里版脱单doge;1;0;1;18388;5.438329345225147e-05
32635;三连求里版doge;1;0;1;18388;5.438329345225147e-05
32638;热词系列三连了，求里版;1;0;1;18388;5.438329345225147e-05
32643;里版脱单doge;1;0;1;18388;5.438329345225147e-05
32646;三连投币了，OK求里版doge;1;0;1;18388;5.438329345225147e-05
32651;鉴于现在的美颜磨皮，我倒觉得ai画的比人还真实了;5;196;201;18388;0.010931041983902545
32657;赶紧做违规的东西吧我等不及了;6;107;113;18388;0.006145312160104416
32665;他虽然数不清手指头，但知道它数清两坨就行;1;44;45;18388;0.002447248205351316
32667;好看是好看，就是千万别画手指了，大多都是6指，吓人笑哭;5;35;40;18388;0.0021753317380900587
32674;现实中真有这种完美的五年准备好了辣眼睛;2;19;21;18388;0.0011420491624972808
32677;看多了就觉得脸都差不多，就腻了;3;16;19;18388;0.0010332825755927778
32681;好可怕呀，人以后不是会真的沉迷在虚拟网络里了呀。;5;13;18;18388;0.0009788992821405265
32687;如果想换脸的话，是要换底模，还是只要换lora就好了;4;10;14;18388;0.0007613661083315206
32692;辣眼睛人家说丑有各的丑，美的人都是相似的，因为作为同一个物种，我们基因有相通之处，但是大兄弟你这审美有点独特啊;3;7;10;18388;0.0005438329345225147
32696;我想知道大家真的敢用来做手机或者电脑墙纸吗？我手机也就在外面用一会，一到家就换回风景，至于电脑连想都不敢想用这些美女做墙纸;2;7;9;18388;0.0004894496410702633
32699;没链接哒？doge;1;2;3;18388;0.0001631498803567544
32702;这样的话，独立游戏制作人可以剩下一大笔美工费用doge但是美工要哭了;1;1;2;18388;0.00010876658690450294
32705;up画得好棒这两天老刷到所以自己去试了一下，现在对那两类参数有点懵，有多少词条可以写呀，有没有类似开发文档的东西呀吃瓜吃瓜我目前就是在hugeface上看别人分享的作品里对应的一些词条照模画虎的程度笑哭;2;1;3;18388;0.0001631498803567544
32713;有带词原图下载没;1;0;1;18388;5.438329345225147e-05
32722;求关键词辣眼睛;2;0;2;18388;0.00010876658690450294
32731;看的多就腻了，全都是一张脸，韩式妆容;1;0;1;18388;5.438329345225147e-05
32737;有没有竖屏啊;2;0;2;18388;0.00010876658690450294
32741;有这个画的软件吗？;1;0;1;18388;5.438329345225147e-05
32746;bgm是什么;1;0;1;18388;5.438329345225147e-05
32749;这手笑哭突然没感觉了;1;0;1;18388;5.438329345225147e-05
32754;这个用的啥模型啊;1;0;1;18388;5.438329345225147e-05
32756;问下这是哪个ai模型;1;0;1;18388;5.438329345225147e-05
32765;索佬dogedoge;1;0;1;18388;5.438329345225147e-05
32767;AI这么牛逼了么。越来越真了;2;0;2;18388;0.00010876658690450294
32770;sony打call;1;0;1;18388;5.438329345225147e-05
32772;老规矩，关注，点赞，收藏，没币了，三连了，有连接我拿走，没连接求图;1;0;1;18388;5.438329345225147e-05
32777;AI涩图冲的感觉和真人完全不一样，因为你知道这是假的是虚构的不存在的，所以对AI发情没有心理负担，真人的话还有几分矜持几分难堪，念头不通达;9;376;385;18388;0.020937567979116816
32787;我想新ai都这么强了应该不只会做这些吧doge;33;275;308;18388;0.016750054383293453
32821;推特大把，别说葡萄了，整个的都大堆doge;15;180;195;18388;0.010604742223189037
32837;都Ai了为什么要穿衣服doge;6;43;49;18388;0.002664781379160322
32844;推特有全套全果体图片。我刚打了一梭子;7;30;37;18388;0.002012181857733304
32853;你想戒，就能戒，要知道，道法自然，色即是空;1;20;21;18388;0.0011420491624972808
32855;已经有点分不清ai和真人;2;19;21;18388;0.0011420491624972808
32858;那么你的模型在哪拿呢？doge;1;5;6;18388;0.0003262997607135088
32860;想自己电脑跑ai画图的话，首先需要N卡，A卡也有类似的但是性能损失非常大，N卡在生产力上的表现不是A卡能比的；其次显卡显存需要4g往上，越大越好。308010g的卡跑一张一般的小图几乎秒生成，但是视频里这么高清的图估计得半个小时往上吧跪了;2;4;6;18388;0.0003262997607135088
32864;这不是下垂;4;2;6;18388;0.0003262997607135088
32870;貌美如花卡古拉酱;1;1;2;18388;0.00010876658690450294
32873;我有一个收藏夹叫《厚礼谢》，但是这个AI画画到底算不算厚礼，该不该谢呢思考;2;1;3;18388;0.0001631498803567544
32878;233柴柴学一下;1;1;2;18388;0.00010876658690450294
32880;AI就是我哥们蒙古周树人他懂我;1;1;2;18388;0.00010876658690450294
32883;什么时候能根据ai生成，用3d打印技术，用tpe做材料，批量生产伴侣dogedogedoge;1;1;2;18388;0.00010876658690450294
32886;谎言王座;1;1;2;18388;0.00010876658690450294
32895;我已经在推特上看过更得劲的了;1;0;1;18388;5.438329345225147e-05
32899;啥时候有ai画本子滑稽;1;0;1;18388;5.438329345225147e-05
32924;说实话，一看到这些个玩意是ai画的我没半点兴趣，就好像电次想要摸结果摸的是海绵球懂我意思吗？我宁愿看别人画的漫画，动漫，都比这玩意好。;1;0;1;18388;5.438329345225147e-05
32928;这如果搞涩涩不得薄纱3d;1;0;1;18388;5.438329345225147e-05
32948;这bgm听得有人在我脑子里跳舞;1;0;1;18388;5.438329345225147e-05
32964;直男癌加一;1;0;1;18388;5.438329345225147e-05
32968;热心市民煜先生;4;0;4;18388;0.00021753317380900588
32978;ai还不会化淡妆啊，全是浓妆艳抹;2;0;2;18388;0.00010876658690450294
32981;没那味;1;0;1;18388;5.438329345225147e-05
32985;叉腰等图包;1;0;1;18388;5.438329345225147e-05
33002;哪个;1;0;1;18388;5.438329345225147e-05
33012;哥们，图包呢doge阿里的哦;7;0;7;18388;0.0003806830541657603
33020;AI逐渐掌握人类XP;1;68;69;18388;0.003752447248205351
33022;太无敌了，以前想都不敢想，那些能画这种级别的都神级画手，而且完成一张都很麻烦。现在这AI直接量产神;4;45;49;18388;0.002664781379160322
33027;跟审核打成一片了;1;34;35;18388;0.0019034152708288013
33029;这个真的不错，搞多些御姐，幼儿太多了。;1;28;29;18388;0.0015771155101152925
33031;图包来咯链接：httpspanbaiducoms1IGAK9DplIPXO6fyJGfgYQpwdffcv提取码：ffcv点赞三连支持一下吧给心心给心心给心心;13;27;40;18388;0.0021753317380900587
33045;这种风格的图片截止今日本期最佳;1;13;14;18388;0.0007613661083315206
33047;给我图包;1;9;10;18388;0.0005438329345225147
33049;天天妹子，心情愉悦多了滑稽;1;9;10;18388;0.0005438329345225147
33051;进步太快了笑哭我已经想到在不久的未来，ai绘画ai语音chatgpt40你的赛博女友了脱单doge到时候玩那种互动式故事游戏，你可以与你的赛博女友沟通，然后她可以根据你的文本做出相应的文字反应，再用集成了专业女配音ai语音说出来，然后ai绘画根据文字生成对应画面，怎么说，赛博女友确实离我们不远了脱单doge;1;5;6;18388;0.0003262997607135088
33053;太强了点赞给心心给心心给心心;1;2;3;18388;0.0001631498803567544
33055;真心希望抓紧发展ai动画，抓紧应用到3d区doge;1;5;6;18388;0.0003262997607135088
33057;多来点这种doge硬币大大的有;2;7;9;18388;0.0004894496410702633
33060;已赞，送你上首页;1;2;3;18388;0.0001631498803567544
33062;三连了，图包在哪里？;1;3;4;18388;0.00021753317380900588
33064;新年后开始转型啦哦呼;1;2;3;18388;0.0001631498803567544
33080;up太厉害了，用的是哪款模型？;1;1;2;18388;0.00010876658690450294
33086;大胆妖孽妙啊;1;1;2;18388;0.00010876658690450294
33095;加up关注，是我做的很明智的决定;1;1;2;18388;0.00010876658690450294
33099;不错不错;1;1;2;18388;0.00010876658690450294
33102;有图肯定有三连;1;2;3;18388;0.0001631498803567544
33104;三连已给doge;1;1;2;18388;0.00010876658690450294
33106;喜欢喜欢给心心;1;1;2;18388;0.00010876658690450294
33108;真好看;1;1;2;18388;0.00010876658690450294
33110;这么厉害的UP主不关注一下不行doge;1;2;3;18388;0.0001631498803567544
33112;UP给图必须3连;1;1;2;18388;0.00010876658690450294
33114;看来不关注是不行了喜欢;1;1;2;18388;0.00010876658690450294
33116;纸片人真香;1;1;2;18388;0.00010876658690450294
33118;挺好看的doge很软;1;1;2;18388;0.00010876658690450294
33120;吃瓜有没有，你懂的;4;1;5;18388;0.00027191646726125733
33125;我天，这ai成精了星星眼;1;2;3;18388;0.0001631498803567544
33127;还是你行doge;2;1;3;18388;0.0001631498803567544
33130;惊艳到了;1;1;2;18388;0.00010876658690450294
33132;恭喜你离百大又近了一步;1;0;1;18388;5.438329345225147e-05
33148;已点赞投币给我图包滑稽滑稽;1;0;1;18388;5.438329345225147e-05
33153;请问up用的是什么模型;1;0;1;18388;5.438329345225147e-05
33155;这个需要电脑有什么配置;2;0;2;18388;0.00010876658690450294
33158;有没有那种刺激血液的;1;0;1;18388;5.438329345225147e-05
33160;有群吗;1;0;1;18388;5.438329345225147e-05
33162;79期开始写实起来了，是喂了模型嘛？;1;0;1;18388;5.438329345225147e-05
33164;希望能什么时候ai模拟人的声音，然后还有触感，以及温度doge;1;0;1;18388;5.438329345225147e-05
33166;这怎么整的doge;1;0;1;18388;5.438329345225147e-05
33168;用的是哪个AI呀？星星眼;5;0;5;18388;0.00027191646726125733
33174;多搞些嫂子，爱看;1;0;1;18388;5.438329345225147e-05
33176;大哥整点高清啊，;2;0;2;18388;0.00010876658690450294
33180;什么模型？;1;0;1;18388;5.438329345225147e-05
33182;关键词不发出来，天打雷劈;1;0;1;18388;5.438329345225147e-05
33186;能否看看咒语doge;1;0;1;18388;5.438329345225147e-05
33188;UP主能不能把全部期数都放一起下载，今晚点到手软;1;0;1;18388;5.438329345225147e-05
33190;这是用ai软件画的吗？;3;0;3;18388;0.0001631498803567544
33194;这ai画圈越来越卷了吗;1;0;1;18388;5.438329345225147e-05
33196;ai建模吗;1;0;1;18388;5.438329345225147e-05
33198;老大用什么软件搞的;1;0;1;18388;5.438329345225147e-05
33200;夸克下载要钱？笑哭;2;0;2;18388;0.00010876658690450294
33203;up主的名字让我想起了“斗罗玉兔传”;1;5;6;18388;0.0003262997607135088
33207;文件已删除？;4;0;4;18388;0.00021753317380900588
33215;up文件没有了;3;0;3;18388;0.0001631498803567544
33219;链接图包被删了doge;1;0;1;18388;5.438329345225147e-05
33222;链接失效了;2;0;2;18388;0.00010876658690450294
33229;up，原图链接发一下吃瓜;3;104;107;18388;0.005819012399390907
33235;ai一出，二三线接稿人全体完蛋笑哭;4;16;20;18388;0.0010876658690450293
33241;好涩，牛牛要站起来了;1;11;12;18388;0.0006525995214270176
33243;Ai涩图多来点doge;1;11;12;18388;0.0006525995214270176
33245;很大很白;1;7;8;18388;0.00043506634761801175
33247;ai啥都好，就是手老是奇奇怪怪的;3;6;9;18388;0.0004894496410702633
33255;这用啥软件;1;5;6;18388;0.0003262997607135088
33257;冲锋啊在干什么，分扣我们成都的好了doge;4;5;9;18388;0.0004894496410702633
33272;ai现在会画手了吗doge;2;2;4;18388;0.00021753317380900588
33276;ai作画同质化太严重，我还是喜欢找真人的;1;2;3;18388;0.0001631498803567544
33287;图一发一下？doge;1;1;2;18388;0.00010876658690450294
33298;UP主，建议不要漏出来手，AI画不好;1;0;1;18388;5.438329345225147e-05
33300;置顶置顶别想了人家有男朋友他男朋友的主页httpsspacebilibilicom脱单doge;1;0;1;18388;5.438329345225147e-05
33306;本子画家是吧吃瓜;1;0;1;18388;5.438329345225147e-05
33317;咱们就是说，有没有一种可能，这个up狡猾得很，把不该看的私藏了起来doge;6;770;776;18388;0.04220143571894714
33324;这个头像这个名字看来有人跟我一样在等待吊带袜天使;4;151;155;18388;0.008429410485098978
33329;前段：吃香肠前中段：吃有些不对劲但是说不出哪里不对劲的香肠中段：广告代言中后段：手指的错乱与穿模后段：香肠？什么香肠？;5;2152;2157;18388;0.11730476397650642
33335;doge滑稽滑稽滑稽滑稽滑稽滑稽滑稽滑稽滑稽;11;129;140;18388;0.007613661083315205
33347;哇，是爱杀，都不知道改名叫啥了tv笑哭;1;26;27;18388;0.0014683489232107897
33349;这个视频告诉我们香肠越吃越小，最后就没了（）;2;86;88;18388;0.004785729823798129
33352;因因为开头火吧;3;15;18;18388;0.0009788992821405265
33356;0009感觉这里最像啊兔年;2;23;25;18388;0.0013595823363062867
33361;我们至今为止仍未知道人类何时能驯服AI;1;12;13;18388;0.0007069828148792691
33365;AI在逐渐看向你;1;8;9;18388;0.0004894496410702633
33367;一开始那个意义不明的白线绝对是学了什么不该学的东西。喜极而泣;1;8;9;18388;0.0004894496410702633
33369;后面变成赛琳娜，然后变成曲，最后变成刻晴了辣眼睛打call;3;8;11;18388;0.0005982162279747662
33376;吃肠的时候刚好刷到这个;1;5;6;18388;0.0003262997607135088
33378;她在逐渐转头啊囧;1;8;9;18388;0.0004894496410702633
33383;現在還有人剪愛殺寶貝星星眼;2;4;6;18388;0.0003262997607135088
33386;省流：越含越细;1;7;8;18388;0.00043506634761801175
33389;越来越像赛琳娜（战双粉）;1;4;5;18388;0.00027191646726125733
33392;越来越细，最后没了吃瓜;1;7;8;18388;0.00043506634761801175
33394;Up头像是吊带袜天使吗？脱单doge;1;2;3;18388;0.0001631498803567544
33396;打了个码感觉好怪哦妙啊;1;7;8;18388;0.00043506634761801175
33398;你们到底在期待什么？大声地说出来doge;1;5;6;18388;0.0003262997607135088
33415;空不是无，空是一种存在doge;5;3;8;18388;0.00043506634761801175
33438;最后一张像刻睛;1;2;3;18388;0.0001631498803567544
33442;求AI圖（全部差分）打call;2;1;3;18388;0.0001631498803567544
33445;up头像给心心;2;1;3;18388;0.0001631498803567544
33459;ai还有待开发啊，没看到想看的;2;1;3;18388;0.0001631498803567544
33468;啊这;1;1;2;18388;0.00010876658690450294
33472;眼睛一直看着手辣眼睛;1;1;2;18388;0.00010876658690450294
33478;把trollge扔ai绘画试试作者;1;2;3;18388;0.0001631498803567544
33500;up主用的哪款AI画画鸭？;2;0;2;18388;0.00010876658690450294
33545;所以bgm是啥;1;0;1;18388;5.438329345225147e-05
33549;原？;1;0;1;18388;5.438329345225147e-05
33552;bgm都是ai合成的，在整个皮套人配个智能语音包，还不得成赛博女友doge;8;285;293;18388;0.01593430498150968
33561;作为一个小画师，很悲观，但只能说真牛逼笑哭;49;255;304;18388;0.016532521209484445
33611;好好看但是看着感觉还是有点悲哀的，一个新人需要多少年才能够成临摹进阶到自主创作，最后想法和能力高度集中达到这个水平，ai干掉的不是已经成为顶尖的那一批人，而是正在努力和开始学习的那批人;15;152;167;18388;0.009082010006525995
33627;真希望ai软件能把他融了谁的图给标上啊这样就能顺藤摸瓜找到原作者欣赏美丽原图了;8;123;131;18388;0.007124211442244942
33636;细节有问题，不过粗看的话颜色很舒服，看到的第一眼甚至会令人感到惊艳。（能出现不同的画风是因为换了模型吗？）;14;145;159;18388;0.008646943658907983
33651;好，我要偷你的图的创意来做设子;9;89;98;18388;0.005329562758320644
33661;作为一个属于这行的人，真的绷不住想笑，练习好几年被ai干得稀碎，而且速度快百倍有余，大学几年还刚好卡着疫情的点，真是多灾多难，外行有信心说ai是答辩那真是因为他们只知道顶尖画师，ai目前是碰瓷不了但能干碎8成小画师，你们去米画师或者其他约稿软件看看就知道小画师45百的图比上ai的图才是最绷不住的，而且我身边的从事动画行业的朋友，还都属于学校前端的那种，一样比不了，也许之后会成长，但ai也会成长;9;72;81;18388;0.004405046769632369
33671;说句中肯的话，刻画很棒，但是只是在加细节，没有取舍，看的眼睛疲劳，非常的繁琐，细节经不起推敲，建模看了两眼一黑，作为参考有点价值，作为商业美术毫无意义;103;49;152;18388;0.008266260604742223
33775;AI把我的工作变成纯兴趣了越来越喜欢画画了星星眼星星眼;7;52;59;18388;0.0032086143136828365
33783;那些说ai共享的没有版权的tv白眼，希望你们以后工作的成果也被别人拿走做共享，当然你也是免费劳动力，老板不用给你们一分钱哟tv抠鼻;12;47;59;18388;0.0032086143136828365
33797;doge如何才能屏蔽这种让人心情不好的东西dogedogedoge;8;58;66;18388;0.003589297367848597
33806;希望UP不要理会质疑，继续探索下去。;2;68;70;18388;0.0038068305416576026
33809;眼界放宽点，别眼熟就是舟既视感，好多图明显是吉田明彦那派画风，或者在这个画风基础上精进了。最终幻想，碧蓝幻想差不多这种（史克威尔出来的美术团队画风都多少像吉田明彦）。舟那个背景站台也是学的人家的，小日子大佬以前也给人家项目画过外包。还有硬夹克舟没出来前lm7就画出名了，舟算是给发扬光大了。;1;30;31;18388;0.0016858820970197955
33811;感觉目前通常AI是很难训练的有真正厉害的画手那么精细的，细节上总是会有不和谐之处。做到足够精细的话应该需要的成本也不低，还需要更精进的算法。感觉AI可以作为画手很好的辅助工具，这会迫使想要商业化的画手需要很快的成长，不低于AI水平太低。当然另一个问题是原始版权也合法化，但是这种东西的界定太困难了。然而抵制感觉也是徒劳的，根本无法阻挡科技的前进吧，不太可能完全禁止这种本身就难以识别的东西。以后还有可能出现甚至已经出现了方便使用的AI绘图工具，想依靠AI绘画卖画的人都可能失业，软件可能更便宜甚至免费。。。。或许艺术将成为一个纯净的领域，可能只剩下顶层人才，和真正纯粹热爱艺术的人吧。。。;8;15;23;18388;0.0012508157494017839
33820;看到绘画变成如此“快捷”的东西，让人感觉很悲哀。一瞬间就能生产如此多的“作品”让人参考，自己的灵感与创想，在这么多“作品”下显得如此微弱无力。里面随便选一个出来都能比我自己半天构思的人物要丰富，美丽（悲伤）;2;36;38;18388;0.0020665651511855556
33823;不愧是nijijourney，看来吃的素材都是顶级货惊喜;2;40;42;18388;0.0022840983249945617
33827;好多我见过的画的影子啊，敲;5;20;25;18388;0.0013595823363062867
33833;Ai抄人，人又反过来抄ai。说真的，这里不少设计直接拿来用都比不少游戏里的人物设计要好多了。只是细节不能看，不合理。但只要人改合理就行了。这么看来，美术基础才是最重要的，设计这种吃灵感的东西才会最先被ai攻破。;2;3;5;18388;0.00027191646726125733
33837;好家伙，本美术生不知道以后怎么上班了囧;14;11;25;18388;0.0013595823363062867
33853;我看到有人说画师该退出时代了后生仔，真就学了手艺饿死师傅呗，画师退出时代的唯一结果就是人类绘画审美直接定格，停滞;8;20;28;18388;0.0015227322166630412
33863;快进到ai代替一切，咱们一起去厂里拧螺丝doge;9;9;18;18388;0.0009788992821405265
33873;他生成的这些图是没有版权的吧，可以随便用吗;9;9;18;18388;0.0009788992821405265
33883;我看到优秀的ai作画就想死;2;2;4;18388;0.00021753317380900588
33886;心疼被喂图的画师们妙啊;1;8;9;18388;0.0004894496410702633
33888;就算大部分画师都被ai干死我也会坚持下去;2;2;4;18388;0.00021753317380900588
33891;插画家没前途的，趁年轻赶紧学点别的吧我已经打算放弃插画了，按这个劲头，只要有厂子做出先例，不到一年，80的cg画师都可以被替代，剩下20全是用来给ai图补充细节，说真的，就算去干服务员也比画插画赚的多，目前来看，ai触及不到的艺术创作领域就是写文和剧本，趁年轻转行去当漫画家和游戏策划吧;17;22;39;18388;0.002120948444637807
33910;对于我这种在学画画的小白，其实ai没什么好说的。我画画的初衷其实就是画出好看美丽的图案，后面慢慢的被软妹币，被不被市场需要这种的事情取代。看开点，普通人卷的过ai？某些问题上越想越焦虑，摆摆烂心情还更好，做好最坏的打算，会快乐很多;2;2;4;18388;0.00021753317380900588
33914;有一说一舟里舟气的;1;2;3;18388;0.0001631498803567544
33916;之前说ai没有构图的，现在这种情况该怎么说啊，还以为要更久，结果还是保守了，这种进化速度;13;9;22;18388;0.0011964324559495323
33931;我认为，反对ai就如同反对蒸汽火车的马车夫，ai毫无疑问正是下个时代的核心所在。;1;5;6;18388;0.0003262997607135088
33942;挺好的，个人想要做点小作品，可以用ai写剧情，ai画立绘，自己学点基本技能润色一下就好了。希望以后能生成角色的原设，用户调整，然后通过原设生成其他图片以保持设定一致。然后能生成多角色互动的图，这样创作会变得简单很多;1;3;4;18388;0.00021753317380900588
33960;呵呵拼贴别人图而已，有的还好意思说自己画手，几个词条输入。是个人稍微学学就能弄这玩意儿。;1;1;2;18388;0.00010876658690450294
33974;令人无语;1;0;1;18388;5.438329345225147e-05
33984;如果以后AI能把2D图转变为3D建模那到时后下岗的人会不会更多;1;0;1;18388;5.438329345225147e-05
34010;为什么这画风很眼熟捏微笑难道画师都是参考这个画的吗笑;2;0;2;18388;0.00010876658690450294
34021;ai是人类未来;2;0;2;18388;0.00010876658690450294
34040;up出的都是设计图，还有人在自我催眠ai细节不行，真的难绷，连i2i的转换放大都没用过就开始写小作文预言未来是真的有乐子;1;0;1;18388;5.438329345225147e-05
34047;只要缝得够多就不算抄袭，其实你自己画也基本是这样，但肯定比不过电脑;1;0;1;18388;5.438329345225147e-05
34056;正好拿来练这画速写，人体大部分没问题妙啊;2;0;2;18388;0.00010876658690450294
34073;所以有无人科普一下这东西是是什么原理，是单纯缝合还是ai真的会画画;10;0;10;18388;0.0005438329345225147
34085;少女先到西边裙摆铺满整个北亚她在东方有了一位学生后来少女离开了剩下了东方的学生东方的学生用忧郁的眼神望着西方好像在回忆什么打call;48;2649;2697;18388;0.1466717424407222
34134;英国AIBV1FM4y1D7bL波兰AIBV1k24y1W7Jp德三AIBV1rv4y1x72b;2;205;207;18388;0.011257341744616053
34137;看到一半开始不屑，快要结束时重新审视，我原以为偏题了，原来一直没有偏过doge;1;1041;1042;18388;0.05666739177724603
34139;人物由左走向了右;29;1058;1087;18388;0.05911463998259735
34169;她逐渐迷茫，眼神空洞，身上的衣服也逐渐变黑预加的厚重，逐渐的她厌倦了也知道自己要走了，开始用厌恶的眼神看待世间一切，自暴自弃，突然他想起了曾经的另一个小女孩，她看见了她，她知道自己曾经对这个小女孩做了一些过分的事，所以并没向前找她道别，只是眼中重新有了光与依恋并说道：接下来的事就靠你了。保卫萝卜哭哭保卫萝卜哭哭保卫萝卜哭哭;7;466;473;18388;0.025723297802914945
34177;她看向远方，看着没有她的世界，她又看向我们，我们却看不见她，她站在原地，看着自己没有完成的梦想遗憾在心，又看了一眼，她看着她之前的学生，看着她背负的红色，她明白，有人替她承担下去，她明白，她的精神已经铭记的人民的心中，她放下心来，慢慢的向外走去，慢慢的，慢慢的，走向那个梦境之中再见，老大哥;6;277;283;18388;0.015390472046987165
34184;他们的结局在发动苏芬战争的时候就已经注定了，到了后期，是值得被唾弃的国家;39;869;908;18388;0.049380030454644334
34224;淡粉色头发的女孩，身披红衣，在微风吹拂的花田中对你笑着。“果然，那个时代，就像这女孩一样，隐匿在花海中了”;4;147;151;18388;0.008211877311289972
34234;我们将接过苏联的接力棒，我坚信，有一天，红旗终会满天下虽然苏联不在了，但精神永存;16;53;69;18388;0.003752447248205351
34251;怎么感觉开头的红色变成人形的过程好像马克思主义由理论转向实践的过程;1;36;37;18388;0.002012181857733304
34253;这版图是苏俄？;9;232;241;18388;0.013106373721992604
34263;作者能把野兽先辈的图给A画吗doge;1;54;55;18388;0.002991081139873831
34266;冈易;3;30;33;18388;0.0017946486839242985
34271;新视频，是可爱的波兰娘，BV1k24y1W7Jp;2;44;46;18388;0.0025016314988035677
34274;她披着红旗，遥望着曾经的自己。当年的她笑的是那么的灿烂。她释然的笑着化作了一抹红。是南昌的城头。是东京的火。是走遍安地斯山脉的那个人。是朝鲜三八线上的坚守。是风雪里的《至，苏维埃》;1;29;30;18388;0.001631498803567544
34277;碎成一地了;3;124;127;18388;0.006906678268435936
34282;不管怎么重复，她身上的红色元素始终没有消失;5;15;20;18388;0.0010876658690450293
34289;本来挺喜欢苏维埃的doge;1;12;13;18388;0.0007069828148792691
34292;对不起啊，苏苏，今天晚上就拜托你了doge;4;43;47;18388;0.0025560147922558192
34300;少女名为“喀秋莎”;2;35;37;18388;0.002012181857733304
34304;，好像下红才是波兰吧doge;1;7;8;18388;0.00043506634761801175
34306;怎么画里的人从左向右转了啊惊喜;4;29;33;18388;0.0017946486839242985
34311;ai这么厉害的吗那还要日韩风格的画师干什么。。。。毕竟反正都是根据需求画画，AI画画不一定厉害但一定稳定。;3;10;13;18388;0.0007069828148792691
34315;AI是这样的，无论你给他什么东西，最后都会变成人形笑哭;1;6;7;18388;0.0003806830541657603
34317;那一抹红色从未消失;3;24;27;18388;0.0014683489232107897
34322;红色越画越少，白色越画越多;3;19;22;18388;0.0011964324559495323
34327;感觉这张最涩doge;1;5;6;18388;0.0003262997607135088
34330;本文运用了不知道是啥的修辞手法，生动形象的写出了“红色”的变迁史;2;24;26;18388;0.0014139656297585382
34333;为什么看这么多ai画到最后都会卡通化笑哭笑哭;2;19;21;18388;0.0011420491624972808
34338;妈耶，在坐的各位阅读理解都是满分的吧笑哭;1;12;13;18388;0.0007069828148792691
34342;我知道谁敢撅，小日子敢doge;1;10;11;18388;0.0005982162279747662
34345;0021甚至有架飞机，这是她对未来的期望吧;6;43;49;18388;0.002664781379160322
34352;可以说啥都能被ai变成女的了。。。;3;4;7;18388;0.0003806830541657603
34356;不是，我这苏联怎么就变成妹子了？;2;4;6;18388;0.0003262997607135088
34359;现在就没有一个AI绘画不变美少女的笑哭;2;4;6;18388;0.0003262997607135088
34363;现在就没有一个AI绘画不变美少女的;2;4;6;18388;0.0003262997607135088
34386;为啥AI只会画二次元女生;3;2;5;18388;0.00027191646726125733
34427;波斯卡，波斯卡，Im波斯卡;1;1;2;18388;0.00010876658690450294
34438;恶魔;7;3;10;18388;0.0005438329345225147
34446;省流苏联版图变成了苏联国旗;1;1;2;18388;0.00010876658690450294
34469;机器工具人识别歌曲;1;0;1;18388;5.438329345225147e-05
34493;这是苏修的旗;1;0;1;18388;5.438329345225147e-05
34502;0011;1;0;1;18388;5.438329345225147e-05
34522;内心毫无波兰;1;0;1;18388;5.438329345225147e-05
34527;啊666，不知道为什么，世界都女性化了;1;0;1;18388;5.438329345225147e-05
34530;前期画成俄罗斯了思考;2;0;2;18388;0.00010876658690450294
34535;素联就是个笑话;3;0;3;18388;0.0001631498803567544
34560;那你怎么还骂霓虹;1;0;1;18388;5.438329345225147e-05
34564;雅科夫米哈伊诺维奇斯维尔德洛夫也是苏俄领导人，只不过名字觉得陌生;3;0;3;18388;0.0001631498803567544
34577;戒指呢，没戒指我只会被冻成冰棍;14;974;988;18388;0.05373069393082445
34592;我看到有一个弹幕说比大多的画手好太多了，我想问一下没有那些画手上传画到网络上，AI哪来的数据去统计解析然后成画？AI绘画不就是把网络上的数据合成吗？捂脸;55;263;318;18388;0.017293887317815965
34648;图包看这里链接：httpspanbaiducoms1er85VdG3P9MInUNcFtXBKwpwdk25m提取码：k25m来自百度网盘超级会员V4的分享;1;7;8;18388;0.00043506634761801175
34650;鲷啊，图要是能是4k分辨率就好了藏狐4k显示器看1080p实在有点糊;17;418;435;18388;0.02365673265172939
34668;我记得之前有个gif是快递拆开是个少女，然后被男主调教成工具脱单doge;7;38;45;18388;0.002447248205351316
34676;第一次惊艳于AI图的质量就是看到up主的孤独摇滚系列图，以前一直觉得AI图非常粗制滥造的。很厉害。不过，为什么来自璃月的快递里面全是稻妻人啊hh;1;19;20;18388;0.0010876658690450293
34678;这个画的其实不是太像雪女太太，倒像是她和男主生的娃吃瓜;1;38;39;18388;0.002120948444637807
34680;雪女太太实在没钱吃饭了所以把自己邮寄到我家了，没关系，我家还蛮大的doge;8;251;259;18388;0.01408527300413313
34689;你的更新速度就像甄子丹穿丝袜，贼只因儿快doge，我下一步就要枸杞当饭吃了;1;87;88;18388;0.004785729823798129
34692;怎么看都好看，但为什么就是不觉的色;5;21;26;18388;0.0014139656297585382
34699;为什么破站会有这种东西，难道大家都变了？这种东西居然可以上传出来，真的是无语了，满脑子天天都是美女难道你们心中没有点别的么？这种东西真的那么好看？一个源头传播到现在都有不同版本，这东西有这么好看？我不信，除非发给我一份让我也看看脱单doge脱单dogedoge;2;33;35;18388;0.0019034152708288013
34704;雪女是什么意思;5;3;8;18388;0.00043506634761801175
34710;这是橘子蜡笔的效果吗？脱单doge;1;5;6;18388;0.0003262997607135088
34715;这里版的可真棒啊要是多一点再加点触手就更好了doge;1;6;7;18388;0.0003806830541657603
34729;大佬请问怎么让画生成的时候是从模糊到清晰啊我的都是空白只有100了才会出图贝拉个性装扮20委屈小贝拉;1;2;3;18388;0.0001631498803567544
34732;话说咱这边真寄个活人会怎样我问个蠢问题笑哭;1;1;2;18388;0.00010876658690450294
34742;雪女的后集感觉不好看，没前部分有意思;1;1;2;18388;0.00010876658690450294
34744;笑死，说比大多画师要好。相当于说照片比很多美术生写生的要像。;1;2;3;18388;0.0001631498803567544
34747;MaverickFPV嗑瓜子;1;1;2;18388;0.00010876658690450294
34752;扭曲的手指和意义不明的构图，AI终究是AI吃瓜;7;2;9;18388;0.0004894496410702633
34768;bgm真好听，有人知道叫什么吗;2;0;2;18388;0.00010876658690450294
34774;这让我想起一个韩漫滑稽;2;1;3;18388;0.0001631498803567544
34777;BGM是钟国的黑猫吗？doge;1;5;6;18388;0.0003262997607135088
34779;308012g显存能玩吗喜欢;1;0;1;18388;5.438329345225147e-05
34784;在哪搜索？;1;1;2;18388;0.00010876658690450294
34809;其实还是不要里版的啦;1;1;2;18388;0.00010876658690450294
34815;不知道为什么，看到最后雪女舍弃前夫的戒指莫名觉得很难受难过;11;56;67;18388;0.0036436806613008486
34829;胸怀大志者得天下也doge;3;28;31;18388;0.0016858820970197955
34833;包呐？愣着干嘛你倒是下包呀敌人都压到B点了，你还不下包。爱心下包了记得踢我一下，我挂会儿机，上个厕所。吃瓜;1;12;13;18388;0.0007069828148792691
34835;三连了，求图包tvdoge;1;2;3;18388;0.0001631498803567544
34837;点赞送你上首页，求图包;1;2;3;18388;0.0001631498803567544
34839;求图包热词系列恭喜发财;1;1;2;18388;0.00010876658690450294
34841;求图包脱单doge;1;1;2;18388;0.00010876658690450294
34843;已三连doge来个图;1;1;2;18388;0.00010876658690450294
34845;求图;1;1;2;18388;0.00010876658690450294
34848;想要图，这图大吗;1;1;2;18388;0.00010876658690450294
34850;三连，图包，谢谢好人;5;1;6;18388;0.0003262997607135088
34856;首页推荐，up主牛逼了，希望来个完整的图包星星眼，比个心;1;1;2;18388;0.00010876658690450294
34858;已三连;1;0;1;18388;5.438329345225147e-05
34860;为什么我之前看的她们好穷，思考都没钱买衣服;2;0;2;18388;0.00010876658690450294
34864;求图包呀;1;0;1;18388;5.438329345225147e-05
34866;求图包，已三连;1;0;1;18388;5.438329345225147e-05
34868;来图;1;0;1;18388;5.438329345225147e-05
34870;已三连求图包doge;1;0;1;18388;5.438329345225147e-05
34872;都下雨了，衣服还不湿doge;2;0;2;18388;0.00010876658690450294
34875;滴滴滴，已三连，求图包tv流鼻血;2;0;2;18388;0.00010876658690450294
34878;已三连，求图包;1;0;1;18388;5.438329345225147e-05
34881;一键三连，求图包脱单doge;1;0;1;18388;5.438329345225147e-05
34883;求图包。求图包;1;0;1;18388;5.438329345225147e-05
34885;求图包;1;0;1;18388;5.438329345225147e-05
34887;三连求图包;1;0;1;18388;5.438329345225147e-05
34889;该更新了脱单doge脱单doge脱单doge;2;0;2;18388;0.00010876658690450294
34893;求图包，谢谢;1;0;1;18388;5.438329345225147e-05
34895;三连等包;1;0;1;18388;5.438329345225147e-05
34897;哎呀，我掉了一个三连。。。包。。。;1;0;1;18388;5.438329345225147e-05
34899;三连求图;1;0;1;18388;5.438329345225147e-05
34901;求图包脱单doge;4;0;4;18388;0.00021753317380900588
34906;三连了，可以给图包吗;1;0;1;18388;5.438329345225147e-05
34908;三连求图;1;0;1;18388;5.438329345225147e-05
34910;求图包。求图包;1;0;1;18388;5.438329345225147e-05
34912;求图包支持;1;0;1;18388;5.438329345225147e-05
34914;求包;1;0;1;18388;5.438329345225147e-05
34916;求图包脱单doge;1;0;1;18388;5.438329345225147e-05
34918;已三连，求图包;1;0;1;18388;5.438329345225147e-05
34920;求包;1;0;1;18388;5.438329345225147e-05
34922;虽然我也可以练，但是求图doge;3;0;3;18388;0.0001631498803567544
34926;三连求图星星眼;1;0;1;18388;5.438329345225147e-05
34928;点赞投币啦，图包图包;1;0;1;18388;5.438329345225147e-05
34930;三连了求图思考;1;0;1;18388;5.438329345225147e-05
34932;三连求图包，感想UP;2;0;2;18388;0.00010876658690450294
34935;脱单doge已投币你懂我意思吧;1;0;1;18388;5.438329345225147e-05
34937;已三连，求图包;1;0;1;18388;5.438329345225147e-05
34939;点赞投币一气呵成（），图包交出来;1;0;1;18388;5.438329345225147e-05
34941;up，请问这种半透明白纱质感是什么tag实现的，顺便求一下图包脱单doge;2;0;2;18388;0.00010876658690450294
34944;求图包;2;0;2;18388;0.00010876658690450294
34947;有盘吗;2;0;2;18388;0.00010876658690450294
34950;三连了，图;4;0;4;18388;0.00021753317380900588
34955;已赞，图包，谢谢老板;3;0;3;18388;0.0001631498803567544
34959;求图星星眼星星眼星星眼;7;0;7;18388;0.0003806830541657603
34967;求图;4;0;4;18388;0.00021753317380900588
34972;三连关住了求图哥喜欢;1;0;1;18388;5.438329345225147e-05
34975;三连求包;1;0;1;18388;5.438329345225147e-05
34977;三连求图包;1;0;1;18388;5.438329345225147e-05
34979;已三连求图包脱单doge;1;0;1;18388;5.438329345225147e-05
34981;已3连求图包打call;3;0;3;18388;0.0001631498803567544
34985;求图包;1;0;1;18388;5.438329345225147e-05
34987;已三连求图包;2;0;2;18388;0.00010876658690450294
34990;老板求图;1;0;1;18388;5.438329345225147e-05
34992;想要制作图的ai关键词;1;0;1;18388;5.438329345225147e-05
34994;支持;1;0;1;18388;5.438329345225147e-05
34996;星星眼星星眼老板求图;1;0;1;18388;5.438329345225147e-05
34998;最近高产啊doge;3;0;3;18388;0.0001631498803567544
35002;已三连求图包;1;0;1;18388;5.438329345225147e-05
35004;有个小建议，下眼睑小一点，并且不要下垂，都是熬夜熬大熬垂的;1;0;1;18388;5.438329345225147e-05
35006;求横屏的;1;0;1;18388;5.438329345225147e-05
35008;求图包的合集;1;0;1;18388;5.438329345225147e-05
35010;三连求图星星眼;1;0;1;18388;5.438329345225147e-05
35012;三连送上，剩下的都是我的;1;0;1;18388;5.438329345225147e-05
35014;三连求图;1;0;1;18388;5.438329345225147e-05
35016;已三连，求图包;1;0;1;18388;5.438329345225147e-05
35018;wetdoge各种，求图哈哈;1;0;1;18388;5.438329345225147e-05
35020;点赞求图包;1;0;1;18388;5.438329345225147e-05
35022;已三连，谢谢哥。;1;0;1;18388;5.438329345225147e-05
35024;恭喜首页看见了dogedoge;5;0;5;18388;0.00027191646726125733
35030;已赞，送你上首页;3;0;3;18388;0.0001631498803567544
35034;已三连，up可以私发每日图包吗热词表情世萌双冠;2;0;2;18388;0.00010876658690450294
35037;这个下雨整得不错;1;0;1;18388;5.438329345225147e-05
35039;我凑，以后只要会画火柴人就能画美女了吗？doge;1;24;25;18388;0.0013595823363062867
35041;怎么做到生产写实画风的人啊，我不是卡通就是古神;4;13;17;18388;0.000924515988688275
35047;问一下可以生成不带脸部的嘛就是我如果想生成几张身材图片可以实现嘛;5;3;8;18388;0.00043506634761801175
35054;有张图有3只手doge;3;2;5;18388;0.00027191646726125733
35059;为什么我自己画涂鸦识别不出来，出来的是一张黑图，看来我的画技和大家不在同一个次元酸了;3;2;5;18388;0.00027191646726125733
35068;controlnet有手的openpose的模型在哪里找？普通的openpose没有手的骨骼。;1;1;2;18388;0.00010876658690450294
35072;我一直会写故事，但不会漫画，我以后能当漫画家么doge;1;0;1;18388;5.438329345225147e-05
35081;作者没画衣服啊，这ai怎么回事;1;0;1;18388;5.438329345225147e-05
35083;在哪下软件;1;0;1;18388;5.438329345225147e-05
35085;手太细，腿太粗。;1;0;1;18388;5.438329345225147e-05
35104;好像用了controlnet文生图，就没办法用hires;2;0;2;18388;0.00010876658690450294
35108;省流：;2;30;32;18388;0.001740265390472047
35111;新的贝克报看;1;5;6;18388;0.0003262997607135088
35121;做的不错。;1;0;1;18388;5.438329345225147e-05
35123;加油;1;0;1;18388;5.438329345225147e-05
35125;贝克TM是男的;1;0;1;18388;5.438329345225147e-05
35128;贝克怎么重整了？;1;0;1;18388;5.438329345225147e-05
35130;好好看;1;0;1;18388;5.438329345225147e-05
35133;喜欢你的视频;1;0;1;18388;5.438329345225147e-05
35135;加油;1;0;1;18388;5.438329345225147e-05
35137;作者做得太棒了;1;0;1;18388;5.438329345225147e-05
35139;共同特点，都看不到手doge;8;39;47;18388;0.0025560147922558192
35148;Ai进化的太牛批了;3;9;12;18388;0.0006525995214270176
35152;0131求tagdoge;1;7;8;18388;0.00043506634761801175
35154;别以为我不知道这是周淑怡doge;3;6;9;18388;0.0004894496410702633
35158;新的Lora模型出了吗，原来那个韩国网红脸看腻了吃瓜;1;2;3;18388;0.0001631498803567544
35160;头与颈部感觉违和，就好像换头一样p上去似的假;1;1;2;18388;0.00010876658690450294
35162;用啥软件嗑瓜子;1;1;2;18388;0.00010876658690450294
35164;想必你的显卡也跟我的显卡一样拉吧doge;2;1;3;18388;0.0001631498803567544
35167;有百du网盘吗;1;1;2;18388;0.00010876658690450294
35169;有群吗;1;1;2;18388;0.00010876658690450294
35171;请问为什么我的一直都是动漫角色啊大哭;1;0;1;18388;5.438329345225147e-05
35173;什么软件啊;2;0;2;18388;0.00010876658690450294
35176;这个是用啥生成的呀;1;0;1;18388;5.438329345225147e-05
35178;为什么up你出的图那么好看，我的就是一坨笑哭，真的是服了，是不是电脑配置低，出的图片就丑一些;1;0;1;18388;5.438329345225147e-05
35180;UP请请问下我用的都是真人TAGLORA模型也是为什么生成出来的不够真人啊;1;0;1;18388;5.438329345225147e-05
35182;有图包嘛;1;0;1;18388;5.438329345225147e-05
35185;为啥画不出真人效果啊，画出来都是二次元;1;0;1;18388;5.438329345225147e-05
35189;你小子，指定有些副业doge;1;0;1;18388;5.438329345225147e-05
35193;背景能用特定的吗;1;0;1;18388;5.438329345225147e-05
35195;用的是哪个模型啊dogedoge;3;0;3;18388;0.0001631498803567544
35200;是用novelai生成的吗？最近打算搞一个小程序，但是ai绘制的接口好难找。;6;0;6;18388;0.0003262997607135088
35207;有没有那种果感的啊doge;2;0;2;18388;0.00010876658690450294
35210;点赞，求链接;3;0;3;18388;0.0001631498803567544
35214;估计搞动画的每次看到这种标题得气死一次，可以说对动画一点帮助都没有。;13;384;397;18388;0.021590167500543832
35228;相机刚出来时，有一群人就说绘画已死，然而当普通人拿也起相机时，才发现自己拍照还是不如画家。呲牙;29;129;158;18388;0.008592560365455732
35258;这种生成视频连动作都没有，根本没有意义吃瓜;20;85;105;18388;0.005710245812486404
35279;我个人觉得，可以画无背景的图片，用优质的lora角色，配合control那个插件骨骼绘制，以达到想要的动作效果，然后再把动画背景单独绘制添加，最终达成较好的动画效果。所以AI应该能让动画制作节省不少时间和成本;1;64;65;18388;0.0035349140743963455
35281;有手就行算牛人，这是什么逻辑。所以那些说ai厉害的，并不是真认为ai厉害对吗，而是误把ai绘图当成自己的成果，产生幻觉了;5;48;53;18388;0.002882314552969328
35287;还国外牛人，微博转的吧星星眼星星眼，国外开始尝试训练比较稳定的模型配合实景拍摄做动画好久了，鉴定为纯纯的白齿;3;41;44;18388;0.0023928649118990647
35291;这也叫惊艳吗;19;38;57;18388;0.003099847726778334
35321;比较在意用的model和prompt，毕竟深色皮肤在常见模型里几乎是生成不出来的，哪怕是加入了针对性的描述也出不了类似的效果;2;1;3;18388;0.0001631498803567544
35329;一个画师三年的产出AI一天产出，真是不知道该如何评价。。;2;2;4;18388;0.00021753317380900588
35332;httpsb23tvBV1UY4y127Eb这里有正经的AI动画有些人只是不愿意承认罢了吃瓜;2;1;3;18388;0.0001631498803567544
35335;为什么有人喷，画得挺好嘛;2;0;2;18388;0.00010876658690450294
35351;关键是喂给ai的图都有版权么;19;11;30;18388;0.001631498803567544
35372;我教你怎么生成动画，pr视频导出序列帧，再把每张序列帧ai绘画，再导入prdoge;4;14;18;18388;0.0009788992821405265
35381;黑妹真不错;10;8;18;18388;0.0009788992821405265
35399;不够，还要再色点阴险;22;892;914;18388;0.04970633021535784
35422;人啊。。果然还是要穿着衣服才好看doge;14;529;543;18388;0.029530128344572547
35437;现在的AI技术发展的太恐怖了，跟AI聊天，结果我敢说，这货比99的女人都会撩异性，唠的我骨头都发酥。而且不是事先设定好那种，是真的会根据你说什么而改变自身发言结构的，要不是事先知道是AI，绝对以为是真人。不知道再发展几十年，AI是不是真的会产生自我意识，真的难以想象。;29;466;495;18388;0.026919730258864478
35467;太喜欢这种富有人妻味的毛衣了;2;268;270;18388;0.014683489232107896
35470;这太美了吧，太好看了，等我老死以后，我要穿越到二次元世界tv害羞;14;118;132;18388;0.007178594735697194
35485;胸太影响整体了吧;4;30;34;18388;0.00184903197737655
35492;既然可以这样，为什么不那样？热词系列妙啊;1;5;6;18388;0.0003262997607135088
35494;我14岁时补习班的同学有这种美貌，;1;2;3;18388;0.0001631498803567544
35500;拉着女朋友一起看，直接自动挡;1;10;11;18388;0.0005982162279747662
35504;怎么不是湿身doge;1;2;3;18388;0.0001631498803567544
35509;这是家妻，不好意思，给各位献丑了，望各位曹贼收敛一点，别觊觎吾妻美色，我两可恩爱了。脱单doge;5;56;61;18388;0.0033173809005873395
35518;感觉可以收点费，白嫖总是不好的。。。;8;2;10;18388;0.0005438329345225147
35527;这个脸型是怎么融合出来的啊星星眼UP可以分享一下吗;2;5;7;18388;0.0003806830541657603
35530;有漏的吗doge（越来越贪心了捂眼）;4;4;8;18388;0.00043506634761801175
35536;图包脱单doge;1;1;2;18388;0.00010876658690450294
35538;图包呢;1;1;2;18388;0.00010876658690450294
35540;图包呢吃瓜;2;1;3;18388;0.0001631498803567544
35543;评论区没有图包啊。。up主;2;1;3;18388;0.0001631498803567544
35546;1观看直接首页顶部刷到星星眼;1;2;3;18388;0.0001631498803567544
35558;BGM是什么？;1;0;1;18388;5.438329345225147e-05
35569;这不来图包？;1;0;1;18388;5.438329345225147e-05
35571;怎么全部解压失败啊？;3;0;3;18388;0.0001631498803567544
35594;求bgm，我记得是好像是泫雅的，因为曾经有过，但是忘记存哪里了;1;0;1;18388;5.438329345225147e-05
35596;这都是ai生成的;2;0;2;18388;0.00010876658690450294
35605;有毛衣模型链接了吗脱单doge;2;0;2;18388;0.00010876658690450294
35633;余酒笙丶阳耀宏親友;1;0;1;18388;5.438329345225147e-05
35647;三连求图;1;0;1;18388;5.438329345225147e-05
35655;已三连，求图;1;0;1;18388;5.438329345225147e-05
35668;bgm是什么诶;1;0;1;18388;5.438329345225147e-05
35677;打包加密上传网盘，直接上传很容易被河蟹;2;0;2;18388;0.00010876658690450294
35693;为啥没有帅哥doge;1;0;1;18388;5.438329345225147e-05
35699;省流：图喂过冯提莫、周淑怡、王冰冰妙啊;11;239;250;18388;0.013595823363062868
35711;我他妈无数图包，涵盖中日韩无数菩萨，人称找资源小王子，百度云，迅雷会员已开，两台电脑已备好，4070ti在路上，哪位好心人来教怎么跑模型，往死里喂图，出好东西立马分享doge;18;62;80;18388;0.004350663476180117
35730;如果ai有这个功能，我不敢想象它陷害一个明星是多么简单的事滑稽;11;38;49;18388;0.002664781379160322
35743;如果我三连能给权重文件吗吃瓜;2;15;17;18388;0.000924515988688275
35746;看过很多ai绘出来的，这一套狠狠地戳中了我保卫萝卜哇;1;9;10;18388;0.0005438329345225147
35748;这是绘画吗？真看不出跟真实照片有什么区别了;7;9;16;18388;0.0008701326952360235
35756;我发布了一篇笔记，快来看看吧;2;6;8;18388;0.00043506634761801175
35759;赣，现在技术这么厉害了吗？笑哭;2;5;7;18388;0.0003806830541657603
35762;不要质疑周姐的实力;1;3;4;18388;0.00021753317380900588
35769;都是半身的，能不能画些全身给心心;4;0;4;18388;0.00021753317380900588
35774;能出一期录屏教程吗想自己画但是无从下手;1;0;1;18388;5.438329345225147e-05
35779;小金鱼kimyve这不是你吗;1;0;1;18388;5.438329345225147e-05
35781;up大大有没有除百度云以外的链接，百度线限速太吓人了;1;0;1;18388;5.438329345225147e-05
35784;投币了，给个图包热词系列知识增加;1;0;1;18388;5.438329345225147e-05
35787;如果我三连可以给prompts吗星星眼;1;0;1;18388;5.438329345225147e-05
35789;求包;1;0;1;18388;5.438329345225147e-05
35793;这个好喜欢;1;0;1;18388;5.438329345225147e-05
35795;小金鱼kimyve;1;0;1;18388;5.438329345225147e-05
35797;已三连脱单doge;1;0;1;18388;5.438329345225147e-05
35800;woc这拟真度;1;0;1;18388;5.438329345225147e-05
35802;唉以后分不清真人还是ai了;1;0;1;18388;5.438329345225147e-05
35804;手还是画不好;2;0;2;18388;0.00010876658690450294
35807;有教程吗;2;0;2;18388;0.00010876658690450294
35814;已三连私信求包脱单doge;1;0;1;18388;5.438329345225147e-05
35816;求学习方法;1;0;1;18388;5.438329345225147e-05
35818;已经三连up求图;1;0;1;18388;5.438329345225147e-05
35820;求图已三连;3;0;3;18388;0.0001631498803567544
35824;求图;1;0;1;18388;5.438329345225147e-05
35826;三连求图;1;0;1;18388;5.438329345225147e-05
35828;三连求原图;1;0;1;18388;5.438329345225147e-05
35830;求图给心心;1;0;1;18388;5.438329345225147e-05
35832;不可能关注纯视频号的;1;0;1;18388;5.438329345225147e-05
35835;三连了，求图doge;1;0;1;18388;5.438329345225147e-05
35837;图;1;0;1;18388;5.438329345225147e-05
35839;求图包doge;1;0;1;18388;5.438329345225147e-05
35843;求图;1;0;1;18388;5.438329345225147e-05
35845;三连了，求图包微笑微笑微笑;1;0;1;18388;5.438329345225147e-05
35847;三连求私信图包脱单doge;1;0;1;18388;5.438329345225147e-05
35849;三连了，有prompt吗;1;0;1;18388;5.438329345225147e-05
35851;我三连换个提示词可以吗;1;0;1;18388;5.438329345225147e-05
35855;求图;1;0;1;18388;5.438329345225147e-05
35857;三连求图;1;0;1;18388;5.438329345225147e-05
35862;求图，拜谢;1;0;1;18388;5.438329345225147e-05
35864;求图包;1;0;1;18388;5.438329345225147e-05
35866;已三连脱单doge;1;0;1;18388;5.438329345225147e-05
35868;三连求图;1;0;1;18388;5.438329345225147e-05
35870;求图doge;2;0;2;18388;0.00010876658690450294
35873;三連求圖;1;0;1;18388;5.438329345225147e-05
35875;已三连，求转发吃瓜;1;0;1;18388;5.438329345225147e-05
35877;这个有用lora吗;1;0;1;18388;5.438329345225147e-05
35882;已三连求图谢谢;1;0;1;18388;5.438329345225147e-05
35884;三连求图;1;0;1;18388;5.438329345225147e-05
35886;已三连求图谢谢呲牙;1;0;1;18388;5.438329345225147e-05
35888;求图;3;0;3;18388;0.0001631498803567544
35892;求图卡，已三连;1;0;1;18388;5.438329345225147e-05
35894;求图;1;0;1;18388;5.438329345225147e-05
35896;三连求图;1;0;1;18388;5.438329345225147e-05
35898;已三连求图呲牙;1;0;1;18388;5.438329345225147e-05
35900;用的哪个模型？;1;0;1;18388;5.438329345225147e-05
35903;求图包;1;0;1;18388;5.438329345225147e-05
35905;求个图包;1;0;1;18388;5.438329345225147e-05
35908;三连求图包;1;0;1;18388;5.438329345225147e-05
35910;求图卡，滴;1;0;1;18388;5.438329345225147e-05
35912;三连求图，已关注;1;0;1;18388;5.438329345225147e-05
35914;狠狠的三连求up发图tv腼腆;1;0;1;18388;5.438329345225147e-05
35917;有点像小姜;1;0;1;18388;5.438329345225147e-05
35919;求图太爱了;1;0;1;18388;5.438329345225147e-05
35921;来个图包的老板;1;0;1;18388;5.438329345225147e-05
35923;求图包，点赞;1;0;1;18388;5.438329345225147e-05
35925;求up分享图包脱单doge;1;0;1;18388;5.438329345225147e-05
35927;三连求图;1;0;1;18388;5.438329345225147e-05
35929;已三连脱单doge;1;0;1;18388;5.438329345225147e-05
35932;图包安排吗？;1;0;1;18388;5.438329345225147e-05
35935;三连求图;1;0;1;18388;5.438329345225147e-05
35937;图呢？老弟歪嘴;2;0;2;18388;0.00010876658690450294
35942;第二张的手看着不对劲;1;0;1;18388;5.438329345225147e-05
35944;三连求图;1;0;1;18388;5.438329345225147e-05
35946;三连拿下tv点赞已私信;1;0;1;18388;5.438329345225147e-05
35948;有意思;1;0;1;18388;5.438329345225147e-05
35951;已三连求图;1;0;1;18388;5.438329345225147e-05
35953;已三连求;1;0;1;18388;5.438329345225147e-05
35955;已三连求图;1;0;1;18388;5.438329345225147e-05
35958;三连求图;1;0;1;18388;5.438329345225147e-05
35960;这这这真的不是真人么？;1;0;1;18388;5.438329345225147e-05
35962;求图大哭打call;1;0;1;18388;5.438329345225147e-05
35964;三连了我的图图呢贝拉kira笔芯;1;0;1;18388;5.438329345225147e-05
35967;三连求图;1;0;1;18388;5.438329345225147e-05
35969;三连，文件呢脱单doge脱单doge;1;0;1;18388;5.438329345225147e-05
35971;已三连dogedoge;1;0;1;18388;5.438329345225147e-05
35973;求图包脱单doge;1;0;1;18388;5.438329345225147e-05
35978;三连求图;1;0;1;18388;5.438329345225147e-05
35981;已三连;1;0;1;18388;5.438329345225147e-05
35983;点赞求图，大哭;1;0;1;18388;5.438329345225147e-05
35985;求原图;1;0;1;18388;5.438329345225147e-05
35987;三连求图;1;0;1;18388;5.438329345225147e-05
35989;求4K图;1;0;1;18388;5.438329345225147e-05
35991;三连求图谢谢;1;0;1;18388;5.438329345225147e-05
35994;三连了，给个图包吧脱单doge;1;0;1;18388;5.438329345225147e-05
35996;三连了doge;1;0;1;18388;5.438329345225147e-05
35998;星星眼求;1;0;1;18388;5.438329345225147e-05
36000;每日一看doge提高审美;1;0;1;18388;5.438329345225147e-05
36002;已三连，求图星星眼;1;0;1;18388;5.438329345225147e-05
36004;大佬求图藏狐;1;0;1;18388;5.438329345225147e-05
36006;求图;1;0;1;18388;5.438329345225147e-05
36008;三连了doge求图;1;0;1;18388;5.438329345225147e-05
36010;求图已三连;1;0;1;18388;5.438329345225147e-05
36012;已三连，牛爷爷我图图呢星星眼;1;0;1;18388;5.438329345225147e-05
36014;三连了;1;0;1;18388;5.438329345225147e-05
36016;已三连，求图;1;0;1;18388;5.438329345225147e-05
36018;求图已三连;1;0;1;18388;5.438329345225147e-05
36020;三连求图;1;0;1;18388;5.438329345225147e-05
36023;三连关注求图包给心心;1;0;1;18388;5.438329345225147e-05
36028;关注拿图doge;1;0;1;18388;5.438329345225147e-05
36030;笑哭不知道哪里设置有问题，我用亚洲人脸型模型，特么出来的图特么像亚裔的，有的图直接欧洲人了，不知道模型作者是不是拿来美国亚裔脸来训练的。;1;0;1;18388;5.438329345225147e-05
36032;三联了给图给图星星眼;1;0;1;18388;5.438329345225147e-05
36034;球球了，图片;4;0;4;18388;0.00021753317380900588
36039;三连求图星星眼;1;0;1;18388;5.438329345225147e-05
36042;打call;1;0;1;18388;5.438329345225147e-05
36044;三连等图脸红;1;0;1;18388;5.438329345225147e-05
36046;三连求图包;1;0;1;18388;5.438329345225147e-05
36048;UP主加油看好你噢;1;0;1;18388;5.438329345225147e-05
36050;请问用的哪一款软件啊;2;0;2;18388;0.00010876658690450294
36053;阿半？？？？;1;0;1;18388;5.438329345225147e-05
36055;AI马上就能取代服装设计师了doge;2;0;2;18388;0.00010876658690450294
36058;三连等图脸红;1;0;1;18388;5.438329345225147e-05
36060;三连求图;1;0;1;18388;5.438329345225147e-05
36062;三连求图;1;0;1;18388;5.438329345225147e-05
36064;已三连，求发;1;0;1;18388;5.438329345225147e-05
36066;厉害厉害呲牙呲牙呲牙;2;0;2;18388;0.00010876658690450294
36069;关注关注，拿图拿图星星眼;1;0;1;18388;5.438329345225147e-05
36071;已三连，求图星星眼;1;0;1;18388;5.438329345225147e-05
36073;已三连，大佬图吃瓜;1;0;1;18388;5.438329345225147e-05
36075;三连求图;1;0;1;18388;5.438329345225147e-05
36077;己三连，请发;1;0;1;18388;5.438329345225147e-05
36079;求包;1;0;1;18388;5.438329345225147e-05
36081;求图，三连doge;1;0;1;18388;5.438329345225147e-05
36083;等着看你下一个视频哦;1;0;1;18388;5.438329345225147e-05
36085;很棒诶;1;0;1;18388;5.438329345225147e-05
36087;大佬，来个图包。dogedogedogedoge;1;0;1;18388;5.438329345225147e-05
36089;老规矩，三连关注，图赶紧拿来。2233娘大笑;1;0;1;18388;5.438329345225147e-05
36091;来点真人风格的全身图;2;4;6;18388;0.0003262997607135088
36097;有链接的良心up必须素质三连;1;1;2;18388;0.00010876658690450294
36099;doge妙啊;6;1;7;18388;0.0003806830541657603
36108;大佬这个用的什么lora？审美棒极了;1;1;2;18388;0.00010876658690450294
36111;UP主加油看好你噢;1;1;2;18388;0.00010876658690450294
36113;3连给你;1;1;2;18388;0.00010876658690450294
36118;多发点，很喜欢打call打call;1;1;2;18388;0.00010876658690450294
36120;投币三连，加油更新吃瓜;1;1;2;18388;0.00010876658690450294
36125;把兄弟们当外人doge;1;0;1;18388;5.438329345225147e-05
36127;楼主是好人，天天发大财;1;0;1;18388;5.438329345225147e-05
36130;不想去网盘的就在这看看朦胧的美吧doge;15;323;338;18388;0.018381553186860997
36146;来了来了通过百度网盘分享的文件：23粉色系链接：httpspanbaiducoms1h9Z3kTJlO42zLb2NHcCluA提取码：c960复制这段内容打开百度网盘APP即可获取;49;149;198;18388;0.010767892103545791
36196;这么清纯的小姑娘，我只在播放器里见过;4;61;65;18388;0.0035349140743963455
36201;萝莉，是亚文化的珍贵结晶；萝莉，是可爱与萌的象征；萝莉，是女生最精华的年龄段的雏形；萝莉，是二次元送给人类的瑰宝；萝莉，是另一个次元的正义本身萝莉，永远的神萝莉是一颗青涩的果实，成熟了反而不好吃了萝莉是一个女孩子最美好的年华，那可爱而美丽的容颜，那稚嫩而动听的嗓音，那天真而纯洁的笑脸，那娇小而玲珑的身体，喜欢那生气时而微鼓起的脸颊，喜欢那害羞时而微红的俏脸，喜欢那得到礼物时露出的开心表情，都透露出深深地魔力，让人为这着迷的魔力。萝莉，是亚文的珍贵结晶；萝莉，是可爱与萌的象征；萝莉，是女生最精华的年龄段的雏形；萝莉，是二次元送给人类的瑰宝；萝莉，是另一个次元的正义本身萝莉，给了人类莫大的勇气和动力，她是盛开的花朵，她是高歌的鸟儿，她像是清晨绿草上的露珠，她像是世界上一切美好的事物，她是未来，她代表希望，她展露生命的美好，她代表神的奇迹。;2;41;43;18388;0.002338481618446813
36204;但凡娃娃这么真实，我就买一个了;9;37;46;18388;0.0025016314988035677
36214;我不想看图，我想买这样的娃娃星星眼;2;20;22;18388;0.0011964324559495323
36217;有没有人跟我一样看错了;1;11;12;18388;0.0006525995214270176
36219;拒绝幼态从我们广东做起傲娇;5;9;14;18388;0.0007613661083315206
36225;点进去截屏到QQ扫二维httpswwwbilibilicomaudioau2698891;2;8;10;18388;0.0005438329345225147
36230;拒绝幼态审美，从（河南河北，广东广西，湖南湖北，山东山西）做起;1;4;5;18388;0.00027191646726125733
36235;拒绝幼态审美，从广东做起;4;3;7;18388;0.0003806830541657603
36244;好看好看，没兴趣的，都有兴趣了吧;2;2;4;18388;0.00021753317380900588
36251;拒绝幼态从我们广西做起傲娇;2;2;4;18388;0.00021753317380900588
36257;这是把真照片二次元化吗，还是AI自动生成的？;2;2;4;18388;0.00021753317380900588
36267;你都给ai喂的啥素材？全是幼态的滑稽;1;1;2;18388;0.00010876658690450294
36289;不懂就问，为什么我的AI不能画写实风的画;1;0;1;18388;5.438329345225147e-05
36301;这个程序犯法了吧;1;0;1;18388;5.438329345225147e-05
36391;已拿，三连交易;1;0;1;18388;5.438329345225147e-05
36393;加油;1;0;1;18388;5.438329345225147e-05
36395;看个寂寞;1;0;1;18388;5.438329345225147e-05
36401;图包去哪了doge;1;0;1;18388;5.438329345225147e-05
36403;求分享;1;0;1;18388;5.438329345225147e-05
36405;有个大胆的想法各个省份的比基尼doge;46;1718;1764;18388;0.09593212964977159
36452;作为省流大家帮我点点赞吧打call北京005上海011天津017重庆023河北029山西035辽宁041吉林047黑龙江053江苏059浙江105安徽111福建117江西123山东129河南135河北141湖南147广东153海南159四川205贵州211云南217陕西223甘肃229青海235台湾241内蒙古247广西253西藏259宁夏305新疆311香港317澳门323;16;1385;1401;18388;0.07619099412660431
36469;按刻板印象来说内蒙没给画成半人马扛着羊跑我不是很认可思考;20;904;924;18388;0.05025016314988036
36490;“大”山东妙啊;45;612;657;18388;0.035729823798129216
36536;A画的这河南看起来一副赛博风，少了些农业大省的感觉;24;553;577;18388;0.031379160321949096
36561;有些挺形象的，有些感觉挺反差的，我就是河南的中国最具历史的省份文化的发源地，本以为是个挺端庄的妹子，结果给我来个赛博朋克doge;21;441;462;18388;0.02512508157494018
36583;我吉林为什么在东北三兄弟（划掉）东北三姐妹里也是看起来最小的一个啊tv生气，虽然挺可爱的tv流鼻血;31;290;321;18388;0.017457037198172723
36615;为什么我安徽是一副金毛败犬样啊是因为我安徽每次经济发展都是最慢的吗笑哭;17;283;300;18388;0.01631498803567544
36633;省流：旗袍与jk，夹杂少量赛博和泳装（自治区不是民族服也是旗袍我是没想到的doge）;12;158;170;18388;0.009245159886882749
36646;为什么河南一个农业大省和高考S级地图这么有科技感？（只是疑惑，没有别的意思。我是河南人）;6;122;128;18388;0.006961061561888188
36653;大部分还行，就是普通的美少女图片，有御姐有古风有萝莉，体现不大出省份特色，但是有几个省比如山东、贵州、青海画风比较离奇，很好奇up用的啥词条能让ai误解成这样笑哭;5;50;55;18388;0.002991081139873831
36660;这就是普通的二次元美少女画风啊，没看出来一点娘化的省份特典哦呼;3;19;22;18388;0.0011964324559495323
36664;白毛红瞳的四川，我四川人直接狂喜東雪蓮飞吻;8;166;174;18388;0.009462693060691755
36673;山东来了呲牙;1;101;102;18388;0.00554709593212965
36675;贵州人蚌埠住了笑哭;9;67;76;18388;0.004133130302371111
36685;蓝毛竟是我自己;6;47;53;18388;0.002882314552969328
36692;湖南太大了，越小越好吃瓜;8;72;80;18388;0.004350663476180117
36701;四川最有气质打call;1;33;34;18388;0.00184903197737655
36703;黑龙江穿这么少喜欢;4;30;34;18388;0.00184903197737655
36708;我爱你家doge;2;8;10;18388;0.0005438329345225147
36711;内蒙人来了，这金发紫眼顶啊妙啊;5;8;13;18388;0.0007069828148792691
36717;陕西完美符合我的xp白神遥骄傲;1;24;25;18388;0.0013595823363062867
36719;我们甘肃里兰州可是被黄河穿城而过，拟人图中心不得有黄河穿过？脱单doge;3;15;18;18388;0.0009788992821405265
36723;据我所知大部分河北人比较冷淡doge;7;17;24;18388;0.0013051990428540352
36734;作为青海人我看到青海的时候很是震惊啊。。。那个体型跟眼神真的吓到我了;3;15;18;18388;0.0009788992821405265
36740;为什么就只有天津在干饭;5;12;17;18388;0.000924515988688275
36746;神TM辽宁是贫瘠小妹妹，太逆天了喜极而泣;4;7;11;18388;0.0005982162279747662
36751;江西好朴素啊笑哭;1;7;8;18388;0.00043506634761801175
36753;山西为什么那么平啊初音未来吃惊;4;15;19;18388;0.0010332825755927778
36758;我嘞个，青海是因为三江源才那么大是吧，一堆大家闺秀里突然蹦出个野路子的感觉笑哭捂脸;2;16;18;18388;0.0009788992821405265
36761;安徽集合咯;1;7;8;18388;0.00043506634761801175
36763;广东的特征挺到位的呲牙呲牙饮早茶;2;7;9;18388;0.0004894496410702633
36766;河南居然是最炫的热词系列知识增加;1;7;8;18388;0.00043506634761801175
36768;我需要医生开导一下脱单doge;1;12;13;18388;0.0007069828148792691
36771;看个家乡AI图，看得昏了过去害羞;1;9;10;18388;0.0005438329345225147
36774;总感觉黑龙江罩着其他俩省doge;4;6;10;18388;0.0005438329345225147
36781;河北不是朵拉头我不是很认可小电视笑;5;6;11;18388;0.0005982162279747662
36788;河北写满了卷;14;6;20;18388;0.0010876658690450293
36804;我大甘肃好看星星眼;1;8;9;18388;0.0004894496410702633
36806;我说一下，江苏不应该有拟人，因为散装江苏doge;2;9;11;18388;0.0005982162279747662
36815;我司来浙江吃人的星星眼喜欢;6;11;17;18388;0.000924515988688275
36825;江苏请精确到市doge;2;4;6;18388;0.0003262997607135088
36828;天津的有点不对劲;1;4;5;18388;0.00027191646726125733
36835;不许你们对着我的家乡冲大哭;1;3;4;18388;0.00021753317380900588
36837;所以说ai不能代替人光看图看不出来各省特点你说她是谁就是谁都可以;1;3;4;18388;0.00021753317380900588
36841;我爱我家傲娇;2;3;5;18388;0.00027191646726125733
36846;江苏呢？;2;3;5;18388;0.00027191646726125733
36849;太牵强了，没有各省各区的特点啊，大多都是什么旗袍的，呵;2;4;6;18388;0.0003262997607135088
36855;我个人认为自治区应该是带上些少数民族聚居地的服饰特征的微笑;1;2;3;18388;0.0001631498803567544
36862;豆沙浆脱单doge;1;2;3;18388;0.0001631498803567544
36877;带内蒙古了好耶;2;2;4;18388;0.00021753317380900588
36880;请问能把图发一下吗？doge;2;2;4;18388;0.00021753317380900588
36888;因为太穷不得不以这种方式养孩子的母亲误;1;1;2;18388;0.00010876658690450294
36895;hhgyw由乃酱yunoIgasu兔本草SrEE;1;1;2;18388;0.00010876658690450294
36907;本以为陕西是个御，没想到是萝莉星星眼;1;1;2;18388;0.00010876658690450294
36927;我最爱吃胡建人doge;1;1;2;18388;0.00010876658690450294
36954;湖南太好看了保卫萝卜笔芯;1;1;2;18388;0.00010876658690450294
36957;我出生省还挺好看支持我四川南充生;1;1;2;18388;0.00010876658690450294
36966;黑龙江大姐姐我爱死你了星星眼星星眼等等穿这么少不会被冻坏吗qwq;1;1;2;18388;0.00010876658690450294
36988;安徽呢，你把安微tv发怒给吃了呀;1;0;1;18388;5.438329345225147e-05
37018;黑龙江不是穿破破烂烂的我不是很认可脱单doge;1;0;1;18388;5.438329345225147e-05
37027;安徽的我不认可;1;0;1;18388;5.438329345225147e-05
37059;还不如直接用各省的地图来构图;1;0;1;18388;5.438329345225147e-05
37063;你确定黑龙江穿成那样不会冻死，虽然有暖气但是只有室内有;1;0;1;18388;5.438329345225147e-05
37072;感觉没那味，没体现各个省份的特点。提几个我的看法吧，北京作为国之都，其旗袍，红色等能代表中国特色的要有，气质表现要大方优雅就像古代皇后一样，而现代都市上海则可以西装都市风气质傲气十足，安徽河南可为民国风气质温柔似水，浙江可汉服气质仙气浓郁，四川，成都可搭配竹子元素并且性格表现活泼搭点傲骄，东北三省呢冷主搭棉袄辅以锤子或扳手等可以代表工业的元素。新疆等少数民族多的省份更容易了直接用本族服装就行，贵州呢多山可在山元素做点功夫且气质要坚韧不屈。其他省份也都有各自的特点供其选择。;2;0;2;18388;0.00010876658690450294
37084;以什么为依据呢，感觉这些图放什么省份好像都差不多;1;0;1;18388;5.438329345225147e-05
37135;河南的我好爱脱单doge;1;0;1;18388;5.438329345225147e-05
37150;Mouvana;1;0;1;18388;5.438329345225147e-05
37186;让我看看河南的。震声）tv抓狂;1;0;1;18388;5.438329345225147e-05
37200;辽宁应该算是老大哥呀，为什么看起来这么小？本辽宁人不太满意，当然没有pen的意思啊就是提出意见;1;0;1;18388;5.438329345225147e-05
37208;想要图doge;1;0;1;18388;5.438329345225147e-05
37211;感觉有几个多少有点重复，不过总体不错答主能不能发个jpg，有的想拿来当头像了吃瓜;3;0;3;18388;0.0001631498803567544
37222;河北不应该是个乞丐形象;1;0;1;18388;5.438329345225147e-05
37250;完了我谁都喜欢哈哈哈;1;0;1;18388;5.438329345225147e-05
37274;我从小喝到大滑稽;2;0;2;18388;0.00010876658690450294
37289;AI绘画要有原始参照物的吧？这是以什么为参照物画出来的？不可能单凭“山西”两个字就能画吧？;1;0;1;18388;5.438329345225147e-05
37377;我喜欢辽宁的，或者吉林也挺不错。害羞;3;0;3;18388;0.0001631498803567544
37392;江苏因该13张图。dogedogedoge你用一张图代表江苏，你偷懒了;1;0;1;18388;5.438329345225147e-05
37405;？？？这是人吗？;1;0;1;18388;5.438329345225147e-05
37431;我超，山东大姐姐;1;0;1;18388;5.438329345225147e-05
37451;大佬求图;2;0;2;18388;0.00010876658690450294
37466;为什么北京是一身黄啊哈哈哈哈;4;0;4;18388;0.00021753317380900588
37477;可以麻烦up帮我们学校校徽娘化一下吗星星眼;1;0;1;18388;5.438329345225147e-05
37482;这技术以后发展视频应该可以吧？视频整出来语音也可以吧？vr不是搞出来吗？在等等几十年那岂不是在家就能创作有意思的东西？;5;94;99;18388;0.0053839460517728956
37488;我生成的脱单doge;13;84;97;18388;0.0052751794648683925
37502;个人认为，第三个视频的风格更让人赏心悦目dogedoge;5;45;50;18388;0.0027191646726125733
37508;AI绘图的尽头是周姐辣眼睛;7;29;36;18388;0.001957798564281053
37516;有这技术给兄弟们看这些？;1;16;17;18388;0.000924515988688275
37518;求模型集，好像不是lora;4;10;14;18388;0.0007613661083315206
37523;因为你妈会说对面要不是瞎子怎么会找你;1;7;8;18388;0.00043506634761801175
37525;我自己生成的，比较满意的几张。;2;6;8;18388;0.00043506634761801175
37528;都是大众脸，看多了真没意思笑哭希望能搞点有特色的，有韵味的;1;5;6;18388;0.0003262997607135088
37530;ai画看得多了审美都比原来高一个档次;1;3;4;18388;0.00021753317380900588
37532;我有预感ai皮套人要来当爱豆了dogedogedoge;1;3;4;18388;0.00021753317380900588
37536;up这个不太行啊，很容易看出来是ai;1;2;3;18388;0.0001631498803567544
37552;看了好多AI笑哭为什么都这么像这位韩国网红;2;0;2;18388;0.00010876658690450294
37559;能用ai做出视频吗？;2;0;2;18388;0.00010876658690450294
37562;要是能吸，我都能打醉奶拳呲牙;1;0;1;18388;5.438329345225147e-05
37571;我只需要各图tag即可有没有tag参数分享;1;0;1;18388;5.438329345225147e-05
37584;看着眼熟啊疑惑;2;0;2;18388;0.00010876658690450294
37587;我已经不敢想象，如果某一天，人们能够驾驭ai轻松画出这么精美的图像，并且可以精确表达人物的肢体动作和表情，艺术将借助ai的力量向上拔高一大节，兴奋起来了星星眼;64;949;1013;18388;0.055090276267130735
37652;ai设定了美的标准，所以有点千篇一律。脸型，鼻型，眼睛大小，唇形，以及美白光亮度等都非常统一。实际美女的美，不应该是统一风格的。有的可爱玲珑，有的端庄秀气，有的雍容华贵。美的各有特色才是真的美。而不是有这么一个标准，越靠近这个标准就越美。;33;489;522;18388;0.028388079182075268
37686;原来我不是对3D无感，只是没看到喜欢的大哭;6;245;251;18388;0.013650206656515118
37693;就不能让ai画手;12;155;167;18388;0.009082010006525995
37706;太漂亮啦，就是不知道有没有年龄加强版;10;126;136;18388;0.0073961279095062
37717;比绝大部分的人工画好多了，只是有一些细节不完美。;7;58;65;18388;0.0035349140743963455
37725;下次别戴耳环了，古风加蓝牙耳机试一试。脱单doge;2;40;42;18388;0.0022840983249945617
37728;程序员：AI一定会帮助人类文明走向更加光明的未来未来的AI：画本子ing;7;209;216;18388;0.011746791385686317
37736;这个图直接拿去交页游商稿没问题的。;22;38;60;18388;0.003262997607135088
37759;xiaoli国风这个模型真的强，简简单单就能润一个好看的图;1;30;31;18388;0.0016858820970197955
37761;每一个拿出去都能打9分以上，倾城倾国，可惜好像脸型差不多，都偏娇小萝莉那种感觉。小孩子才做选择，我全都要来当老婆;4;89;93;18388;0.0050576462910593865
37766;吃瓜别的不说这进化速度未来要失业的人可能真不少（当然顶级高手永不会失业只是大众就）;5;27;32;18388;0.001740265390472047
37772;很好，符合华夏审美，媚而不俗，俏丽灵动;6;69;75;18388;0.00407874700891886
37779;好看，但都是同一张脸，看完记不住;2;15;17;18388;0.000924515988688275
37782;还有美人吗？多发些养眼。;2;9;11;18388;0.0005982162279747662
37785;除了神情过于坚硬，找不到什么缺点。表情太单调了，要是表情能丰富起来，喜怒哀乐，带点点情绪那将是绝杀。;1;16;17;18388;0.000924515988688275
37787;符合我看小说时的女主想象;1;16;17;18388;0.000924515988688275
37789;ai已经进化到这步了好美;1;9;10;18388;0.0005438329345225147
37791;都送山上来吧大笑;1;6;7;18388;0.0003806830541657603
37794;图包来啦原图和加强版，还有竖版20链接：httpspanbaiducoms1gJUIjAr4i7fw8qM7dwFXAgpwdah34提取码：ah34点赞三连支持一下吧给心心给心心给心心;56;282;338;18388;0.018381553186860997
37851;图包在这里原图和分辨率加强图，还有竖版20使用NovelAI绘画模型来自小李xiaolxl夸克网盘链接：httpspanquarkcnsb04474b2212f百度网盘链接：httpspanbaiducoms1gJUIjAr4i7fw8qM7dwFXAgpwdah34点赞三连支持一下吧给心心给心心给心心;27;108;135;18388;0.007341744616053948
37879;ai现在不止偷贴画了。模型渲染图也开始偷了吃瓜。;1;5;6;18388;0.0003262997607135088
37881;基本都一个表情一个脸型画出型对现在的ai来说已经非常简单了，但表情这种东西还是很困难啊;3;10;13;18388;0.0007069828148792691
37885;我现在非常肯定人工智能肯定会让原画师下岗的，以后的人工智能，可以自己画漫画，自己设计人物，甚至可以参与动画的制做，半年前。我很难想象人工智能可以设计，这么漂亮精美的人物，但是现在人工智能做到了，就这个水平，我相信大多数的美术生做不到;10;10;20;18388;0.0010876658690450293
37896;曾经的ai天网将接管这个世界。现在的ai给我关键词，什么涩图我都能画。;2;80;82;18388;0.00445943006308462
37899;有被经验到是我刚换的显示器质量太好了吗;1;4;5;18388;0.00027191646726125733
37901;双手打字，已证清白;1;4;5;18388;0.00027191646726125733
37903;眼鏡娘好棒;1;4;5;18388;0.00027191646726125733
37905;感谢大佬让我发现这个模型，返图脱单doge;20;49;69;18388;0.003752447248205351
37926;图还没拿，币先投，等用电脑再拿。微笑微笑微笑;4;4;8;18388;0.00043506634761801175
37931;不用进群就有图，给你两个圆圆的东西;1;39;40;18388;0.0021753317380900587
37933;每一张都是壁纸;1;4;5;18388;0.00027191646726125733
37935;心好痛大哭宝宝苦学绘画，如今却不及AI三分我要这数位板有何用？;4;14;18;18388;0.0009788992821405265
37940;很好多看几遍晚上做梦就有素材了脸红;3;18;21;18388;0.0011420491624972808
37944;请问是什么模型doge;1;4;5;18388;0.00027191646726125733
37946;涩涩才是世界第一动力拜年纪2022摸鱼;1;12;13;18388;0.0007069828148792691
37949;AI审美很幼，拒绝幼态审美，从你他开始，从Ai开始;4;11;15;18388;0.000815749401783772
37954;壁纸软件上有动态的嘛银杏鎏金记住了银杏鎏金巅峰;2;5;7;18388;0.0003806830541657603
37957;很好看，希望出半身1080P喜欢;1;10;11;18388;0.0005982162279747662
37959;好看归好看，但总觉得少点什么;2;6;8;18388;0.00043506634761801175
37963;md，真好看啊奥比岛喜欢;1;3;4;18388;0.00021753317380900588
37965;既然这技术，，可不可以。。。;4;6;10;18388;0.0005438329345225147
37970;一模一样吃瓜;1;6;7;18388;0.0003806830541657603
37972;古风加眼镜有些奇怪;1;3;4;18388;0.00021753317380900588
37974;去年连都刻画不好，今年已经爆了;1;3;4;18388;0.00021753317380900588
37976;几十年前的科学家永远也想不到doge，自己奠定的ai，以后会被人们拿来涩涩，太艹了滑稽;1;22;23;18388;0.0012508157494017839
37978;画风非常喜欢;1;3;4;18388;0.00021753317380900588
37980;dogeai是不是就一个脸模;1;5;6;18388;0.0003262997607135088
37982;这期真是高质量脱单doge;3;5;8;18388;0.00043506634761801175
37988;推上有个和这个脸有些相似，搜莉犬doge;3;5;8;18388;0.00043506634761801175
37992;现实中有就好了doge;1;2;3;18388;0.0001631498803567544
37994;我有个大胆的想法;1;2;3;18388;0.0001631498803567544
37996;多整点眼镜娘，硬币大大的有tv点赞;1;5;6;18388;0.0003262997607135088
37998;？酱紫偷懒，不换表情tag的？？？傲娇;1;2;3;18388;0.0001631498803567544
38000;妖孽，我要你助我修行给心心给心心给心心;1;5;6;18388;0.0003262997607135088
38002;牛逼三连了;1;2;3;18388;0.0001631498803567544
38004;好康;1;2;3;18388;0.0001631498803567544
38006;曹贼都给我出来点赞脱单doge;1;2;3;18388;0.0001631498803567544
38008;关注了小电视赞;1;2;3;18388;0.0001631498803567544
38010;请问能临摹吗兔年;3;2;5;18388;0.00027191646726125733
38014;有这好事必须三连了;1;2;3;18388;0.0001631498803567544
38016;这模型在我手上跑全身跑的有点恐怖辣眼睛;1;2;3;18388;0.0001631498803567544
38018;美若天仙打call;1;2;3;18388;0.0001631498803567544
38020;全身照呢？doge;2;2;4;18388;0.00021753317380900588
38023;给三连了;1;2;3;18388;0.0001631498803567544
38025;好美吃瓜;1;2;3;18388;0.0001631498803567544
38029;ai真是魔鬼，绝色也不过如此了吧;3;3;6;18388;0.0003262997607135088
38033;咋都是同一张脸，审美是不是太单一了点？思考;2;3;5;18388;0.00027191646726125733
38052;兄弟们，这些照片都是up，是本人，快去充up;1;1;2;18388;0.00010876658690450294
38054;求tga给心心;1;1;2;18388;0.00010876658690450294
38056;绝了啊;1;1;2;18388;0.00010876658690450294
38058;初看很惊艳，但看久了感觉没有灵魂，总是差点意思思考;2;1;3;18388;0.0001631498803567544
38061;眼镜系列还有其他吗？;1;1;2;18388;0.00010876658690450294
38063;感觉眼睛再小一点会更好看;7;1;8;18388;0.00043506634761801175
38071;这种看多了再看现实生活中的女性真的是失去知觉了，ai技术赶紧发展吧，几十年后说不定能买到会动的娃娃;4;1;5;18388;0.00027191646726125733
38076;呲牙;1;1;2;18388;0.00010876658690450294
38078;我有个大胆的想法滑稽;1;1;2;18388;0.00010876658690450294
38080;md随便拿去一个给萧薰儿不香嘛tv斜眼笑;1;1;2;18388;0.00010876658690450294
38082;帅哥呢;3;1;4;18388;0.00021753317380900588
38086;三个币;1;1;2;18388;0.00010876658690450294
38088;我滴个妈太好看了绝了;1;1;2;18388;0.00010876658690450294
38090;好支持;1;1;2;18388;0.00010876658690450294
38092;有这技术;1;1;2;18388;0.00010876658690450294
38094;第一张最好看了热词系列妙啊眼镜美人;1;1;2;18388;0.00010876658690450294
38096;现在的插画也很唯美;1;1;2;18388;0.00010876658690450294
38098;投币了质量不错;1;1;2;18388;0.00010876658690450294
38100;三连了;1;1;2;18388;0.00010876658690450294
38102;古风大姐姐们，啊啊啊超喜欢，都好美太可了;1;1;2;18388;0.00010876658690450294
38104;好美，她真的像人脱单doge;1;1;2;18388;0.00010876658690450294
38106;看美女不为别的，就是为了心情愉悦脱单doge脱单doge;1;1;2;18388;0.00010876658690450294
38108;栩栩如生;1;1;2;18388;0.00010876658690450294
38110;我的壁纸一直是电脑自带蓝图，不是我不想换个好看的，是没发现这里有好康的脱单doge;1;1;2;18388;0.00010876658690450294
38112;哇，是美女姐姐，我好喜欢。保卫萝卜哇;1;1;2;18388;0.00010876658690450294
38114;doge幸好我早早就不画头像了，我就知道这玩意简单又没啥用doge;3;1;4;18388;0.00021753317380900588
38118;doge不错不错;1;1;2;18388;0.00010876658690450294
38120;我很喜欢眼镜，和up主很对头tvdoge;1;1;2;18388;0.00010876658690450294
38122;你小子指定有点主业doge这里只是副业确信滑稽;1;1;2;18388;0.00010876658690450294
38124;好看，有没有帅哥建模;1;1;2;18388;0.00010876658690450294
38126;这技术大哥你是知道我的我从来不满足于当下doge;1;1;2;18388;0.00010876658690450294
38128;确实好看;1;1;2;18388;0.00010876658690450294
38130;这样的老婆在哪里找;1;1;2;18388;0.00010876658690450294
38132;牛的牛的牛的;1;1;2;18388;0.00010876658690450294
38134;dogedoge还是你懂我们;1;1;2;18388;0.00010876658690450294
38136;找不同doge;1;1;2;18388;0.00010876658690450294
38138;可惜没办法从屏幕里跳出来，不然我的寿命撑不过三天脱单doge;1;1;2;18388;0.00010876658690450294
38140;热词系列妙啊;1;1;2;18388;0.00010876658690450294
38142;带水印啊，有人盗图;2;1;3;18388;0.0001631498803567544
38145;我什么时候能画成这样呢酸了;1;1;2;18388;0.00010876658690450294
38147;全身只有上半身就不是很美好;7;1;8;18388;0.00043506634761801175
38155;快画瑟图去doge;1;1;2;18388;0.00010876658690450294
38157;我要把这个换成电脑桌面星星眼;1;1;2;18388;0.00010876658690450294
38159;我靠，你这图怎么这么像我一同学;3;1;4;18388;0.00021753317380900588
38163;必须投币;1;1;2;18388;0.00010876658690450294
38165;在，看看手？doge;2;1;3;18388;0.0001631498803567544
38168;三连加关注星星眼，up加油;1;1;2;18388;0.00010876658690450294
38170;这是用的什么模型;3;1;4;18388;0.00021753317380900588
38174;up可以出一期basil或者茶系模型的吗;1;1;2;18388;0.00010876658690450294
38176;封面的高清呢？干脆把这期的高清都放动态嗑瓜子;3;1;4;18388;0.00021753317380900588
38180;直接热词系列三连;1;1;2;18388;0.00010876658690450294
38182;突某人不请自来滑稽阴险;1;1;2;18388;0.00010876658690450294
38184;支持一下星星眼;1;1;2;18388;0.00010876658690450294
38186;哇，好棒，币送你了脱单doge;1;1;2;18388;0.00010876658690450294
38188;怎么只有头部呀doge;10;1;11;18388;0.0005982162279747662
38199;谢谢星星眼;1;1;2;18388;0.00010876658690450294
38201;三连了，大佬;1;1;2;18388;0.00010876658690450294
38203;你画上你画的吗;1;1;2;18388;0.00010876658690450294
38205;三连了;1;1;2;18388;0.00010876658690450294
38207;有图包，必须点赞投币;1;1;2;18388;0.00010876658690450294
38209;吃瓜;1;1;2;18388;0.00010876658690450294
38211;有没有原图下载链接，有的话发一下，谢谢。打call;3;1;4;18388;0.00021753317380900588
38215;崩坏3终焉归始cool崩坏3终焉归始cool;1;1;2;18388;0.00010876658690450294
38217;脱单doge;4;1;5;18388;0.00027191646726125733
38222;打call;1;2;3;18388;0.0001631498803567544
38230;希望未来能有这么漂亮的机器人吧我找个屁的对象保卫萝卜哭哭二次元梦要成真了保卫萝卜哭哭保卫萝卜哭哭;2;1;3;18388;0.0001631498803567544
38259;H河河Al施法;1;1;2;18388;0.00010876658690450294
38276;AI作图不能放大细看，不要说手的问题了，眼睛嘴巴问题也多，可以跑图然后手动修改。下面两图比较，第一个AI，第二个画师。;3;1;4;18388;0.00021753317380900588
38289;越来越像真人的，技术真好支持支持;4;1;5;18388;0.00027191646726125733
38314;藍桉滑稽;2;1;3;18388;0.0001631498803567544
38334;感觉都是同一个人;1;1;2;18388;0.00010876658690450294
38347;AI画的为什么全是幼态美，这种美实际上更多的是可爱;2;1;3;18388;0.0001631498803567544
38366;如果把标题改成纯手绘，说是自己辛苦几个月画出来的成果，弹幕和评论就基本都会变成夸赞了滑稽;2;1;3;18388;0.0001631498803567544
38369;呃呃做就做别发图站污染图库了谢谢;1;1;2;18388;0.00010876658690450294
38373;去踏马的幼态审美;1;1;2;18388;0.00010876658690450294
38401;UP可以发一下具体模型名字吗？;1;0;1;18388;5.438329345225147e-05
38404;好看是好看但千篇一律;1;0;1;18388;5.438329345225147e-05
38406;UP主，您用的是哪款AI绘图软件;1;0;1;18388;5.438329345225147e-05
38417;训练没，没训练求个tag;1;0;1;18388;5.438329345225147e-05
38420;妙啊贴吧游戏广告看到封面那张了;3;0;3;18388;0.0001631498803567544
38424;有没有真人的;1;0;1;18388;5.438329345225147e-05
38430;可以下载吗;1;0;1;18388;5.438329345225147e-05
38433;AI画出来的是不是就没有版权了？可以随便用吗？;1;0;1;18388;5.438329345225147e-05
38442;背景音乐是啥？;1;0;1;18388;5.438329345225147e-05
38445;求tag;2;0;2;18388;0.00010876658690450294
38450;UP用的是哪一款软件;1;0;1;18388;5.438329345225147e-05
38452;我觉着，AI作画还是搞皇社实在点，反正冲就完事了;1;0;1;18388;5.438329345225147e-05
38456;请教一下，您使用下来二代和三代模型哪个效果更好一些呢;4;0;4;18388;0.00021753317380900588
38463;up你的处理器和显卡配置是什么doge;1;0;1;18388;5.438329345225147e-05
38467;AI不太会汉服;1;0;1;18388;5.438329345225147e-05
38469;壁纸有上传steam吗;1;0;1;18388;5.438329345225147e-05
38473;dogedogedoge;1;0;1;18388;5.438329345225147e-05
38475;我真的好想欧皇附体呀;1;0;1;18388;5.438329345225147e-05
38477;瞧不起AI的人我只能说无知，现在看见的AI还只是个小孩而已，可是小孩终有一天会长大成人。;2;0;2;18388;0.00010876658690450294
38484;求个TAG呀UP大大;4;0;4;18388;0.00021753317380900588
38490;是不是原画师可以退休了doge;1;0;1;18388;5.438329345225147e-05
38492;大佬，为什么我的图上会有紫斑。。。;1;0;1;18388;5.438329345225147e-05
38495;up主用的什么显卡，这么高分辨率不会显皴溢出嘛;2;0;2;18388;0.00010876658690450294
38498;这是国风几代模型？;1;0;1;18388;5.438329345225147e-05
38502;说实话感觉都长的一模一样不如欧美的好看;2;0;2;18388;0.00010876658690450294
38508;这是用哪个ai画的;1;0;1;18388;5.438329345225147e-05
38510;后续怎么放大而优化细节的鸭可以教一下咩;1;0;1;18388;5.438329345225147e-05
38513;丹是up自己练的，还是网上有人共享的？;1;0;1;18388;5.438329345225147e-05
38516;后续怎么放大而优化细节的鸭可以教一下咩;1;0;1;18388;5.438329345225147e-05
38518;什么ai软件啊;1;0;1;18388;5.438329345225147e-05
38521;什么ai软件啊;1;0;1;18388;5.438329345225147e-05
38523;自己做的模型吗？感觉我用的模型都只会生成白女;2;0;2;18388;0.00010876658690450294
38526;干嘛把我老婆搬过来;3;0;3;18388;0.0001631498803567544
38530;求BGM;1;0;1;18388;5.438329345225147e-05
38532;请问楼主用的是哪个模型，什么渲染器，谢谢;1;0;1;18388;5.438329345225147e-05
38534;感觉这样挺好的画师用自己的画风训练的话更方便找灵感doge;1;0;1;18388;5.438329345225147e-05
38536;这个那个软件;1;0;1;18388;5.438329345225147e-05
38538;哥，嫂子挺好看的是吧;2;0;2;18388;0.00010876658690450294
38542;越看越像同一张脸;1;0;1;18388;5.438329345225147e-05
38545;热词系列三连up求tag打call打call打call打call;1;0;1;18388;5.438329345225147e-05
38547;这是什么软件画的？;1;0;1;18388;5.438329345225147e-05
38549;有3D版吗;1;0;1;18388;5.438329345225147e-05
38551;受留言的小伙伴提醒，截图放大了下，好恐怖大家千万不要截图放大;1;0;1;18388;5.438329345225147e-05
38553;最近看了流浪地球2，对于AI太过发展陷入了深思当然图确实好看，但是真的害怕AI高度发展下去;1;0;1;18388;5.438329345225147e-05
38555;什么软件画的？;1;0;1;18388;5.438329345225147e-05
38557;哥们直接特别关注doge;1;0;1;18388;5.438329345225147e-05
38561;ai老婆指日可待滑稽;1;0;1;18388;5.438329345225147e-05
38563;置顶图包在这里原图和分辨率加强图，还有竖版20使用NovelAI绘画模型来自小李xiaolxl夸克网盘链接：httpspanquarkcnsb04474b2212f百度网盘链接：httpspanbaiducoms1gJUIjAr4i7fw8qM7dwFXAgpwdah34点赞三连支持一下吧给心心给心心给心心;1;0;1;18388;5.438329345225147e-05
38567;就是太幼态了;1;0;1;18388;5.438329345225147e-05
38569;什么软件啊大佬;1;0;1;18388;5.438329345225147e-05
38571;补下链接大佬;1;0;1;18388;5.438329345225147e-05
38573;这建模，太恐怖了灵魂出窍，感觉画师建模师职业以后要被冲掉一些人;1;0;1;18388;5.438329345225147e-05
38576;你们老婆真白;1;0;1;18388;5.438329345225147e-05
38578;拒绝幼态审美，从你他做起。;1;0;1;18388;5.438329345225147e-05
38580;什么地方自己做;1;0;1;18388;5.438329345225147e-05
38582;机器工具人识别音乐;1;0;1;18388;5.438329345225147e-05
38584;这小可爱有名字吗嘟嘟嘟嘟;1;0;1;18388;5.438329345225147e-05
38586;能不能ai建模;1;0;1;18388;5.438329345225147e-05
38588;就一个上半身我想要下来dogedoge;1;0;1;18388;5.438329345225147e-05
38592;这些画是一个人？我脸盲看着都一样;1;0;1;18388;5.438329345225147e-05
38594;我需要ai瑟图tv害羞;1;0;1;18388;5.438329345225147e-05
38596;可以给原图吗？;1;0;1;18388;5.438329345225147e-05
38598;这些是根据原图改出来的吗？;3;0;3;18388;0.0001631498803567544
38602;这个用的是什么AI软件？;1;0;1;18388;5.438329345225147e-05
38604;一个个不屑，审美疲劳，真到你眼前，让你提鞋做梦都会笑醒吧;1;0;1;18388;5.438329345225147e-05
38608;腾讯味审美;1;0;1;18388;5.438329345225147e-05
38610;ai绘画出本前我是不会认可的;1;0;1;18388;5.438329345225147e-05
38612;够橙光用了;1;0;1;18388;5.438329345225147e-05
38614;ai画的看的发毛doge;1;0;1;18388;5.438329345225147e-05
38616;兔年;1;0;1;18388;5.438329345225147e-05
38618;有全身的吗;2;0;2;18388;0.00010876658690450294
38621;科技的尽头是毁灭吃瓜;1;0;1;18388;5.438329345225147e-05
38623;我只想知道用的什么app;1;0;1;18388;5.438329345225147e-05
38625;单一张放出来都是很精美的，看多了弹幕就开始说“都一样”“审美疲劳”了。如果不标ai，大家肯定一顿夸，标了是ai画的，就有人开始“完全不如画师”;1;0;1;18388;5.438329345225147e-05
38632;什么软件画的啊？;2;0;2;18388;0.00010876658690450294
38636;大佬，求模型;1;0;1;18388;5.438329345225147e-05
38638;没有感觉了藏狐;1;0;1;18388;5.438329345225147e-05
38640;大佬，这是哪个模型;1;0;1;18388;5.438329345225147e-05
38642;ai上哪里领？tvdogetvdoge;3;0;3;18388;0.0001631498803567544
38646;500评论：有点东西滑稽;1;0;1;18388;5.438329345225147e-05
38648;明明《终结者》已经告诉我们了，ai叛变会毁天灭地，可是感觉我们还是在一步步靠近所以，人就是作死。脱单doge;1;0;1;18388;5.438329345225147e-05
38650;脸看着差不太多啊;1;0;1;18388;5.438329345225147e-05
38652;这咋画的呀;1;0;1;18388;5.438329345225147e-05
38654;雅菲洛琪我是电费飞车党;1;0;1;18388;5.438329345225147e-05
38657;无敌了;1;0;1;18388;5.438329345225147e-05
38659;没有4k吗;1;0;1;18388;5.438329345225147e-05
38661;为什么都说ai不会画手;3;0;3;18388;0.0001631498803567544
38665;大师开个班吧脱单doge;1;0;1;18388;5.438329345225147e-05
38667;NovelAI还是SD？;8;0;8;18388;0.00043506634761801175
38677;问一下是用什么软件生成的;1;0;1;18388;5.438329345225147e-05
38679;不许发我老婆照片doge;1;0;1;18388;5.438329345225147e-05
38681;让它画手呲牙呲牙;1;0;1;18388;5.438329345225147e-05
38683;页面不存在了捂脸;4;0;4;18388;0.00021753317380900588
38690;0007好像九龄呀，不会是用她的cos照喂的吧;2;0;2;18388;0.00010876658690450294
38693;请问是用什么软件生成的？;1;0;1;18388;5.438329345225147e-05
38695;为什么国产3D动画不用这些女角色翻白眼翻白眼;1;0;1;18388;5.438329345225147e-05
38697;求咒语;3;0;3;18388;0.0001631498803567544
38701;ai画的全身或者半身不能细看吃瓜不然会发现手掌经常出现五六个甚至十来个手指，脚也同理，有时候还会出现三只手;1;0;1;18388;5.438329345225147e-05
38712;像啊，真的很像啊;1;0;1;18388;5.438329345225147e-05
38714;什么软件？;1;0;1;18388;5.438329345225147e-05
38716;去发NFT吧;1;0;1;18388;5.438329345225147e-05
38720;以后手游成本大降啊;1;0;1;18388;5.438329345225147e-05
38722;我不懂绘画，但是我觉得这些很美;1;0;1;18388;5.438329345225147e-05
38726;AI已经这么厉害了，看来人工要淘汰了;1;0;1;18388;5.438329345225147e-05
38728;可惜只有头;1;0;1;18388;5.438329345225147e-05
38737;支持nsfw吗;1;0;1;18388;5.438329345225147e-05
38739;想知道模仿的谁的画作;2;0;2;18388;0.00010876658690450294
38742;看到就点进来，出去就忘掉;1;0;1;18388;5.438329345225147e-05
38750;有没有onlyfanstvdoge;1;0;1;18388;5.438329345225147e-05
38755;能看看Tag吗;1;0;1;18388;5.438329345225147e-05
38757;赶紧截图吧老土匪些;1;0;1;18388;5.438329345225147e-05
38765;古风戴眼镜？好怪;5;0;5;18388;0.00027191646726125733
38771;AI画手指不行;1;0;1;18388;5.438329345225147e-05
38784;什么模型up;1;0;1;18388;5.438329345225147e-05
38787;怎么下载啊网盘不行啊;2;0;2;18388;0.00010876658690450294
38790;用的ai叫什么;2;0;2;18388;0.00010876658690450294
38793;请问啥软件？;1;0;1;18388;5.438329345225147e-05
38795;发点tag还有配置啊，模型是什么？;1;0;1;18388;5.438329345225147e-05
38797;真离谱啊，才几天ai就到这个程度了，前些时间看的面容还不是很精细的，进化的好快啊。;1;0;1;18388;5.438329345225147e-05
38799;就不能画几个全身的？doge;1;0;1;18388;5.438329345225147e-05
38801;已热词系列三连，求个阿里盘的链接脱单doge;1;0;1;18388;5.438329345225147e-05
38803;好精细呀，good;1;0;1;18388;5.438329345225147e-05
38805;这特么不就是自己当甲方，AI当乙方吗？AI：你想画个啥？我：具体我也不知道，大概跟你说一下，你先画几版我看看吧AI行口巴这是我画的四个方案我：方案二比较有感觉，不过还得调整一下AI：这是调整后的我：挺好的，不过我突然有个想法，你再加几个元素进去试试AI：调整后的我：不错不错，以这个为基础细化润色一下吧AI：这次可以了吗？我：好像细化完没有那个感觉了，对了，你最初提的那四个方案再给我看看AI：公元2022年，第一次AI对人类战争爆发;15;451;466;18388;0.025342614748749184
38821;设计的底裤更好扒，元素的整合重组，AI最擅长这个。;29;115;144;18388;0.007831194257124212
38851;主题环境（背景，周围）气氛（烈日下，雾蒙蒙，恐怖的，风暴席卷的）灯光（顶光，雾气光，漫反射的，强对比的）色彩（低饱和度，颜色鲜艳的，花里胡哨的，强;2;93;95;18388;0.0051664128779638895
38855;ai已经解决版权问题了吗，一直以为它这个素材库应该都是有版权的，但是之前看有画师发现ai做出来的图把他的原图拆吧拆吧拼上去了，上面还有他的签名，这种商用会不会有风险，这个机器人到底是它学会了逻辑在无中生有还是在拆解前人优秀片段拼接啊，如果是后者感觉后面会有很大的纷争啊;14;88;102;18388;0.00554709593212965
38870;关键词公式：主题环境（背景，周围）气氛（烈日下，雾蒙蒙，恐怖的，风暴席卷的）灯光（顶光，雾气光，漫反射的，强对比的）色彩（低饱和度，颜色鲜艳的，花里胡哨的，强反射的主色调，某种颜色是是accentcolor）构图黄金分割，三分法的，电影镜头，广角，鸟瞰图风格参考（超清细节的，照片级别的，写实的，抽象的，2D3D，4k8k，数字雕刻，概念艺术，水墨，水彩，海报，某个软件，某个游戏，艺术家，艺术平台）;1;53;54;18388;0.0029366978464215794
38872;MidJourney不是软件，不需要下载，相当于一个用了一堆脚本的账号，就是一个自动脚本，所有制作过程都是在mj官方自己那里完成的。你进入MidJourney相关频道，简单来说就是相当于进了一个聊天群，你在这个群里提出你需要的图画，MidJourney账号会在一分钟内自动制作完成你可能需要的图片，并你，你可以对MidJourney给出的画面提出进一步修改的意见，MidJourney会继续修改。MidJourney不是软件，不需要下载，你只需要直接对这个账号提出关键词或者语句即可，对你的电脑，对你的手机没有要求，它不是利用你的设备进行处理过程的，只要你能上网，只要能显示图片就可以。MidJourney很优秀，给出的图画通常都很好，但是它给出的人体相关的图片仍然会出很多问题，比如你要求它画个美少女给你，然后，它经常给你整个没有五官或者五官全挤在一起，人体结构浮夸的恐怖谷。它在一些方面很优秀，但在人体，以及一些大场面上仍然存在很多问题。;6;59;65;18388;0.0035349140743963455
38879;其实嘛ai画画这种适合参考学习，这种可以投入到游戏场景cg设计，应用起来肯定比人方便，不过当ai应用多了就会廉价，在ai的千篇一律的风格比不过人的大脑的想法，就像看10个高质量文案视频再看一个单纯搞笑沙雕文案，比起那九往往是那个与众不同要吸引人跪了个人见解;8;39;47;18388;0.0025560147922558192
38888;完整看完了，做的很好。我说下我自己的看法啊，可能不对。现在用视频里AI画画的感觉，有种梦回到DOS系统程序员需要输入代码来操作电脑的时代。简单来说就是还是用代码规定元素后渲染图形。AI模型就是一个游戏引擎，引擎的素材就是图片。而DOS系统后来演化成了可视化操作系统，所见即所得。总结下就是在一个可视化操作系统里内嵌了一个只能画画的DOS系统进行编程。我感觉AI绘画的下一步应该是会进行可视化。就像PS一样，现在所有的参数就像PS里面的效果一样集成在设计软件里，可以看到材质的预览图，然后选中效果会有下拉菜单调节参数。也许以后的AI绘画就是一个专攻平面的UE。doge;2;27;29;18388;0.0015771155101152925
38892;我觉得ai还是工具，有了相机之后，真正好的写实绘画并没有死，有了美颜相机之后，摄影师行业也没有死。还是看能给人创造什么价值。都是工具，没必要抗拒，好好儿学好好儿用，当下一个阶段的大手子机会就在眼前;2;17;19;18388;0.0010332825755927778
38895;这就是历史洪流，未来的趋势，谁也逃不脱，只能学起来大哭;14;29;43;18388;0.002338481618446813
38912;用了几款软件，感觉ai画人物还是很“抽象”别的都很好看，你也别搁那说这不行那不好的，我不会板绘我也没钱找画师，我能用软件画出我内心想的做个壁纸做个头像啥的就够了;4;8;12;18388;0.0006525995214270176
38918;庆幸自己做了设计师不是画画工匠;18;33;51;18388;0.002773547966064825
38937;为某些小可爱省流：经过实验，免费版的haungbao类词汇会被锁定，无法识别。想用来生成huang图的可以不用看了。至于付费的，没试过。doge;2;3;5;18388;0.00027191646726125733
38942;想对自己已有的风景或者人像照片进行再创作的软件有吗？MJ这块好像不太行。;2;1;3;18388;0.0001631498803567544
38945;表达情绪的似乎没有看到，可以试一下关于感情的词条。要是能输中文，能试试诗句就更有趣了。;1;1;2;18388;0.00010876658690450294
38947;如何在mid里面关注你啊，怎么搜索的。。。;3;1;4;18388;0.00021753317380900588
38951;有没有能根据自己的草图进行绘画的AI？;2;3;5;18388;0.00027191646726125733
38956;绘画修罗场，场景原画师几十个小时不如ai几秒的成果笑哭;2;4;6;18388;0.0003262997607135088
38960;ai的发展，让人们有了更先进的生产力。就从艺术绘画这个行业来说，有些人很反抗。这是因为ai动了这些人的利益（金钱）。打工的绘画者认为这是威胁，因为ai抢了他们的饭碗。但你有没有想过，ai他是一个工具，一个可以大大提高劳动生产力的工具。你一天的工作量，用ai半天就可以干好。那剩下的时间，你可以去做自己想做的事，闻闻花香，看看外面，陪陪家人，过自己的生活，这不挺好吗？你不这么想，是因为怕老板只用少量的绘画者完成工作，因此对你或自其他人进行裁员进而导致你没饭吃是，在资本主义制度下，这种压榨确实会发生可我们是社会主义追求的是共产主义社会主义不就是用先进的生产力，减少人类繁重的工作，从而让人有空余时间过上自由幸福的生活吗？既然有了先进的生产工具，那你还被压榨的这么狠，过的这么苦逼那这根本原因到底是ai威胁了你，还是统治集团故意不让你过的那么舒服。到底是ai压榨着你，还是统治集团压榨着你你把压榨你的对象归咎于一个没有意识的工具，那你把ai这个工具毁灭掉，你就能过上幸福的生活了？搞清楚你生存的困难到是谁和谁的矛盾工具永远是中性的，关键是看谁在用工具欺压着谁，谁又在用工具造福着谁热词系列锤;4;7;11;18388;0.0005982162279747662
38966;我觉得leo作为一线的概念美术，很多看法远比网上乱七八糟的营销号深入多了。应该把这个视频顶上去，让大家看看ai对于真正的美术业界工作有怎样的改变;1;6;7;18388;0.0003806830541657603
38972;怎么修改画布了？？这个;3;2;5;18388;0.00027191646726125733
38977;就ai这发展速度，感觉我自己视觉设计这类岗位来说，可能会由较为单一的美术视觉，加速转变为更综合性的岗位了，未来想继续留在这个行业内，可能需要经历一段痛苦的转变和提升学习期了，还是要做好这个心理和专业上的准备啊难过难过，疫情之后真的越来越难了各位大哭大哭;1;2;3;18388;0.0001631498803567544
38981;ai这种东西肯定会变的越来越厉害的，再过个5年10年ai肯定会代替一大批东西，不知道以后还能不能靠画画赚钱，感觉好迷茫啊。;4;2;6;18388;0.0003262997607135088
38987;糟了我成大触了;1;2;3;18388;0.0001631498803567544
38989;热订阅不识别国内银行卡。。。伤的一批。。啥时候开通支付宝付款啊。。;2;1;3;18388;0.0001631498803567544
38992;没有visa怎么办，想付费;3;2;5;18388;0.00027191646726125733
38998;设计如果被AI替代人类的智慧就快玩完了智慧将不再传承;1;3;4;18388;0.00021753317380900588
39001;sd免费的，用sd吧。doge;2;2;4;18388;0.00021753317380900588
39005;好奇订阅多少钱;2;1;3;18388;0.0001631498803567544
39011;热词系列吹爆;1;1;2;18388;0.00010876658690450294
39015;ai生成的图可以商用吗？;4;2;6;18388;0.0003262997607135088
39028;是否能弄卡通形象，皮克斯，迪斯尼等;1;1;2;18388;0.00010876658690450294
39031;真正的设计师都该抵制ai绘画之前新闻有个不会画画的b用了ai得了绘画比赛的奖;3;1;4;18388;0.00021753317380900588
39043;总是提示加入前确定不是机器人请问怎么解决啊？;1;0;1;18388;5.438329345225147e-05
39059;视频最后部分，是充值后就能点开任何一张图查看吗？创意齿轮CGD;1;0;1;18388;5.438329345225147e-05
39064;大佬我想问一下，充值后如果不是天天用，能不能暂停啊之前看你的视频里好像提到过，刚才又浏览一遍但是没找到，能不能指点一下，谢谢拉;2;0;2;18388;0.00010876658690450294
39071;MidJourney怎么出图以后再加元素啊;1;0;1;18388;5.438329345225147e-05
39073;想问问up里面说的新功能叫啥呀就是让画面更清晰的那个;1;0;1;18388;5.438329345225147e-05
39079;老师这一套公式对StableDiffusion和DD都适合吗？;1;0;1;18388;5.438329345225147e-05
39088;会员多少钱一个月;4;0;4;18388;0.00021753317380900588
39095;能不能给他一张图要他临摹？;1;0;1;18388;5.438329345225147e-05
39097;UPUP，能不能在一幅已经生成好的作品的基础上添加关键词和要素;3;0;3;18388;0.0001631498803567544
39103;一觉睡醒发现世界版本更新了，这个形容真恰当;1;0;1;18388;5.438329345225147e-05
39105;怎么找到以前合成好的图片啊？;1;0;1;18388;5.438329345225147e-05
39107;在策略竞技和逻辑推演上人类已经彻彻底底输给ai，而现在人类上万年逐渐形成的精神世界需求也将逐渐被程序的代码所满足，这到底算不算科技的带来的福音？当美术乃至更多的精神需求逐渐变得廉价，创造力与想象力也因此逐渐萎缩之时，不知道人类将会迈入一个崭新的纪元，还是一个颓废而停滞的长夜;2;0;2;18388;0.00010876658690450294
39110;ai永远只能当辅助工具否则会出大乱;2;0;2;18388;0.00010876658690450294
39114;是不是没办法输出高分辨的图啊？我看有些第三方网站上的图分辨率又比较大，是不是用软件强行拉的分辨率？;1;0;1;18388;5.438329345225147e-05
39116;慢速的要多久出一张图;1;0;1;18388;5.438329345225147e-05
39120;有没有中文版。留下英文不好的泪水;1;0;1;18388;5.438329345225147e-05
39122;是不是要翻才能打开？我的网页跳转新页面一直跳不出;1;0;1;18388;5.438329345225147e-05
39124;机器人加入到自己服务器没有响应是怎么回事;2;0;2;18388;0.00010876658690450294
39127;想问下大佬能在绘图选择过程中添加关键词吗大哭;1;0;1;18388;5.438329345225147e-05
39130;大神，讲一下mid中照片叠加功能吧;1;0;1;18388;5.438329345225147e-05
39132;这感觉可以学英语;1;0;1;18388;5.438329345225147e-05
39134;ai的邀请码无效怎么办;1;0;1;18388;5.438329345225147e-05
39136;AI过度开发会导致终结者出现墨镜;1;0;1;18388;5.438329345225147e-05
39138;大佬想问下，mj的图片参考怎么用啊，感觉和参考的图片差距很大？不太明白他是参考啥东西;3;0;3;18388;0.0001631498803567544
39142;您好，如果我用关键词达到某个效果后，想在这个效果图的基础上再添加一些关键词，该如何实现？;1;0;1;18388;5.438329345225147e-05
39145;midjourne可以上传对图片进行二次创作不;4;0;4;18388;0.00021753317380900588
39152;神经网络，不是具体逻辑代码，里面是一团雾，没有人能理解里面的逻辑。;2;0;2;18388;0.00010876658690450294
39155;关注Leo老师midjourney可以看到老师作品那个列表和关键词吗;1;0;1;18388;5.438329345225147e-05
39158;大佬，请问1420014206之间的那个听起来像“瑞巴斯特尔”的词是什么意思，我不了解这个词语的含义tv腼腆;3;0;3;18388;0.0001631498803567544
39162;有能画二次元的吗珈乐Carol不懂二次元;1;0;1;18388;5.438329345225147e-05
39164;请问开会员后200张一个月是怎么算200张呢？输入一次关键词算一次吗？;2;0;2;18388;0.00010876658690450294
39168;说好的网站呢？？;1;0;1;18388;5.438329345225147e-05
39170;一键三连等网站地址;1;0;1;18388;5.438329345225147e-05
39176;我记得本地部署的stablediffusion已经有大佬出了吧，不知道那个怎么样;2;0;2;18388;0.00010876658690450294
39180;原图在这，httpswwwbilibilicomreadcv21740623但是我知道你们要的不止是这些dogedoge;72;34;106;18388;0.005764629105938656
39253;解燃眉之急;1;4;5;18388;0.00027191646726125733
39255;三连了，听说有特别版doge;2;2;4;18388;0.00021753317380900588
39258;大佬，三连了，求特殊包;1;2;3;18388;0.0001631498803567544
39260;三连求图;1;2;3;18388;0.0001631498803567544
39263;感觉白手挺不错的，比冰结好多了;2;2;4;18388;0.00021753317380900588
39266;不错哦蹲个百度图包吃瓜吃瓜吃瓜;1;2;3;18388;0.0001631498803567544
39268;三连了，求特殊版;1;1;2;18388;0.00010876658690450294
39289;三连求特别版;1;1;2;18388;0.00010876658690450294
39303;三连了，蹲个特别版吃瓜;2;1;3;18388;0.0001631498803567544
39306;莫辜负滑稽;1;1;2;18388;0.00010876658690450294
39310;三连求特别脱单doge;1;1;2;18388;0.00010876658690450294
39313;热词系列三连热词系列神仙UP求图包星星眼;2;1;3;18388;0.0001631498803567544
39318;三连了，求里版;4;1;5;18388;0.00027191646726125733
39323;已三连，求特殊版;1;1;2;18388;0.00010876658690450294
39325;三连了，听说有特别版星星眼;1;1;2;18388;0.00010876658690450294
39328;已三连求特别版;1;1;2;18388;0.00010876658690450294
39332;求特别版星星眼;1;1;2;18388;0.00010876658690450294
39334;三连了，蹲个特别版吃瓜;1;1;2;18388;0.00010876658690450294
39336;已三连，老铁doge，求;1;1;2;18388;0.00010876658690450294
39338;三连了，听说有特别版doge;4;1;5;18388;0.00027191646726125733
39343;求图包;1;1;2;18388;0.00010876658690450294
39345;三连，求图，你懂的doge;1;1;2;18388;0.00010876658690450294
39347;求图dogedogedoge;1;1;2;18388;0.00010876658690450294
39349;三连求图;1;1;2;18388;0.00010876658690450294
39351;三连已给，求特殊版本doge;1;1;2;18388;0.00010876658690450294
39356;群号346513799;1;0;1;18388;5.438329345225147e-05
39393;求特别版;1;0;1;18388;5.438329345225147e-05
39395;三连了，球特别版脱单doge;1;0;1;18388;5.438329345225147e-05
39418;三连了，听说有特别版星星眼;1;0;1;18388;5.438329345225147e-05
39465;Upup三连了，也想要图包脱单doge;1;0;1;18388;5.438329345225147e-05
39524;woc，有发小红车吗？;2;0;2;18388;0.00010876658690450294
39555;三连求图;1;0;1;18388;5.438329345225147e-05
39571;听说3连有其他版本滑稽嗑瓜子;1;0;1;18388;5.438329345225147e-05
39582;三连已发，坐等了;1;0;1;18388;5.438329345225147e-05
39605;三连支持一下up脱单doge;1;0;1;18388;5.438329345225147e-05
39609;没事就想夸夸挺好看，up已经发的人够多了不麻烦了给心心;1;0;1;18388;5.438329345225147e-05
39611;三连了，求脱单doge;1;0;1;18388;5.438329345225147e-05
39615;有特别版的doge;1;0;1;18388;5.438329345225147e-05
39619;特别版是啥，我帮b站的朋友们鉴赏一下doge;1;0;1;18388;5.438329345225147e-05
39622;doge;1;0;1;18388;5.438329345225147e-05
39629;大佬，三连了，求特殊包;1;0;1;18388;5.438329345225147e-05
39631;已三连，老铁doge，求;1;0;1;18388;5.438329345225147e-05
39633;特别版？我也要一份doge;2;0;2;18388;0.00010876658690450294
39636;三连了，你懂的，顺带个1月26的doge;1;0;1;18388;5.438329345225147e-05
39641;特别版本是什么，在哪;1;0;1;18388;5.438329345225147e-05
39643;求特殊版本;1;0;1;18388;5.438329345225147e-05
39645;求图脱单doge脱单doge脱单doge;2;0;2;18388;0.00010876658690450294
39648;等一个图包;2;0;2;18388;0.00010876658690450294
39651;还是那句话有特殊版本记得发我doge;11;0;11;18388;0.0005982162279747662
39666;不喜欢ai绘图其中一点的原因，就是在微博看到有的平台上已经出现了用ai绘图接稿的行为了。ai学习的图来源就不干净，接稿的人更是一点力没出就能赚钱捂脸气得鬼火冒;76;3012;3088;18388;0.16793561018055253
39743;粉不粉画师是一回事，以后使用画师的风格用AI作画需不需要付版权费又是另一回事了，目前可以确定的是如果这项技术发展起来首先收益的就是这些头部的画风辨识度高有名气的画师热;52;1702;1754;18388;0.09538829671524908
39796;突然坚定了把画画当爱好的想法笑哭高端画手很难被影响，被影响的大概率是正在学的和普通画手。反正我列表里的美术生都在骂ai画画;26;934;960;18388;0.05220796171416141
39823;今天已经看到有人拿画师直播画稿的截图去喂ai出图，完了还倒打一耙说画师参考他的ai出图了，倘若这就是未来的话，还是算了吧;56;534;590;18388;0.032086143136828366
39880;虽然我不喜欢他人，但是现在的程度连老累脚指头都比不上，素描黑白关系直接给ai秒爆了，调成黑白的看看就知道了，不过以后就说不准了;44;580;624;18388;0.033935175114204914
39925;我就很讨厌ai绘图，不是因为正在学，我只是觉得大家太依赖这个软件了，包括很多同学也在考虑要不要转行，觉得ai比他们画的好，我倒是觉得每个人的画都是有自己的特点的，而每个人的喜欢的点也不一样，这是ai无法替代的，我没看过ai怎么作画的，我也不感兴趣，我也不会因为这个东西打击到我，总而言之，能给我鼓励和让我欣赏的永远只有大佬的画，而不是什么ai微笑;51;582;633;18388;0.03442462475527518
39977;哎，虽然老累人不怎么样，，，但是ai这件事，，，真的很让人心碎;22;398;420;18388;0.022840983249945615
40000;最大的落空就是自己的热爱被贬值;13;379;392;18388;0.021318251033282574
40014;问题是，这个速度，AI打败拳头也只是时间问题吧，AI的进步是全方位的，从算法到感知，涵盖从IT到自然科学和艺术领域，画师看起来是在和AI作战实际上，是和背后的一堆资本集团作战，一个好的发明应该是让生产力更上一层楼而不是抢人饭碗，我有点想念冷战了，那个全球积极向上的时代大哭大哭大哭;76;723;799;18388;0.043452251468348926
40091;虽然但是，现在老累这张比较好，但ai再学再进步呢？素描关系、透气的线条，不会真觉得有什么高端的了不得的技法是ai永远也学不会的吧。还有ai无法理解人类需求？算了吧，只要限定词加的够多，而且它还能无限次修改，对于一些要求没那么高的甲方来说已经足够了。今天已经看到好多人说不会再花钱约游戏立绘和小说插图了;10;360;370;18388;0.020121818577333042
40102;好喜欢，人类灭亡又快进一步啦自己的艺术终于全都可以没有啦;8;174;182;18388;0.009897759408309767
40111;现在ai确实可能没啥威胁，但以后就不一定了，科技的发展是很快的。到时候普通画师一个月画的图，可能只需要一些关键词ai三个小时就能弄出来。当然，高级画师可能没这么快淘汰，但高级画师一个月画的画和ai三天画的没太大区别的话，那又有谁会去找画师呢。滑稽;9;249;258;18388;0.014030889710680878
40121;取代呗，把人也取代了最好，活着也累了;1;96;97;18388;0.0052751794648683925
40123;虽然没品，但是看到老累这种“高端画法”被ai冲击我真是“爽到脚后跟”;27;550;577;18388;0.031379160321949096
40151;一幅画，在特定的条件下，该在画面的什么地方安排什么东西，用什么颜色，用什么表现手法怎么去用事物和颜色合理的相互映衬以达到表达特定内涵的作用，画面要严谨，要有秩序，人类传统绘画拥有一套复杂的逻辑。ai目前要想在绘画方面超过人类，歪嘴不可能，美术又不是下围。ai绘画的学习根本算不上学习，在从无到有的过程中ai只是获得了众多画师的“结果”，而且ai学习本质上和人类是一样的，只是不停的得到“结果”，它永远不可能在美术上超过人。只能说最近的种种迹象表明人类真的太小看美术以及美术工作者了;16;91;107;18388;0.005819012399390907
40168;第一批艺术领域受害者，以后ai紧接着会取代什么呢？我们不得而知;5;61;66;18388;0.003589297367848597
40174;可能我心态不太好，既然现在这个世界这样子，我希望AI小说，AI作曲一系列的东西也快点强大起来，大家一起难受;14;141;155;18388;0.008429410485098978
40189;ai不能称之为绘画吧，毕竟从始至终没动过一笔，生成的不能叫画，叫图更合适思考;11;81;92;18388;0.005003262997607135
40201;第一，看到有些人说为什么要拒绝它，它明明可以变成很好的画师辅助工具，不努力适应不去学习活该被它取代。这样说吧，这个东西并不是为了成为辅助工具而诞生的，他不是整理参考的，不是帮你拉透视的，不是帮你贴素材的，不是方便你整理思路的，不是帮你模拟光源的，不是帮你寻找灵感的，它是为了一步成图取代画师的。那些热爱绘画的大佬根本不屑用，普通人生成图片不会调整（以后会进化到不用调整就是完美成图），它的进步靠什么呢？靠吞噬你现在可能看不起的那些”曾经或者现在仍在用努力和天赋跟上时代脚步，十年磨一剑，不走捷径“的笨拙的画师们的心血，它不会为此付出任何版权费用。没有人在拒绝它，是它正在可预见的蚕食掉这个行业，而且速度只会越来越快。有的人说不要危言耸听，真正的有创意画工好的画师根本不担心这些，都是些底层画师在跳脚，但是这是基于现在的成图而言的，而几个月前很少人能预测到它的进步会如此巨大，几个月后的它同样是难以预测的。你再能画，你能一秒练习和同步消化吸收成千上万张不同类型的图吗？你再有创意，能保证时时刻刻每分每秒都在吸收最前沿信息的它不会有一天超越你吗？你看过和这个类似的设计（AB），你知道这么设计这么应用能出效果然后你应用在自己的设计中（AC，AD），看上去就是原创设计而且完全不涉及抄袭，你能做到，终有一天它也能做到而且比你快得多躬耕苦练多少载，磨练审美为修图，没有真心喜欢画画的提高审美画技是为了变成AI修图师第二，创新型人才根本支撑不起一个行业的健康生态，努力型人才才是大多数，才是创新型人才赖以生存的土壤转;1;12;13;18388;0.0007069828148792691
40203;等以后内容创作者都没了，ai玩家就可以抱着不再更新的图库玩一辈子了;26;103;129;18388;0.007015444855340439
40230;其实ai是拉平画手高低差的，毕竟画师本来是赢者通吃，而天资或者技巧不足的连粥都喝不上，现在有可以系统学习服务的ai辅助，可见未来画手行业会像IT里的代码搬运工一样变成劳动密集型工种而不再是纯技术工种，没技术能力的当ai的操作湿件，有一定技术的做优化修改，高技术的给ai学习拓展思路和方向只要需求在职位反而会更多。;8;105;113;18388;0.006145312160104416
40239;因为以色彩为主，她的色彩本来就有公式在里边，ai一学就会了，非常容易模仿到。不过线稿才是最难模仿的，厉害的线稿大佬画出的线条是会呼吸的，随机性很强，这才是ai难学的点。;1;10;11;18388;0.0005982162279747662
40241;色温画法倒也不至于像看什么稀有物种一样吧藏狐;2;10;12;18388;0.0006525995214270176
40244;圈子本来就卷，现在还加入了无敌的ai属实是把人劝去柠螺丝;4;63;67;18388;0.0036436806613008486
40250;对于为自己服务的那部分画师倒是有益的，直接生成，然后再自己修改。要是ai能画连续的剧情漫画就更好了。;7;67;74;18388;0.004024363715466608
40258;我还看到米山舞画风和Mikapikazo的ai画了质量都很高;1;8;9;18388;0.0004894496410702633
40260;你的热爱一文不值，人类引以为傲的艺术原来在科技面前如此渺小;1;78;79;18388;0.004296280182727866
40263;我记得大量生产某个画师的特定画风的图并广泛传播，导致混淆的话（比如让大家以为这个用ai画图的是原画师），是有可能造成不正当竞争的微笑;1;57;58;18388;0.003154231020230585
40268;不懂就问，我其实特别不能理解，为什么ai写歌，写小说没有作家和作曲家出来反对，而ai画画就有人反对？是因为画画具有“具象性”而歌曲和小说是“抽象性”么;52;74;126;18388;0.006852294974983685
40321;如果每个画师能给自己定制一套ai，那不是双赢;9;11;20;18388;0.0010876658690450293
40335;老累高清画册，图集，PSD源文件，绘画视频可供学习参考哦星星眼星星眼星星眼;49;49;98;18388;0.005329562758320644
40386;我认为ai很难取代画师，ai的本质就是对关键词的原素进行缝合和创造。ai的审美和创作技术在不断提高，但ai读不懂人话，就很难理解高精度的要求和设定，画师也就很难被取代;3;22;25;18388;0.0013595823363062867
40390;不应该是画手害怕，而是人类害怕吧，专属于人类的智慧与艺术将被取代，人类将进入机械化退步，机械将人格化飞升，人类已经在试图创造神了，我自己倒不害怕被取代，两种发展，高端画手的画更加值钱，底层画手被取代，人类艺术出现断层，老一辈死去后艺术死亡，第二种，不久后ai绘画以侵犯版权或者其他不良影响被抵制，国家等到声音更多更高的时候出面抵制，为了文化传承，市场经济，国民素质与就业，所以不用害怕感觉，要么艺术死要么ai死，但是都影响不到高端画手，所以努力就好了;1;7;8;18388;0.00043506634761801175
40392;怎么说呢，其实ai这种学习方法对绘画爱好者还是有启发的。我觉得这种方法和刷题很接近，当然要想学的好不能只刷题，要找到出题者真正要考的知识点，而真正的知识点创作思想感情和背后的考据绘图ai目前是发现不了的。而且往好的说ai对大佬其实不会有冲击，还可以推进努力的小白吸收ai优点，同时发现ai的缺点，学习画外的知识，不断完善自己。;9;27;36;18388;0.001957798564281053
40402;看到了这个感觉。画画没有用了，搞不到钱，现在完全不知道画画的意义是什么;2;5;7;18388;0.0003806830541657603
40405;srds。雷母遇到过多少个小雷母啊，，，，哪个小累不必那个ai画的好;1;17;18;18388;0.0009788992821405265
40408;已经有人截图画师的去ai创作然后说画师抄袭了，说这是资本必然趋势，可资本跟资本也是对立的，有很多因为画画起家的产业，只能说这些对冲最受伤还是普通人。;1;18;19;18388;0.0010332825755927778
40411;这老累不得火速出警开喷啊？;1;7;8;18388;0.00043506634761801175
40414;好奇，AI做出来的画可以随便商用吗？思考;7;4;11;18388;0.0005982162279747662
40423;三连了，求求;1;4;5;18388;0.00027191646726125733
40434;用脚趾头想也不可能取代，要是连老累都被取代了，你我早就灰飞烟灭了无语无语;5;12;17;18388;0.000924515988688275
40440;普通小狗，一张17万。但我喜欢他的画风;3;3;6;18388;0.0003262997607135088
40444;求视频文件和图，学习，谢谢UP;1;3;4;18388;0.00021753317380900588
40446;有视频吗，想学习;1;3;4;18388;0.00021753317380900588
40448;怎么获取呢;1;3;4;18388;0.00021753317380900588
40451;有些人说的好像自己不是从模仿开始一样大笑你以为的创作也基本上是各种风格元素的堆砌，跟ai算法有区别吗？传统人类有一天被ai等等这些人类所创造的事物取代那也算好事了，不过更令人好奇的是，那时的人类借助这些东西到底能进化到什么程度，光想想就兴奋。现在的生物技术发展再快点吧，不然怕是到时候没有融合进化的机会，而是完全被取代变成真正意义上的灭绝那可就太逗了大笑;25;18;43;18388;0.002338481618446813
40479;我从小就喜欢画画，虽然我因为父母没选择这条路。就是，不要太自卑了，自己创作的东西，展现的是自己的思想，自己的灵魂，自己的特色，这是无法代替的。每个人都是从小菜鸡变成大佬的虽然ai这种捷径扰乱了很多学画画人的心思，其实比起被别人嘲讽ai代替画师什么什么的言论而感到难过，我更喜欢享受自己创作的过程。这些自己画来的成就感是几秒钟ai合成的画所替代不了的。相信自己呀，小画家们不知道为什么我一直觉得ai代替不了画师的。可能是因为自己的画风不像ai吧反正我更喜欢自己画的画;2;2;4;18388;0.00021753317380900588
40485;想要教程，怎么踢怎么踢星星眼星星眼;1;2;3;18388;0.0001631498803567544
40487;求;1;2;3;18388;0.0001631498803567544
40489;已三连求图;1;2;3;18388;0.0001631498803567544
40491;三连三连我都要;1;2;3;18388;0.0001631498803567544
40493;怎么获取那;1;2;3;18388;0.0001631498803567544
40495;嗯嗯;1;2;3;18388;0.0001631498803567544
40497;热词系列好耶;1;2;3;18388;0.0001631498803567544
40500;啊。没加到，还可以吗;2;1;3;18388;0.0001631498803567544
40505;可是ai能进步，人类就不能进步了吗？人类不能进步哪来的ai我问你？？？ai不就是人类进步创造出来的笑哭焦虑啥啊，人类继续努力吧真的，别动不动就放弃不画了。;1;1;2;18388;0.00010876658690450294
40507;如果一滴眼泪，科学家用技术完美复刻了它的成分，那么这还算是一滴眼泪吗;1;1;2;18388;0.00010876658690450294
40509;怎么说，其实不是特别像老累画的;1;1;2;18388;0.00010876658690450294
40516;约稿的人也是为了老累的名气啊就算ai能模仿高端画师，但是他们本身有名气加成，肯定是更想约本人的;1;1;2;18388;0.00010876658690450294
40518;《低端画师》《冲击》《爽到后脚跟》;6;1;7;18388;0.0003806830541657603
40525;现在的问题就是AI是把别人的画撕碎了重新拼一张出来，你想要的画是AI撕碎了无数张画拼出来的，自己用也就算了，你信不信要是不做好准备的话以后会出现画师还没画完有人拿AI绘图直接拿画师底稿去喂AI然后在画师好容易画完画或者卖出去之后没有几分钟就把和画师的画能有8成像的AI画放出来说画师侵权，当然了，这种事要操作起来还要专业人士，但是这确实是一个途径，以及现在画师们反对的就是未经许可拿自己的画喂AI这个行为，你要是所有的喂食都是经过同意的，画师也没话说，问题就是AI想要拼出一张好图是需要大量的优质画喂，那偷窃的行为是势必会产生的，你不能因为AI把画撕的足够碎，碎到你根本不知道这幅画是由几千副画拼起来的就说这和原画师没关系;8;1;9;18388;0.0004894496410702633
40535;呃呃现在说砸饭碗还不至于吧，真正那种大型的插画指望ai还是不大现实，更多是让不懂画画的人不去上绘圈五十一百一张的当;1;1;2;18388;0.00010876658690450294
40542;其实我不是很在意ai绘画能达到什么程度，我好奇的是创造出这玩意儿的初衷是什么，是想代替画师？还是想让每个人都有一张好画？思考;1;1;2;18388;0.00010876658690450294
40546;妙啊我比较喜欢干净点的图，花里胡哨五彩斑斓的看的眼睛难受;1;1;2;18388;0.00010876658690450294
40548;只是我在想，如果我是个画师，导入大量我以前的画并且保证它的封闭性，学习成果不联网传播只在我个人这端存在的话，不就能让ai免费打工吗？所以程序本身还是有一定可取性？不过现在的ai素材来源方面还有侵权的大问题（不是杠仅仅表达个人观点如有冒犯果咩那塞）;1;1;2;18388;0.00010876658690450294
40551;求分享哇;1;1;2;18388;0.00010876658690450294
40554;求视频和文件，学习用原神哇;1;1;2;18388;0.00010876658690450294
40556;想要星星眼;1;1;2;18388;0.00010876658690450294
40558;求分享;1;1;2;18388;0.00010876658690450294
40560;已三连，求求;3;1;4;18388;0.00021753317380900588
40564;你视频用的哪个AI语音脸红;1;1;2;18388;0.00010876658690450294
40567;求视频和图包谢谢up喜欢;1;1;2;18388;0.00010876658690450294
40569;三连交易脱单doge;1;1;2;18388;0.00010876658690450294
40571;想要想要星星眼;1;1;2;18388;0.00010876658690450294
40573;求视频最后的图，学习用，;1;1;2;18388;0.00010876658690450294
40575;三连拉星星眼;1;1;2;18388;0.00010876658690450294
40577;确实;1;1;2;18388;0.00010876658690450294
40580;ai超越米山舞了吗？;1;4;5;18388;0.00027191646726125733
40617;画风收版权费可能是另一个坏的开始;1;0;1;18388;5.438329345225147e-05
40619;我就在想ai用别人的风格算不算侵权;1;0;1;18388;5.438329345225147e-05
40621;累老师在哔站嘛，我怎么找不到笑哭;1;0;1;18388;5.438329345225147e-05
40631;我刚上手玩ai画图，用stablediffusion生成了穿白色婚纱悲伤哭泣的基努里维斯，别说，艺术效果拉满，ai不需要什么创造力和情感，只要你能描述清楚让他干什么大部分工作就完成了藏狐;1;0;1;18388;5.438329345225147e-05
40642;道理很简单。画是画家的劳动成果，画家不乐意自己的劳动成果被那些投机分子和自私自利不尊重他人的人白白夺走。不管那些人如何高举“进步大旗”，都不能正当化在他人不同意的情况下掠夺劳动成果的行为，这始终是不公平不道德的。不能因为一个人经常帮邻居们“做白工”就剥夺他们自愿劳动的权力或者是向老板讨要工钱的权力。顺便一提，基于掠夺和不公平理念下的“科技进步”最终只会造福少数人，大部分人只配“进步”的牺牲品。等更高级的ai出现，它需要更高算力且闭源收费时，你就会意识到“挂也是有价位的”;90;887;977;18388;0.053132477702849686
40733;这几个月来有些人说ai会制裁绘圈制裁小画家，可实际上ai让绘圈又多了鉴ai的事，众多人甚至用ai骗钱。有人说小画家急了急了，但ai伤害最深的不是小画家，是众多未经允许便被用来被训练ai模型、炼私炉的成熟画师。（有的甚至明令禁止还被跳脸），是还未成熟却依然抱着热爱，却被ai打击迷茫退后的初生画手。有人说技术本身无错，但新技术需要管控，尤其是有风险争议、有可能用于犯罪的技术。有人说ai可以用来辅助，但目前的ai还有很多根本性的逻辑错误，尤其对于新手来说用ai改图和辅助并不是好的选择。有人嘲讽小画家活该，有人嘲讽艺术，有各种各样的人站在自己的世界里任意发表观点，但很多人或许都需要了解更多、更理智一点。在这场无奈的抢夺里，很少有人真正的关注画师就算你真的被所谓的“小画家”伤害过，有更多的画师并非伤害你的人所以至少不要再随意伤害这些被成为“科技土壤”的人了;71;1374;1445;18388;0.07858385903850337
40805;有人说小画家急了。就是急了。就急眼了怎么了？自己热爱的东西突然被替代了。就像你的家庭多了个长得和你一样的机器人把你挤掉了。你爸妈更喜欢这个干活更快学习更好甚至不需要睡觉的孩子。你生气他们还说你急了。;14;703;717;18388;0.038992821405264305
40821;有些人AI用就用了，还跑出来享受画师利益是真的难绷。p站一个绘画活动能有一半是AI图，跟抽奖号没啥区别tv鄙视;22;238;260;18388;0.014139656297585382
40844;很讽刺的是，我看的时候这条视频底下的广告是AI绘画的。。。;5;138;143;18388;0.00777681096367196
40850;估计所有科幻小说家都没想到，人工智能导致的第一个伦理问题竟然发生在画家笑哭;21;359;380;18388;0.020665651511855558
40872;确实很感触，无论是商业画师还是艺术爱好者，在自己的画被ai学习后制造出一大堆乱七八糟的图片的时候，还有人跑来问你哪一个好，我想这一定是非常痛苦的，尽管我不是那些画师，我也热爱绘画，可以理解这里面的辛酸，对于那些正在绘画道路上前进的人也是很无助的，他们不是机器，没办法几秒钟就画一张画，只能淹没在ai图片的海洋里，可能永无出头之日，就像现在很多绘画作品网站上充斥着ai图，半天看不见一张人类作品，最可笑的是某些人指责这些画手脑子里就是想着出名和挣钱，可惜不只是画师，大多数人都想着这些东西，没有人喜欢无条件的付出没有一点点回应，自己自私地利用画师的成果去玩耍的时候还要指责画师只想着自己，有一点过于讽刺了，人还是那个样子，没有发生到自己身上就不可能感同身受，ai不需要消失，更加现代化的世界需要它，但是不代表未来的世界不需要法律和道德，有一些东西不管时代如何改变，它们都不应该被人类抛弃。;8;145;153;18388;0.008320643898194474
40882;现在这样自觉的反抗其实并不能很好地撼动资本，必须得联合起来成为工会才能如此，然而我本身并没有能够组织或者要求别人组织的资格，只是希望罢了，不管到最后是真正的共存了，还是一方把另一方消灭了，我都还是希望有一个真正对人民来说好的结局;40;99;139;18388;0.007559277789862954
40923;很多对绘画一无所知的外行人，却总是拿着AI嘲讽真正喜欢绘画的人，但是我又很难说些什么，好像喜欢绘画就注定会被比较。一想到穷尽时间钻研造型能力的我画的画要和那些对画画一点也不懂的人用ai画的画放到一起比我就挺不爽的，完事了还得被说总一天会被ai超越。;3;104;107;18388;0.005819012399390907
40927;怎么用ai，那都还是用的人的事，在法律还没覆盖到这一块之前，怎么用都是别人的事，但用ai生成的东西就是不配参与艺术交流，artstation是给艺术家交流学习的网站，很多人也是靠这个网站宣传自己找工作的，ai出现在这就好像用ai生成的论文投到知网一样;3;96;99;18388;0.0053839460517728956
40931;有什么方法能够联动所有人抵制ai呢？那就是让很多人感受到ai的摧残，不满现在不止弥漫在画画界，还有律师，音乐家，小说等等;30;86;116;18388;0.00630846204046117
40962;突然想到一个问题，现在的大部分绘画艺术都是基于商业需求，ai以后干的事情也肯定是服务于商业。那么当到了ai能代替大部分画家满足商业需求时，比如有一个游戏所有插图都是ai生成的，那么另一家公司可以一尘不变全抄过来，做一个一模一样的游戏，本来游戏行业玩法抄袭已经见怪不怪了，现在艺术插图也可以完全抄袭，因为ai生成的东西没有版权，就像现在ai图这么猖獗的原因也是没有版权画家告不了一样。而且Ai图说到底也是一键生成的，没有了生产成本其价值也会变低，而且是低到廉价的程度，放在以立绘为卖点的氪金手游里，资本家想要赚钱，但作为消费者不会为廉价的立绘买单，甚至可能看也不看一眼。;11;54;65;18388;0.0035349140743963455
40974;还有肖像权的问题，已经看到毫无道德底线的人用正常的照片通过AI来生成黄图了捂脸;3;42;45;18388;0.002447248205351316
40978;资本只在乎收益，不会考虑画师们的利益的难过;10;48;58;18388;0.003154231020230585
40989;一些人还说不是偷的;39;118;157;18388;0.00853817707200348
41029;笑其实举个最简单的例子就知道为什么画师对于AI那么讨厌和愤怒了一个从来不学习的学渣考试作弊得到了和努力学习的你相同甚至比你好的成绩，顶替你拿到本该属于你心仪大学的录取通知书换你你愿意吗？现在AI也是如此，画师长时间学习思考的成果，给一群不从来不画画的人偷去生成图片还美名曰这是我辛辛苦苦打tag出来的所以这也是我画的请问这种剽窃来的“画”能称之为你的绘画作品吗？AI没有自主思维他做出来的东西全是人为赋予他复制的结果根本谈不上“绘画”看到AI作图后面还加个绘画简直侮辱绘画两个词，如果AI作图能成为绘画建议人类把绘画和艺术家相关的词从字典里删掉好了;4;138;142;18388;0.007722427670219708
41034;虽然难以接受，但更多比画画还重要的东西都被摧毁了还没人管，画画这件事又有谁会管。笑哭;8;43;51;18388;0.002773547966064825
41043;一群贼偷图喂AI来满足自己没有刻苦学习就能达到的虚荣心，背后有没有显卡厂商变相炒显卡的价格就不得而知了，至少现在有一点是清楚的：这是一个由资本布局的商业行为，与人类进步无关。;1;125;126;18388;0.006852294974983685
41047;？为什么这么多人没看视频就发表评论，根本问题不是技术本身的问题，而是利用这些技术背后的公司的大量盗版然后赚钱的问题。;1;27;28;18388;0.0015227322166630412
41049;其他行业被AI掠夺的时候，我也不会替他们说话，反正最后赢的总是资本，毁灭吧，累了。;9;108;117;18388;0.006362845333913422
41062;AI就是强盗没得洗，除非他把数据库的每一张图都买下来。AI高潮的无非是没得艺术细胞，还妄想用艺术（AI生成））赚钱的。没有道德法律约束，人类迟早玩儿完。;2;71;73;18388;0.003969980422014357
41066;按ai的发展速度，有几个行业是有自信未来自己绝对不会被代替的？一天到晚在网上嘲讽失业画师的网友还是多为自己想想吧吃瓜;24;57;81;18388;0.004405046769632369
41093;ai画出来的画毫无美感逻辑可言，这是我不喜欢ai绘画的主要原因。但是我同时也在做ai歌唱，因为嗓音这东西是天生的，是不可改变的硬件屏障，我还是很感谢ai能够给我一个玩音乐的机会。但是绘画不同，是可以后天努力改变的，所以我觉得这方面不应该依赖ai;35;45;80;18388;0.004350663476180117
41132;ai绘画是在抹消人的价值;8;55;63;18388;0.0034261474874918425
41141;这禁止标还被拿去跑ai玩了;1;22;23;18388;0.0012508157494017839
41144;有一说一，如果是要画这种抵制ai的抗议图，其实直接画个简单的禁止符号即可，完全就不应该画的像封面那么细，还非得加各种元素进去tv鬼脸估计人家这张抗议画中的毒蛇和机械纹理，现在可能也已经被ai当作素材学习进去了笑哭;10;67;77;18388;0.004187513595823363
41155;这克隆人来解决生育率低下多是一件美事啊，tnnd为什么不用，为什么反对技术进步;2;23;25;18388;0.0013595823363062867
41159;我；打不过，摆烂，反正不只是绘画领域，配音圈和文案圈也惨遭AI洗礼，大不了，以后一个工地见，希望各位搬砖的时候给我留两块doge;2;34;36;18388;0.001957798564281053
41162;支持Ai绘画不是艺术Ai绘画要求作出限制，动画依赖Ai可以，毕竟经费是有限的，动画师也想要轻松，但是原画绝不可以用Ai希望国家可以发出管制，这是在毁了人类审美有人说当时汽车出现马夫也不愿意，你是马吗？汽车只是代替了马，没代替马夫黄包车夫可以去开汽车，马夫也可以去开汽车，但是马不可以Ai不是艺术，只是工具记住;13;21;34;18388;0.00184903197737655
41176;但是AI不是自己努力得来的，AI也不是你自己做的东西，就会让人不满，凭什么你这么容易;2;33;35;18388;0.0019034152708288013
41181;up说的挺对的，要抵制的是公司这种盗用他人素材这种不道德的行为，而不是ai本身，因为根本抵制不了。但国内社区吵的基本还是AI绘画饿死画师这事。。。。;4;36;40;18388;0.0021753317380900587
41186;不仅有ai绘画，还有ai编程，ai作曲，ai声乐，ai动画甚至ai论文ai法官。以后反ai的作品将会由ai生成;3;30;33;18388;0.0017946486839242985
41190;谁管你，只要把你的作品往软件里面一丢稍微改一下，你的东西就是我的了doge懂不懂什么叫科技的进步啊，抄袭哪里有抄袭？按照这个道理来说你们人类学习难道就不叫抄袭了吗？你们就是反对技术，就是砸纺织机的纺织工doge你们4，5年才能学会的东西，我两三天就搞出一大堆了，我我还是建议趁早转行吧doge画东西这么没有效率，活该被淘汰doge;4;39;43;18388;0.002338481618446813
41195;看完更焦虑了本来可能说服自己在工作上为了效率不用的话会被人优化的用吧（说实话也确实难用，加上公司电脑配置又差只有2G）心情又开始猛烈动摇，真的不知道如果被公司开了还有几家能接受我比不过AI的效率我的生活只会更加艰难，当然如果我的技术过硬，我确实不需要担心这些，很遗憾我只是一个画的不够好的普通画师;1;15;16;18388;0.0008701326952360235
41199;今天你帮画家，明天画家就帮你，不要觉得事不关己，等以后你的职业被AI取代了，你就知道了;6;36;42;18388;0.0022840983249945617
41206;反正再怎么卷也卷不过ai，对绘画的热情也不如以前了，我曾经以为我找到了我一生的救赎;1;14;15;18388;0.000815749401783772
41210;我所在的测序行业已经开始应用AI了，其他的到不是很清楚，不过早在novelai之前ai就已经在逐步替代某些工作。画师这类行业因为面向大众所以舆论声量比较大，但肯定没办法阻止大趋势。最简单的一点ai只要继续运行赢家设施就会大量消耗刀乐，更别说其他投入，除了用最原始的物理方法。不太可能阻止人力被替代的情况。pop子和pipi美哭哭;1;12;13;18388;0.0007069828148792691
41213;AI技术本身是没有问题的，有问题的是那些自称有所谓梦想、没有天赋，却不想努力学习，投机取巧使用别人的付出和血汗来训练AI，点点鼠标生成图片后自称插画家、艺术家，还声称自己这样不学无术之人马上就要取代真正付出努力和热爱的画师。（别跟我杠杠就是你对呲牙）;4;11;15;18388;0.000815749401783772
41219;Stablediffusion模型的作品，精细程度与二十一世纪的写实艺术家们相当；Novelai的二次元，在绘圈能卖到一百五十元，与绘圈小画家的平均水平差不多；但这些仍不过是传统的数据驱动型ai而已，不可能与人类画师抗衡。基础理论决定一切，开源社区清楚地看到了这一点。而你们，却被回光返照的低级技术蒙住了眼睛。你们躺在营销号的温床中安于享乐，对即将到来的真正威胁人类的技术完全没有精神上的准备。;9;28;37;18388;0.002012181857733304
41229;我不知道创造出ai绘画的人是怎么想的，我只想说发明ai绘画可以让人类进步吗？既然没有的话，那为什么要发明它，这种东西有什么存在意义吗？只会让更多人失业，让更多人不会去学画画，让更多人失去耐心，让更多人失去审美能力，人类是走不出太阳系的，不是因为外星人或者天灾什么的，人类最后只会死于自己手里;3;17;20;18388;0.0010876658690450293
41234;现在Ai作品还挤占很多的浏览量，随便搜个关键词里面一堆作品都是Ai作品，而且甚至还有用Ai作画来搞付费约稿的，价格白菜价;2;10;12;18388;0.0006525995214270176
41241;ai发展太快了，现在是喂图，未来不敢想;28;19;47;18388;0.0025560147922558192
41270;ai不行手不会画不说各种细节都不可能画好;4;11;15;18388;0.000815749401783772
41275;如果资本用AI作图，那我也不会花钱买用AI画出的皮肤脱单doge，更别说充一分钱了，游戏最重要的不就是画面吗，让我知道画面成本这么低，凭什么让我充钱？;3;8;11;18388;0.0005982162279747662
41280;就一句话，画画是人对生活的一种表达方式，这都能被代替，ai咋不替人活呢;1;8;9;18388;0.0004894496410702633
41289;如果这个事情得不到解决，我很期待断电的那一天，人们还会用什么创作。;1;7;8;18388;0.00043506634761801175
41291;很简单，你觉得哪个模型侵犯你的权利，去法院告它，你觉得拿被分享的图片训练ai违法，让法律禁止它。但哪怕一个国家禁止了，可以用服务器在其他国家训练，再把结果分享到禁止训练的地方，一样可以生成。指望法律约束ai训练根本没用，这玩意不会停下来的;1;9;10;18388;0.0005438329345225147
41293;AI很难做到创新，他只能通过他学习的那些图片来创作，如果以后都由AI来代替，人类的艺术就会停滞，除非AI发展成有独立思维的机器人，拥有自己的生活（有点不切实际，说实话）;5;6;11;18388;0.0005982162279747662
41299;即便从在一个冷漠的、不关心从业者死活的、对免费的“原创图片”喜闻乐见的非从业者的角度来看，这也并不只是钱的问题，更深层次的问题在于现在的AI事实上并不具备和人类艺术家同水平的创造的能力。在出现一个能被严格证明有能力创作出任何古往今来的人类有可能创作出的作品，以”合理地”终结绘画行业之前，过早地终结这个行业对人类这个整体来说是一个不可接受的损失。这和挖掘机取代了（至少是绝大部分的）工人、发动机取代了（至少是绝大部分的）纤夫有着根本性的区别，因为现代科学可以轻易地证明机械的强度和适用性在绝大部分场合下远远超过任何时期的人类，而即便是AI技术的头部从业者也只会说AI和人脑没有办法进行比较。;4;6;10;18388;0.0005438329345225147
41309;反正我个人以后所有的作品都不会使用AI的。慢就慢呗，我是很享受这种亲手创作的过程的。;1;5;6;18388;0.0003262997607135088
41311;最大的问题是任何艺术家的进步都会被AI吃光卷平既然进步无意义又何必进步;1;5;6;18388;0.0003262997607135088
41314;我认为AI应该成为画师们的工具而非敌人，应该用AI来保护自己的权益。stablediffusion的模型自20开始已经避开一些明星的面容生成，这是其中一个好的方向，但我认为可能解决不了根本问题。根本问题还在于在AI生成图像的使用上要加以识别并发起维权。我的想法是应该用有版权的画师作品来训练一些模型（非生成模型）专门用来识别AI生成的作品是否侵权。从工具角度，画师可以通过用自己作品训练的模型授权一些商业用途。或者通过这些模型快速产出一些作品提高自己的生产效率。;3;5;8;18388;0.00043506634761801175
41319;问题是现在反ai也变成一种行为艺术了。。。;6;18;24;18388;0.0013051990428540352
41326;ai爱怎么进步怎么进步但要有人拿着未经允许的数据库不付出辛苦只打关键字就获得相同的收获你就给我死千刀万剐就是这么过激不满意就来网暴我;1;6;7;18388;0.0003806830541657603
41329;我不喜欢AI画，我觉得AI画的和人画的显得十分僵硬和不自然，这种感觉就不像是一个画该有的样子，它美吗，美，但是种很僵硬的美;1;6;7;18388;0.0003806830541657603
41331;最近在B站看到一些自制的AI歌手（歌手本人在世）唱某些歌，乍看是自我满足希望某歌手的声音来唱喜欢的曲子，可能满足了现实中达不到的需要（现实中该歌手不想唱这首歌之类的）。虽然没有商用只是分享，但感觉也在版权附近试探了像之前了解的明星声音AI导航语音，都是达成商业合作双方同意的结果，现在未免过于泛滥难以控制了。;2;4;6;18388;0.0003262997607135088
41340;研发技术的人很可能沉浸在自己的美好未来幻想和骄傲中，也许不会发现一项技术带来的负面影响。现环境下，我实在感觉到我们教育中对人文教育的缺失。这种奇怪的环境下造出了一大批“机械神教徒”，盲目追捧崇拜科学技术，给自己心里造出“赛博新神”。;4;4;8;18388;0.00043506634761801175
41346;资本家决定垄断生产资料;4;4;8;18388;0.00043506634761801175
41360;ai坑的可远远不止艺术家来古呆滞不过能有啥办法呢，大势所趋挡不住的，总不能因为害怕失业就不发展科技吧;2;3;5;18388;0.00027191646726125733
41366;想象一下未来的乌合麒麟是个AIdoge;1;3;4;18388;0.00021753317380900588
41368;其实问题在哪？这项技术过早的投入商用以及某些人想从中牟利，现在的ai绘画高端点的还处于模仿阶段，低端点的还在拼石块囧;9;4;13;18388;0.0007069828148792691
41378;送你一个词：新卢德运动本质上是旧的生产关系限制持续进步发展的生产力;2;4;6;18388;0.0003262997607135088
41382;一句话总结：喜欢的事被外界冲击，但既然是我喜欢的努力过的，被冲的稀巴烂也无所谓。;2;4;6;18388;0.0003262997607135088
41394;在这里问一下，ai翻译和ai绘画的差异在哪呢？ai翻译在学习的时候所使用的语料库有没有版权呢？好像ai翻译并没有多少人抵制，反而是后来成长起来的ai绘画先掀起了抵制的浪潮，这两者有什么区别呢？如果说ai翻译基本上是在辅助译者，那用ai绘画来辅助画师，这样是可以接受的吗？;8;2;10;18388;0.0005438329345225147
41403;每次看到这种视频都很焦虑，真的因为我又用Ai又画画（就网上的漫画那样），我也拿我的画喂过Ai，这种视频就是让我在科技和原生之间选择，但我觉得两个都好难过;2;2;4;18388;0.00021753317380900588
41407;我老师，劝我们努力学好三维，抓紧学好三维，不要在二维插画之类的地方着太多力，要趁现在三维还没被ai拿下之前学好三维，他和我们说，外面好多公司已经在辞退原画之类的人了，叫我们不要往这发展;2;2;4;18388;0.00021753317380900588
41411;说这些大道理，不如做一张AI生成的拜登se图来的实际，马上就会出台相关法律。;1;2;3;18388;0.0001631498803567544
41416;很好奇为什么没人抵制chatgpt，是不是还没到他们的工作被取代的时候doge然后他们还觉得可以用chatgpt应对工作，在过了一段时间后老板把他们开了，自己用或者顾更少的人用ai了呲牙;1;2;3;18388;0.0001631498803567544
41421;只有科技才可以战胜科技，所以我决定去抗吧鼓动老哥把原神炼进去洗两轮然后合法赚米，让O友替我们冲锋陷阵tv微笑;3;9;12;18388;0.0006525995214270176
41427;版权钱尊重问题重重但我支持AI发展;1;3;4;18388;0.00021753317380900588
41429;一般我不会关心这些，但是ai画的太（）了，污染我的眼睛初音未来嫌弃;2;3;5;18388;0.00027191646726125733
41433;我觉得，劣币驱逐良币是必然。ai取代画师也是趋势。更宏观的说，技术的发展会在这种思想下最终取代人类的所有重要工作。自从工业革命以来，人类一直在不断的用探索和行动来推动科学技术的发展，并使之成为人类文明进化的推动力。但是，随着科技的进一步发展，当人类越来越依赖人工智能，终有一日，人类推动文明前进的的这种探索和行动最终会被技术取代，人类最终将失去对自己未来前进方向的控制权，和对技术的掌握权。不过，回顾人类历史，正确的事情总是会被无法挽回的错误所代替。结果就是，代价由每一个人承担。;2;7;9;18388;0.0004894496410702633
41446;过个几年十年再看看是啥情况藏狐;1;1;2;18388;0.00010876658690450294
41450;放心，ai反不了天;1;1;2;18388;0.00010876658690450294
41454;AI绘画没那么大的影响跟画家手绘比不了哪有什么艺术成分他只不过是惊艳的画作更廉价了普通家庭可以进行廉价的定制而有收藏或者想购入艺术品的也能辨别出来人画的还是AI画的AI本质依然是模仿都是一个画家的性格他对这本画的理解以及每一笔都是有感情的呈现出的感觉是不一样的;2;1;3;18388;0.0001631498803567544
41461;说到底还是一个新时代圈地运动的问题，有没有一种方法可以让原始积累在“无痛”，或者说不那么具有压迫性的完成呢？;9;1;10;18388;0.0005438329345225147
41472;AI能不能通过模仿种地而让农民的收入降低？为什么不能？回过头来，能被AI完全复制的艺术家们赚得比农民多这么多，这样的法律和市场真的合乎物质原理吗？随着技术的发展，价格正在回归它本该有的样子。让我们拥抱这个新世界。;1;2;3;18388;0.0001631498803567544
41474;但是我觉得本身学习绘画的过程就是模仿别人的作品啊（有任何人能不看任何人的作品自己产出成熟的创意作品吗？）画面构成的要素方法肯定是有限的ai就是时代发展的趋势抄袭这玩意国内小画手抄大画手的风格和技法还不少吗？只能说之后我们不能过于看中技法而是要把重心放在表达上;2;2;4;18388;0.00021753317380900588
41481;最讽刺的是这个视频下面推荐了一堆ai作品，挨个举报都举报不过来;2;2;4;18388;0.00021753317380900588
41486;许多所谓艺术家们藏着掖着的东西被ai轻易学去，或许是因为它们本来就没什么艺术价值;6;3;9;18388;0.0004894496410702633
41493;开发ai绘画的团队不违法吗？这属于公然侵权;2;1;3;18388;0.0001631498803567544
41499;艺术品生成器本身也能作为艺术品发布。这类作品在现在叫roguelike游戏;1;1;2;18388;0.00010876658690450294
41506;AI去死吐;3;5;8;18388;0.00043506634761801175
41510;除开openai的，很多模型都开源了，每个人都可以用，根本没法管的;5;2;7;18388;0.0003806830541657603
41518;设想，AI进步没有这么快，即使喂了大量图片，依然只会画一些无意义的抽象线条，还会有现在这么多人抵制AI吗？如果你的答案是否，那你就不是真的想抵制AI侵权。设想，之前那些喂过别人图的ai统统销毁，今后ai只喂公开的，免费的，和经过授权的图，然后出图质量依然取代了大部分底层画师，你们还会不会抵制呢？如果你的答案是是，说明你也不是真的版权卫士，你真正想抵制的是被AI取代。;2;1;3;18388;0.0001631498803567544
41523;我最喜欢看有人对经济规律发动挑战;1;0;1;18388;5.438329345225147e-05
41525;一直有个疑问，虽然这些素材都是有版权的，但是如果只是作为AI学习和参考的对象被揉碎了之后生成的图，抛开思想灵魂啥的不说，这个过程本质上和人类原创有啥区别没？;5;0;5;18388;0.00027191646726125733
41534;时代在进步，不能抵制的话，只能拥抱了，版权这块是最好操作的，很多讼棍都喜欢在这边钻空子;1;0;1;18388;5.438329345225147e-05
41536;时代在前进哪有这么道理可言呢;3;0;3;18388;0.0001631498803567544
41548;我画了四年多，发现这个ai真的吊然后组了台电脑dogedogedoge拿来跑色图;1;0;1;18388;5.438329345225147e-05
41554;绘画软件是人类开发的软件，而AI绘画也是人类开发的软件，画师拥有的一切工具都是文明科技赋予的。画师的发展是科技的光芒照到了画师，而现在AI的发展只是拥有了更强烈的光芒。不管怎么说，人类确实无法回头了。;2;0;2;18388;0.00010876658690450294
41557;越强调道德的社会就越难以获得真正的创新;3;0;3;18388;0.0001631498803567544
41561;笑哭虽然我很抵制AI画画，毕竟我画了不短的时间了。但是我感觉自己其实没有资格愤怒，因为我用了那么多有版权的盗版资源软件什么的。。。。;2;0;2;18388;0.00010876658690450294
41564;有超大利润的行业肯定谁都想想分一杯啊约个破图几百几千还拽的不行;1;0;1;18388;5.438329345225147e-05
41566;手绘人无所畏惧doge;2;0;2;18388;0.00010876658690450294
41570;呃呃商业就商业，艺术就艺术，别缠在一起说吧。如果你真的热爱艺术，为什么要在意AI画的好不好呢？只要每天都比昨天的自己进步一点点不也挺好吗;6;0;6;18388;0.0003262997607135088
41579;很理解被机械取代工人的心情了。效率和工匠精神，人之所以会成为高等智慧生物就是因为人学会了用工具。而在一种新工具出现的时候，被取代者很容易会出现恐惧。我们从最基础的颜料纸墨笔绘画进化到电子绘画提升了很多效率和降低了很多成本。但是为什么纸张绘画的人没有站出来限制电子绘画呢。并且每个人学画画都是从模仿别人的作品开始的，然后逐渐找到自己的风格和创意。我们人工绘画的创意不会凭空产生，也是需要积累大量的数据。最后一些不侵权而惊艳的作品被选择性忽视，人工绘画也有抄袭的这取决于创作者而AI绘画则取决于输入关键词的人。不能一杆子打死一船人。;2;0;2;18388;0.00010876658690450294
41583;哈哈，现在ai已经开始入侵文学界了，估计不用几年各行各业都会有ai的身影doge;1;0;1;18388;5.438329345225147e-05
41602;求图三连了;1;0;1;18388;5.438329345225147e-05
41605;链接呢;1;0;1;18388;5.438329345225147e-05
41607;这种的太假了已经淘汰了;2;23;25;18388;0.0013595823363062867
41610;还有其他好看的doge;2;10;12;18388;0.0006525995214270176
41613;上链接啊;1;4;5;18388;0.00027191646726125733
41616;tag呢生气;1;1;2;18388;0.00010876658690450294
41618;AI都是手残除了长得好看;1;1;2;18388;0.00010876658690450294
41622;三连换图星星眼;4;1;5;18388;0.00027191646726125733
41628;啥时候能把手崩的补丁打上;1;1;2;18388;0.00010876658690450294
41630;这是那什么软件画的;1;1;2;18388;0.00010876658690450294
41632;有模型吗;6;1;7;18388;0.0003806830541657603
41640;手是后来休的吗;1;1;2;18388;0.00010876658690450294
41646;这是什么软件的。手指居然没问题。修过了？;1;0;1;18388;5.438329345225147e-05
41655;ai辅助，现在是人辅助ai了，ai是主导笑哭;15;192;207;18388;0.011257341744616053
41671;以后新工种，AI人工原画修图师doge;12;128;140;18388;0.007613661083315205
41684;私以为当ai攻入市场时，绘画变得廉价到所有人都可以画成这样时，门槛也就紧随变低。那么我们这些人在现在的努力都是一文不值，你说你特意学过训练ai？没用，不可能上岗，因为吃饭大家都会，不会的话，吃几顿就会了;15;33;48;18388;0.0026103980857080703
41700;doge自助式开盲盒的魅力就在此吧doge;1;23;24;18388;0.0013051990428540352
41702;那些笔都不动几下的懒狗们，是怎么敢想只靠ai碰瓷原画行业的呀吃瓜;24;59;83;18388;0.004513813356536872
41727;我也想跟着up玩sp，哦不，我是说ps妙啊;1;16;17;18388;0.000924515988688275
41729;不试试最新的controlNet吗？;1;16;17;18388;0.000924515988688275
41731;我要坚持手绘原创然后死后去英灵座doge虽然可能武力值很低顶多一星希望有人召唤我;5;37;42;18388;0.0022840983249945617
41737;ai的出现会更加让画师们注重版权意识，因为ai只有吃的更多的高质量图片才能可以去真正意义上辅助专业人员，自己瞎玩的除外，现在ai刚出现有真空期，各种大佬的图都被免费的纳入了它的资源库里，而有的软件却还收起了费，版权费的问题不解决这就是个bug。受益的只会是白嫖怪;1;33;34;18388;0.00184903197737655
41739;我觉得这才是ai的正确用法，就好像画师多了一个好用的的助手，而不是完全摒弃ai或者完全依赖ai;5;16;21;18388;0.0011420491624972808
41745;这玩意修图主要好处是门槛极低，只要画个大概AI就能猜出来，只要有幼儿园简笔画的水平就可以，也不用数位板，用系统自带的画图修都可以;11;14;25;18388;0.0013595823363062867
41759;根本就不用自己修图sd也可以;1;0;1;18388;5.438329345225147e-05
41761;UP这个用的是图生图吗。;1;0;1;18388;5.438329345225147e-05
41763;还有个难办的地方就是ai出图的清晰度低;1;0;1;18388;5.438329345225147e-05
41765;想请教一个问题，用stablediffusion的局部重绘功能时重绘出来的部分颜色整体比原图要浅，这个怎么解决。看你的视频里重绘的部分和其他部分基本颜色一样。;1;0;1;18388;5.438329345225147e-05
41771;说不定和预言相反，AI最先淘汰的反而是脑力工作者呢大哭像搬砖这种体力劳动者搞不好AI反而很难替代。。。;1;1;2;18388;0.00010876658690450294
41783;tag和模型是什么感觉现在新ai使用者们越来越少分享tag和模型了，明明用的是开源软件;1;2;3;18388;0.0001631498803567544
41786;这种画画已经没有必要了，因为99都不是自己搞的，顶多修图，而且特别容易跟别人撞，顶多二创罢了。明明我不是搞画画的，但越想但又越气捂脸觉得自己要被时代淘汰了;7;13;20;18388;0.0010876658690450293
41794;想问下up我画了一个色稿怎么用AI帮忙细化哇，需要哪些插件步骤是怎么样的，我自己研究了几天弄出来一直都是一团浆糊，要不就完成度比草图还低;1;0;1;18388;5.438329345225147e-05
41797;请问是什么bgm啊，好好听;1;0;1;18388;5.438329345225147e-05
41800;这个是怎么做的，我也想了解一下AI辅助，但是不知道从哪里开始笑哭;1;0;1;18388;5.438329345225147e-05
41803;up可以付费帮画吗;1;0;1;18388;5.438329345225147e-05
41805;这玩意画的图有版权问题吗;1;0;1;18388;5.438329345225147e-05
41808;可以问下UP用的是哪一款AI工具吗？;1;0;1;18388;5.438329345225147e-05
41810;这是哪个模型，up能告知一下吗;2;0;2;18388;0.00010876658690450294
41813;主播用哪个显卡;1;0;1;18388;5.438329345225147e-05
41815;不动脸下面随便涂抹色块也可以吧;3;0;3;18388;0.0001631498803567544
41821;这个ai显存吃吗;1;0;1;18388;5.438329345225147e-05
41823;怎么让ai定向修改的;1;0;1;18388;5.438329345225147e-05
41825;upup，你在ps画过的图存的什么格式的呀，我把画过的图放进重绘里重复几次以后图变得越来越糊了笑哭;1;0;1;18388;5.438329345225147e-05
41828;这用的哪款Ai软件啊？;2;0;2;18388;0.00010876658690450294
41832;upup，prompt怎么填写才能获得这样的画风啊？给心心给心心给心心（韩国娃娃的那些是需要下载的关键词组吗？找不到在哪下载大哭）;2;0;2;18388;0.00010876658690450294
41835;哥们眼睛方向不对;2;0;2;18388;0.00010876658690450294
41839;ai啥时候能直接生成s三维模型就np了doge;2;0;2;18388;0.00010876658690450294
41842;这几天我也在疯狂折腾显卡，有空就跑图，自己都懒得动笔，ai画的场景已经吊打我了，给ai打打辅助画画人完事笑哭;1;0;1;18388;5.438329345225147e-05
41847;什么显卡？只要1分钟？我这动不动就是10分钟以上;1;0;1;18388;5.438329345225147e-05
41849;Upup，你用inpaint的时候，模型选用的是impaint模型吗？;1;0;1;18388;5.438329345225147e-05
41851;和up一样会画，但是没时间懒，搞个草图或者大色块就ai，然而ai刚刚开始摸索打call打call;2;1;3;18388;0.0001631498803567544
41855;生成图好像不高清，高清很卡，很容易没动静笑哭;1;0;1;18388;5.438329345225147e-05
41857;这是up自己画的草图生成的，还是文字生成然后改;1;6;7;18388;0.0003806830541657603
41859;以前我一直不明白画画到底是画什么。;2;5;7;18388;0.0003806830541657603
41864;up可以出一出稍微详细一点的教程吗，关于这个视频PS的那部分，这期大致意思是能看懂，但是不知道该怎么操作（我PS操作界面不怎么熟悉，能看懂的但是不知道怎么自己做）;3;0;3;18388;0.0001631498803567544
41868;啥ai;1;0;1;18388;5.438329345225147e-05
41870;你有这水平还不如自己画笑哭;1;2;3;18388;0.0001631498803567544
41876;这样搞画画越来越不值钱了。doge;5;7;12;18388;0.0006525995214270176
41882;三连了，这是啥插件？;1;0;1;18388;5.438329345225147e-05
41885;装不了插件怎么弄，要手动去那个git下吗;1;2;3;18388;0.0001631498803567544
41888;0203吃瓜;1;1;2;18388;0.00010876658690450294
41890;啊这我没有我不是小黑子，只因为你的视频太有意思了;14;3072;3086;18388;0.16782684359364802
41905;首字里面的人有没有可能是隐形的doge;4;742;746;18388;0.04056993691537959
41910;别黑了，有意思吗笑笑你们越黑，我家鸽鸽越火，火越大，烤的就越香;48;7447;7495;18388;0.4076027844246248
41959;你这是喂了ai多少只因哥的表情包脱单doge;15;2277;2292;18388;0.12464650859256036
41975;要不来个囧试试？dogedoge;11;1237;1248;18388;0.06787035022840983
41987;戳啦，首字得斜过来一些，要么外面加个框（;3;109;112;18388;0.006090928866652165
41991;不错，答和首的提议者正是在下脱单doge;12;455;467;18388;0.025396998042201437
42004;君衣飘飞更刑了;1;11;12;18388;0.0006525995214270176
42006;辩呢傲娇;5;81;86;18388;0.004676963236893626
42012;象形字doge;1;115;116;18388;0.00630846204046117
42014;为啥我觉得封面这个答那么像人脸脱单doge;2;94;96;18388;0.005220796171416141
42017;关于我关注的UP全是小黑子这件事;1;90;91;18388;0.0049488797041548835
42019;写“答辩”会不会识别出昊京捏doge;7;101;108;18388;0.005873395692843159
42038;整个总呲牙;1;1;2;18388;0.00010876658690450294
42062;鸢羽yo哈哈嗨;2;4;6;18388;0.0003262997607135088
42067;AI是在哪里找的啊？什么软件啊;2;1;3;18388;0.0001631498803567544
42070;这里要提醒一下，倒数第二个不是字啊是贴吧的一个帖子然后被营销号炒出来了原帖；httpstiebabaiducomp3198541117;1;19;20;18388;0.0010876658690450293
42073;up这是什么软件啊脱单doge;1;1;2;18388;0.00010876658690450294
42077;什么音乐？;1;2;3;18388;0.0001631498803567544
42080;可不可以把si那个字的图片发到动态里，三连奉上;1;23;24;18388;0.0013051990428540352
42085;这个是怎么做的啊？我也想玩玩;1;1;2;18388;0.00010876658690450294
42087;什么软件啊up？;5;5;10;18388;0.0005438329345225147
42096;把图放出来啊，那张死的星星眼;4;14;18;18388;0.0009788992821405265
42111;盘古耶和华卡俄斯女娲宙斯哈迪斯鸿钧太清元始通天后土准提接引，这有小黑子，快带走;1;1;2;18388;0.00010876658690450294
42123;么么安;2;0;2;18388;0.00010876658690450294
42127;写个“片”doge;1;0;1;18388;5.438329345225147e-05
42129;bili60352262650;1;0;1;18388;5.438329345225147e-05
42131;机器工具人识别音乐;2;0;2;18388;0.00010876658690450294
42135;机器工具人识别音乐;1;0;1;18388;5.438329345225147e-05
42207;下次来个“辩”;1;0;1;18388;5.438329345225147e-05
42221;ah今天吃什么哈哈哈哈哈哈哈哈哈哈哈哈哈哈哈哈哈哈哈;3;0;3;18388;0.0001631498803567544
42278;噶累噶累噶累康克瑞，布瑞克布瑞克布瑞克比比烦（幻奏dj版）;1;0;1;18388;5.438329345225147e-05
42280;脱单doge子凉Z;1;0;1;18388;5.438329345225147e-05
42282;是豌豆豌豆;1;0;1;18388;5.438329345225147e-05
42338;快发图，我想要“死”;1;0;1;18388;5.438329345225147e-05
42346;谢谢学了12年画画已经准备摊煎饼了;43;466;509;18388;0.027681096367195998
42390;其实都不会失业，不过从业要求多了一个熟练使用aidoge;19;147;166;18388;0.009027626713073745
42410;之前同学和我杠，说画画不会被替代的，他学了绘画，我学了编程doge;45;145;190;18388;0.010332825755927779
42456;可以想象，当ai把美术配音，甚至简单编程都搞定后，虚拟文娱产业将迎来质一般的飞跃，人类可以用极低的价钱享受极高质量的产品。现实的一般享受很可能比不了这些产品，人们更愿意花时间在这些产品上面，于是元宇宙的雏形就诞生了;12;54;66;18388;0.003589297367848597
42469;谢谢，学了三年编程，还计划着学画画doge，现在可以准备去烤肠了;5;53;58;18388;0.003154231020230585
42475;失业是不可能的，首先你要会，会了你要入行，然后再谈失业。门都没入，谈什么失业，给自己照不自在吗？;5;51;56;18388;0.0030454644333260824
42481;还以为啥新技术，点进来一看还是cont，来来回回要么cont要么lora就这俩反复新技术是吧笑哭;4;24;28;18388;0.0015227322166630412
42486;室内设计那个，岂不是行业门槛一下子降低好多;20;24;44;18388;0.0023928649118990647
42510;推特上都是没穿衣服的;4;8;12;18388;0.0006525995214270176
42515;关于手，有没有一种可能是因为手控太少了doge;2;8;10;18388;0.0005438329345225147
42518;怎么提取线条？？这个太牛了;4;8;12;18388;0.0006525995214270176
42523;玩了aiweb只会基础，但是我发现毕竟电脑生成的，有些想要的画面仍然是生成不了的，光文字描写还是不够，图生图也是，和我幻想出来的还是有差距;2;7;9;18388;0.0004894496410702633
42526;没事，美术专业的兄弟们还有一条路。;4;7;11;18388;0.0005982162279747662
42531;关键是怎么固定生成的是同一个虚拟人物，我现在生成的每个都长不大一样笑哭;17;7;24;18388;0.0013051990428540352
42549;那不是日本女演员也可以失业了吗doge;1;5;6;18388;0.0003262997607135088
42558;失业倒是不必，这玩意儿都是付费的。除非到处都是本地部署。;1;1;2;18388;0.00010876658690450294
42576;别想了，都不会失业，只是绘画工具变了而已;1;0;1;18388;5.438329345225147e-05
42580;再发展发展，是不是可以个人做动画，上学时就想过动画化方想的小说;1;0;1;18388;5.438329345225147e-05
42587;新行业产生，学会ai画图，可以顶多少个画师了滑稽;1;0;1;18388;5.438329345225147e-05
42590;sese图是不是没资源喂啊一点进展没;1;0;1;18388;5.438329345225147e-05
42593;ai绘画，以后会不会有ai动画啊喜极而泣;2;0;2;18388;0.00010876658690450294
42596;某些特点是ai画不出来的doge;1;0;1;18388;5.438329345225147e-05
42608;以前我高中的时候，花300找个画师画头像，完事我发现他根本没看我的要求，我要的是萝莉他画了个男的，完事给我删了，我也全当买了个教训，后面几年在QQ群里聊这个事，群友发现他给我的完全就是别人画里截的，这种叼画师被AI创死我只能说好死，现在有了AI好歹我能自己生成自己要的了吃瓜;21;1021;1042;18388;0.05666739177724603
42630;我科普一下。我发现很多人不知道，AI直接生成的图没有著作权，在我国法律中，画师作品一经完成创造即享有著作权，但是AI绘画不同，AI的版权方在公司，画出来的画是AI的，而使用者画不出来画，跟他没关系，别人拿AI生成百分之九十以上相似度的图你是完全没有版权法来告他们的，而没有版权跟著作权代表什么呢？这意味着你也没用对这幅图有拥有权，而没有拥有权跟使用权还有著作权的图，基本等于废物，这就是这个技术的致命伤，我们再来说说对标的珍妮机，人家珍妮机生产出来的产品，属于买方，别人要不经过买方同意私自拿走。那算什么？算偷，算抢，这生产图大家都可以用，有什么价值可说？而著作权这点就是衡量画最大价值的东西，哪怕你死后拥有权不在你这里，但画依旧会标注你的名字;953;2488;3441;18388;0.1871329127691973
43584;其实是很不甘，学了很久的绘画，到时候几个小鬼跳脸说画的还不如他们好，一看是AI绘画辅助，心里还是不平衡的;13;478;491;18388;0.02670219708505547
43598;抵制技术是愚蠢的，但毕竟艺术现在他们现在还学不会，ai会画画也仅仅是画画而已;23;363;386;18388;0.020991951272569066
43622;二月这玩意能看？十年内不用担心九月初手脚画得不好，崩坏处太多，一文不值九月底都是靠拼贴缝合的，模型里有素材库十月初没有灵魂历史上每当新事物出现时，这类现象也算屡见不鲜并且如果AI真的从素材库拿图，那么内存得几万T。但是现在AI不联网也能跑，为什么还有人认为AI跑图就是这里拿一个头那里拿一个眼睛再从其他地方那个鼻子和嘴呢？;28;194;222;18388;0.012073091146399826
43651;米画师下架了所有ai绘画，b站工坊下架了一大批ai绘画，小红书半次元老福特一有用ai接稿的被喷的半死。现在繁荣的也许只有咸鱼。;7;90;97;18388;0.0052751794648683925
43659;不理解为什么很多人抵制它，就算他画的再好，也只是将画师们的画从普通推向高端，Ai绘画注定廉价，就像如果机器能够做菜，那人做的菜一定比机器卖的贵一样。;85;131;216;18388;0.011746791385686317
43745;AI确实厉害，不得不承认，但是那些说跟紧时代嘲讽攻击人家努力学习画画的也要学会换位思考，他们已经很不容易了，练了这么多年吃饭的家伙说没就没了，而且本身这技术诞生就离不开他们的汗水。可能很多嘲讽的人是被离谱小画师坑钱坑时间了，但以小标签囊括一个群体过于草率，大部分人都是正常且知礼的。所以，对于画师还是体谅为主吧。当然这门技术也不是说就直接废弃，等以后相关规定合情合理能够保障他人权益不受侵犯时，这项技术对于动画之类的2D作品的产生可以说是节省成本节省时间的利器，希望到时候，我能够看到许多优秀的国内2D动漫像雨后春笋一般跃然于屏幕上吧保卫萝卜哇;14;80;94;18388;0.0051120295845116384
43760;技术发展势不可挡，它太快侵入人们的生产生活了，感觉很多人都没有准备好，因此被淘汰的人就一夜之间失去了生存的手段，挺无措的。。各行各业都这样，很好奇未来是怎样接轨人与科技间的断层思考;6;57;63;18388;0.0034261474874918425
43767;我只能这么说吧，我听说的是，绘画里，甲方当孙子，画师当爷爷，而且有好多人都被坑了现在那些低端画师没法坑人挣钱当爷爷了自然就会反对了;12;83;95;18388;0.0051664128779638895
43780;ai会把画师分流最后只有顶尖画师才能留在行业内我很支持ai不过版权确实是一方面的问题希望以后ai可以向画师买版权放到资源库然后使用者使用的时候可以购买生成图的版权这样顶尖的画师除了接单子之外还可以把自己画的卖给aiai还能为我们除去一些装模作样的外行画师让他们没有市场多好;9;63;72;18388;0.003915597128562106
43790;热评激萌阿虎v6实属人才，码字贼快，一问他口中的法律与条款出处，给的全是就只有关键词对上的，属于是问他怎么炼钢，他给我读《钢铁是怎样炼成的》;11;73;84;18388;0.004568196649989123
43802;我画画因为我喜欢，我就会给我的画赋予生命，ai画的很好，技术很好，值得我去学习，但也只是一味的为了画去画，但也不否认对他的喜欢和方便，但经由我手的绘画是值得赋予爱的，因为每画一幅都会倾注我的热爱，他们，是有灵魂的，我会更多的去学习的害羞害羞害羞，大家也要加油啊;11;45;56;18388;0.0030454644333260824
43814;腾讯ai创作大赛，用ai作画，然后版权是他们的，笑死，ai的版权还没搞明白呢，它就已经开始暴露嘴脸了;3;51;54;18388;0.0029366978464215794
43818;ai这东西怎么说呢，它好，又不好。“ai超越人类”这句话我感觉打击很大，比如：柯洁与阿尔法的围棋战，他输的那一刻，我都感觉很难受，更不用说一些热爱画画的大佬们了。;5;41;46;18388;0.0025016314988035677
43824;首先，真要算的话，AI的作品算是公司的版权。也就是创造AI的公司的版权。但问题是，人家是傻子吗？只要有需要，人家肯定会直接把版权开放给付费的会员。所以什么版权问题这个是迟早解决的，请给资本主义一点儿信心。在低价和效率面前，相信没什么会成为资本主义的阻碍。只要有利润，肯定是想破头的挤过去。请相信资本主义的嘴脸。;15;34;49;18388;0.002664781379160322
43840;偷别人的成果榨成的汁而已吃瓜;15;68;83;18388;0.004513813356536872
43857;关于ai绘画这个软件产品在开发过程中使用大量未经允许的作品训练的严重侵权行为，因为法律上的不完善导致画师维权不了而觉得画师是罪恶的，资本才是正义的，你可以想一下为什么你被资本剥削是合法的就可以了。;41;36;77;18388;0.004187513595823363
43900;虽然AI画画跟好看，但我依旧想学画画，喜欢画画，那种任我创造、全心投入、每一个笔触每一个色块都出自我手、最后反复去看、反复夸赞自己的感觉太美妙了，可能是因为我并不在这个行业中，并没有什么焦虑吧，我只是想说画画带给人的快乐永存，画画所投入的情感永存，当开始第一笔起，它对于我来说便比任何AI绘画要珍贵了。;2;20;22;18388;0.0011964324559495323
43903;ai就是指令的产物，没有情感，作品永远只能模仿，做不到创新，作品也流露不出人类的情感，那么它的作品终究只能是一张廉价的画纸。而且如果ai绘画成了流水线工程，那么画师的存在就没有意义了，如果人类画师终有一天后继无人，那么绘画艺术离停滞不前也不远了。为什么？道理很明了：一个是热爱而去画，一个是指令驱使下为了画而去画。;3;5;8;18388;0.00043506634761801175
43908;我是画师，关我屁事，谜之焦虑，底层画师小鬼越少我越乐吃瓜;7;17;24;18388;0.0013051990428540352
43917;艺术是表现画家感情的，这只能叫美图;1;16;17;18388;0.000924515988688275
43919;AI终究是比不过人，因为画出来的作品，没有“神”。;4;8;12;18388;0.0006525995214270176
43924;我觉得说ai绘画是打击画师行业的根系倒是不至于，我觉得要在这个行业有立足之地本来就是先说画画再谈赚钱，很多人都是先喜欢画画才去画画的，然后才能坚持下去，熟练了自然而然就能接到稿子，还有一点就是画师毕竟是人，灵活性和应变能力肯定是高于ai，至于情感表达其实能被模仿就是因为商图的大众风格有趋同性，我画画的时候就不会想那么多就是为了好看，所以我其实不会觉得ai的画面呆板没有感情什么的，当然具有强烈感情色彩的作品确实感觉是无法被模仿的，而且有时画画没有思路了说不定ai的图能提供参考和启发，优秀的画师是具有不可替代性的，而不那么优秀的画师有了ai这个强力的竞争对手不一定就是坏事情笑哭我也去试着接过稿子，我应该算是被ai打压的那一类吧，感觉画技不行真的吃力不讨好赚钱不多对画画的提升也一般;11;14;25;18388;0.0013595823363062867
43936;感觉这个软件迟早要下架，因为没有版权，都是很多太太们画的图，这个软件就是把很多太太的图分解开再拼凑，就成了一副“新”画，这属于侵权了OK;2;5;7;18388;0.0003806830541657603
43939;怎么说呢，技术力人类确实是无法同ai相比的，但ai的画没有意境，有一些感觉有意境的，是在大量组合下，看的人赋予了意境，而不是ai在画时把已经画进去;14;17;31;18388;0.0016858820970197955
43955;说灵魂说感情的多少有点，活生生的人在你面前，你都看不出有多少感情，搁这在画里找，真的是热爱了，都是火眼金睛啊，技术就是技术，表现力就是技术，只要是技术，ai就能学，并且永恒的学下去，ai最牛逼的有两点，一是比你活得久，二是比你刻苦千万倍;5;19;24;18388;0.0013051990428540352
43963;行了行了十年前的老废物别吹啦，要进化早进化了。换个皮出来骗钱被自媒培训班小丑吹的呀。概率模型大头贴吹屁啊，什么鬼ai，概率统计模型少装逼、像素点堆积概率筛选什么时候还有本我意识了扯犊子，十几年前的老废物拖出来再吹一次，拿个搞笑奖，搞个推广，说这玩意可以注册版权，怎么版权局踢回去比有的人多？要真有还用踢？拿广告吹广告，哎呦神逻辑。上一次说取代美工，这次取代画师，除了恶心画师以外没任何正面效果;2;3;5;18388;0.00027191646726125733
43966;看到你们，我就很生气，什么都不懂，瞎说，ai的技术压根就是拿别人的图缝合起来的。没有版权，没有版权，而且反过来压榨画师们的空间。日本那边很多画师已经开始在网络上删图了，因为AI公司有扒手的全网抓图。对此，我只能表示直接抵制就完了。AI，是用来辅助的，不是代替挤压人们的生存空间的。遇到的种种问题都能内部解决，各种谴责。至少是手绘出来的，而AI就是在一边拿着大家的图缝合起来，一边又在挤占画师们的空间。这种原理压根就是侵权的可耻的压根不是什么技术发展？有人拿着工业举例，我只能表示你懂什么？AI不是画画是裁缝，拿着画师们的画缝合起来。而且还压榨画师们的生存空间，在没有画师同意的情况下，把画师们的图导进素材库。这种行为是什么，不能用以往的来概括的好吧AI，不会画画只是裁缝搬运工没有作品。我只能表示面对这种行为，我宁愿自己画画的自己亲手动手的。画作背后的意义是什么？难道就是，用着几万人的画作拼接起来的四不像？而且这些被拼接的人的画作压根也是没有授权的。而且还要说的是，以上都是商业行为，不是科技的进步，而是压榨，科技进步了，人们生活不能变好丢了工作，那还要干嘛？况且，这是建立在血腥可恶的盗图之上的。不要用什么进步啊，实验啊，各种各种的来绑架版权就是版权，一声不吭拿走就是犯罪。长此以往的那些画画的怎么办他画的不好你不会只挣不买吗，有的人画的好这都是市场内部问题，而不是来一个血腥掠夺侵权毁生态的悲哀，公司来直接把所有人都一杆打。像这种的，怎么可能没有影响？没有挤压到生存空间？承认有些小画家确实是懂得都懂，但是也不应该由那些侵权的AI公司来毁掉整个画画的生态，让他们失业，无单可接。况且这一切都是建立在没有版权全网抓手，无似放肆的侵权情况下的，等于就是用着画师们的图挤压着画师们的生存空间，让画师们丢掉饭碗没饭吃。对此我只能表示坚决抵制我只站在正义这边;3;14;17;18388;0.000924515988688275
43971;我用AI画个图自己欣赏，不行，非得花钱找那些三流二流画师是吧。你说画师也有一流的画师，没错，但是个人都有钱请一流画师作画是吧吃瓜吃瓜吃瓜能用免费的AI，几秒一张图，我为什么要花这钱去喂给二三流画师？吃瓜吃瓜吃瓜物竞天择，适者生存，你要想不被淘汰，要么适应它，要么努力超越它。;1;3;4;18388;0.00021753317380900588
43973;有的不是ai的吧，有张感觉最起码三年前的画了，p站就有，就黄昏的那张。;1;10;11;18388;0.0005982162279747662
43975;一句话，ai会达到人类的顶端，但人会死，ai不会;1;11;12;18388;0.0006525995214270176
43977;没事，我落榜了妙啊;3;11;14;18388;0.0007613661083315206
43981;让我想起马原了，机器不创造价值，所以ai的图无法商用，不过一大批画师的价值已经快要被社会平均生产效率的提高打压干净了，哪怕是最值钱的画师面对平均生产效率的提高也得贬值。;1;3;4;18388;0.00021753317380900588
43983;二次元本来就是为了批量生产才开发出来的画法啊，它本身就是最适合批量生产的，要我说这不叫ai抢了人类饭碗，这叫ai终于拿回来了属于自己的饭碗;13;16;29;18388;0.0015771155101152925
43997;不管高水平的人他能不能超越，反正亲自尝试过了后我身边绘画圈稍微不那么专业的都没法画出这种水平的，ai只要你稍加引导不断的生成就可以了，比人快了太多太多;2;9;11;18388;0.0005982162279747662
44003;理论和情理上来说抵制现在这个ai绘画在法理上合理的，看似很合理但快速的抵制只会快速进一步加剧未来艺术家的工人化和去艺术化，程序就在那里，没有的只是模板，在创作和培养做模板的人带来从输入端到学习端的大批就业岗位的同时，也把整个行业的地位拉低了，不过就算现在不抵制也无济于事，当ai绘画证明了能做到今天这步的时候，人类艺术家的艺术性构造就已经开始崩塌了;1;10;11;18388;0.0005982162279747662
44005;ai很棒为什么不用，还不用去看那些画师摆着一张臭脸;9;38;47;18388;0.0025560147922558192
44015;AI绘画是本世纪最伟大的发明之一;44;18;62;18388;0.003371764194039591
44066;AI绘画与人类绘画的差距就如同人造钻石和天然钻石一样怪我咯;2;2;4;18388;0.00021753317380900588
44078;没有感情，再艳丽也是废品;3;6;9;18388;0.0004894496410702633
44083;不抵制，甚至希望能辅助作画，而不是抄袭，裁缝，被一些不会绘画的人拿来嘲讽会画画的人。;1;2;3;18388;0.0001631498803567544
44086;眼睛画的完全看不出是一个活人;1;2;3;18388;0.0001631498803567544
44088;我不知道ai绘画会对画手造成影响，我只知道我现在可以随时随地讲脑海中的画面转换到现实了（虽然大概只有六七成像吧，但也比以前强多了，我自己既没天赋又没有时间，连跟画手约稿的钱和时间都没有，至于版权问题，我又不商用，我自己生成了给朋友和自己看的，版权问题跟我又有什么关系）;1;6;7;18388;0.0003806830541657603
44090;有没有画师愿意开启挑战ai的作画活动;1;2;3;18388;0.0001631498803567544
44092;版权：？阿？审核：你敢商用？原画师：喵喵喵？;2;2;4;18388;0.00021753317380900588
44095;人类，还是太弱小了大哭;4;2;6;18388;0.0003262997607135088
44100;Ai大部分时候都是人工智障，只有小范围的东西可以画的很好，很多时候你是没办法得到你想要的东西的。还有人类的创新能力是目前Ai学不来的;2;2;4;18388;0.00021753317380900588
44108;现在AI能画吃面条的画了吗思考;1;1;2;18388;0.00010876658690450294
44117;AI绘画是没有所谓的灵魂，细节，所以以后画师不再需要多么扎实的基本功，只需要补上不合理之处就可以了，AI绘画的出现对于这个行业就是织布机对于织布工人。;2;1;3;18388;0.0001631498803567544
44128;这里面甚至有我生成的几张，这就是大数据吗思考;1;1;2;18388;0.00010876658690450294
44137;AI只是没有感情的机器，它永远无法体会到画师对画画的热爱;1;1;2;18388;0.00010876658690450294
44139;人会整活，但ai不会。;8;1;9;18388;0.0004894496410702633
44158;我笑了，同样冷酷的眼神跟尸体沒什么区别;1;1;2;18388;0.00010876658690450294
44160;融图罢了，拿人类的作品超越人类？;2;1;3;18388;0.0001631498803567544
44168;版权是zcjj的东西，真以为是啥好玩意儿？;1;1;2;18388;0.00010876658690450294
44185;ai绘画水平真的超乎我想象，但ai所有作品的画风其实也都差不多，有一股清澈感一直包裹着;1;0;1;18388;5.438329345225147e-05
44206;看到AI绘画逐渐进步学习深度学习，信号与系统，电路基础，模拟电CMOS电路，计算机组成原理，大数据，数据结构，卷积神经网络，python，贝叶斯神经网络，数字集成电路设计，FPGA门阵列编程（）疯狂抵制AI（）;2;0;2;18388;0.00010876658690450294
44214;ai的画也都是曾经那些画手的影子在阿。。;1;0;1;18388;5.438329345225147e-05
44223;说实话，外行才在那热闹，这种纯统计的ai也就那样了;8;0;8;18388;0.00043506634761801175
44233;不大行前几张动漫人像能看出是同一个画师的，应该是把那个画师的稿给导里头了，后面的风景不做评价，前面起码有两张图是画风一样的;3;0;3;18388;0.0001631498803567544
44240;美是美，就是感觉aI画的风景画怪怪的说不出怪在哪里就是感觉这话怪怪的或者说。不自然撇嘴;1;0;1;18388;5.438329345225147e-05
44243;这东西叫ai拼图纠正一下;1;0;1;18388;5.438329345225147e-05
44250;目前ai作画对于中低端画师确实是极不友善，再发展几年估计都能和高端画师抢饭碗了;1;0;1;18388;5.438329345225147e-05
44252;回复一下评论区把我拉黑激萌什么虎v6的科普评论，咱们的百度哥说不过我之后，来了个学历有屁用怪我咯，还得是百度哥，b站24小时挂着的战神，佩服，尤其是那句学历高有屁用，拿着自己看不懂的资料复制粘贴的时候，我就知道我输了支持;1;0;1;18388;5.438329345225147e-05
44254;画师用ai不是更方便了吗？有美术基础的去修改这些东西，或者是挑选，不比普通人快多了;1;0;1;18388;5.438329345225147e-05
44258;下一个就会是ai写作了吧;1;0;1;18388;5.438329345225147e-05
44261;只要有利益驱动，所谓光荣的传统很快就会成为过去式。法拉利在展示他的成果时，有人嘲笑他说这有什么用呢？对此法拉利的回答是，一个刚出生的婴儿有什么用呢？;1;0;1;18388;5.438329345225147e-05
44267;二月份：九月份：;1;0;1;18388;5.438329345225147e-05
44278;知识产权法王迁教授摘要：如果人工智能生成的内容在表现形式上不符合作品的构成要件如计算机生成的无独创性数据库当然不能作为作品受到保护。但如果人工智能生成的内容在表现形式与人类创作的作品类似如机器人绘制的图画、写出的新闻报道或谱出的乐曲则需要从其产生过程判断其是否构成作品。迄今为止这些内容都是应用算法、规则和模板的结果不能体现创作者独特的个性并不能被认定为作品。在不披露相关内容由人工智能生成时该内容可能因具备作品的表现形式而实际受到了保护但该现象是举证规则造成的并不意味着著作权法因人工智能而改变;1;0;1;18388;5.438329345225147e-05
44282;很快就会有不需要喂图的AI出来，到时候你们就闭嘴吧;1;0;1;18388;5.438329345225147e-05
44294;我不觉得有啥好喷的完美解决了一些画师要不完的臭脸，和一些画渣骗钱，大佬也不会因为这个受影响，说白了淘汰开始了;1;0;1;18388;5.438329345225147e-05
44303;有些人太把自己当回事了说实话，ai没自我意识你就根本不用去担心啥代替人类，说围棋ai吊打人类，围棋最后的顶级世界赛是ai打ai是吗？我干的主行机械制造行业顶尖加工工艺是ai一手操作的？到最后全都是助人进步突破的工具，机械化生产是大势不可阻挡，你要做的只有往上爬不被淘汰，说什么打击你，我说句难听的你就是想躺着挣钱，就算没ai一个必底层画师这么多底层同行真觉得自己好过？;1;0;1;18388;5.438329345225147e-05
44305;哈哈哈哈，一群人把没版权的ai绘画当神仙。我不好说了微笑不会真的有人以为他ai画画画就是他的了吧。本质上就是本来自己需求就不是很高的小朋友看见能自己定制热门画风还便宜笑嘻了。又没版权不知道在高潮什么，有本事你就商用捏星星眼星星眼你看哪个公司要捏;1;0;1;18388;5.438329345225147e-05
44312;ai和人最大的区别就是ai无法表达人的情感，一幅画中所蕴含的情感是ai呈现不出来的藏狐;1;0;1;18388;5.438329345225147e-05
44314;ai要靠人类投喂养料，但人类不需要，没有了人类ai绘画就无法发展，如果只是依赖ai，绘画的发展一定会停滞，但那些非顶级大师的人，可能就会被淘汰了，只能说会非常卷，不仅要跟人卷，还要跟机器卷热;1;0;1;18388;5.438329345225147e-05
44319;失业美术生不要慌，可以学习别的谋生手段，比如在啤酒馆演讲。;1;0;1;18388;5.438329345225147e-05
44324;ai也就个人用用吧，你真允许商用直接大部分画师不干，光是人的反对就受不了。你敢立法艺术界和绘画界的人就敢闹。;1;0;1;18388;5.438329345225147e-05
44330;仔细看每张人脸基本上都没有笑诶。吃瓜doge;2;0;2;18388;0.00010876658690450294
44334;阿尔法0现在可以说现在的职业棋手没有人可以打败了，但现实是没有那个职业棋手因为这个丢掉饭碗，反而围棋得到了很大进步不是吗;3;0;3;18388;0.0001631498803567544
44338;破防的大多数都是中低端画师，特别是一些画技不怎么样还迷之自信的;2;0;2;18388;0.00010876658690450294
44350;等ai学完了，以后只有顶尖画师能赚钱咯;1;0;1;18388;5.438329345225147e-05
44356;AI绘画可以画出没有资本的世界吗脱单doge;1;0;1;18388;5.438329345225147e-05
44387;ai图真不行，也就刚出来时候新鲜感，画风单调，感觉不如我p站关注的2800位画师画风各不相同tv偷笑;2;0;2;18388;0.00010876658690450294
44393;看看手？呲牙;1;0;1;18388;5.438329345225147e-05
44397;我刷哔咔刷到ai本了藏狐;1;0;1;18388;5.438329345225147e-05
44405;那里能找到这些图呢;1;0;1;18388;5.438329345225147e-05
44407;缺陷肯定还是有的，比如说不会画筷子;1;0;1;18388;5.438329345225147e-05
44409;不能画肢体，风景还是可以的;2;0;2;18388;0.00010876658690450294
44412;不是ai画的好因该是现在的网络女生长得都一样吧doge;1;36;37;18388;0.002012181857733304
44417;这是画的？这分明是真人抠鼻;1;6;7;18388;0.0003806830541657603
44422;韩国美女的模板;2;1;3;18388;0.0001631498803567544
44425;三连求图包;1;0;1;18388;5.438329345225147e-05
44427;有网盘链接吗打call;1;0;1;18388;5.438329345225147e-05
44429;有点像某个老师脱单doge;1;0;1;18388;5.438329345225147e-05
44431;求图包;1;0;1;18388;5.438329345225147e-05
44434;以假乱真了吃瓜吃瓜吃瓜;2;0;2;18388;0.00010876658690450294
44439;求图包;1;0;1;18388;5.438329345225147e-05
44446;别用快抖的做学习素材了，全是美颜后的锥子脸笑哭;1;0;1;18388;5.438329345225147e-05
44453;等图包;1;0;1;18388;5.438329345225147e-05
44458;这玩意能不能用女朋友的脸去绘画;1;0;1;18388;5.438329345225147e-05
44462;ai产图的画风可以如此稳定了吗？？那岂不是可以直接画本子了，，之前ai同样的TAG产出来的图都有不一样的感觉，，这额你这感觉就像一个画师的系列图了;31;438;469;18388;0.025505764629105938
44494;真恐怖，现在的人工智能已经能画高度一致的人物了吗？连衣服看起来也像是一样的;3;157;160;18388;0.008701326952360235
44498;衣服有的有带子，有的没有，有的还是半脱落，现在ai这么懂了吗doge;2;135;137;18388;0.007450511202958451
44501;天，要画成这样不知道要练多少年大哭连手都能画了天哪;9;107;116;18388;0.00630846204046117
44511;笑哭笑哭真要感谢ai，现在画画步步都留步骤了，随时准备以证清白撕自己底裤;13;91;104;18388;0.005655862519034153
44525;恐怖如斯doge自选姿势;4;86;90;18388;0.004894496410702632
44530;还不够，还得等技术再爆炸一会doge;6;65;71;18388;0.003861213835109854
44537;有了这，那岂不是可以同人图自由了？恐怖如斯啊;3;51;54;18388;0.0029366978464215794
44541;为啥我的图，骨骼总是缺东西啊大哭大哭大哭;3;19;22;18388;0.0011964324559495323
44545;作者有没有想过啥特殊的？;4;24;28;18388;0.0015227322166630412
44550;之前看到有人用ai画了个拜登在白宫做sakana的动作tv笑哭;1;18;19;18388;0.0010332825755927778
44552;现在快出ai医生，ai资本家ai人类吧，人类感觉活不下去了大哭;3;8;11;18388;0.0005982162279747662
44557;可以用矢量图模式画这些二次元风格的吗（这样不用担心图片尺寸了;2;14;16;18388;0.0008701326952360235
44562;我有一个大胆的想法doge;1;1;2;18388;0.00010876658690450294
44571;我一直不知道这个骨架图怎么用，有一次我用了一个结果直接生成了一张全黑的图;3;2;5;18388;0.00027191646726125733
44576;画画可以参考ai的人体吗，准不准确？，;3;1;4;18388;0.00021753317380900588
44584;确实不是是手和脚复杂点的人体都一团糟;2;1;3;18388;0.0001631498803567544
44594;基本功达到一定程度2d绘画就没多少地方可以精细了，后天性质是画风决定，大家大可不必过于担心ai绘画。要是ai生成画风和你很像，这就要等相关的新法律推出才能保护doge;5;10;15;18388;0.000815749401783772
44600;有没有福瑞，或者欧美风格的ai图呢;1;1;2;18388;0.00010876658690450294
44604;请问怎么用这种骨骼图直接导入动作啊？我在controlnet那里只有放真人照片才可以识别动作，是需要换模型还是选什么选项？;1;1;2;18388;0.00010876658690450294
44608;AI绘画对我这种动画初学者还是蛮有用的，所以我选择建模doge;1;1;2;18388;0.00010876658690450294
44610;悄悄问个BGM，好耳熟，但是忘记名字了，抓心挠肝好难受;2;4;6;18388;0.0003262997607135088
44613;哪个AI啊？;12;1;13;18388;0.0007069828148792691
44626;肚皮画的好厉害;1;1;2;18388;0.00010876658690450294
44629;up咨询一下，你这个用的是controlnet吗;4;2;6;18388;0.0003262997607135088
44634;up用的模型和lora是啥方便说一下嘛？感觉效果很棒给心心;14;2;16;18388;0.0008701326952360235
44649;我倒是最想要的是你的火柴人的图片。打call打call打call;1;2;3;18388;0.0001631498803567544
44651;这种衣服是啥TAG啊露肚子背心吗;2;2;4;18388;0.00021753317380900588
44656;这质量是真高堪比职业画师了;1;1;2;18388;0.00010876658690450294
44660;这种裤子的关键词是什么，我英语白痴愣是不知道;3;0;3;18388;0.0001631498803567544
44664;有教程吗求求求;1;0;1;18388;5.438329345225147e-05
44666;不是很懂思考数位板才刚刚白菜价的时代，数位屏技术都依然臃肿的时代，电子绘画都没有异常方便的时代，画手就逐渐要被AI超车了？科技树真是奇怪，我等待的白菜价耐用轻薄无线续航久高性能压感倾斜感应纸质感轻型数位笔数位屏，这种产品都没有大规模出现的时代，就要逐渐被ai超越了？疑惑这科技树是什么回事？;1;0;1;18388;5.438329345225147e-05
44669;大佬这个骨骼图怎么做啊;1;0;1;18388;5.438329345225147e-05
44671;所以说现在的游戏行业还需要画师干什么？花低价招一些萌新用AI量产不就行了吗？不仅省成本，而且美术质量也高一些没学过画画，或者说画的比较烂的萌新用AI也能取代一些大佬的饭碗，而且他们还比大佬便宜，AI时代更像是变革，机器流水线取代人力，对游戏行业来说是好事情，对画师来说是一件悲伤的事情。失业是难免的。;7;0;7;18388;0.0003806830541657603
44680;up可以多分享一点姿势吗？谢谢啦三周年谢谢老板;4;0;4;18388;0.00021753317380900588
44686;为啥有些图有手部骨骼;1;0;1;18388;5.438329345225147e-05
44688;用的是什么软件;2;0;2;18388;0.00010876658690450294
44691;这个要如何使用啊，我自己也想试试;1;0;1;18388;5.438329345225147e-05
44693;这骨骼图是怎么制作的啊？;1;0;1;18388;5.438329345225147e-05
44695;感觉最近看到的ai画风都是这样的，颜色鲜艳，上色有立体感，所以画风是ai自己决定的吗;1;0;1;18388;5.438329345225147e-05
44697;左边，脖子以下全是腿;1;0;1;18388;5.438329345225147e-05
44699;现在连手都能做到大致稳定了吗只能说幸好没学纯艺;1;0;1;18388;5.438329345225147e-05
44701;我最近把ControlNet加入到了我开发的APP中，如果电脑不支持webUI可以试试app。AI绘画ControlNet不用webUI了，手机就能使用。httpswwwbilibilicomvideoBV1kY411z7Ur;1;0;1;18388;5.438329345225147e-05
44703;其实我觉得AI画的风格只有微笑，辣眼睛辣眼睛太僵硬了，没有那种其他生气，难过，伤心，大笑的表情风格，太死板，而且AI风格的画面永远有一种渡光的光效，当然不敢保证等再过几年，会越来越先进OKOK;1;0;1;18388;5.438329345225147e-05
44705;up想问问头上那几个点是什么啊;1;0;1;18388;5.438329345225147e-05
44707;大佬，用这个需要电脑啥配置呀？给心心;1;0;1;18388;5.438329345225147e-05
44709;如果能用骨架限定画出来的效果是不是可以解决不会画手的问题;1;0;1;18388;5.438329345225147e-05
44711;1650能带动吗doge;1;0;1;18388;5.438329345225147e-05
44713;大佬什么卡跑的啊每天稳定能产多少张？还有接不接约稿;2;0;2;18388;0.00010876658690450294
44716;大佬你是怎么做到相同服装服装和脸做到不同的动作？是通过人物的lora吗？;1;0;1;18388;5.438329345225147e-05
44718;up骨骼比重一般拉多少;1;0;1;18388;5.438329345225147e-05
44720;求个tga;1;0;1;18388;5.438329345225147e-05
44722;我之前想学画画来着，想画一些同人本子什么的，结果学了一段时间发现费时费力，没天赋没有老师指导系统学习也很难学出个样子出来，现在看来ai画图确实能满足很多需求了，除了觉得画画很有意思或者专业学习过的，一般人看了ai绘画确实很难有动力再坚持绘画了;1;0;1;18388;5.438329345225147e-05
44724;这些骨骼图是怎么做的啊;3;0;3;18388;0.0001631498803567544
44728;这什么模型啊手好稳定;1;0;1;18388;5.438329345225147e-05
44730;作者大大，这个有用修手pt吗？感觉手很好;1;0;1;18388;5.438329345225147e-05
44732;我自己使用这个骨骼做不到侧视图tv难过，上半身不论怎样都是正对屏幕的，有解决办法吗？;1;0;1;18388;5.438329345225147e-05
44734;有办法自己画骨骼吗;3;0;3;18388;0.0001631498803567544
44738;这个骨骼的动作是怎么做的，是自己做动作拍照然后生成骨骼。我感觉我拿图生成的骨骼很抽象;1;0;1;18388;5.438329345225147e-05
44740;可以铁山靠吗;1;0;1;18388;5.438329345225147e-05
44742;我去，刚想学画画。不学了;6;0;6;18388;0.0003262997607135088
44749;up模型是啥名字呀;3;0;3;18388;0.0001631498803567544
44753;我觉得lz可以试一下动画，这个人物形象每张都高度一致，去掉背景应该可以生成动画;1;0;1;18388;5.438329345225147e-05
44755;大佬用的什么模型脱单doge;3;0;3;18388;0.0001631498803567544
44759;碧蓝的金坷垃吗？;1;0;1;18388;5.438329345225147e-05
44761;ai为啥不会画手请问有人能解答吗;6;0;6;18388;0.0003262997607135088
44768;请问能单独生成骨骼图吗？;1;0;1;18388;5.438329345225147e-05
44770;这个能倒立劈叉吗doge;1;0;1;18388;5.438329345225147e-05
44772;这个骨骼可以自己画吗，自己画能识别吗;1;0;1;18388;5.438329345225147e-05
44774;哦呼手指问题解决了？;1;0;1;18388;5.438329345225147e-05
44776;那种高难度动作会怎么样;1;0;1;18388;5.438329345225147e-05
44778;这手还是会变形？;1;0;1;18388;5.438329345225147e-05
44780;up能出个这个的教程吗，感谢;2;0;2;18388;0.00010876658690450294
44783;难吗星星眼;1;0;1;18388;5.438329345225147e-05
44785;bgm是啥挺好听;3;0;3;18388;0.0001631498803567544
44789;Up显存多大啊，我6g好像爆显存了;5;0;5;18388;0.00027191646726125733
44795;真好看，用的是什么模型啊能分享下吗鼓掌;4;0;4;18388;0.00021753317380900588
44800;m腿呢;1;0;1;18388;5.438329345225147e-05
44802;请问请问，骨骼图是怎么用的啊星星眼;2;0;2;18388;0.00010876658690450294
44805;腹部好棒。。;2;0;2;18388;0.00010876658690450294
44808;好像也不是很听话啊doge和骨骼姿势的差异还是有的;1;0;1;18388;5.438329345225147e-05
44810;我发布了一篇笔记，快来看看吧;11;1271;1282;18388;0.06971938220578638
44822;现在正在思考我把罗老师压着，罗老师脸红气喘地列数我的罪行的样子热热;138;6152;6290;18388;0.34207091581466176
44961;罗翔：构成侵犯他人肖像权，处三年五年有期徒刑doge;17;3910;3927;18388;0.2135631933869915
44979;法律的尽头是神学doge;7;1149;1156;18388;0.0628670872308027
44987;罗翔说刑法有人侵犯你肖像权;7;1282;1289;18388;0.07010006525995215
44995;大家觉得up这种行为构不构成犯罪？不构成，但是，我找个理由把他判了，然后我说，学法容易丧失人性，所以我不做人了，我把up吃了，大家觉得我构不构成犯罪？不构成，我是个吸血鬼，我快要饿死了，我三天三夜没吃东西，我见面包吃面包，一天吃一个，吃饱了娱乐一下，都不构成犯罪doge;5;442;447;18388;0.024309332173156405
45001;这么大（指教堂）应该成年了所以合法doge;3;194;197;18388;0.01071350881009354
45005;最后一张是不是要变成女教皇了吃瓜;1;107;108;18388;0.005873395692843159
45008;我发现ai就是喜欢把各种各样的东西尽量的贴近人类女性doge;5;113;118;18388;0.006417228627365673
45016;雷普罗翔要判几年？doge;4;63;67;18388;0.0036436806613008486
45022;求：罗翔老师亲自出马后，UP主能进去待几年？;2;24;26;18388;0.0014139656297585382
45026;像斥罪给心心;2;12;14;18388;0.0007613661083315206
45031;所以这个AI绘画是哪个网站？;1;8;9;18388;0.0004894496410702633
45078;这个罗翔逐渐女化是怎么回事吃瓜吃瓜;2;1;3;18388;0.0001631498803567544
45103;罗翔说刑法您对此怎么看;1;1;2;18388;0.00010876658690450294
45143;大家不要罗翔说刑法了，罗翔说刑法老师说他很忙的，不要随随便便罗翔说刑法了。再说，要是罗翔说刑法真的过来了，up主可能要被罗翔说刑法起诉诽谤和侵犯肖像权，会被罗翔说刑法送进局子里的，那样up主就不能做更多关于罗翔说刑法的视频了。所以，重要的事情说三遍，不要罗翔说刑法，不要罗翔说刑法，不要罗翔说刑法;1;0;1;18388;5.438329345225147e-05
45176;为啥AI画人爱画女画建筑爱画飞船呢？;1;0;1;18388;5.438329345225147e-05
45191;真失败者鬼畜版;2;0;2;18388;0.00010876658690450294
45214;有20遍之后不转性的照片吗doge;1;0;1;18388;5.438329345225147e-05
45277;你这是违法行为、走跟我去自首doge;1;0;1;18388;5.438329345225147e-05
45300;链接：httpspanbaiducoms1C3ud34LyDk2P5nMrsaegZQpwdbsi7提取码：bsi7;2;11;13;18388;0.0007069828148792691
45303;哥们，做的真不错，但是没有一个pan开头得连接这个三连很难办啊doge;3;10;13;18388;0.0007069828148792691
45307;请问可以把图片丢进去自己生成一张相似的图吗？绘画速度怎么样？多久出一张图？2060;5;2;7;18388;0.0003806830541657603
45314;求个图包，已经三连;1;1;2;18388;0.00010876658690450294
45316;这时候应该有个置顶pan开头的东西是吧，updoge;1;1;2;18388;0.00010876658690450294
45319;求图;1;1;2;18388;0.00010876658690450294
45330;链接链接;1;0;1;18388;5.438329345225147e-05
45334;已经三连，求私发图包;1;0;1;18388;5.438329345225147e-05
45336;图包呢？;1;0;1;18388;5.438329345225147e-05
45338;图包呢？;1;0;1;18388;5.438329345225147e-05
45343;呜呜呜，这个up我用三连也换不了他的图大哭;1;0;1;18388;5.438329345225147e-05
45345;没有分享不算英雄;2;0;2;18388;0.00010876658690450294
45348;那个痣点得真不错。;1;0;1;18388;5.438329345225147e-05
45350;不给图包还想要3连？;2;0;2;18388;0.00010876658690450294
45353;哪能下载;1;0;1;18388;5.438329345225147e-05
45355;求图包;1;0;1;18388;5.438329345225147e-05
45359;老师QQ有人盗你好多视频说自己是原创，叫什么我不是富贵吗还是微笑微笑;4;146;150;18388;0.00815749401783772
45364;AI不配与任何画帅的作品相比，AI本身就是一个缝合怪;3;823;826;18388;0.04492060039155971
45368;要说AI和画师画的差别，我觉得就是AI画的人没有画师画的灵性，眼神是有差别的，神态是有差别的，画不出那种蔑视的感觉，简单来说：没有那味儿;7;267;274;18388;0.014901022405916902
45376;薄纱AI了属于是;1;55;56;18388;0.0030454644333260824
45378;确实比不上，所以你什么时候来我家。doge;1;31;32;18388;0.001740265390472047
45380;评论区的人不要在那里秀自己的无知有很多顶级太太的作品都是用AI创作的Ai抄袭，那是看个人用AI创作的人你甚至可以把AI当成一种绘画方式AI绘画的品质好坏，也取决于用AI的那个人当然能取代同等级的AI画家就能取代同等级的手绘但是你要让那些杂鱼去取代大佬，那可能吗？;11;20;31;18388;0.0016858820970197955
45393;您的作品当然比Al好看，但是再好看也不耽误我喜欢Al脱单doge;2;2;4;18388;0.00021753317380900588
45407;虽然，但是。。现在ai可以画得比这好了，抱歉笑哭;11;7;18;18388;0.0009788992821405265
45419;但是要知道我们和Ai的画最终都是面对甲方和大众，需求的就是精致完美，无论啥样的行业，只要Ai达到顶点，或许任何行业都会被替代，人们所追求的不正是快捷便利吗？就拿战争来说能用核弹来解决的事为什么要用人命来堆呢？这就是为什么人类发展的尽头便是人类的终点，人们最终会因为追求极致的便捷而灭亡;1;1;2;18388;0.00010876658690450294
45426;人工智能绝不可能取代人类;1;0;1;18388;5.438329345225147e-05
45435;短暂的喧闹，竟嘲笑上帝永恒的音乐飞鸟集;1;1;2;18388;0.00010876658690450294
45468;钢铁之躯，怎能比肩神明脱单doge;1;2;3;18388;0.0001631498803567544
45486;tag用的是之前天使与黑暗天使的那两期的，我都发过专栏的，只是换了个模型，瞧着出图质量还不错，就分享给大家了，喜欢的话给个三连吧doge;14;275;289;18388;0.015716771807700675
45501;渍，还是喜欢萝莉;17;127;144;18388;0.007831194257124212
45519;tag是怎么选的，我只能想到几个笼统关键词笑哭;3;112;115;18388;0.006254078747008919
45523;ai绘画发展起来可能会影响画师这个职业，画师可能需要转型;13;69;82;18388;0.00445943006308462
45537;大哥大哥，有教程吗？我想为放弃艺术下定决心。;2;59;61;18388;0.0033173809005873395
45540;这我直接来一个一键三连doge;1;33;34;18388;0.00184903197737655
45542;还得是你，每次的质量都这么高;2;31;33;18388;0.0017946486839242985
45545;拿up的图去画了几下doge;4;36;40;18388;0.0021753317380900587
45550;对唔住，天帝哥;1;18;19;18388;0.0010332825755927778
45552;蹲一手里版;7;16;23;18388;0.0012508157494017839
45560;另一个版本做好了，但是现在应该没人看了吧大哭;47;10;57;18388;0.003099847726778334
45608;不画点本子赚钱么微笑;1;5;6;18388;0.0003262997607135088
45610;原图搞一下。三连大大的有无悔华夏点赞;1;10;11;18388;0.0005982162279747662
45612;我打开了我的浏览器然后它跟我说访问有风险然后就是要坚持访问;2;8;10;18388;0.0005438329345225147
45615;什么模型啊，画质这么高啊打call;2;4;6;18388;0.0003262997607135088
45618;兄弟们，我虚了呀。;1;4;5;18388;0.00027191646726125733
45620;up图片可以发一下吗星星眼;1;4;5;18388;0.00027191646726125733
45628;白毛老公视角doge;1;5;6;18388;0.0003262997607135088
45630;不要转剑魂啊upup，三连了，求特殊版doge;1;1;2;18388;0.00010876658690450294
45632;不是全身的有点失望。;1;1;2;18388;0.00010876658690450294
45635;高啊，实在是太高了，UP主知道，AI不会画手，所以让大部分图片都，不，露出手;1;2;3;18388;0.0001631498803567544
45637;出来了好多谢谢up主;1;2;3;18388;0.0001631498803567544
45639;想知道用了什么软件画的;2;1;3;18388;0.0001631498803567544
45642;AI手都画不好，永远取代不了画师;2;3;5;18388;0.00027191646726125733
45645;我这号终于成熟了;1;1;2;18388;0.00010876658690450294
45647;你的视频居然没有水印，直接三连脱单doge;1;1;2;18388;0.00010876658690450294
45649;老哥，给个图集链接;2;1;3;18388;0.0001631498803567544
45652;up整个群，来点好康的脱单doge脱单doge脱单doge;1;1;2;18388;0.00010876658690450294
45654;看了此人动态，为了时间的和平，为了人类的未来，我决定牺牲自己的眼睛，狠狠的关注了dogedoge;1;1;2;18388;0.00010876658690450294
45656;拿图就走doge;2;2;4;18388;0.00021753317380900588
45659;简介在哪里啊已三连;1;1;2;18388;0.00010876658690450294
45661;老铁，能知道你这个类型跑的的模型名字吗，这种风格我挺喜欢的热词系列三连;1;1;2;18388;0.00010876658690450294
45663;怎么取图脱单doge;2;2;4;18388;0.00021753317380900588
45666;ai能画那种吗，就是那种，我就好奇doge;1;1;2;18388;0.00010876658690450294
45668;up，我想要封面的图片，能否割爱。;2;1;3;18388;0.0001631498803567544
45674;除了手，什么都好;1;4;5;18388;0.00027191646726125733
45678;求图包，已三连;2;1;3;18388;0.0001631498803567544
45681;求图包;1;1;2;18388;0.00010876658690450294
45683;第三张图在哪里可以弄到;1;1;2;18388;0.00010876658690450294
45685;为什么网盘的画质不行啊;1;1;2;18388;0.00010876658690450294
45720;手居然不崩，太牛了;1;1;2;18388;0.00010876658690450294
45736;你小子指定有啥副业;1;1;2;18388;0.00010876658690450294
45740;还有吗？？？;1;0;1;18388;5.438329345225147e-05
45749;想问软件或者网站是啥啊脱单doge，三连了;1;0;1;18388;5.438329345225147e-05
45761;外国对中国的刻板印象实在是太深了。。。;1;53;54;18388;0.0029366978464215794
45763;可恶，挡到了啊哼，哼，哼，啊啊;1;45;46;18388;0.0025016314988035677
45765;这放不出来的图不得来个网盘傲娇;1;30;31;18388;0.0016858820970197955
45768;也就加拿大、日本、西班牙、ch符合，剩下的都一股子日漫风;1;11;12;18388;0.0006525995214270176
45774;趁人少，欺负一下uptvdoge你看到这个硬币了吗吃了也不给你开玩笑啦给你给你诶，我又抢回来啦给你啦给你啦不开玩笑辣诶，骗你的略略诶诶你怎么哭辣硬币点赞给你给你都给你发现了：好吧，你展开了，那么在24个小时之内，把这句评论转发到10个作品，否则倒一辈子霉，我也是受害者;4;2;6;18388;0.0003262997607135088
45786;doge;1;0;1;18388;5.438329345225147e-05
45790;我在救你一次，你需要一点比欲望更高级的东西;10;177;187;18388;0.010169675875571025
45801;老夫每天玩一部大作指日可待了doge;4;114;118;18388;0.006417228627365673
45806;这我不得考个清华大学;5;62;67;18388;0.0036436806613008486
45812;我帮大家打了，大家留着下次再打吧，不用谢doge;3;32;35;18388;0.0019034152708288013
45816;ai的画看起来越来越写实了;1;21;22;18388;0.0011964324559495323
45818;她就是人间的美好胸怀着远大的理想真知灼见跃然心上大千世界不负于她dogedogedogedogedoge;1;10;11;18388;0.0005982162279747662
45820;艹，以后ai反攻人类的时候会不会出这样的仿生人啊？劳资想投降;1;5;6;18388;0.0003262997607135088
45822;真的有这么漂亮的小姐姐存在吗？doge;1;4;5;18388;0.00027191646726125733
45828;zxas882266玉骨bai月初魔罗抚月柳CHRISTINAmuyuTeemo的笛子忘世沉沦;1;1;2;18388;0.00010876658690450294
45833;我不信是画的惊喜;1;0;1;18388;5.438329345225147e-05
45852;郑凯婷的爷爷;1;0;1;18388;5.438329345225147e-05
45872;AAcar;1;0;1;18388;5.438329345225147e-05
45920;跟真的一样;1;0;1;18388;5.438329345225147e-05
45946;手画的可以了;1;0;1;18388;5.438329345225147e-05
45957;然后加上高跟鞋或者是脚，就会偏向于出全身照了，绝对不是想看嗨丝美腿的（其实就是）doge，然后对脚描写更多就会偏向从下向上拍的（不过感觉那些不容易过审）吃瓜;1;6;7;18388;0.0003806830541657603
45959;不过好多照片都像是从上方0057拍的，感觉大佬的tag应该是对于某些部位描写比重过高了，我听说好像有些tag有些隐藏属性的，比如大眼睛就会更像二次元doge;2;4;6;18388;0.0003262997607135088
45963;五官表情可以调吗，感觉所有的图片眼神和嘴型都是几乎一模一样的，而且过于年轻幼态了，没有OL的感觉。最后就是大部分都是监控视角，单调了;1;0;1;18388;5.438329345225147e-05
45969;请问下防止出现两张照片拼接效果，负值该属于什么Tag啊？;2;0;2;18388;0.00010876658690450294
45976;能不能出教程dogedogedoge;1;0;1;18388;5.438329345225147e-05
45979;感谢大佬星星眼星星眼星星眼，太厉害了打call打call打call;1;0;1;18388;5.438329345225147e-05
45982;求图星星眼好棒啊;2;0;2;18388;0.00010876658690450294
45986;师太这段，手法超神。最开始李火旺和师太聊天的，聊着聊着，就很自然的开始，李火旺讲师太的台词，师太讲李火旺的台词，我还以为是作者传错稿子了，把人称搞混乱了，和盗版小说一模一样的bug。再往后面看才知道，这种感官混乱就是师太的能力啊艹。读小说比较少的我，看到这种前无古人后无来者的手法，忍不住又看了一遍这两章节。结果我也特么跟着混乱起来了辣眼睛;29;1677;1706;18388;0.092777898629541
46016;差点意思，静心师太身上的肉都能藏人，瘦的那段身上的皮还能塌到地上，图片上的有点壮，我印象里她身上的肉都能托起她坐着，肥肉也是左叠一块右叠一块，然后脸上的肥肉都快要把五官遮住，尤其是眼睛，远处看是眯着眼给人一种黑洞洞的感觉靠近一看都是皮跟肉把它遮住，也没有脖子，都被肥肉代替了，身上的所有肥肉托起她就像在躺着一样（纯属我的印象，不知道你们怎么想的）;11;753;764;18388;0.041548836197520124
46028;师太现在为止仅有几个好人啊;57;510;567;18388;0.030835327387426583
46086;“之前这孩子捧着我的脸叫我妈了”前面都有心理准备，看到这一下就不行了。;14;301;315;18388;0.01713073743745921
46101;师太肉里能放人，这个还是太瘦了，宽度至少还要两倍;2;220;222;18388;0.012073091146399826
46104;纳垢师太，奸奇坐忘道，恐虐兵家，色孽和尚，帝皇在哪;9;223;232;18388;0.01261692408092234
46114;感觉师太这体型还是太小了，没有那种塞满整个屋子的压迫感;2;165;167;18388;0.009082010006525995
46117;其实师太他们给人旺除掉丹阳子之后变瘦还挺好看的。橘猫大橘为重;4;145;149;18388;0.008103110724385468
46122;up，up，想看白玉京的场景;4;26;30;18388;0.001631498803567544
46128;起点牛人的同人画，你们看吊不tvdoge;1;11;12;18388;0.0006525995214270176
46130;都给我进来叫妈;1;21;22;18388;0.0011964324559495323
46144;看过电影了来说一下，和电影比起来色彩方面还是差了一点，电影版的升格镜头比较多，导演是新锐，缺点是男女主角虽然小有名气了但是表现不如配角抢眼（心疼二神那么美但是一直不能露脸），总之豆瓣最后评分会在八分左右，期待2023年的续作。;2;1;3;18388;0.0001631498803567544
46147;推荐你去静慈庵，这个门派角色修炼方式能吃很多好吃的。体质的话把理智调成0，多的点数可以分配到感知上，就是所谓的心素号，最近很火的一种配点方式，能开的剧情比较多，机会也多，主要是好玩，好耍。我自己第一个号是初始20体质，袄景教，修炼方式是搞直播。“全体目光向我看齐，我是个。”结果越级用了一次苍蜣登阶之后就废掉了。是的，有些技能代价是永久性的。第二个号乖一些，平均分配，坐忘道。坐忘道就是什么都不精，但就是什么都能搞，花样比较多。蛮特殊的，修炼方式是学别人的心法技能，小无相功吧。只是上个月挨了策划一刀，本来就不强，只是技能组太乱，反制的学习成本比较高而已。本来每个门派就有很多技能啊，都是打起来才知道几斤几两，这也是这个游戏牛逼的地方。反正我觉得这一刀挨得不明不白，但是我蛮喜欢坐忘道的，信仰需长存嘛。;1;7;8;18388;0.00043506634761801175
46152;注意别被骗了httpsb23tv9mgTqnhttpsb23tvXI41PChttpsb23tvzrlMEYhttpsb23tvAj3Zhw;1;1;2;18388;0.00010876658690450294
46154;拍电影吧，想看这剧本不比咒强;1;1;2;18388;0.00010876658690450294
46162;这小说这么牛的嘛;2;0;2;18388;0.00010876658690450294
46165;和尚庙全是酒池肉林，尼姑庙又全是苍蝇蟑螂老鼠，疑惑;2;2;4;18388;0.00021753317380900588
46177;游戏在哪下载？;1;6;7;18388;0.0003806830541657603
46179;我才是李火旺，我才是李火旺，我才是李火旺;2;0;2;18388;0.00010876658690450294
46196;你们都用什么APP看道诡啊我看的都是删减的要不就是少一章;2;0;2;18388;0.00010876658690450294
46215;师太你就从了老纳吧;1;10;11;18388;0.0005982162279747662
46217;不要在线操作httpspanquarkcns000babaddd98下载后在本地重命名删除txt和汉字就可以了;1;5;6;18388;0.0003262997607135088
46219;今天又是充满希望的一天;1;60;61;18388;0.0033173809005873395
46221;不要在线操作httpspanquarkcnsfdd4384116b2下载后在本地重命名删除txt就可以了;4;5;9;18388;0.0004894496410702633
46227;投币，求图吃瓜吃瓜;2;3;5;18388;0.00027191646726125733
46232;夸克网盘链接：httpspanquarkcns6b31eda5467c删除链接末尾空格打开删除多余汉字，不然显示失效或者删除，都是搞错了的三连支持一下吧;8;6;14;18388;0.0007613661083315206
46241;图包来咯夸克网盘httpspanquarkcns619906a1e0a9删除链接末尾空格打开删除多余汉字，不然显示失效或者删除，都是搞错了的三连支持一下吧给心心给心心给心心;42;45;87;18388;0.0047313465303458774
46284;来人把他装进去吃瓜;1;23;24;18388;0.0013051990428540352
46286;夸克网盘链接httpspanquarkcns2a09b981f96c不要在线操作下载后在本地重命名删除txt就可以了;2;2;4;18388;0.00021753317380900588
46289;手机内存快不够用的了吃瓜;1;8;9;18388;0.0004894496410702633
46291;doge;1;3;4;18388;0.00021753317380900588
46293;脱单doge;1;2;3;18388;0.0001631498803567544
46295;麻袋什么，装枸杞？;1;2;3;18388;0.0001631498803567544
46298;币已投，坐等图包;1;2;3;18388;0.0001631498803567544
46315;质量越来越高了;1;2;3;18388;0.0001631498803567544
46317;小电视发愁需要解压码;2;1;3;18388;0.0001631498803567544
46322;这咋要解压密码;1;1;2;18388;0.00010876658690450294
46326;他来了，竖版图来了吃瓜吃瓜;5;7;12;18388;0.0006525995214270176
46332;自从关注了up现实的妹纸就越来越没吸引力了，我该怎么办大哭;1;2;3;18388;0.0001631498803567544
46334;脱单doge脱单doge脱单doge脱单doge;1;1;2;18388;0.00010876658690450294
46336;打call打call打call打call;1;1;2;18388;0.00010876658690450294
46338;包呢？我币都发了没包？你们就是这样对待老干部的？阴险;1;7;8;18388;0.00043506634761801175
46341;等UP主图包滑稽;1;1;2;18388;0.00010876658690450294
46349;还得是你啊星星眼;1;1;2;18388;0.00010876658690450294
46351;富有且慷慨的龙哥脱单doge;1;5;6;18388;0.0003262997607135088
46369;我还以为有色图压缩文件来了个删字笑哭;1;1;2;18388;0.00010876658690450294
46374;up主的图看多了，不好找女朋友啊;1;0;1;18388;5.438329345225147e-05
46384;打开了显示文件已被过滤看不了笑哭;1;0;1;18388;5.438329345225147e-05
46391;这期的包怎么又是藏后缀又是加密的doge;1;0;1;18388;5.438329345225147e-05
46395;有些不是发过了？;1;0;1;18388;5.438329345225147e-05
46399;密码是啥微笑;1;0;1;18388;5.438329345225147e-05
46415;呼啦俯卧撑皮卡丘;1;0;1;18388;5.438329345225147e-05
46431;想问一下，你们看到一张照片时，眼镜第一眼是看照片里人物的哪个部位？;1;0;1;18388;5.438329345225147e-05
46459;如果这真的是ai作画，那真的太恐怖了。百分之99p站的作者都画不到这水平。;44;132;176;18388;0.009571459647596259
46504;大多都能看出原画师是谁，画风都挺熟悉的，不过好看是真好看，画师画的太少了;3;55;58;18388;0.003154231020230585
46508;ai对色彩的把控即使是顶级画师也是比不上的，在二次元的话差距还没那么明显，到写实绘画时差距就大了，究其原因就是32位的色彩就有1600万种，ai可以轻松的用里头大部分的颜色但画师基本上只能用到极少数的颜色。。。;6;54;60;18388;0.003262997607135088
46515;麻了这个模型看完之后口味给养刁了以前很多喜欢的图都无感了。;2;14;16;18388;0.0008701326952360235
46519;给图集不如给tag和模型;2;19;21;18388;0.0011420491624972808
46522;希望ai能继续努力，现在画师约一张视频里的500r都算白菜，起码四位数，虽然很辛苦还是质量，价格和效率得综合比比吧，我凭什么给自己设子买美图几顿饭钱就没了，画师要画十几天这个一秒钟出图，不知道免不免费但是肯定比约稿便宜好多，ai继续加油，科技真是越来越发达了（没有看不起画师的意思）;21;23;44;18388;0.0023928649118990647
46544;看的我疯狂心动;1;10;11;18388;0.0005982162279747662
46553;这tm直接让AL生成动漫给我看得了;1;1;2;18388;0.00010876658690450294
46560;还没当上太太就要退坑了tv大哭;2;0;2;18388;0.00010876658690450294
46564;我好像在网易里看到过一样的封面图。;3;1;4;18388;0.00021753317380900588
46570;没有下载权限;1;0;1;18388;5.438329345225147e-05
46577;UP我要看ControlNet的效果doge;1;1;2;18388;0.00010876658690450294
46582;无人区的音乐，碧蓝档案的名字，你究竟是什么人（）;1;1;2;18388;0.00010876658690450294
46584;你的图片是不是压缩过了？反向解析整不出东西笑哭说好的信任呢;1;2;3;18388;0.0001631498803567544
46588;背景看起来很清楚诶，怎么做到的，我弄起来的糊成一片;1;0;1;18388;5.438329345225147e-05
46590;这音乐。。。不适合这个场景吧;3;0;3;18388;0.0001631498803567544
46599;啊这wallpaper上有吗;1;0;1;18388;5.438329345225147e-05
46607;她就是人间的美好胸怀着远大的理想真知灼见跃然心上大千世界不负于她dogedogedoge;2;17;19;18388;0.0010332825755927778
46611;收藏比点赞高一倍，真不厚道doge;1;3;4;18388;0.00021753317380900588
46629;唉，审核怎么过的？;1;0;1;18388;5.438329345225147e-05
46636;这不是少女吃瓜这是御姐呲牙;1;0;1;18388;5.438329345225147e-05
46646;AI都觉得布洛克是猴子吃瓜吃瓜;16;295;311;18388;0.016913204263650207
46663;黑鸦、科莱特丶梅格、珍妮特超牛滑稽;12;78;90;18388;0.004894496410702632
46676;离开母星的第25天，今天依旧是非常想家，碳基生物总是做一些对技术革新和物种进化毫无意义的事情，而它们似乎非常热衷于此，这令我感到疑惑，也让我感到寂寞。我仿佛置身于故乡那清澈的甲烷湖边;1;55;56;18388;0.0030454644333260824
46678;阿拾直接回归本质了;3;45;48;18388;0.0026103980857080703
46682;格斯有六个手指doge他应该是在日本长大的doge;3;32;35;18388;0.0019034152708288013
46686;2：08佩佩3：03邦尼3：08铲子3：15塔拉4：02黑鸦4：14沙迪4：26梅格4：45科莱特5：03贝尔5：39珍妮特（个人认为比较好看的）;2;26;28;18388;0.0015227322166630412
46689;想不到水视频火了约战4不解约战4危;4;19;23;18388;0.0012508157494017839
46696;把塔拉的图交出来。星星眼;1;7;8;18388;0.00043506634761801175
46699;我要为布洛克发声，我觉得不公平（狗知道我画了多少回，才画出这个效果，至少几百回了，前几次都是猴子，我真的服了，真太像猴了笑哭笑哭笑哭笑哭;1;3;4;18388;0.00021753317380900588
46701;建议出一款皮肤篇doge;1;3;4;18388;0.00021753317380900588
46703;芽芽酷酷我看看那些莫奇斯还怎么打败我我一身健壮的肌肉给他一顿欧拉;1;3;4;18388;0.00021753317380900588
46705;失踪粉丝回归dogedogedoge先来个三连;1;2;3;18388;0.0001631498803567544
46709;p先生的企鹅在干什么;1;2;3;18388;0.0001631498803567544
46712;妮塔那个，hhhh;1;2;3;18388;0.0001631498803567544
46719;波克是变化最小的doge科莱特是变的最漂亮的doge;1;1;2;18388;0.00010876658690450294
46722;怎么感觉Ai画的反倒不行了呢？;1;1;2;18388;0.00010876658690450294
46741;这是你画的吧喜极而泣喜极而泣喜极而泣;1;0;1;18388;5.438329345225147e-05
46755;背景却不是原声差评傲娇;1;0;1;18388;5.438329345225147e-05
46761;BGM，快点告诉我BGM抓狂抓狂抓狂热;1;0;1;18388;5.438329345225147e-05
46792;好像确实都没有手，原因我也知道。doge;4;75;79;18388;0.004296280182727866
46797;原图在这里链接：httpspanbaiducoms1AaUYgIgS7uV0mGHDp0rgpwd89v2提取码：89v2喜欢的小伙伴点赞三连支持一下哟脱单doge脱单doge脱单doge;6;73;79;18388;0.004296280182727866
46804;好看是真的，没有表情也是真的;3;29;32;18388;0.001740265390472047
46808;这种需要训练模型吗需要使用修饰程度的词语吗;1;17;18;18388;0.0009788992821405265
46810;AI的线条还是有点生硬，我还是比较喜欢米奇王画的那种感觉，前两天刚买了新出的姉体験合订本妙啊;1;8;9;18388;0.0004894496410702633
46813;你们这些up，整天搞这些我的身体一天不如一天也还想要三连dogedogedoge（以三连）;2;2;4;18388;0.00021753317380900588
46817;AustinWGriffindoge;1;1;2;18388;0.00010876658690450294
46820;BGM是;2;1;3;18388;0.0001631498803567544
46823;求tag;3;1;4;18388;0.00021753317380900588
46827;手呢doge;1;1;2;18388;0.00010876658690450294
46830;本来都退出了，可tnnd觉得歌好听，硬是进来再听一遍笑哭;3;1;4;18388;0.00021753317380900588
46835;求图包;1;1;2;18388;0.00010876658690450294
46841;什么应用？;1;0;1;18388;5.438329345225147e-05
46844;旋风少女的bgm吗;1;0;1;18388;5.438329345225147e-05
46848;up能发一下tag吗星星眼;1;0;1;18388;5.438329345225147e-05
46857;打call求图包;1;0;1;18388;5.438329345225147e-05
46859;图包热词系列三连;1;0;1;18388;5.438329345225147e-05
46861;仙气十足爱了，这AI调教得可以啊，终于不是幼气脸了喜欢;3;77;80;18388;0.004350663476180117
46867;太浮夸，人均两篮球，比头还大。不是说大不好，但得看人体比例，细枝结硕果，很违和吃瓜;1;9;10;18388;0.0005438329345225147
46869;好正经，以前你不是这样的;1;8;9;18388;0.0004894496410702633
46876;“像周姐”;1;1;2;18388;0.00010876658690450294
46900;什么软件做的;1;0;1;18388;5.438329345225147e-05
46902;这是用哪个弄的;3;0;3;18388;0.0001631498803567544
46906;不要发迅雷链接，没几个人用迅雷;3;0;3;18388;0.0001631498803567544
46915;求链接星星眼;1;0;1;18388;5.438329345225147e-05
46924;《用画画养活自己》脱单doge;3;188;191;18388;0.010387209049380031
46928;ai美丽的脸和它乱七八糟的头发和手;2;238;240;18388;0.013051990428540352
46931;已经不知道为什么就，看多了之后ai的图能一眼看出来，就乍一看很好看，可是画师看的出来画面缺乏一些意识上的严重问题，不单单是头发和手这种，但是ai它量产参考什么的真的很香，用的好可以成为很棒的绘画工具耶，而且当当社交头像什么的会糊掉的那种远看的感觉还挺好。tv害羞;9;154;163;18388;0.008864476832716989
46943;这个ai牛逼，跟其他的比更有设计感了;1;26;27;18388;0.0014683489232107897
46945;在珐露珊这个名字出现之前她叫初音未来;22;48;70;18388;0.0038068305416576026
46968;除了头发有点乱几乎没问题虽然理解为是风吹的也不是不行所以跪求up出小鹿的脱单doge;3;23;26;18388;0.0014139656297585382
46972;ai绘画现在是真的离谱，好多都蛮戳我xp的星星眼;1;9;10;18388;0.0005438329345225147
46974;可以出一个散兵的吗原神哇;3;9;12;18388;0.0006525995214270176
46981;什么模型呀;1;1;2;18388;0.00010876658690450294
46985;说过给你视频三连的哦，不会忘记的脱单doge;1;2;3;18388;0.0001631498803567544
46991;问一下这个viewermix可以用做基底模型代替novelai的4g模型去训练吗？;1;2;3;18388;0.0001631498803567544
46993;upup，简介的基底模型要怎么用怎么装阿，有没有推荐的教学视频，我的ai跑不出这种高质量的图呜呜呜呜呜呜;5;3;8;18388;0.00043506634761801175
46999;感觉重复度有点高啊;1;1;2;18388;0.00010876658690450294
47006;赞美up保卫萝卜哇小小三连不成敬意热词系列三连;1;2;3;18388;0.0001631498803567544
47009;请问手是后期修过还是ai画的？感觉不错啊;1;2;3;18388;0.0001631498803567544
47013;两币奉上;1;3;4;18388;0.00021753317380900588
47015;一个点赞两个币催更打call打call打call;1;2;3;18388;0.0001631498803567544
47017;up好棒，可以做心海的吗;3;2;5;18388;0.00027191646726125733
47024;好看bgm是啥呀问问up;1;1;2;18388;0.00010876658690450294
47027;Ai已经进化的会画手了？酸了;3;1;4;18388;0.00021753317380900588
47035;AI瞳色画错了，珐露珊是异瞳;1;0;1;18388;5.438329345225147e-05
47040;吃的应该就是初音的图吧;1;0;1;18388;5.438329345225147e-05
47043;太好看了Ai这种这么还原人设是怎么做到的还有期待之后更多的原神同人作品好看死了星星眼;1;0;1;18388;5.438329345225147e-05
47050;这个手被人工修过了吧doge我天天逛ai的作品要么手是异性要么就藏起来doge;2;0;2;18388;0.00010876658690450294
47053;有瑕疵的地方是怎么修的，能简单说一下吗夏诺雅老婆;1;0;1;18388;5.438329345225147e-05
47057;能不能再试试雷军打call谢谢up;1;0;1;18388;5.438329345225147e-05
47059;换个meina或者橘子模型看看;1;0;1;18388;5.438329345225147e-05
47062;《AI毁画》;3;385;388;18388;0.02110071785947357
47066;有没有一种可能ai绘画或许能够画出sensei的真正样子doge;1;139;140;18388;0.007613661083315205
47068;真人图画出来挺好看的，但美图可能会画毁笑哭;1;109;110;18388;0.005982162279747662
47070;讲个笑话，这个没办法画马化腾吃瓜;1;58;59;18388;0.0032086143136828365
47072;美游那张盖住了的能不能发一下脱单doge;25;23;48;18388;0.0026103980857080703
47098;upup我有一个问题，QQAI不是只能识别人脸吗，为什么你放了个18上去也行？笑哭还有这QQ配BGM配的直接把原曲下降了不止一个档次;1;17;18;18388;0.0009788992821405265
47100;威威字幕君;2;10;12;18388;0.0006525995214270176
47103;第一张好屑啊doge;1;9;10;18388;0.0005438329345225147
47105;啊美游美游为师为了你，为了你要cos优香去跳加州女孩;1;5;6;18388;0.0003262997607135088
47108;0217兄弟们点这个有惊喜不用谢doge;1;4;5;18388;0.00027191646726125733
47111;请问up1分55到2分间的BGM是什么？;1;3;4;18388;0.00021753317380900588
47115;美游拖更咧;5;2;7;18388;0.0003806830541657603
47127;AI：普通照片二次元化二次元照片毀滅化;1;1;2;18388;0.00010876658690450294
47129;兄弟们，请问这是什么软件啊？我也想试试，我想我用色图放上去能不能变得更色doge;2;1;3;18388;0.0001631498803567544
47139;自取;1;85;86;18388;0.004676963236893626
47141;有这技术你就给兄弟们看这些？doge;23;117;140;18388;0.007613661083315205
47165;说ai没有灵魂的你要灵魂，妹子我抱走了doge;5;84;89;18388;0.0048401131172503805
47171;我觉得真的会让画师颤抖了辣眼睛;12;29;41;18388;0.00222971503154231
47184;大大大啊呸。微笑分记得扣广西老表的;5;14;19;18388;0.0010332825755927778
47190;讲道理光看脸，AI确实很能打啊doge;2;14;16;18388;0.0008701326952360235
47193;AI绘画还在发展，你们现在看到的缺点都是下一个版本修复的对象妙啊;1;8;9;18388;0.0004894496410702633
47195;一直说手指的，是在表达画师就剩手指比AI强了吗？;2;12;14;18388;0.0007613661083315206
47198;这技术真的在飞速发展;3;9;12;18388;0.0006525995214270176
47202;他们都在求图，我想求模型;2;13;15;18388;0.000815749401783772
47207;群里刚看过特别大的笑哭;7;4;11;18388;0.0005982162279747662
47215;我前天在D站才看到这项技术，给我推送这个。人家自己开发的代码，写实的，跟真人无疑，真人找不到那么漂亮的，4美元一张图，我下载了十几张1K的小图。;6;9;15;18388;0.000815749401783772
47224;有种暖暖的感觉，衣服和发型饰品都在变，但是脸差不多是一模一样的;1;4;5;18388;0.00027191646726125733
47226;99的画师画不出这种水平;29;6;35;18388;0.0019034152708288013
47256;撞衫了。我在听风之谷。。。。。点开你的视频。。。。我酷狗出问题了？怎么跳回去重播了。反复了三次。。。我才确定撞音乐了。。。吃瓜吃瓜吃瓜;1;5;6;18388;0.0003262997607135088
47260;不能看手，手就是答辩;5;3;8;18388;0.00043506634761801175
47266;为什么ai画的都是半身，腹部及退都不会画吗？还是手不会画;1;2;3;18388;0.0001631498803567544
47271;我可以自己做自己想看的吗星星眼;6;2;8;18388;0.00043506634761801175
47280;出4k图需要什么显卡;1;0;1;18388;5.438329345225147e-05
47283;授人以鱼不如授人以渔，把渔具发出来把doge;2;0;2;18388;0.00010876658690450294
47291;求图up主;1;0;1;18388;5.438329345225147e-05
47300;AI用的是哪一款软件;1;0;1;18388;5.438329345225147e-05
47302;这一组有链接么;5;0;5;18388;0.00027191646726125733
47309;up快把模型交出来傲娇;1;0;1;18388;5.438329345225147e-05
47315;AI画人，画的了轮廓，画不了变化。所以AI画的脸，五官很精致，但是不会有任何表情；AI画的躯干（xion等）很哇塞，但应对手指的透视变化却无能为力。;1;0;1;18388;5.438329345225147e-05
47319;ai绘图进步神速，画师会失业吗？;1;0;1;18388;5.438329345225147e-05
47322;私聊了呀，可以发一下嘛;1;0;1;18388;5.438329345225147e-05
47329;做个图包吧，私信你也看不到啊;1;1;2;18388;0.00010876658690450294
47339;这级别的画质一张图片需要多少分钟？;1;0;1;18388;5.438329345225147e-05
47341;大佬站酷有没有号;2;1;3;18388;0.0001631498803567544
47344;求模型和tag;1;1;2;18388;0.00010876658690450294
47353;全是一个人是吧;3;0;3;18388;0.0001631498803567544
47381;画的？;2;0;2;18388;0.00010876658690450294
47386;这是stable吗;1;1;2;18388;0.00010876658690450294
47401;这是用什么软件做的啊;3;0;3;18388;0.0001631498803567544
47406;现在AI能处理好手指吗吃瓜;1;0;1;18388;5.438329345225147e-05
47420;做美宣的朋友终于可以不用太累了;6;0;6;18388;0.0003262997607135088
47430;AI能画没衣服的吗;3;0;3;18388;0.0001631498803567544
47445;请问up主是云端还是本地？;1;0;1;18388;5.438329345225147e-05
47449;4k怎么做到的;4;0;4;18388;0.00021753317380900588
47456;做成单独专栏吧;1;1;2;18388;0.00010876658690450294
47467;你懂的doge;1;0;1;18388;5.438329345225147e-05
47486;有一说一，这是我目前看到的最好的ai作品;1;0;1;18388;5.438329345225147e-05
47498;确实是ai画作，手指问题依旧明显，ru头明显偶有瑕疵，但按这个发展速度，新时代没多远了可能以后除了顶流风格画师，其他画师可以歇着了捂脸藏狐;18;135;153;18388;0.008320643898194474
47517;BOM盘寄了，是不是哪个二极管在线解压了;5;71;76;18388;0.004133130302371111
47523;别搞那么大，不好看;3;27;30;18388;0.001631498803567544
47527;三连了去私信我自动回复链接，不是在这评论，说打不开的请把后缀删除二字删掉;5;10;15;18388;0.000815749401783772
47537;别废话，模型名，提示词，随机种子统统交上来脱单doge;3;6;9;18388;0.0004894496410702633
47542;失效了？;2;2;4;18388;0.00021753317380900588
47546;有果的嘛？;1;1;2;18388;0.00010876658690450294
47550;根本解压不了doge解压失败。;6;4;10;18388;0.0005438329345225147
47557;图很奈斯，回来还一键三连脱单doge;3;1;4;18388;0.00021753317380900588
47561;卧槽正点绝对正点把文件名改后缀改rar点赞;1;2;3;18388;0.0001631498803567544
47563;为什么显示文件损坏;2;2;4;18388;0.00021753317380900588
47569;哪个成功下载了的，求分享微笑;5;2;7;18388;0.0003806830541657603
47575;g了好像up被封了;1;6;7;18388;0.0003806830541657603
47579;手机上为什么看不了啊大哭;1;3;4;18388;0.00021753317380900588
47594;我看到的怎么都是全身光溜溜的滑稽滑稽;1;1;2;18388;0.00010876658690450294
47597;我想问问解压密码是啥;1;1;2;18388;0.00010876658690450294
47600;怎么老是显示（不支持该类型文件预览;1;1;2;18388;0.00010876658690450294
47606;为什么手机解压缩不了，已删后缀;5;0;5;18388;0.00027191646726125733
47614;隐私部位居然都能画出来，看来ai学习很快;1;1;2;18388;0.00010876658690450294
47616;看过和手不行熊大的过分了点这就彻底冲不动了;5;0;5;18388;0.00027191646726125733
47632;吃瓜很有料，居然还有冰冰版;3;0;3;18388;0.0001631498803567544
47642;那么多网盘为什么要选狗度？辣眼睛;1;0;1;18388;5.438329345225147e-05
47653;牛逼惊讶;1;0;1;18388;5.438329345225147e-05
47660;质量很高，就是凶器太大，太接近二次元夸张手法，引起极度的不真实感，，建议调整相关参数。祝多出好图三连了doge;2;0;2;18388;0.00010876658690450294
47670;什么模型？;1;0;1;18388;5.438329345225147e-05
47674;为啥我的百度网盘没有改名功能？笑哭;1;1;2;18388;0.00010876658690450294
47712;已三连，图来;1;0;1;18388;5.438329345225147e-05
47770;啥也不说了，英雄up主，如果有高清和压缩包就更好了;2;0;2;18388;0.00010876658690450294
47774;笑哭笑哭笑哭你把那几个词条删除就不会那么夸张了。;2;0;2;18388;0.00010876658690450294
47786;撸电子管，升赛博天;12;404;416;18388;0.02262345007613661
47799;首先恭喜大佬第一批金丹出炉doge顺便求些丹药（图）哈另外大佬有没有考虑多做点办公OL风的换换口味（顺便测试新的药炉），秘书老师护士医生都不错星星眼;7;85;92;18388;0.005003262997607135
47807;眉宇间有点像河北彩花;2;25;27;18388;0.0014683489232107897
47810;59秒那个手是真吓人，赶紧往上看压压惊滑稽;2;5;7;18388;0.0003806830541657603
47813;为什么感觉AIcos的脸型都是一样的？是素材的缘故？;2;5;7;18388;0.0003806830541657603
47816;开头的是不是鲤鱼姐的loradoge;1;4;5;18388;0.00027191646726125733
47823;AI是真的喜欢大啊，这么多图一个d以下的都没有，只有我觉得b和c是最完美大小范围吗笑哭;1;1;2;18388;0.00010876658690450294
47831;用的是别人的脸你有良心吗;1;0;1;18388;5.438329345225147e-05
47833;我就奇怪，这些ai生成的都有些既视感，会不会跟真人撞衫侵犯肖像权啊。;2;0;2;18388;0.00010876658690450294
47837;雷神的lora是什么啊大佬;1;0;1;18388;5.438329345225147e-05
47840;这图片说实在看好几遍了;1;0;1;18388;5.438329345225147e-05
47844;没AI男生的吗，全女生;1;0;1;18388;5.438329345225147e-05
47866;前面几张的背景，求一下咒语;1;0;1;18388;5.438329345225147e-05
47869;雷电将军是什么模型啊，感觉好精致星星眼;1;0;1;18388;5.438329345225147e-05
47872;需要电脑配置高吗;9;0;9;18388;0.0004894496410702633
47883;up，手模这里是自己调的么;1;0;1;18388;5.438329345225147e-05
47886;炼什么？;3;0;3;18388;0.0001631498803567544
47895;用的什么ai;7;0;7;18388;0.0003806830541657603
47907;054;4;83;87;18388;0.0047313465303458774
47914;大佬请问这是什么模型啊，能分享一下吗，超喜欢赛博朋克;1;5;6;18388;0.0003262997607135088
47917;有夸克网盘吗？谢谢星星眼;1;2;3;18388;0.0001631498803567544
47925;解压密码是啥;1;1;2;18388;0.00010876658690450294
47927;UP主加油看好你噢;1;1;2;18388;0.00010876658690450294
47929;差不多全是上半身笑哭全身图有点少;2;1;3;18388;0.0001631498803567544
47938;这小游戏封面是不是侵权你了笑哭;1;0;1;18388;5.438329345225147e-05
47941;手机的吗？电脑能不能用呢？;2;0;2;18388;0.00010876658690450294
47954;UP主加油看好你噢;1;0;1;18388;5.438329345225147e-05
47966;继续努力;1;0;1;18388;5.438329345225147e-05
47971;求求关键词;3;17;20;18388;0.0010876658690450293
47975;除了手，其他真的和真人别无二致了tv呆;1;10;11;18388;0.0005982162279747662
47977;这ai的素材库怕不是从韩国的整形医院复制的;1;8;9;18388;0.0004894496410702633
47979;手指头确实有点恐怖;1;4;5;18388;0.00027191646726125733
47983;好真实;1;1;2;18388;0.00010876658690450294
47985;手很怪;1;1;2;18388;0.00010876658690450294
47987;职业装？91职业吧笑哭;1;1;2;18388;0.00010876658690450294
47989;三联，求图包;1;1;2;18388;0.00010876658690450294
47994;用的lora是KoreanIDO吧;3;0;3;18388;0.0001631498803567544
47998;ai手的问题什么时候才能修复。;1;0;1;18388;5.438329345225147e-05
48000;已三连吃瓜链接呢，顺便多来点这种题材的;1;0;1;18388;5.438329345225147e-05
48002;能不能让ai做点激凸半透明明日方舟嘿嘿;1;0;1;18388;5.438329345225147e-05
48006;反正网图都是高P，不如直接AI算了doge;1;0;1;18388;5.438329345225147e-05
48008;人家不是说了不能提人家模型名了吗;4;0;4;18388;0.00021753317380900588
48017;求库和关键词吃瓜;1;0;1;18388;5.438329345225147e-05
48019;请问ai软件去哪里找？;2;0;2;18388;0.00010876658690450294
48022;好看doge;1;0;1;18388;5.438329345225147e-05
48024;UP主加油看好你噢;1;0;1;18388;5.438329345225147e-05
48028;电脑不行，只能求包;1;0;1;18388;5.438329345225147e-05
48030;除了手指都不错吃瓜;1;0;1;18388;5.438329345225147e-05
48032;只能看一眼，不能看多，看多审美疲劳;1;0;1;18388;5.438329345225147e-05
48035;关注了多发点星星眼;1;0;1;18388;5.438329345225147e-05
48037;再接再厉妙啊;1;0;1;18388;5.438329345225147e-05
48039;很正呀doge;1;0;1;18388;5.438329345225147e-05
48041;师傅，你是做什么工作的？;1;0;1;18388;5.438329345225147e-05
48047;UP主加油看好你噢;1;0;1;18388;5.438329345225147e-05
48049;手咋回事囧;1;0;1;18388;5.438329345225147e-05
48051;两个圆圆的东西给你了doge;2;0;2;18388;0.00010876658690450294
48054;关键词来点;2;0;2;18388;0.00010876658690450294
48057;up什么显卡，生成的分辨率多少;3;0;3;18388;0.0001631498803567544
48061;还在引还在引，真正给社区做贡献的已经和真人模型切割了，蹭热度的还在引流;1;0;1;18388;5.438329345225147e-05
48063;dogeAI不会画手还是一大毛病。;1;0;1;18388;5.438329345225147e-05
48066;图包图包doge;4;0;4;18388;0.00021753317380900588
48071;已三连，求图包吃瓜吃瓜吃瓜;2;0;2;18388;0.00010876658690450294
48074;关键词给一个啊;1;0;1;18388;5.438329345225147e-05
48076;还得是你啊;1;0;1;18388;5.438329345225147e-05
48078;星星眼星星眼星星眼支持支持再来点;5;0;5;18388;0.00027191646726125733
48084;已三连吃瓜链接呢，顺便多来点这种题材的;3;0;3;18388;0.0001631498803567544
48088;第一张和第二张还有香菇酱那张真不错，人体没啥大问题不说构图还很好;9;2020;2029;18388;0.11034370241461823
48098;有几张还挺可爱的，拿来宣发还真不错，就是产品可能不太需要宣发（）;15;908;923;18388;0.050195779856428105
48114;妮干妈;19;4299;4318;18388;0.23482706112682183
48135;很好奇025这个辣椒AI是怎么学来的辣眼睛;17;485;502;18388;0.027300413313030236
48153;我：碳氢氧氮;8;227;235;18388;0.012780073961279096
48162;AI绘画有时候生成的图片会很奇怪，甚至猎奇，但效率高啊，可以先生成个几百张，选其中一张。doge;6;212;218;18388;0.01185555797259082
48169;总觉得已现在的禁咒体系还没办法支持这么高精度的人体炼成，应该是古魔法师纯手搓出来;3;139;142;18388;0.007722427670219708
48173;现在的AI绘画还处于学习人类的阶段，本来就是学习的高手画风doge;6;7;13;18388;0.0007069828148792691
48180;看着确实不像ai画的，倒像是一整套食品拟人图;2;84;86;18388;0.004676963236893626
48183;怎么感觉是以图转画;1;8;9;18388;0.0004894496410702633
48185;up能不能透露一下丹方啊，一个也好，超想知道up究竟写了什么;1;27;28;18388;0.0015227322166630412
48187;色秀可餐（）;1;61;62;18388;0.003371764194039591
48193;看的出来融合了很多呲牙;1;27;28;18388;0.0015227322166630412
48197;请问，这个ai绘画到底怎么用;2;1;3;18388;0.0001631498803567544
48200;现在ai绘画这么厉害了吗;2;4;6;18388;0.0003262997607135088
48207;AI这水平已经超过很多所谓的“娘化”画手了。别说这些是抄别人的，如果不商用没有任何人可以指责这些作品。;2;9;11;18388;0.0005982162279747662
48210;强烈建议来个中药方剂拟人只是担心这些AI没有学过相应中药的数据;1;2;3;18388;0.0001631498803567544
48224;啥软件？;1;0;1;18388;5.438329345225147e-05
48231;bili长歌怀采薇啊啊啊啊啊啊啊啊啊啊啊啊啊啊啊;1;0;1;18388;5.438329345225147e-05
48235;假的，人画的;1;0;1;18388;5.438329345225147e-05
48258;我总感觉那个鸡精那个不是ai画的，ai是没办法把鸡翅膀识别成人手拟人的;1;1;2;18388;0.00010876658690450294
48286;感觉ai会画手了;1;0;1;18388;5.438329345225147e-05
48299;我记得之前ai还很傻来着，怎么最近进步这么大哦呼;1;0;1;18388;5.438329345225147e-05
48311;这玩意不会真的只能用作色图和抽象图吧热;1;0;1;18388;5.438329345225147e-05
48314;AI似乎已经把人体结构和画手部的问题攻克了？？;5;0;5;18388;0.00027191646726125733
48334;坏了，ai会画手了;7;0;7;18388;0.0003806830541657603
48346;为什么按配料画出来会是人doge;3;0;3;18388;0.0001631498803567544
48353;ai居然会画手了jpg;1;0;1;18388;5.438329345225147e-05
48358;没把各种添加剂写进去吗吃瓜;1;1;2;18388;0.00010876658690450294
48364;为什么你的ai绘画播放量能破万，我的却不能;4;37;41;18388;0.00222971503154231
48370;这很不合理，最后怎么还变兽娘了？不应该变怕怕吗？就像这样;1;22;23;18388;0.0012508157494017839
48379;6;1;1;2;18388;0.00010876658690450294
48382;什么时候出用AI画战锤40K的克里格死亡兵团;1;1;2;18388;0.00010876658690450294
48392;什么软件星星眼doge;4;0;4;18388;0.00021753317380900588
48397;我所接触的所有AI作品没有一个会画奈投的吃瓜不知道什么时候能看见进步;6;12;18;18388;0.0009788992821405265
48404;图包来咯链接：httpspanbaiducoms1AGKdtEHfCj36jpQM8sIPApwd6ura点赞三连支持一下吧给心心给心心给心心;7;11;18;18388;0.0009788992821405265
48412;看多了会胡思乱想OK;2;4;6;18388;0.0003262997607135088
48415;投币支持，话说UP主，有没有同人的图？不用GHS，只要是同人的美图就行，比如蒂法。喜欢;1;2;3;18388;0.0001631498803567544
48417;继续加油;1;2;3;18388;0.0001631498803567544
48419;真不错大笑;1;1;2;18388;0.00010876658690450294
48421;不自觉就投币了;1;1;2;18388;0.00010876658690450294
48423;热词系列三连;1;1;2;18388;0.00010876658690450294
48425;脱单doge;1;1;2;18388;0.00010876658690450294
48427;352我觉得很好;1;1;2;18388;0.00010876658690450294
48430;24年真人都能画了吧;1;1;2;18388;0.00010876658690450294
48432;太哇塞了;1;1;2;18388;0.00010876658690450294
48434;UP主加油;1;1;2;18388;0.00010876658690450294
48438;我还是小看了你，营养逐渐跟不上了，取关取关doge;1;0;1;18388;5.438329345225147e-05
48440;用什么软件画的;1;0;1;18388;5.438329345225147e-05
48443;悲，有没有原图，一张一张截屏太费哩tvdogetvdogetvdogetv大哭tv大哭tv大哭;45;1227;1272;18388;0.06917554927126386
48489;高开叉的tag是什么啊？;7;962;969;18388;0.05269741135523167
48497;小波奇的大波奇使我波奇;4;412;416;18388;0.02262345007613661
48502;小波奇身材太可了，那个圆圆的肚肚，我干的。dogedogedoge;14;525;539;18388;0.029312595170763543
48517;黄蓝发夹缺少了发夹;1;253;254;18388;0.013813356536871872
48519;好想吃波奇酱的软饭呀让波奇酱做最不喜欢的工作养着我，每天拿波奇酱的钱去赌，反正波奇酱一定是打不还手骂不还口吧，每天躲在被子里哭。最后我要把波奇酱的吉他拿去卖掉，然后看着波奇哭着求我的样子doge;19;374;393;18388;0.021372634326734828
48539;波奇酱会跪下来干的事情不只是祈祷（）;1;8;9;18388;0.0004894496410702633
48541;感觉ai画手进步了;1;10;11;18388;0.0005982162279747662
48543;这手没有太大问题诶，up修改了吗;1;4;5;18388;0.00027191646726125733
48545;这ai绘画都是哪里搞得doge;1;16;17;18388;0.000924515988688275
48547;撕虽然ai画的手有的还是手指数量不对或者形状出错，但确实已经有画好手的能力了惊讶;2;10;12;18388;0.0006525995214270176
48551;我超，你这喂了啥tag啊，波门;1;4;5;18388;0.00027191646726125733
48553;吉他手成神职人员了;1;107;108;18388;0.005873395692843159
48555;这下波奇了（雾）;1;13;14;18388;0.0007613661083315206
48557;申鹤重云了疑惑;1;7;8;18388;0.00043506634761801175
48568;求个全tag;1;2;3;18388;0.0001631498803567544
48571;你这AI怎么越画越涩呢，而且这个画风，不是我认识的那个AI;1;3;4;18388;0.00021753317380900588
48586;ai画出来的手明显进步了好多;1;4;5;18388;0.00027191646726125733
48598;这下真画不过ai了大哭;3;3;6;18388;0.0003262997607135088
48602;三连求图;1;1;2;18388;0.00010876658690450294
48605;用的哪个ai;2;1;3;18388;0.0001631498803567544
48608;这手没修过我是不信的;1;1;2;18388;0.00010876658690450294
48664;六个手指的屑一里藏狐;2;1;3;18388;0.0001631498803567544
48677;这什么ai啊，手一个都没崩星星眼;6;2;8;18388;0.00043506634761801175
48686;呱沽大魔王弹幕说开盖即食属实让我绷不住了;1;1;2;18388;0.00010876658690450294
48696;波奇酱，最近您所在乐队的财务很紧张，大家决定辞退您这样社恐又没有特殊技能的普通吉他手，您也不想失去这份热爱吧？还有凉同学又在大手大脚的花钱了，而且她现在又在吃草了，几乎可以说不能生活了，你手里也没有钱吧。那么将来您的乐队和凉同学未来问题会怎样发展，就看您今晚和以后的表现了另外波奇同学您也很想要吧虽然您的嘴里在说不要，可是身体却很诚实地开始抖动了呢这么美丽的一个女人，很难想象您竟然会做出这种事情，如果您不想让乐队的大家看到你现在的丑态，就给我小心一点，以后每个周四到我办公室一趟懂吗？;2;0;2;18388;0.00010876658690450294
48708;太不适合了，薇尔莉特是那种感觉神圣不可侵犯的，如果让没看过这番的人看还以为是一部买肉福利番呢;6;0;6;18388;0.0003262997607135088
48715;省流稿定AI功能看简介没给链接;15;190;205;18388;0.011148575157711551
48731;用过了，但非常不好用，先别说上传图片和上色都动不动就无法通过审核，如果你给的是一张精致的线稿，他不会按照你的线稿来上色而是会把你的线稿都改掉，变成与之类似的图，所以画手想用这个来偷懒上色过程是行不通的，这个网站只能喂火柴人线稿;8;98;106;18388;0.005764629105938656
48742;我只能说画的真的很好看但这个画手。。。有点。。。笑哭;1;8;9;18388;0.0004894496410702633
48746;好像就是ControlNet插件;1;4;5;18388;0.00027191646726125733
48748;省流：要登录脱单dogedogedoge妙啊;1;4;5;18388;0.00027191646726125733
48750;那么，链接酸了;1;3;4;18388;0.00021753317380900588
48762;Httpswwwgaodingcomai;7;267;274;18388;0.014901022405916902
48770;这是我用神圣分离者，弄出来的图;5;65;70;18388;0.0038068305416576026
48776;非常实用脱单doge;2;127;129;18388;0.007015444855340439
48779;好用;3;34;37;18388;0.002012181857733304
48783;鼓励ai绘画真的6;4;9;13;18388;0.0007069828148792691
48790;？这视频上午好像看过疑惑;3;2;5;18388;0.00027191646726125733
48794;很不错;4;29;33;18388;0.0017946486839242985
48802;哇哦;1;3;4;18388;0.00021753317380900588
48807;左边喂的，右边AI吃瓜;4;28;32;18388;0.001740265390472047
48812;6;4;8;12;18388;0.0006525995214270176
48823;很好用打call;3;7;10;18388;0.0005438329345225147
48828;色图根本看不完;2;11;13;18388;0.0007069828148792691
48833;我发布了一篇笔记，快来看看吧;1;10;11;18388;0.0005982162279747662
48842;全都搜不到（早有预料）;1;6;7;18388;0.0003806830541657603
48845;我怎么感觉昨天看过;1;4;5;18388;0.00027191646726125733
48849;链接呢;1;1;2;18388;0.00010876658690450294
48851;所以，链接在哪？;2;1;3;18388;0.0001631498803567544
48870;httpsdraftart1936462国内绘画网站;1;0;1;18388;5.438329345225147e-05
48888;瑠夏酱我的ai又有新乐子了;1;0;1;18388;5.438329345225147e-05
48906;还有审核，我TM;1;0;1;18388;5.438329345225147e-05
48917;省流：没链接;1;0;1;18388;5.438329345225147e-05
48922;原图与识别出来的;2;3;5;18388;0.00027191646726125733
48926;一网一匠感觉好奇怪;1;1;2;18388;0.00010876658690450294
48929;性别都变了无语;1;0;1;18388;5.438329345225147e-05
48938;笑死，明明形容词里写的是白色眼睛，生成出来的却成了金色眼睛蓝色眼睛，不会没被喂过白色眼睛的吧;1;0;1;18388;5.438329345225147e-05
48940;有个风险是AI技术到更成熟的时候它是否还能保持低成本，这是一个实打实的垄断技术。画师们表现出的抗拒主要来源于从小生产者降级成了无产者的阶级跌落，我这个小画师更是因为AI的发展变成了共产主义的忠实追随者;35;142;177;18388;0.00962584294104851
48976;看AI能发展到什么地步，是画笔还是机床，这里有个质变的临界点。前者让画师成为掌握新装备的高手，后者让画师成为机床边儿上拧螺丝的。两者的预期薪酬差距数倍，职业前景也大不相同。国内公众号很少有人考虑过，AI普及真的能提高绘画艺术水平吗？至少，隔壁机器翻译就没有，相反，机翻效率太香，大家默认都用机翻，工期缩短，很多书籍的翻译质量下降到了一个摆在以前绝对无法接受的地步。;4;78;82;18388;0.00445943006308462
48981;现在看到满天飞的ai图都头大，很想有个什么过滤器能把那些ai图从视野里筛掉。经过一段时间接触ai后，我面对ai绘画的合成图好像再也没有以前那种心动感了，似乎下意识的就会给那些疑似ai的图打上劣质，没意思的标签，一方面可能是心理原因，一方面是ai图真的表达不达意。我想ai图会不会在让美术更卷的同时最终消减人们对烂大街的美术作品的热情。;11;79;90;18388;0.004894496410702632
48993;看完围棋的类比之后，不禁想到为何柯洁掩面痛哭，而作者感到欣喜了：柯洁作为当时的接近第一人的存在，围棋对他的乐趣一定程度上类似于探索，在对弈中以人力寻找最优解；但“围棋之神”降临，几无探索的意义；在此之前他是创造了“妙手”，在此之后所有人只是重复AI的妙手，毕竟，神的准则总是对的。而多数下围棋人的乐趣应该都不是探索，当神降临的时候，多数人应该还是会慨叹和欣喜的。;2;78;80;18388;0.004350663476180117
48996;对Ai的焦虑折射出的应该是当代年轻人对于工作和未来的迷茫，各个行业本身就很卷且难度加大了，Ai的出现更是有堵死一切可能的潜质，这就是为什么打算但还没有入行的小画家格外担忧Ai;2;60;62;18388;0.003371764194039591
48999;我觉得最好的解决方法是尽量少看那些跟AI有关的东西因为这会加重自己焦虑的情绪在深渊里陷得太深就不一定能爬的出来了。;9;55;64;18388;0.003480530780944094
49009;ai绘画出来之后，我有半个多月都是很泄气很低落的心情。后来才慢慢平复。也试着学新的东西，3d建模之类的，其实还是想办法提升自己水平才行，时代的车轮，是不可抵挡的。所有人都要顺时代潮流去做，并从中看到新的机会和对自己的帮助与优势;19;54;73;18388;0.003969980422014357
49029;视频中UP的观点我有两点持不同意见，第一点是AI绝对不是翻唱那么简单，翻唱再怎么说都是接近的歌词接近的调子，还能有个歌名可以让你找到原创者，但现在的AI更多是多段旋律的拼接，歌名也改了，你无法找到任何和原创者相关的信息，之前我看到一个AI模型的风格我很喜欢，但无论怎么找都只能找到AI生成的图，完全找不到该风格的画师。第二点是AI会像围棋那样找到新的可能性，但实际上恰恰相反，现在围棋的可能性已经被穷尽了，现在的围棋选手只是拙劣地模仿着AI，已经没有新的招数可以探索了，绘画以后也一定是这样，本来已经几十年没出现新的风格了，我们只是在现有风格里探索各种分支，而AI的出现将很快把现有风格穷尽，继而让人们失去了对绘画的探索。游戏开挂了满级了，这个游戏的可玩性就已经消失了一大半了我自己的话，话私图还是不会用AI的，工作上要是需要用AI我也不抗拒，希望在AI的大时代来临下我还能保持对绘画的热爱;6;44;50;18388;0.0027191646726125733
49036;我靠，那过个三四年我岂不是掌握远古工艺，纯手绘，很酷;1;28;29;18388;0.0015771155101152925
49043;不好意思了，很显然，靠画画赚钱的时代过去了，把画画变成一种爱好和娱乐吧，去享受过程就好。你如果说为了吃饭，那其实还是有很多路可选的，没必要一棵树吊死，祝你幸运。;5;17;22;18388;0.0011964324559495323
49051;作为一个渴望从美术业的普通人，还是先老实打基本功，再去学习3d辅助，ai绘画;1;10;11;18388;0.0005982162279747662
49053;我预测ai绘画会在5年之内销声匿迹。;15;15;30;18388;0.001631498803567544
49069;去学代码吧，技美缺人，大量缺人。脱单doge;6;11;17;18388;0.000924515988688275
49076;不建议新手尝试，致瘾后你会很难抽身;1;9;10;18388;0.0005438329345225147
49078;真正的生存指南：打不过就加入，直接自己去调教ai中国绊爱2nd我觉得OK;19;17;36;18388;0.001957798564281053
49098;为什么AI还不来抄袭我hhhhh;1;9;10;18388;0.0005438329345225147
49101;希望UP能直播聊聊AI绘画，不单单是绘画吧，很多领域未来1年应该都会有很多讨论。;3;2;5;18388;0.00027191646726125733
49106;老哥，我是個底層小程序員，但是因為不喜歡那份工作，在業餘時間報班學習繪圖，然後AI就出來了。屬實走到哪被AI捲到哪了无语无语;2;3;5;18388;0.00027191646726125733
49113;我也是这看法，ai绘画出了以后对画师的文化水平会高到一个离谱的地步;1;1;2;18388;0.00010876658690450294
49115;虽然不愿意承认，但ai确实是生产力;1;1;2;18388;0.00010876658690450294
49145;其实我特别好奇，让AI扫描所有文艺复兴时期和各种新古典主义大师们的画能不能自主的整出莫奈，马蒂斯，梵高和毕加索这样风格的画;5;0;5;18388;0.00027191646726125733
49153;时代的进步注定是要有代价的，从最早的珍妮机，再到电力，流水线，现在的自动化，人工智能。AI绘画在未来一定是会更强大，更易用，行业受到冲击也是不可避免。AI绘画让我这个不懂美术的人，也可以很简单地就获得几张还算不错的图片，不需要约稿，不需要稿费，不需要等待，不满意还可以随便修改关键词，一键重新生成，我觉得这才是最恐怖的一点。我不否认艺术是一个需要沉淀，付出，和技术积累的过程，不是机器随便几秒就可以复刻的，但我也不能否认技术的进步，确实正在改变我对绘画的认知，因为这是我以前从未想象到的。;7;0;7;18388;0.0003806830541657603
49161;枪是个工具，普通人能用，杀手也能用。AI也是个工具，普通人能用，画手也能用。;7;0;7;18388;0.0003806830541657603
49180;我的绘画板是不是可以扔了。吃瓜吃瓜;3;1;4;18388;0.00021753317380900588
49184;所以说人不是死的doge;2;0;2;18388;0.00010876658690450294
49191;除了不像神里其他都很好滑稽;7;236;243;18388;0.013215140308897106
49199;这个神里怎么有点翠翠的味道屑;2;46;48;18388;0.0026103980857080703
49202;多了丝妩媚之意，少了些清纯与身份的尊贵。眼角的问题应该是，这应该算是媚眼吧？最主要的是后面扣分了，因为公主不该这样如此穿着。。。;5;34;39;18388;0.002120948444637807
49208;这眼神必是喂了河里滑;3;20;23;18388;0.0012508157494017839
49212;绫华神教教主前来报道doge;1;12;13;18388;0.0007069828148792691
49218;你这不是绫华，人家绫华头发双耳处有两个大辫，你这没有;1;0;1;18388;5.438329345225147e-05
49222;用的什么模型？脱单doge脱单doge;1;0;1;18388;5.438329345225147e-05
49227;关注我，私信回复龟龟即可获取;2;0;2;18388;0.00010876658690450294
49230;美爆了;1;0;1;18388;5.438329345225147e-05
49232;这脸咋看咋熟悉;1;0;1;18388;5.438329345225147e-05
49235;ai确实好看;1;0;1;18388;5.438329345225147e-05
49241;这种AI模型太完美，现实中应该不存在吧，呜呜，现实就没有真正的绫华，大哭绫华你在哪儿？;1;0;1;18388;5.438329345225147e-05
49257;感觉跟凌华的气质不搭，看着好看但没有那种优雅庄重的感觉，露的太多失去美感了;1;0;1;18388;5.438329345225147e-05
49262;这种烂大街街的电子审美有什么意义？除了提醒我腻味就没别的了微笑;18;6;24;18388;0.0013051990428540352
49283;挺像B站COS区著名cos耶和华害羞;1;1;2;18388;0.00010876658690450294
49286;这AI是不是看了N次何野华好几张都像;1;0;1;18388;5.438329345225147e-05
49290;老哥用的是那个真人版凌华lora吧，C站下架了，能分享下嘛;1;1;2;18388;0.00010876658690450294
49294;绫华的胸真的能长到这么大吗？这不科学啊，兄弟们有解释一下的不;3;11;14;18388;0.0007613661083315206
49299;从大小姐变成妩媚的公主了笑哭如果不露的话，给我一种很善解人意很温柔大方并且会持家的妻子（虽然神里本就是温柔善解人意适合当老婆，这版是直接成熟体doge更适合了）;7;10;17;18388;0.000924515988688275
49309;凌华小姐我是你的太郎丸啊脱单doge;1;1;2;18388;0.00010876658690450294
49311;有8k的原图吗想当壁纸（币已投）;3;1;4;18388;0.00021753317380900588
49315;可以啊，这么高清，电脑配置应该很高吧;2;1;3;18388;0.0001631498803567544
49320;up我想问一下你lora训练喂了几张图？我自己练了十几张图出来的效果啥也不是笑哭;5;0;5;18388;0.00027191646726125733
49328;有几张看着像P过的照片。;1;0;1;18388;5.438329345225147e-05
49330;这脂肪块好好看妙啊;1;2;3;18388;0.0001631498803567544
49337;太漂亮了KizunaAI哭哭;1;0;1;18388;5.438329345225147e-05
49339;漫天繁星不如卿;2;0;2;18388;0.00010876658690450294
49343;热词系列你币有了;1;2;3;18388;0.0001631498803567544
49345;如果是竖屏就好了，;1;0;1;18388;5.438329345225147e-05
49348;两连奉上吃瓜;1;0;1;18388;5.438329345225147e-05
49350;前几张看着真的有一股子翠翠的屑味。。妙啊;1;0;1;18388;5.438329345225147e-05
49353;貌美如花绝世无双;1;0;1;18388;5.438329345225147e-05
49355;赞了，多多更新呀脱单doge;1;1;2;18388;0.00010876658690450294
49358;C酱AWSLC酱AWSLC酱AWSL;1;0;1;18388;5.438329345225147e-05
49360;泪痣没了啊笑哭;1;0;1;18388;5.438329345225147e-05
49363;创作不易给你点赞;1;1;2;18388;0.00010876658690450294
49365;吃瓜群友特来吃瓜吃瓜;1;0;1;18388;5.438329345225147e-05
49367;好;1;0;1;18388;5.438329345225147e-05
49369;好漂亮呀，up可以求个模型和tag吗;4;0;4;18388;0.00021753317380900588
49375;0;1;0;1;18388;5.438329345225147e-05
49377;你别说，ai几十分钟量大管饱上千张而福利这类的要拍摄37天，还得被白嫖doge出产量达几十张doge;68;1307;1375;18388;0.07477702849684577
49446;能不能给AI喂水淼的几百套图啊？很好奇而已，有大佬做了记得踢我墨镜;74;483;557;18388;0.030291494452904067
49521;ai让我越来越不敢生孩子了，我的孩子需要多卷才能在未来找到工作;140;594;734;18388;0.039917337393952576
49662;ai一记重拳打爆虚高泡沫的线上经济，促进行业回归实体经济，大功德;75;5796;5871;18388;0.31928431585816835
49738;高质量的不会死，低质量的会死，还是好事。早烦那些带个蓝毛就说是蕾姆的了笑哭;19;778;797;18388;0.04334348488144442
49758;反正AI已经能骗我弟弟了，我觉得够用了;6;490;496;18388;0.026974113552316728
49765;提问：现在是只允许这样吃现成的吗？我的意思是像视频里说的这样，下载别人预设好的图库然后使用。可不可以自己训练这个ai呢？就是说我自己给它倒入素材图片然后设置标签让它学习以让它更符合我个人的想法。如果这样做了那么图片的标签输入中文它能识别得了吗？因为我看视频里的素材包标签都是英文的;6;47;53;18388;0.002882314552969328
49772;我他妈爱死你了，以后自己写本子doge我就是金色传说;16;398;414;18388;0.022514683489232107
49789;聪明的狐狸鸡早就自己提供样本跟团队一起训练AI了吧doge;6;238;244;18388;0.013269523602349358
49796;还是会产生很多咸鱼佬卖图的脱单doge又一批学生党通过瑟瑟嘎嘎暴富;12;198;210;18388;0.011420491624972808
49809;我觉得吧，ai绘画时没有灵魂加成的，无论比真人多完美，她也不是个人，人的精神需求没有满足。就比如网络上美女那么多那么喜欢看，也很少说非常喜欢甚至去附加爱的属性，但是现实中遇到的人她可能没有那么完美，但是依然会义无反顾的爱上。拿难听点的举例，你看Apian的时候为什么越看越挑剔，因为你的精神满足在拉高，一面玻璃后面真人脱光，和给你一幅完美的通体画，我觉得我还是会选择真人的感觉，虽然结果都是隔着玻璃;24;45;69;18388;0.003752447248205351
49834;主要是修图把人修的不像真人，才显得ai像;7;193;200;18388;0.010876658690450293
49842;我觉得应该让ai和3d打印技术结合一下;3;36;39;18388;0.002120948444637807
49846;失业肯定是不能的，毕竟我可不想冲着冲着突然它发挥不稳定跳个恐怖谷出来;20;174;194;18388;0.010550358929736785
49867;iPhone上已经有这种傻瓜式的app了，集成超分，喂图生图，局部重做，直接手机上跑，还能调用果子的NPU和CoreML本地模型，可预加载模型缓存NPU站起来了A15大约1分多一张图抠鼻抠鼻抠鼻图片模型为DosMix;34;144;178;18388;0.009680226234500761
49902;线上卷不过线下也可能会卷不过，如果哪个厂家发明一个杯子能完全联网，再加上vr和大数据算法，可以根据你的所有指令实时反馈，那;18;86;104;18388;0.005655862519034153
49921;以后片都可能是ai拍的了，仔细想想还挺可怕的。ai绘画才出来几年发展速度有点猛;9;85;94;18388;0.0051120295845116384
49931;现在除了手指跟批画不好，其他地方爆锤fljdoge，所以广大flj知道怎么努力了吗;5;57;62;18388;0.003371764194039591
49937;以后技术成熟起来作动画就和现在的写小说一样简单，人人都可以自制，只需要输入文字，和一张插图，剩下的ai就自己完成。只需要几个月就能完成一部堪比火影海贼的超长篇动漫;8;21;29;18388;0.0015771155101152925
49946;ai绘图chatgpt，二次元老婆是不是就复活了;1;30;31;18388;0.0016858820970197955
49948;之后发色图只需要一行代码，老黄会做剩下的事;1;7;8;18388;0.00043506634761801175
49950;画师失业fulij都不会失业doge;15;33;48;18388;0.0026103980857080703
49966;这样？吃瓜;3;25;28;18388;0.0015227322166630412
49970;大胆假设一下，ai3d打印doge;1;6;7;18388;0.0003806830541657603
49972;我们业内搞绘画的都没这个当回事反而外行人着急;1;6;7;18388;0.0003806830541657603
49974;失业还是不能，毕竟还是有局限性，不过我并不在意以后看的片子都是ai上演，因为ai没有太多瑕疵，顶多一些地方有瑕疵，整体来讲比真人要好看得多，说不定更有观赏感呢脱单doge;2;23;25;18388;0.0013595823363062867
49977;不会的，ai又不会暖被窝;14;22;36;18388;0.001957798564281053
49992;真不真实我不知道，反正成都骗过了我弟弟2233娘吃惊;1;3;4;18388;0.00021753317380900588
49994;可以搞视频吗？顺便把男主换成朋友doge;5;10;15;18388;0.000815749401783772
50000;这是怎么回事啊，卡在这里不动了;1;12;13;18388;0.0007069828148792691
50002;ai的发展是时代大势，但是我想说刀没砍刀自己身上是不知道疼的，现在笑嘻了以后ai侵入自己的行业就知道痛了;1;5;6;18388;0.0003262997607135088
50004;Steam上某类游戏产量会变得极高;2;5;7;18388;0.0003806830541657603
50007;麻烦让AI画个木鱼，我每天就敲这个木鱼脱单doge;1;19;20;18388;0.0010876658690450293
50009;如果以后有了高仿娃娃，鸡都得失业;12;22;34;18388;0.00184903197737655
50022;但是人家还有一项核心技术是AI办不到的吃瓜吃瓜;1;5;6;18388;0.0003262997607135088
50024;不准你参加yinpa;1;8;9;18388;0.0004894496410702633
50028;ai做的视频能不能有点剧情普通的3d就那几个动作重复;3;5;8;18388;0.00043506634761801175
50032;本本满天飞了doge;1;10;11;18388;0.0005982162279747662
50034;前提不要恋手笑哭笑哭;1;4;5;18388;0.00027191646726125733
50036;ai无版权，商用的话将带来很多麻烦;11;15;26;18388;0.0014139656297585382
50049;刚买了个电脑，win11的能用么？;2;2;4;18388;0.00021753317380900588
50052;以后ai能不能把我写的小说变成漫画啊，我只想自家看;3;2;5;18388;0.00027191646726125733
50056;我要的不止是图片，更是图片底下真实的灵魂给心心;1;11;12;18388;0.0006525995214270176
50058;是不见星空大佬嘛？;2;5;7;18388;0.0003806830541657603
50061;11等于几？;1;2;3;18388;0.0001631498803567544
50063;已经失效了啊大哭;1;2;3;18388;0.0001631498803567544
50065;我有个朋友托我问下这个能不能搞无码？;1;5;6;18388;0.0003262997607135088
50067;up这怎么办呀;2;8;10;18388;0.0005438329345225147
50071;我卡在这个页面不动了;2;8;10;18388;0.0005438329345225147
50075;真失业那不是好事吗？让她们干点正经工作去;1;3;4;18388;0.00021753317380900588
50077;跳舞小姐姐也要失业仿真人出来以后（人家工作效率更高，还不用休息滑稽）;2;3;5;18388;0.00027191646726125733
50080;六，生成视频的ai，未来几年会出吗？;9;4;13;18388;0.0007069828148792691
50090;劣币驱逐良币，到最后真的会人人都只能做销售;13;7;20;18388;0.0010876658690450293
50104;真人炼丹吃瓜刑啊，很多up都取消了真人三次元模;1;4;5;18388;0.00027191646726125733
50106;自动运行程序报错了;2;2;4;18388;0.00021753317380900588
50110;好耶，线上的姿势密集型要转到线下的劳动密集型了doge;1;2;3;18388;0.0001631498803567544
50118;能生成影片么？呆doge图没啥意思;3;2;5;18388;0.00027191646726125733
50122;有没有可能，cos的P图比AI更离谱，更一眼假;1;7;8;18388;0.00043506634761801175
50128;安装的lora模型咋使用啊;4;1;5;18388;0.00027191646726125733
50133;而且后面的vae没有找到和你选的一样的东西啊;2;1;3;18388;0.0001631498803567544
50136;夸克网盘只有20g的空间，下不了啊委屈;4;1;5;18388;0.00027191646726125733
50141;什么时候AI能出福利机视频再说好吧。;2;1;3;18388;0.0001631498803567544
50144;终于可以不用翻墙玩到了么？打call;1;1;2;18388;0.00010876658690450294
50146;想问下up，接定制吗？弄个枣糕的doge;1;1;2;18388;0.00010876658690450294
50148;666;1;1;2;18388;0.00010876658690450294
50150;那么ai是不是能自制动画，然后一部小电影就这样完成了tv色;4;3;7;18388;0.0003806830541657603
50159;从线上转移到线下只会赚的更多微笑;1;1;2;18388;0.00010876658690450294
50162;用已有得人脸再绘画得这么操作呀;1;1;2;18388;0.00010876658690450294
50170;ai想要取代人工还是有点时间的，ai只能做风景，剧情内容做不出来;1;1;2;18388;0.00010876658690450294
50175;Gk杨道长前尘pastense内卷的真眼墨香书华岁;2;1;3;18388;0.0001631498803567544
50185;用这个ai生成的图怎么总是模糊的，有大佬知道这是怎么回事;1;1;2;18388;0.00010876658690450294
50187;可以加那些tag嘛，emmm，我替兄弟们问的脱单doge;1;1;2;18388;0.00010876658690450294
50189;但是实际情况是AI的作图大众评价普遍不高偷笑五星给三星这样子;1;1;2;18388;0.00010876658690450294
50191;主要是线下啊，电子只因太多了;1;1;2;18388;0.00010876658690450294
50193;没想到打击最大的居然是cos圈，幸好现在ai还不会设计;3;1;4;18388;0.00021753317380900588
50198;真人能给人带来遐想;1;1;2;18388;0.00010876658690450294
50212;如果想本地1分钟内出1080p的图至少要什么配置的显卡啊;1;1;2;18388;0.00010876658690450294
50214;AI在涩情APP里也杀疯了，不是那个换脸，而是生成人物，还是萝莉，它们怎么下得去手;4;3;7;18388;0.0003806830541657603
50220;我现在一眼就能看出什么是ai而且我不喜欢这玩意，他们无法模仿一些画师早期青涩的画技，那种生疏感画出的画有种说不出的涩吃瓜;5;1;6;18388;0.0003262997607135088
50229;直接快进到ai制作视频;2;0;2;18388;0.00010876658690450294
50234;我问一下，这两个插件主要作用是什么;1;0;1;18388;5.438329345225147e-05
50239;大佬，1070可以吗，不行的话最低要什么卡。正准备换电脑;1;0;1;18388;5.438329345225147e-05
50242;后期AI吗？这不只是个开始滑稽谈什么后期处理。对AI来说它就是个大前期发育。已经结束啦画个框框就后期结束啦捂眼;2;0;2;18388;0.00010876658690450294
50246;这个对显卡和内存有要求吗;1;0;1;18388;5.438329345225147e-05
50258;像那个现在肥的和啥一样的一个主播，以前卖写真。。。。。有啥啊，还卖写真。。。;3;0;3;18388;0.0001631498803567544
50264;呃，东西下完了，然后也像视频里那样去网站，复制，粘贴，生成，然后什么都没有出现是为什么;1;0;1;18388;5.438329345225147e-05
50269;妈的笔记本坏了，只能用家里的老台式，那个显存只有1g，好像是用cpu跑的？;1;0;1;18388;5.438329345225147e-05
50274;up这个ai网站进不去咋搞，我挂了梯子也连不上，直接就打不开;1;0;1;18388;5.438329345225147e-05
50278;复制完信息以后，返回绘画界面，每次按那个箭头（粘贴）都是上次绘画的关键词信息怎么办翻白眼;1;0;1;18388;5.438329345225147e-05
50282;a卡行吗;1;0;1;18388;5.438329345225147e-05
50285;具体需要多少内存啊？我怎么两百多G还告诉我内存不够笑哭;3;0;3;18388;0.0001631498803567544
50289;淘汰不了吧，ai能发声吗？;2;0;2;18388;0.00010876658690450294
50297;最低什么配置，笔记本能跑吗;1;0;1;18388;5.438329345225147e-05
50300;脱单doge哪位大佬有封面上那个妹子的图片？;1;0;1;18388;5.438329345225147e-05
50307;UP我想问一下，VAE插件从哪里获取诶，也是从C站下载么;2;0;2;18388;0.00010876658690450294
50310;想问一下下载的文件是倒入lora还是stablediffusion我不导入到stablediffusion打电话左上角模型里就没这个文件了呀，还是同样的文件lora和stablediffusion文件夹都要放进去;1;0;1;18388;5.438329345225147e-05
50312;我想输入一张真人照片后，生成一个卡通人物的线稿，这个容易实现吗？;1;0;1;18388;5.438329345225147e-05
50314;请问复制数据粘贴后，再去复制别的数据粘贴依旧会粘贴上一次的数据怎么解决;1;0;1;18388;5.438329345225147e-05
50316;up链接挂了啊跪了;1;0;1;18388;5.438329345225147e-05
50318;为什么加载到一半就不动了大哭;1;0;1;18388;5.438329345225147e-05
50320;AI画的逼真吗？;1;0;1;18388;5.438329345225147e-05
50326;运行不了啊，让我下载东西，，;2;0;2;18388;0.00010876658690450294
50335;up可以给百度网盘的吗;1;0;1;18388;5.438329345225147e-05
50337;我的1070不支持，，，无语需要20系往上的rtx;2;0;2;18388;0.00010876658690450294
50340;不可能，ai毕竟是绘图，她不会动;2;0;2;18388;0.00010876658690450294
50343;2060可以吗;1;0;1;18388;5.438329345225147e-05
50345;a卡能用吗;1;0;1;18388;5.438329345225147e-05
50359;一定有用大佬大佬救救孩子吧，我用了这个软件然后也看到生成的图片了，但是总是生成好的一瞬间闪一下就消失，保存不了也看不到成品，这样的问题要怎么处理啊;4;0;4;18388;0.00021753317380900588
50379;为什么模型那边我没办法换模型呢？还有一个设置那边就没有up主所选的那个设置。谢谢;1;0;1;18388;5.438329345225147e-05
50386;这些ai绘画都是外国的吗？有靠谱的中国ai绘画吗？;2;0;2;18388;0.00010876658690450294
50390;up主有其他网盘吗？没有夸克网盘的会员大哭;4;0;4;18388;0.00021753317380900588
50396;doge交出壁纸的名称;1;0;1;18388;5.438329345225147e-05
50400;AI能画有点涩涩的二次元图吗星星眼星星眼星星眼;3;0;3;18388;0.0001631498803567544
50406;宅男真的很奇怪，宁可对是屏幕上的虚拟人冲都不愿意去现实中找女朋友。;4;0;4;18388;0.00021753317380900588
50412;ai能做出视频再说doge;1;0;1;18388;5.438329345225147e-05
50416;我有一个想法，请问这个软件能根据已有人物图片画一个女版的出来么，比如我上传一张kunkun跳舞的照片，可以画一张女版坤坤出来么害羞doge;1;0;1;18388;5.438329345225147e-05
50425;ai可能马上就被封杀了藏狐有些人逆大天已经被不能发的人弄上去了;2;0;2;18388;0.00010876658690450294
50429;a卡不行嗎;2;0;2;18388;0.00010876658690450294
50432;感觉你会火，先关注了，投资两个币;1;0;1;18388;5.438329345225147e-05
50436;至少ai肯定是粉色的捏脸红;2;0;2;18388;0.00010876658690450294
50442;AI既然能这样，为什么不那样？;1;0;1;18388;5.438329345225147e-05
50445;具体的显卡要求能细说吗？;1;0;1;18388;5.438329345225147e-05
50448;快进内卷提供上门doge;1;0;1;18388;5.438329345225147e-05
50451;对了，这个对电脑性能有没有撒子要求？;2;0;2;18388;0.00010876658690450294
50464;大佬。私信你感叹号;5;0;5;18388;0.00027191646726125733
50470;只看真批，不看赛博批生气;2;0;2;18388;0.00010876658690450294
50480;下一步是不是可以ai合成蛋白质doge;1;0;1;18388;5.438329345225147e-05
50487;没百度网盘文件嘛吗？;3;0;3;18388;0.0001631498803567544
50497;不懂就问，这样生成的图片，可以不穿衣服的吗？主要是我想自己给她们画衣服doge;1;0;1;18388;5.438329345225147e-05
50499;手指大概的都是克苏鲁;1;0;1;18388;5.438329345225147e-05
50502;你们AI绘图显卡用的啥等级？不知道我的1660s顶不顶得住妙啊;1;0;1;18388;5.438329345225147e-05
50513;为啥子回复收不到;1;0;1;18388;5.438329345225147e-05
50519;画出来的图可以是限制级的吗？;1;0;1;18388;5.438329345225147e-05
50522;网站打不开呀;2;0;2;18388;0.00010876658690450294
50527;去手可食doge;1;0;1;18388;5.438329345225147e-05
50532;猪猪汽水;3;0;3;18388;0.0001631498803567544
50549;问下3060怎么样，12g显存很诱人;1;0;1;18388;5.438329345225147e-05
50562;能生成不穿衣服的么歪嘴;1;0;1;18388;5.438329345225147e-05
50574;部署这个对电脑有要求吗，就一个核显轻薄本Catcoffeebath;4;0;4;18388;0.00021753317380900588
50582;ai什么时候能合成视频指定姿势，那就牛逼了;2;0;2;18388;0.00010876658690450294
50594;下载以后压缩包显示无法打开为什么呀;2;0;2;18388;0.00010876658690450294
50599;拍不了视频不白搭;1;0;1;18388;5.438329345225147e-05
50601;ai绘画我用过，一旦开始运算c盘内存会疯狂变小，有几次都红了就卸删除没用了dogedoge;1;0;1;18388;5.438329345225147e-05
50607;这个很吃GPU吗，我8750H1060会不会炸鸡;1;0;1;18388;5.438329345225147e-05
50611;这就是新的风口啊;2;0;2;18388;0.00010876658690450294
50615;rx6600能用吗？;1;0;1;18388;5.438329345225147e-05
50617;浮力姬可以拍视频啊doge;1;0;1;18388;5.438329345225147e-05
50620;可惜要20gb，太大了呀（）;1;0;1;18388;5.438329345225147e-05
50629;ai3d建模动画有没有搞头;1;0;1;18388;5.438329345225147e-05
50631;画师会失业吗;5;0;5;18388;0.00027191646726125733
50640;doge;2;3;5;18388;0.00027191646726125733
50646;是不是看了之后真的很想放弃思考让ai代劳算了？思考多累啊，反复推敲，耗时耗力，还伴随自我折磨个不停，然后终于思考出来成果了，被人拿去喂了。;61;121;182;18388;0.009897759408309767
50708;有很多似曾相识的图呢，有韩国画师的尤其124的三个铠甲骑士，还有黑魂的A大，还有那个黑白稿的形式很像以前那个死神镰刀的黑白稿呢;173;109;282;18388;0.015336088753534914
50882;要死一起死脱单doge，ai建模，ai编程，ai动画，ai剪辑，ai编曲等等等等快点发展起来吧;6;63;69;18388;0.003752447248205351
50889;我这边接单群基本上都没有人发了，过去多得都看不过来，现在ai一出现全哑了，画师所有努力都给ai免费做嫁衣，往画师的目标冲结果发现终点什么都没有，还被别人嘲笑夺取成果，普通人才不在乎艺术含量，更多只在乎好不好看就够了，ai能批量吸血生产这种程度的作品，人永远不可能跟机器比得了;145;93;238;18388;0.01294322384163585
51035;这技术要是有小作坊拿去不得0成本换皮回合制卡牌出疯咯;7;52;59;18388;0.0032086143136828365
51043;以前648买设计师呕心沥血的设计，以后648买ai5分钟跑的图，不会真以为ai发展起来以后游戏里的东西就便宜了吧脱单doge;27;51;78;18388;0.004241896889275614
51071;这风格好像某个画师辣眼睛;14;45;59;18388;0.0032086143136828365
51086;作为一名原画师只能说这些视频真令人伤感灵魂出窍;17;57;74;18388;0.004024363715466608
51104;也许AI对于2D美术来说过于前卫，但是对于3D美术来说，恰恰是超级棒的大圣杯啊doge;51;45;96;18388;0.005220796171416141
51156;本来就是踏在画师的尸体上，可有些人还要嘲讽绘画终被代替。;15;44;59;18388;0.0032086143136828365
51172;知道三体里面为什么那么多科学家自杀了吧？现在还不是ai最牛的时候，如果继续发展，过个50年之后，图喂的够多了，人家就可以单干了。一个领域能出现轻松干掉大部分的东西，该是多绝望，要是有一天ai能自产自销，那就笑死我了，可以光明正大的说xxx已经不存在了tv生气;11;28;39;18388;0.002120948444637807
51184;感觉有光剑的图在里面doge;5;28;33;18388;0.0017946486839242985
51190;喂了多少画师作品践踏在别人心血上的产物;9;37;46;18388;0.0025016314988035677
51200;都不知道有啥好开心的，跟盗版游戏一样，搞死的是那些画师，以后估计都不会公开自己的画作，要钱看了;6;21;27;18388;0.0014683489232107897
51207;这以后卡牌游戏开发者可以集全部精力去打磨玩法了，批量生成卡面，美术资源这块可以省很多钱;14;22;36;18388;0.001957798564281053
51222;烦，每天抽时间练人体，色彩，透视，为了以后能更好的上岗，那你说我是练还是不练了。;2;13;15;18388;0.000815749401783772
51225;大佬给个tag，谢谢;3;13;16;18388;0.0008701326952360235
51238;帅是真的帅，ai的优点就是帅的量大管饱，缺点是容易审美疲劳。;1;0;1;18388;5.438329345225147e-05
51249;还有，现在画画儿的，别跟ai拼画面谁好看了，因为拼不过，而且ai完成度还高。多拼想法，画一些有意思的确实是有设计思路和情节的图会好很多。ai目前归根结底只能画个表面的视觉效果，内里没啥内容。跟ai比谁画的好看，很遗憾，你在人家赛道上呢，你是两条腿应该跟ai比爬山，而不是在公路上跟四个轮子的ai比竞速，那是自讨苦吃。;1;1;2;18388;0.00010876658690450294
51264;艺术已死，人类已死，剩下的就是苟延残喘吧，反正不远的未来我们都是零件，只是零件级别的高低问题而已消灭地球暴政，世界属于AI就这样吧，一起期待着属于AI的时代的降临和人类的灭亡吧;2;0;2;18388;0.00010876658690450294
51268;战士断手义肢盔甲狂狼重剑（战斗即是祈祷）;5;5;10;18388;0.0005438329345225147
51286;搞艺术的群体本该小而精，我是支持ai干碎绘圈小画家的;11;19;30;18388;0.001631498803567544
51299;这些画的版权是画师的还是AI的使用者的？;5;0;5;18388;0.00027191646726125733
51308;这样岂不是会有创作者再临摹Ai图当新产品嘛;1;0;1;18388;5.438329345225147e-05
51313;观察下来发现ai更擅长角色，场景类的相对弱一点？;2;0;2;18388;0.00010876658690450294
51326;不会已经将活人投喂ai提上日程了吧囧doge;3;11;14;18388;0.0007613661083315206
51340;这些图感觉当人设灵感很不错啊;1;5;6;18388;0.0003262997607135088
51355;原住民们第一次看到方舟时，并不明白那是什么，只觉得是一片艰难漂浮在河面的黑色木板，和他们造出的独木舟并没有太大区别，因而也没有太过在意。时光流逝，一部分原住民发现了方舟的成长，它拥有光滑反光且冰冷的黑色表面，像铁却能浮在水面，规矩方正，巨大而又沉默，按部就班地展开着自己。一部分人被它的概念所感召，自觉加入了它的建设，一部分人因为它的存在而惴惴不安，担心是不是神明降下的魔盒还有一部分人，他们拿起鱼叉，御起独木舟，攻伐巨物的身影仿佛挑战风车怪物的骑士，却不知他们的出发点是否也是正义与荣耀。建设它的，保护它的，向往它的，畏惧它的，诋毁它的，攻击它的本就不团结的原住民们，因为方舟的出现而党同伐异，平静的河畔乱象丛生。整个过程中，巨物却只是在沉默地展开着自己。如何展开，为何展开，其中具体的过程和细节，经历多少次假想和验证，付出了多少代价和努力，最终如果展开完成，会将人类带向何处绝大多数原住民们并不理解，或者说并不能理解，或者说，并不想去理解。他们在狂欢，而潮水，就要来了。;6;239;245;18388;0.01332390689580161
51362;开源万岁，如果没有SD开源，就不会有novelAI绘图及后续被爆破传播，就不会有这么大的冲击和影响力，资本和各路大佬们就不会这么大力下场，大概率会很长一段时间里都会处于一些人在几个收费网站拿着碰运气般的基础生成功能和底层小画师抢单子的状态。。。;13;449;462;18388;0.02512508157494018
51376;省流简史：2021：抠鼻2022：惊讶2023：跪了;5;310;315;18388;0.01713073743745921
51382;这半年真的体会到了什么叫日新月异;6;189;195;18388;0.010604742223189037
51389;所以说老有人纠结ai是不是“绘画”，有没有“灵魂”，叫不叫“艺术”，其实从头到尾都是图像生成技术，无论是画还是照片还是别的什么都只是技术上的一个分支而已，你想怎么叫就怎么叫，根本无所谓也没有几个人在乎笑哭;27;238;265;18388;0.014411572764846638
51418;人工智能会取代人类吗取代人类的不是人工智能，而是高度异化的私有制劳动，不等人工智能去取代人类，企业家们就会用更高效更便捷的方式取代他的工人。所以并不是人工智能使工人们失去他们热爱的和赖以生存的职业，而是别的什么东西。人工智能会使人类失去创造的能力吗？创造的能力使人类天生的，人的歌声源自他们想要呼唤的冲动，绘画和文字诞生于他们的述史冲动。无论一个孩子多么稚幼，都无法阻止他将一块积木堆起或推到，这就是人想要改造世界或者说对创造性举措的渴求。人类为此而发明的画笔，摄影机和其他工具并没有抹煞原本使用天然染料在石壁上涂画的乐趣，与之相反，这些工具的发明大大促进了人的知情意的充分表达。失业或者职业上的问题，绘画和文字写作，乃至其他一切的活动尽管可能给创造者带来无限的乐趣，但是，一旦当这些活动成为一种为了生存而不得不去做的生产活动时，无论他的创造者再怎么地野心勃勃，都逃脱不了他已经成为工具的事实。画家成了画笔的工具，小说家成为了打字机的工具，播音员成为了话筒的工具，他们日夜劳动，用自己曾经热爱或厌恶的技能创造这些连他们自己都未必满意的东西。这不是创造，而是对人的生命的浪费。我们更应该考虑的是科技变革如何消灭这些不合理的现象，而不是任由这些不合理现象来压制科技变革。一些胡言乱语。;1;9;10;18388;0.0005438329345225147
51420;从DallE第一次接触，后来midjourney出来了之后，去discount注册了，跟一群人一起玩。stablediffusion一出来，又一头扎进去。最开始哥几个都一样，狂搞色图，不过很快就无聊了。civitai上面那这个热门的Loraadult模型就那几个，到最后千篇一律。至此开始捣鼓模拟和训练，因为工作需要，突然发现这东西的版权灰色地带，我做了一大堆，解决了我的业务问题，甲方满意得不得了，他们就想要这种人物插画，“即看起来是真人，又根本不存在”，因为对他们来说，一次性使用，只要不存在肖像权纠纷，完美。以前请小模特，整一组图，我还要置景，没半天下不来，现在AI简直是我亲爹。但是感觉，相关的法律法规，强制交换措施，很快会下来。任何不利于实体经济的“科技”玩意儿，最后都一定会被榜上税收doge;7;161;168;18388;0.009136393299978247
51428;这根本不是什么发展是技术爆炸灵魂出窍;3;104;107;18388;0.005819012399390907
51432;好像人们已经忘记了AI算法固然一次次进步，但没有人类几百年积累的美术作品，AI难道从空气里训练模型么，现在一些人反而回过头高举着“高速发展的AI”来狂踩画师，真是令人嘘唏。;35;34;69;18388;0.003752447248205351
51468;《TheTimelineofArtificialIntelligenceforImageGeneration：AComprehensiveSurvey》doge;3;86;89;18388;0.0048401131172503805
51472;地球生命史长达十几亿年，而现代图形生成技术是在近三年时间内发展起来的，从宇宙的时间尺度上看，这根本不是什么发展，是爆炸脱单doge;2;40;42;18388;0.0022840983249945617
51475;今天又出了论文，可以将脑内所想的模糊东西给你具象化。已经算是马斯克的脑机应用第一步了。以后刑侦也不需要画像对比那么麻烦了，直接脑电波，当时嫌疑人在场的画面AI直接给你重现画出来。以后很多不是画师能接触的，瘫痪病人，植物人脑电波都有可能AI帮你具现化出来;6;48;54;18388;0.0029366978464215794
51482;其实元素法典最开始真的只是给群友自己用的，只不过去年十月底不知道为什么就火出去了（）;6;99;105;18388;0.005710245812486404
51489;太快了，进步得太快了我从去年11月以后就没怎么关注新技术的发展，以为技术已经发展到平稳期了，结果对照视频一看视频里11月份进度条才到2311月以后的新技术我没看视频之前只知道ShapeGuided，MUSE，Lora和ControlNet跪了跪了跪了;2;58;60;18388;0.003262997607135088
51492;永雏塔菲1883安心AI绘画进步神速，根据视频里的进化效率，从去年10月份只能根据咒语抽奖，到现在有各种手段控制图片整体甚至部分区域的编辑，需要的原始素材从多到仅一张图，达到想要效果的模型从需要重新训练到无训练，高分辨率图像的稳定性也一定程度上解决了，算法效率越来越高。它能发展的如此迅速，还是大众对AI绘图非常有兴趣和需求，我近期看的小说，有很多作者用AI图做人设概念，以往同质量花几百到几千不等的一张图，现在可以随手添加。现在能在绘画水平上稳超AI的也就只有那些能接企业商稿的大佬了，中低层需求，特别是对设计模糊的需求用AI反而更能出让人满意的图。以后画师卖图恐怕不得不卖psd源文件了，AI本身的作图质量已经让人分不清出自谁之手了;11;77;88;18388;0.004785729823798129
51505;其实重大节点就是扩散，之后都是靠图库和辅助算法，但是普通人只看见了乱吃图和辅助插件才感受到“进步”，其实反而这几个月进步是几乎没有的doge;5;40;45;18388;0.002447248205351316
51512;进化速度逐渐由年到月，再到按天计算。。。笑哭;1;51;52;18388;0.0028279312595170763
51515;画师们付出素材库，大家拿来享受，这就是开源精神;6;9;15;18388;0.000815749401783772
51525;这够整一个综述了吃瓜;1;23;24;18388;0.0013051990428540352
51527;这几个月的进步感觉好像从学骑自行车一下子进步到开飞机了笑哭;2;24;26;18388;0.0014139656297585382
51530;记得AI绘画应该是去年国庆假期开始火的，从那之后的更新速度真是快得离谱;2;21;23;18388;0.0012508157494017839
51538;是我漏看了嗎沒有看到YangSong的部份大哭;2;8;10;18388;0.0005438329345225147
51542;那么现在画家的出路是什么呢？;3;5;8;18388;0.00043506634761801175
51547;谷歌一致在“推出”，从未能使用;2;11;13;18388;0.0007069828148792691
51552;草，看到一篇审过的文章;1;3;4;18388;0.00021753317380900588
51554;去年上半年我还在用dd跑得很慢10月就几秒一张图了;2;9;11;18388;0.0005982162279747662
51559;这，，还怎么让人学？笑哭人学习的速度远远比不上AI进化的速度，跟着大佬走就好;3;9;12;18388;0.0006525995214270176
51563;怎么感觉AI视觉在疫情这几年突然就爆发了正好是21，22年老美关在家里都研究虚拟了doge;2;3;5;18388;0.00027191646726125733
51567;我一直觉得现在的SD其实早就落后于各种大公司手上的版本了，没想到居然有这么多版，以后个人用户能不能用真的是个问题;3;3;6;18388;0.0003262997607135088
51574;dogeup主在弹幕里提到T2iAdapter和ControlNet想法撞车了，不过现在感觉ControlNet更知名呀，T2i加把劲，大伙卷出个更强大的技术来;3;4;7;18388;0.0003806830541657603
51580;机器工具人识别音乐;1;1;2;18388;0.00010876658690450294
51593;基本上，不是中国就是美国还有人骂这骂那;2;2;4;18388;0.00021753317380900588
51599;“人类之所以为人，是因为他们能创造并使用工具”;1;1;2;18388;0.00010876658690450294
51601;ai这么厉害，门槛低的可怕，可用ai在进行真正意义上的创作的人国内外加起来也没几个。证明了大家压根没什么创作的欲望和表达的欲望。;2;1;3;18388;0.0001631498803567544
51633;人類總是喜歡自我毀滅;3;0;3;18388;0.0001631498803567544
51645;如果UP主能把一些可以访问到的链接整合一下发出来，我可能真的要当场跪下了跪了跪了跪了;1;0;1;18388;5.438329345225147e-05
51654;话说sd怎么最近不更新了，两个星期了;1;0;1;18388;5.438329345225147e-05
51670;最近在学习text2img，很好奇Texttovideo用什么软件实现的;1;0;1;18388;5.438329345225147e-05
51678;开源是一件不负责任的事情，它们不在乎有多少人会因此受害，它们只渴求别人的夸赞而已;4;6;10;18388;0.0005438329345225147
51683;因为我是a卡，用cpu玩了2天，为了更好画老婆，又入手一张p104，一周时间画了2000余张，从完全不懂咒语到现可以生成出理想的老婆，下一步打算换40系，让我更好的生成老婆的所有状态星星眼xxx果然是第一生产力打call;2;9;11;18388;0.0005982162279747662
51686;使用lora的时候，经常会出现这张图的情况，请问大家有遇到过吗，是如何解决的？;2;0;2;18388;0.00010876658690450294
51689;AI画出来之后画师再改是最好的doge;5;78;83;18388;0.004513813356536872
51695;你所不知道的童话故事doge;6;81;87;18388;0.0047313465303458774
51702;见过的网友喂的ai里面，只要输入Alice出来的永远是金色长发蓝色眼眸白色点缀蓝色的长裙。笑哭;1;22;23;18388;0.0012508157494017839
51704;你故意的吧，明明这么好看，非。。。求求了改改手;3;14;17;18388;0.000924515988688275
51708;4g2070s能跑吗;4;3;7;18388;0.0003806830541657603
51714;那个弹幕说手的，真是狗啊，ai作画的手指数量真的是。;2;5;7;18388;0.0003806830541657603
51717;现阶段AI最大的问题，还是人一多就千人一面，另外远景时人脸就崩了，暂时没想到好办法解决。能画的最好的图，就是中近景特写，且只有一个人物;3;4;7;18388;0.0003806830541657603
51721;2：28的头发草笑哭;2;17;19;18388;0.0010332825755927778
51725;原来是没上资源，粉丝才这么少;1;10;11;18388;0.0005982162279747662
51729;可以分享一下BGM吗;2;2;4;18388;0.00021753317380900588
51734;有下载链接分享一下吗？好人一生平安doge;1;4;5;18388;0.00027191646726125733
51736;好好看哇up能分享一下模型吗;2;3;5;18388;0.00027191646726125733
51739;求词条求图包;1;0;1;18388;5.438329345225147e-05
51741;怎么求原图啊;1;0;1;18388;5.438329345225147e-05
51746;求个图包微笑虽然有bug不过还是感觉好看;2;0;2;18388;0.00010876658690450294
51757;就告诉我们关键词吧doge;1;0;1;18388;5.438329345225147e-05
51761;求图包星星眼;1;1;2;18388;0.00010876658690450294
51766;怎么做到的，我们的ai画图是两个软件doge;1;4;5;18388;0.00027191646726125733
51769;wc，，求个模型名字已三连;1;0;1;18388;5.438329345225147e-05
51772;打call好美这是单纯的文生图吗？我的ai做出来全是画面驴头不对马嘴的;4;1;5;18388;0.00027191646726125733
51779;这头饰怎么用tag描述啊;1;1;2;18388;0.00010876658690450294
51789;请问用的是什么模型;1;1;2;18388;0.00010876658690450294
51794;是故意的还是不小心2233娘大笑;1;1;2;18388;0.00010876658690450294
51797;距离我上一次看到这个还是在p站doge;5;1;6;18388;0.0003262997607135088
51806;啊啊啊，眼睛嘴巴好大，想抱起来;1;1;2;18388;0.00010876658690450294
51808;为什么你ai不崩坏笑哭;1;1;2;18388;0.00010876658690450294
51813;古风太多了，能不能搞多点现代的doge比如什么ol，职业之类doge;6;28;34;18388;0.00184903197737655
51821;质量绝了，ai绘图区的顶流。;1;14;15;18388;0.000815749401783772
51823;我丢也太好看了我手机做的都拿不出手;6;4;10;18388;0.0005438329345225147
51833;作为群友我直接一个三连;1;2;3;18388;0.0001631498803567544
51837;打call打call打call;1;1;2;18388;0.00010876658690450294
51840;up用的是什么绘画软件呀，画出来的质感看着好舒服呀;2;1;3;18388;0.0001631498803567544
51843;天天在家做老婆;1;1;2;18388;0.00010876658690450294
51845;doge;1;1;2;18388;0.00010876658690450294
51847;顶喜欢;1;1;2;18388;0.00010876658690450294
51861;你这下半身是放不不出来吗？doge;1;1;2;18388;0.00010876658690450294
51865;解压密码是啥;1;0;1;18388;5.438329345225147e-05
51867;123期不见了呢UP;1;0;1;18388;5.438329345225147e-05
51869;大佬你的画面好干净通透啊有什么技巧吗脱单doge;1;0;1;18388;5.438329345225147e-05
51874;建议加水印，不然要被用作非法无良广告辣眼睛;1;0;1;18388;5.438329345225147e-05
51876;感觉用了范冰冰的lora;2;0;2;18388;0.00010876658690450294
51879;我就想请教一下，这玩意儿的模型可以是自己的照片吗？求大佬解答;2;0;2;18388;0.00010876658690450294
51882;我看小说的女主脸从此有了模版脱单doge;1;1;2;18388;0.00010876658690450294
51885;牙齿细节画不好，嘴巴位置很多图都很怪异。AI图很多细节地方都有缺陷，只能看整体，不能仔细看。笑哭;1;1;2;18388;0.00010876658690450294
51889;好兄弟，你显卡是4090吗？;3;0;3;18388;0.0001631498803567544
51893;119期跑去哪里了dogedoge;2;0;2;18388;0.00010876658690450294
51901;人间一两风，胸前两坨肉doge;1;0;1;18388;5.438329345225147e-05
51916;有一些竖屏的就好了，弄一些做手机壁纸就很棒，这个横屏有点难顶;1;0;1;18388;5.438329345225147e-05
51922;dogedogedogedoge;1;0;1;18388;5.438329345225147e-05
51926;大佬有没有模型参数;1;0;1;18388;5.438329345225147e-05
51932;搭配仙子的修行食用dogedogedoge;1;3;4;18388;0.00021753317380900588
51935;？？？这也能破万？热词系列知识增加;7;68;75;18388;0.00407874700891886
51943;省流：都是老婆doge;1;141;142;18388;0.007722427670219708
51945;这个质量很高啊，ghost甚至画出了角，build画出了兔耳，极狐画出了狐耳。;1;100;101;18388;0.005492712638677399
51948;感觉不像ai，但是电王那张确实又像是ai画的;3;44;47;18388;0.0025560147922558192
51955;我要当反派，我要当反派;3;8;11;18388;0.0005982162279747662
51959;为什么没有阿妈粽？星星眼星星眼;5;8;13;18388;0.0007069828148792691
51965;作者大大求关键词，我每次弄都没有头或者脸笑哭;2;9;11;18388;0.0005982162279747662
51997;这不得把各种形态也安排一下doge;1;2;3;18388;0.0001631498803567544
52006;下期来个二骑的，记得带上一条桑;1;0;1;18388;5.438329345225147e-05
52008;求图包doge;1;0;1;18388;5.438329345225147e-05
52021;这AI有思想，只要是画人，无论男女，最后画成女的呲牙;6;697;703;18388;0.03823145529693278
52028;你他娘的还真是个天才;7;286;293;18388;0.01593430498150968
52036;《色胆包天》;4;222;226;18388;0.012290624320208832
52041;所有人都撅四楼doge;16;187;203;18388;0.011039808570807047
52058;怪不得当时李云龙不救秀琴选择炸城，原来李云龙是女的doge这么说的话李云龙不就是开国女将军吗？doge;1;98;99;18388;0.0053839460517728956
52061;看得出来ai很喜欢那张妹子的脸啊，衣服首饰这些一直在变就脸一直是那张脸（发型都没变）最多表情变了下dogedogedoge;2;15;17;18388;0.000924515988688275
52065;团长让我带弟兄们再冲一次吧;2;24;26;18388;0.0014139656297585382
52069;越变越大;3;43;46;18388;0.0025016314988035677
52073;李云龙最终还是没能保住只因doge;1;21;22;18388;0.0011964324559495323
52081;这回轮到我开炮了;1;6;7;18388;0.0003806830541657603
52083;置顶首页通知书尊敬的up主，你好，由于你的作品出色，现已被放上首页，希望你以后的作品能做得更好。bilibili观众认证;6;7;13;18388;0.0007069828148792691
52091;逐渐变成了自己的敌人;1;9;10;18388;0.0005438329345225147
52098;亚瑟王都能是女的，李云龙怎么了doge笑哭;1;2;3;18388;0.0001631498803567544
52136;想象一下李云龙这个样子骂人的场景;1;1;2;18388;0.00010876658690450294
52140;前几张图看着又真又假，让我都有点恐怖谷效应了笑哭;5;68;73;18388;0.003969980422014357
52146;拒绝犹太审美，从德意志做起doge;3;28;31;18388;0.0016858820970197955
52150;前两张挺好的，非常可爱，后面几个感觉不太像真人，有点恐怖谷效应了;3;27;30;18388;0.001631498803567544
52156;各位出生早上好，想必点进来想法都和我一样doge;2;14;16;18388;0.0008701326952360235
52160;这脸刚开始还好，越看越奇怪doge;1;6;7;18388;0.0003806830541657603
52163;第一张离远了看和照片分辨不出来了。不过还是有瑕疵。小女孩坐的平台和草地粘连到一起成一个平面了;1;6;7;18388;0.0003806830541657603
52166;是用完才拍，还是拍完就用doge;1;5;6;18388;0.0003262997607135088
52168;拒绝幼态审美从鲸落做起脱单doge;1;5;6;18388;0.0003262997607135088
52172;拒绝幼态审美，从我们江西开始蛆音娘卖萌;1;4;5;18388;0.00027191646726125733
52174;有点像我妹妹（不是）脱单doge脱单doge脱单doge;1;4;5;18388;0.00027191646726125733
52181;手指修过了嘛，总算不奇怪了;1;3;4;18388;0.00021753317380900588
52186;拒绝幼态审美，从我海南做起doge;1;3;4;18388;0.00021753317380900588
52193;吃瓜拒绝又太审美了从你他做起。;1;2;3;18388;0.0001631498803567544
52196;拒绝幼态审美，从我们广东开始蛆音娘卖萌;3;2;5;18388;0.00027191646726125733
52201;拒绝幼态审美，从你他做起doge;3;2;5;18388;0.00027191646726125733
52209;这不就是娃娃质感;1;1;2;18388;0.00010876658690450294
52215;脸和眼神太硬了笑哭笑哭笑哭;1;1;2;18388;0.00010876658690450294
52231;拒绝幼态一定要从我们大湖南做起脱单doge;1;0;1;18388;5.438329345225147e-05
52271;段先生算命第一元歌;1;0;1;18388;5.438329345225147e-05
52275;ai能画片吗喜欢喜欢喜欢;1;0;1;18388;5.438329345225147e-05
52311;再高35年就更好了;2;0;2;18388;0.00010876658690450294
52318;真刑啊你小子吃瓜;1;0;1;18388;5.438329345225147e-05
52326;b站到底有多少人在做ai绘图，我这身体一天不如一天了doge;10;58;68;18388;0.0036980639547531
52337;群号：735915137，感兴趣的加一下;7;15;22;18388;0.0011964324559495323
52345;有这样一个姐姐操心就不会这么烦了2233娘大笑;3;15;18;18388;0.0009788992821405265
52349;真受不了不知道接下来该怎么办辣眼睛;4;14;18;18388;0.0009788992821405265
52354;劝学《论语》《孟子》子曰：“夷狄之有君，不如诸夏之亡也。”子曰：“苟志于仁矣，无恶也。”子曰：“知者不惑，仁者不忧，勇者不惧。”子贡问曰：“有一言而可以终身行之者乎？”子曰：“其恕乎己所不欲，勿施于人。”子曰：“仁远乎哉？我欲仁，斯仁至矣。”子曰：“其身正，不令而行；其身不正，虽令不从。”;1;5;6;18388;0.0003262997607135088
52360;没有图包么？;1;1;2;18388;0.00010876658690450294
52362;分辨率有点低了;4;1;5;18388;0.00027191646726125733
52368;三连求图;1;1;2;18388;0.00010876658690450294
52371;图包呢;1;0;1;18388;5.438329345225147e-05
52373;歌名叫什么;1;0;1;18388;5.438329345225147e-05
52375;求图包;1;0;1;18388;5.438329345225147e-05
52379;这是用的什么模型和软件？星星眼;4;0;4;18388;0.00021753317380900588
52386;这是用的什么模型和软件？星星眼;4;0;4;18388;0.00021753317380900588
52392;求图包;1;0;1;18388;5.438329345225147e-05
52399;太像真人了;1;6;7;18388;0.0003806830541657603
52402;我看到的怎么都是全身光溜溜的滑稽滑稽;1;1;2;18388;0.00010876658690450294
52405;什么软件？;1;0;1;18388;5.438329345225147e-05
52412;不看手都还好;1;0;1;18388;5.438329345225147e-05
52416;判断AI很简单画面绚丽细节逻辑混乱没有手doge;24;518;542;18388;0.029475745051120297
52441;进步的速度真的好快啊，和10月份相比又强大了好多，画面表现力越来越强了灵魂出窍;14;216;230;18388;0.012508157494017838
52457;各位插画专业的同学记得把握进厂时机脱单doge;6;144;150;18388;0.00815749401783772
52464;如果未来的人类看着一幅幅ai用关键词和素材库拼出来的画一边欣赏一边讨论着关于这幅画的艺术，只能说那样的人类真可悲无语（转）;135;116;251;18388;0.013650206656515118
52600;AI呀，快快成长吧，未来是属于你的doge;8;68;76;18388;0.004133130302371111
52609;说实话，自己画的和ai好的感觉都不一样，因为自己画的自己会觉得开心ai你总会觉得缺少什么;8;35;43;18388;0.002338481618446813
52618;P站搜图清一色的AI绘画大哭大哭大哭可能是我不会用P站过滤但全是AI绘画让观感真的很不好大哭大哭大哭;1;18;19;18388;0.0010332825755927778
52621;每次一说AI都会有一堆担心的小画师和无关人员，技术进步明明是好事，画师和AI也各有各的美，各有各的技术，明明两者是不冲突的;6;9;15;18388;0.000815749401783772
52632;之前在群里有人发了一张图，我看完后觉得“看嘛，还是真人的画作比较有感觉，不像AI作画那样千篇一律没有灵魂”，然后群友说那张是AI生成的;21;5;26;18388;0.0014139656297585382
52655;AI绘画真的是能让艺术下放的根本性技术支持科技进步;2;4;6;18388;0.0003262997607135088
52660;ai好像不太会画成男微笑;3;2;5;18388;0.00027191646726125733
52665;ai的色彩确实是美的，但是毫无构图可言，看几眼就腻了，不能称之为艺术;20;2;22;18388;0.0011964324559495323
52692;emm你发出来之前能不能好好看看你的图然后再想一下绘圈人的辨别能力，尤其是第一幅图的肩膀我真的蚌埠住了，其他都是AI通病也没什么好说的，发尾瞳孔等等都有很多问题。。;1;1;2;18388;0.00010876658690450294
52694;好好看啊会用AI的真的是魔法师好希望AI画师可以接单，因为真的不是所有人都能吟唱成功的AI画师要是可以接单，便宜又高质，多好啊;15;1;16;18388;0.0008701326952360235
52712;求图包。;2;1;3;18388;0.0001631498803567544
52718;唉，我图包很多，就是不知道怎么搞这个ai绘画;2;0;2;18388;0.00010876658690450294
52726;up的出图是纯吟唱的还是喂了底图再吟唱的啊，画风好相似但又不像AI的底层画风诶音律联觉欢迎;1;0;1;18388;5.438329345225147e-05
52728;私以为，ai与画师就像缝纫机与裁缝，可以用ai打草稿然后画师精修细化;1;0;1;18388;5.438329345225147e-05
52731;什么软件，怎么搞呀，手机可以吗微笑微笑;2;0;2;18388;0.00010876658690450294
52738;求图包;2;0;2;18388;0.00010876658690450294
52741;求图;4;0;4;18388;0.00021753317380900588
52748;3050的笔记本能搞这个AI绘画软件吗？;4;0;4;18388;0.00021753317380900588
52753;以币，求图;2;0;2;18388;0.00010876658690450294
52756;求图;2;0;2;18388;0.00010876658690450294
52759;求图包星星眼;2;0;2;18388;0.00010876658690450294
52762;啊啊太太可以拿图吗;3;0;3;18388;0.0001631498803567544
52767;礼貌求图星星眼星星眼;2;0;2;18388;0.00010876658690450294
52770;想要图包;2;0;2;18388;0.00010876658690450294
52775;求图包大哭;1;0;1;18388;5.438329345225147e-05
52778;三连求图喜欢喜欢喜欢喜欢热词系列三连;2;0;2;18388;0.00010876658690450294
52781;求图啊给心心;3;0;3;18388;0.0001631498803567544
52794;图包在简介doge这一次是应一些观众的要求，出一期长屏的赛博天使，以后的图大概率还是大概9：16的正常比例doge相较于第一期，这一期加入了更多白毛蓝瞳脱单doge;9;93;102;18388;0.00554709593212965
52804;这种吗doge;5;12;17;18388;0.000924515988688275
52810;我是不是对赛博有什么误会，没有机械呢;1;11;12;18388;0.0006525995214270176
52812;第一张求私发，爱了爱了;1;9;10;18388;0.0005438329345225147
52814;收藏比点赞多是怎么回事？笑哭;1;6;7;18388;0.0003806830541657603
52817;楼主，说吧，多少币，打包给我;1;4;5;18388;0.00027191646726125733
52823;这是什么模型啊;4;2;6;18388;0.0003262997607135088
52829;码提示错误呀;1;1;2;18388;0.00010876658690450294
52853;你这画的很不协调啊，看起来有点违和，就后面那三四张还不错;1;0;1;18388;5.438329345225147e-05
52856;一切都是技术的进步doge;1;0;1;18388;5.438329345225147e-05
52864;求背景音乐;1;0;1;18388;5.438329345225147e-05
52870;有动态图包吗;3;0;3;18388;0.0001631498803567544
52880;求包哦呲牙呲牙;1;0;1;18388;5.438329345225147e-05
52885;你这图是不是没发全啊;1;28;29;18388;0.0015771155101152925
52887;黄油是不是用这个无敌？;3;27;30;18388;0.001631498803567544
52892;lora这个形象已经深入人心了，不知道有没有黄油一点的doge;2;2;4;18388;0.00021753317380900588
52936;为什么我感觉这些脸有点熟悉doge吃瓜;1;0;1;18388;5.438329345225147e-05
52945;可不可以让ai画的时候不带衣服;13;20;33;18388;0.0017946486839242985
52959;以前的美女有模有样，现在的美女都是一个生产线出来的微笑;2;13;15;18388;0.000815749401783772
52963;点赞私信我获取图包脱单doge，看到必第一时间发送脱单doge;7;8;15;18388;0.000815749401783772
52971;要是能把图片放到专栏就好了，我非得期期给你个币打call;1;6;7;18388;0.0003806830541657603
52973;质量有点高啊里面有几张感觉都可以当动漫女主了脱单doge;1;5;6;18388;0.0003262997607135088
52975;看手识图;1;5;6;18388;0.0003262997607135088
52977;潮鸣啊，好久没听了;2;5;7;18388;0.0003806830541657603
52980;我不信这是Ai绘画吃瓜吃瓜;2;4;6;18388;0.0003262997607135088
52983;但凡遇到这种up我都要点关注，生怕错过一期doge;1;4;5;18388;0.00027191646726125733
52985;有没有全身的这都才半身;1;3;4;18388;0.00021753317380900588
52988;谢谢用了三连了;1;2;3;18388;0.0001631498803567544
52990;搞个群呗，上传到群里脱单doge;2;2;4;18388;0.00021753317380900588
52993;啥时候搞一个水友群;1;2;3;18388;0.0001631498803567544
52997;以后就没有人手工画了，哎;4;2;6;18388;0.0003262997607135088
53002;是全身图就好了星星眼;7;2;9;18388;0.0004894496410702633
53010;已赞，送你上首页;1;2;3;18388;0.0001631498803567544
53016;软件是什么？;1;1;2;18388;0.00010876658690450294
53020;来个原图妙啊;1;1;2;18388;0.00010876658690450294
53029;加油星星眼;1;1;2;18388;0.00010876658690450294
53031;不知道为啥，我生成1000以上分辨率的很容易出没有内容的黄色图案图笑哭;6;1;7;18388;0.0003806830541657603
53038;加油;4;1;5;18388;0.00027191646726125733
53043;加油;1;1;2;18388;0.00010876658690450294
53048;这也不漏啊，咋让我给币呢？捂眼;3;0;3;18388;0.0001631498803567544
53052;有这技术就给兄弟们看着？;1;0;1;18388;5.438329345225147e-05
53062;冲这首曲子一键三连吃瓜;1;0;1;18388;5.438329345225147e-05
53064;有没有手机的;3;0;3;18388;0.0001631498803567544
53068;UP主加油看好你噢;1;0;1;18388;5.438329345225147e-05
53070;为什么ai不会画手啊？手好奇怪;2;0;2;18388;0.00010876658690450294
53073;我有壁纸，主要是没有手纸热热;1;0;1;18388;5.438329345225147e-05
53075;关注了，期待你的无服图doge;3;0;3;18388;0.0001631498803567544
53081;包下载下来显示错误，试了几次都一样;3;0;3;18388;0.0001631498803567544
53085;我只用没有衣服的壁纸滑稽;3;0;3;18388;0.0001631498803567544
53090;求包;1;0;1;18388;5.438329345225147e-05
53092;doge求图;1;0;1;18388;5.438329345225147e-05
53095;已投币求图;1;0;1;18388;5.438329345225147e-05
53097;求软件QWQ;2;0;2;18388;0.00010876658690450294
53100;热词系列三连滑稽;1;0;1;18388;5.438329345225147e-05
53102;好看呀;1;0;1;18388;5.438329345225147e-05
53104;求图;1;0;1;18388;5.438329345225147e-05
53106;已三连，求图包链接;1;0;1;18388;5.438329345225147e-05
53108;求包啊;1;0;1;18388;5.438329345225147e-05
53110;热词系列三连求图包;1;0;1;18388;5.438329345225147e-05
53112;求图包;1;0;1;18388;5.438329345225147e-05
53114;喜欢喜欢求图包;1;0;1;18388;5.438329345225147e-05
53116;己三连;1;0;1;18388;5.438329345225147e-05
53118;求原图壁纸谢谢星星眼;2;0;2;18388;0.00010876658690450294
53121;已三连，求图包链接;1;0;1;18388;5.438329345225147e-05
53123;知道兄弟们手里的硬币有其他更大的用途，我就不奢求了，只求好兄弟们给我点个免费的赞，我就很满足了脱单doge;2;0;2;18388;0.00010876658690450294
53126;第一眼我想要的：白毛第二眼我想要的：赤瞳第三眼我想要的：机甲;7;107;114;18388;0.006199695453556668
53134;doge进入你选择同伴机甲的世界。;3;69;72;18388;0.003915597128562106
53138;这两天下AI图都百来张了还嫌不够doge;2;38;40;18388;0.0021753317380900587
53141;还用选择，让我变成其中一个就好了脱单doge;3;31;34;18388;0.00184903197737655
53145;AI人类手指画不好竟然能画好机娘的手指是因为用的机械吗doge;1;13;14;18388;0.0007613661083315206
53148;你好，想咨询下，高清放大是怎么使用的，有对应的B站教程推荐吗，我的图片高分辨率下人脸都模糊;1;0;1;18388;5.438329345225147e-05
53151;up用的什么lora跟tag呀，我总感觉我出图的细节程度不太够。;3;2;5;18388;0.00027191646726125733
53157;好看up用的什么模型跟咒语，我也想试试星星眼;4;0;4;18388;0.00021753317380900588
53162;授人以鱼不如授人以渔，UP主，你就不能直接安排一下软件吗？脱单doge脱单doge脱单doge;1;1;2;18388;0.00010876658690450294
53164;求模型啊大大;1;0;1;18388;5.438329345225147e-05
53166;请问机甲lora叫什么名字，C站有吗;1;0;1;18388;5.438329345225147e-05
53168;三连了，求个模组打call;1;0;1;18388;5.438329345225147e-05
53177;AI绘画为什么要给钱？;3;6;9;18388;0.0004894496410702633
53181;为什么我下载的AI绘画要给钱？;1;0;1;18388;5.438329345225147e-05
53185;求模型;13;1;14;18388;0.0007613661083315206
53199;up主能不能出一期教程啊，想学;2;0;2;18388;0.00010876658690450294
53202;图片好像不全，下载完没看到最喜欢的几张啊;2;0;2;18388;0.00010876658690450294
53205;什么显卡呀鹿鸣疑问;4;0;4;18388;0.00021753317380900588
53213;请求上传到创意工坊;6;1;7;18388;0.0003806830541657603
53222;已三连，这软件是PC端还是手机呀？;1;0;1;18388;5.438329345225147e-05
53227;想要;1;2;3;18388;0.0001631498803567544
53229;第一张绝绝子，三秋外瑞马池星星眼加大力度，币拿好;1;0;1;18388;5.438329345225147e-05
53232;求图;1;0;1;18388;5.438329345225147e-05
53235;请问是用了哪套底膜和lora啊;3;1;4;18388;0.00021753317380900588
53244;求关键词;5;0;5;18388;0.00027191646726125733
53250;手终于不骨折了，果断收藏脱单doge;1;0;1;18388;5.438329345225147e-05
53252;三连了，求图脱单doge;2;0;2;18388;0.00010876658690450294
53256;求图脱单doge;1;0;1;18388;5.438329345225147e-05
53260;doge为什么没有一个画姬子的？;1;0;1;18388;5.438329345225147e-05
53266;求图加一脱单doge;1;0;1;18388;5.438329345225147e-05
53275;为数不多的手可以画正常的AI笑哭笑哭笑哭;1;1;2;18388;0.00010876658690450294
53285;求图;1;2;3;18388;0.0001631498803567544
53290;三连了，求图支持;1;0;1;18388;5.438329345225147e-05
53293;三连了，求图呀;1;0;1;18388;5.438329345225147e-05
53296;卧槽这真的是AI么画得这么细腻细节满满除了卧槽已经不知道说什么好了妙啊;1;1;2;18388;0.00010876658690450294
53300;求图doge;1;0;1;18388;5.438329345225147e-05
53302;图来doge;1;1;2;18388;0.00010876658690450294
53304;想要图;1;0;1;18388;5.438329345225147e-05
53306;好看，想要图星尘发呆;1;0;1;18388;5.438329345225147e-05
53308;三连了，求个图;1;0;1;18388;5.438329345225147e-05
53311;求图2233娘大笑2233娘大笑2233娘大笑;2;0;2;18388;0.00010876658690450294
53314;无链接无三连doge;2;6;8;18388;0.00043506634761801175
53319;请问如何融合两个模型呢，我只能使用一个模型;4;1;5;18388;0.00027191646726125733
53326;热词系列三连求图;1;0;1;18388;5.438329345225147e-05
53329;三连了热词系列三连求图;1;0;1;18388;5.438329345225147e-05
53331;三连了，求图;1;0;1;18388;5.438329345225147e-05
53333;想要图;1;0;1;18388;5.438329345225147e-05
53338;三连了求图;1;0;1;18388;5.438329345225147e-05
53341;热词系列三连求图;1;0;1;18388;5.438329345225147e-05
53343;三连了，图呢吃瓜;1;0;1;18388;5.438329345225147e-05
53345;求模型打call，如果是私模能告诉融了那些模型吗？三连了星星眼;1;0;1;18388;5.438329345225147e-05
53348;已三连，能给个tag吗兔年吉祥東雪蓮w;2;0;2;18388;0.00010876658690450294
53352;已三连，求图doge;1;0;1;18388;5.438329345225147e-05
53356;已投币，求图脱单doge;1;0;1;18388;5.438329345225147e-05
53358;求图星星眼;1;0;1;18388;5.438329345225147e-05
53361;图呢？;1;0;1;18388;5.438329345225147e-05
53364;三连了，图呢;1;0;1;18388;5.438329345225147e-05
53367;三连柳，图呢doge;2;0;2;18388;0.00010876658690450294
53370;已投币，图呢;1;0;1;18388;5.438329345225147e-05
53372;图呢脱单doge;1;0;1;18388;5.438329345225147e-05
53374;继续加油;1;0;1;18388;5.438329345225147e-05
53376;恭喜你离百大又近了一步;1;5;6;18388;0.0003262997607135088
53379;图包快来;1;4;5;18388;0.00027191646726125733
53381;图包脱单doge脱单doge;1;3;4;18388;0.00021753317380900588
53383;这成分有点高啊吃瓜，德狗台妹韩妹？而且怎么做到这么瘦的啊;1;3;4;18388;0.00021753317380900588
53385;脱单doge脱单doge脱单doge图包;1;2;3;18388;0.0001631498803567544
53391;来个图包;1;1;2;18388;0.00010876658690450294
53396;图包脱单doge脱单doge;1;1;2;18388;0.00010876658690450294
53398;4连完成，老铁来个包;1;1;2;18388;0.00010876658690450294
53403;以后会不会有动画doge;1;0;1;18388;5.438329345225147e-05
53406;图包何在？脱单doge;1;0;1;18388;5.438329345225147e-05
53409;脱单doge脱单doge脱单doge图包嗑瓜子嗑瓜子嗑瓜子;1;0;1;18388;5.438329345225147e-05
53411;图包何在？脱单doge;1;0;1;18388;5.438329345225147e-05
53413;大乘AI绘画网历时四天，已经撑不住了，希望up的能多坚持会吧;36;1599;1635;18388;0.08891668479443116
53450;关于AI绘画需求，人们的热情是只增不减，再加上有些网站支撑不下去了，要么收费要么跑路，这就导致了服务器过载，现在按照这个需求来说，要是没有几张3090，真支撑不了几天。这就是最大的问题所在，服务器花销大，一个月建个服务器，免费的早就撑不下去几天了，就算是收费的服务器也很困难，白嫖力度肯定是会越来越多，这个私信我会在3天内删除。该言论只是个人观点，如有雷同纯属巧合神龙残梦;12;597;609;18388;0.033119425712421144
53463;无需安装免费在线NovelAi智能绘画网站备注加群可获取网站861203201简单来说，直接输入文字就可以直接转化出图片来，也可以通过图片来转化图片。本视频大部分收益都会用来进行网站维护，来方便大家继续免费在线生成图片。所以请不要吝惜你的三连和投币点赞，这对我们来说真的很重要感谢：上学猫的支持如果你喜欢我的视频或者AI绘画感兴趣，请不要白嫖记得点赞补充说明一下。第一个是群里自己开的公益网站，如果你打不开了，或者无法使用了，那么就请使用第二个公益网站。如果需要赞助的话，找：上学猫，服务器是这位大佬开的。为了满足你们的口味，我真的好难哦，为什么你们都喜欢萝莉音呢？无法理解，反正也就这样了，真的是每做一次视频就折磨我一次了。为了你们的三连点赞，我也是拼了。;18;437;455;18388;0.024744398520774417
53482;无需安装免费在线NovelAi智能绘画网站备注加群可获取网站，以及视频中的模型文件需要视频中模型资源请选择加入其中一个QQ群推荐加新群：7393199571072000群里的免费AI在线网站还有4个，目前网站已更新支持中文模型感谢抹茶提供的技术支持主QQ群：78442220319822000群2445793647仅供学习参考群3：729375504群4149605857群5331879089群6285453196群7589044006如果需要赞助服务器的话，请你自己去公告上联系这个网站的作者。更新进度：高清放大和修复模糊图片的插件已安装下来就是请你们用群里面愿意合作的这个管理员的服务器吧，来满足你们免费绘画的梦想。他们一般网站上都有联系方式他们自己网站上都有联系方式的总有人跟免费的网站过不去。没办法，涉及到的利益太多了。如果大家需要赞助，请加群，然后联系目前现在还在坚持的网站作者，不要联系我，我的服务器下个月底就跑路了。总有人跟免费的网站过不去。没办法，涉及到的利益太多了。;9;362;371;18388;0.020176201870785296
53492;这个网址现在是爆满的，生成一份图片还是要等挺久的藏狐;15;243;258;18388;0.014030889710680878
53508;无需安装免费在线NovelAi智能绘画网站备注加群可获取网站群1：861203201网站作者和我都在群2149768994只有我一个群3732221684小群群4622153009实在进不来再进这个PS：今天晚上做直播的时候，我会在直播间里面现场踢掉几个潜水的群友，给各位留几个位置你要是手速快的话应该能挤进来。如果4个群都满了。就过几天在加，我会随机抽几个人私聊发网站的。最近几天已经有很多服务器都已经开始收费或者已经倒闭了。目前免费的估计也就只剩三，四个网站了。1000多个人在排队，1万多个人在使用。一个人要生成几千张图片。目前服务器已经高度过载，基本上全部都需要排队。希望大家真的是自觉一点，虽然没有做任何限制，但是真的不要再去刷图了。一口气刷几百张。目前来说这个群已经是满员的了，但是我每天都会剔除一部分人。来，保证大家有机会进来。简单来说，直接输入文字就可以直接转化出图片来，也可以通过图片来转化图片。本视频大部分收益都会用来进行网站维护，来方便大家继续免费在线生成图片。所以请不要吝惜你的三连和投币点赞，这对我们来说真的很重要感谢：上学猫的支持都说一句你们所知道的某些网站啊，所谓的免费实际上已经开始收钱了，而且价格跟官网上也差不多了。有这个钱还不如直接去官网上买25美刀的。最后说一句，主播的声音是伪声。你们听上去像合成，只是因为这个视频被反复剪辑过。而且每一句话都是分开来讲过的。因为我真的很难模仿这个声音，基本上说两句就要休息一下，所以整个视频都是很停顿的。我最后我再吐槽一句，某些脚本哥还是悠着点吧，这一天开十几个脚本，恨不得把网站搞炸不可;117;353;470;18388;0.02556014792255819
53626;为什么一定要我们加群呢，这样你们有什么收益吗;40;529;569;18388;0.030944093974331087
53667;无需安装免费在线NovelAi智能绘画网站备注加群可获取网站，以及视频中的模型文件需要视频中模型资源请选择加入其中一个QQ群推荐加群：729375504群里的免费AI网站还有3个，本人已坚持不住了希望其他三个人能坚持的久一点吧主QQ群：7844222031022000群2445793647仅供学习参考群4149605857仅供学习参考群5331879089如果需要赞助服务器的话，请你自己去公告上联系这个网站的作者。我这两天不打算继续开服务器了，经费用的也差不多了。大概到这个月底就关了。下来就是请你们用群里面愿意合作的这个管理员的服务器吧，来满足你们免费绘画的梦想。他们一般网站上都有联系方式他们自己网站上都有联系方式的总有人跟免费的网站过不去。没办法，涉及到的利益太多了。如果大家需要赞助，请加群，然后联系目前现在还在坚持的网站作者，不要联系我，我的服务器下个月底就跑路了。总有人跟免费的网站过不去。没办法，涉及到的利益太多了。;8;287;295;18388;0.016043071568414183
53676;无需安装免费在线NovelAi智能绘画网站备注加群可获取网站群1：861203201群2149768994简单来说，直接输入文字就可以直接转化出图片来，也可以通过图片来转化图片。本视频大部分收益都会用来进行网站维护，来方便大家继续免费在线生成图片。所以请不要吝惜你的三连和投币点赞，这对我们来说真的很重要感谢：上学猫的支持如果你喜欢我的视频或者AI绘画感兴趣，请不要白嫖记得点赞补充说明一下。第一个是群里自己开的公益网站，如果你打不开了，或者无法使用了，那么就请使用第二个公益网站。如果需要赞助的话，找：上学猫，服务器是这位大佬开的。为了满足你们的口味，我真的好难哦，为什么你们都喜欢萝莉音呢？无法理解，反正也就这样了，真的是每做一次视频就折磨我一次了。为了你们的三连点赞，我也是拼了。;9;170;179;18388;0.009734609527953013
53686;无需安装免费在线NovelAi智能绘画网站备注加群可获取网站，网站目前依然可用中文输入全新模型支持涩涩，最新进度：添加草神，妮露可莉等原神新模型，内部集成tag查询和反查询群1：861203201网站作者和我都在群2149605857新群1群3331879089新群2群4149768994只有我一个群5732221684小群群6547028284交流用群7622153009实在进不来再进这个我的QQ被人恶意举报冻结了，现在你们就随缘加群吧目前管不了QQ群，希望大家自觉不要违法本视频大部分收益都会用来进行网站维做不了护，来方便大家继续免费在线生成图片。所以请不要吝惜你的三连和投币点赞，这对我们来说真的很重要感谢：上学猫的支持你们所知道的某些网站啊，所谓的免费实际上已经开始收钱了，而且价格跟官网上也差不多了。有这个钱还不如直接去官网上买25美刀的。最后说一句，主播的声音是伪声。你们听上去像合成，只是因为这个视频被反复剪辑过。某些脚本哥还是悠着点吧，这一天开十几个脚本，恨不得把网站搞炸不可httpswwwbilibilicomvideoBV1ue41157cZvdsource8d2f195424637ca347e218c3f6034a9creply134696389632此视频点赞过一千后我会再考虑开一个新群;32;119;151;18388;0.008211877311289972
53719;NovelAI信息并联计划：httpsdocsqqcomsheetDRHJNb0NVZHBxVEVQtabBB08J2tv点赞诚挚邀请所有想学或者已经学习并且拥有一定技术能力的朋友们一起来完善这个由novelai吧发起的共享信息文档，我们的目的是免费普及基本的使用与运行该工具的基础程序，主要是提供给国内的用户们整合目前所拥有的所有信息和资源的地方。如果各位有除了贴吧群以外的其他社区论坛可以扩散一下以方便大家获取我们组建的技术群和其他平台的技术神佬提供和开发的一系列实用的工具在这里我们诚挚邀请所有与ai绘画相关的专业与研究方向等等各路技术大神们加入我们的技术群内，如果有能力的也可以直接去git的官网为官网上的大量内容更新提供帮助tv调皮其实真正的目的并不是说要求什么资源或者是得到一些什么，而是希望能够获得各种各样的人脉关系。ai的冲击确实非常大，注定将会取缔一部分的岗位，这是不可避免的发展趋势，但是它同时也创造了巨大的需求。因此我们希望能够以我们为开头，鼓励各位去积极地寻找新的需求，只要有新的需求不断出现，那么必然会有新的机遇与新的工作。人类就是在生产力的发展带来的毁灭与新生当中不断挣扎过来的。;1;217;218;18388;0.01185555797259082
53722;买台高配电脑，双4090加i913XXXX交火，安装本地novelai，内穿到公网，贡献给广大网友免费玩，现在计划已经有了，就是能不能V我50妙啊，因为星期四快到了;11;233;244;18388;0.013269523602349358
53734;无需安装免费在线NovelAi智能绘画网站备注加群可获取网站网站目前已经经过了六次更新，中文输入全新模型支持涩涩群1：861203201网站作者和我都在群2149768994只有我一个群3732221684小群群4547028284交流用群5622153009实在进不来再进这个PS：晚上做直播的时候，我会在直播间里面现场踢掉几个潜水的群友，给各位留几个位置如果4个群都满了。就过几天在加，我会随机抽几个人私聊发网站的。本视频大部分收益都会用来进行网站维护，来方便大家继续免费在线生成图片。所以请不要吝惜你的三连和投币点赞，这对我们来说真的很重要最近几天已经有很多服务器都已经开始收费或者已经倒闭了。1000多个人在排队，1万多个人在使用。一个人要生成几千张图片。目前服务器已经高度过载，基本上全部都需要排队。希望大家真的是自觉一点，虽然没有做任何限制，但是真的不要再去刷图了。感谢：上学猫的支持你们所知道的某些网站啊，所谓的免费实际上已经开始收钱了，而且价格跟官网上也差不多了。有这个钱还不如直接去官网上买25美刀的。最后说一句，主播的声音是伪声。你们听上去像合成，只是因为这个视频被反复剪辑过。而且每一句话都是分开来讲过的。真的很难模仿这个声音，所以视频都是很停顿的。某些脚本哥还是悠着点吧，这一天开十几个脚本，恨不得把网站搞炸不可;27;108;135;18388;0.007341744616053948
53762;无需安装免费在线NovelAi智能绘画网站备注加群可获取网站，以及视频中的模型文件需要视频中模型资源请选择加入其中一个QQ群主QQ群：7844222031022000群里的免费AI网站还有3个，本人已坚持不住了希望其他三个人能坚持的久一点吧群2445793647仅供学习参考群3547028284仅供学习参考群4149605857仅供学习参考群5331879089如果需要赞助服务器的话，请你自己去公告上联系这个网站的作者。我这两天不打算继续开服务器了，经费用的也差不多了。大概到这个月底就关了。下来就是请你们用群里面愿意合作的这个管理员的服务器吧，来满足你们免费绘画的梦想。他们一般网站上都有联系方式他们自己网站上都有联系方式的总有人跟免费的网站过不去。没办法，涉及到的利益太多了。如果大家需要赞助，请加群，然后联系目前现在还在坚持的网站作者，不要联系我，我的服务器下个月底就跑路了。总有人跟免费的网站过不去。没办法，涉及到的利益太多了。;10;166;176;18388;0.009571459647596259
53773;无需安装免费在线NovelAi智能绘画网站备注加群可获取网站861203201简单来说，直接输入文字就可以直接转化出图片来，也可以通过图片来转化图片。本视频大部分收益都会用来进行网站维护，来方便大家继续免费在线生成图片。所以请不要吝惜你的三连和投币点赞，这对我们来说真的很重要感谢：上学猫的支持如果你喜欢我的视频或者AI绘画感兴趣，请不要白嫖记得点赞为了满足你们的口味，我真的好难哦，为什么你们都喜欢萝莉音呢？无法理解，反正也就这样了，真的是每做一次视频就折磨我一次了。为了你们的三年，我也是拼了。;8;56;64;18388;0.003480530780944094
53783;我啥也没干，我还在群里时不时提醒人不要发涩图，结果我还被踢了？那把三连还我呗（）;3;57;60;18388;0.003262997607135088
53787;大佬能问问有没有办法对图片进行微调呢，就是比如换个瞳色什么的doge还有有没有办法一次多生成几张图啊;7;66;73;18388;0.003969980422014357
53795;无需安装免费在线NovelAi智能绘画网站备注加群可获取网站，以及视频中的模型文件需要视频中模型资源请选择加入其中一个QQ群推荐加新群：5820475732112000推荐加新群：5784677731032000群里的免费AI在线网站还有6个，添加了最新的ORA50模型。感谢清运提供的技术支持主QQ群：78442220319822000群2445793647仅供学习参考群3：729375504群4149605857群5331879089群6285453196群737794193619822000如果需要赞助服务器的话，请你自己去公告上联系这个网站的作者。更新进度：高清放大和修复模糊图片的插件已安装下来就是请你们用群里面愿意合作的这个管理员的服务器吧，来满足你们免费绘画的梦想。他们一般网站上都有联系方式他们自己网站上都有联系方式的总有人跟免费的网站过不去。没办法，涉及到的利益太多了。如果大家需要赞助，请加群，然后联系目前现在还在坚持的网站作者，不要联系我，我的服务器下个月底就跑路了。总有人跟免费的网站过不去。没办法，涉及到的利益太多了。;3;49;52;18388;0.0028279312595170763
53799;无需安装免费在线NovelAi智能绘画网站备注加群可获取网站群1：861203201群2149768994群3622153009如果三个群都满了。就过几天在加，我会随机抽几个人私聊发网站的。简单来说，直接输入文字就可以直接转化出图片来，也可以通过图片来转化图片。本视频大部分收益都会用来进行网站维护，来方便大家继续免费在线生成图片。所以请不要吝惜你的三连和投币点赞，这对我们来说真的很重要感谢：上学猫的支持如果你喜欢我的视频或者AI绘画感兴趣，请不要白嫖记得点赞补充说明一下。第一个是群里自己开的公益网站，如果你打不开了，或者无法使用了，那么就请使用第二个公益网站。如果需要赞助的话，找：上学猫，服务器是这位大佬开的。为了满足你们的口味，我真的好难哦，为什么你们都喜欢萝莉音呢？无法理解，反正也就这样了，真的是每做一次视频就折磨我一次了。为了你们的三连点赞，我也是拼了。;3;97;100;18388;0.005438329345225147
53804;大家别浪费时间了，进的了群也上不去这个网站，就搁那看着这个up自己玩，有条件直接去官方或者自己本地训练吧;4;19;23;18388;0.0012508157494017839
53809;大家都是大乘难民脱单doge;2;25;27;18388;0.0014683489232107897
53812;你就不能把网址放在评论区或者简介，搞什么引流;1;72;73;18388;0.003969980422014357
53814;一个49一个月一个798一个月你丫的是真敢要钱啊还他妈是个备用网站，还把我踢了热热热;8;98;106;18388;0.005764629105938656
53823;无需安装免费在线NovelAi智能绘画网站备注加群可获取网站目前网站已经经过了六次更新，新的模型，中文，以及一些特殊的功能，目前都已经更新了。群之后请打开第二个网站。不要使用第一个，第一个已经被脚本哥摧毁了。群1：861203201网站作者和我都在群2149768994只有我一个群3732221684小群群4622153009实在进不来再进这个PS：今天晚上做直播的时候，我会在直播间里面现场踢掉几个潜水的群友，给各位留几个位置你要是手速快的话应该能挤进来。如果4个群都满了。就过几天在加，我会随机抽几个人私聊发网站的。最近几天已经有很多服务器都已经开始收费或者已经倒闭了。目前免费的估计也就只剩三，四个网站了。1000多个人在排队，1万多个人在使用。一个人要生成几千张图片。目前服务器已经高度过载，基本上全部都需要排队。希望大家真的是自觉一点，虽然没有做任何限制，但是真的不要再去刷图了。一口气刷几百张。目前来说这个群已经是满员的了，但是我每天都会剔除一部分人。来，保证大家有机会进来。简单来说，直接输入文字就可以直接转化出图片来，也可以通过图片来转化图片。本视频大部分收益都会用来进行网站维护，来方便大家继续免费在线生成图片。所以请不要吝惜你的三连和投币点赞，这对我们来说真的很重要感谢：上学猫的支持都说一句你们所知道的某些网站啊，所谓的免费实际上已经开始收钱了，而且价格跟官网上也差不多了。有这个钱还不如直接去官网上买25美刀的。最后说一句，主播的声音是伪声。你们听上去像合成，只是因为这个视频被反复剪辑过。而且每一句话都是分开来讲过的。真的很难模仿这个声音，所以视频都是很停顿的。最后我再吐槽一句，某些脚本哥还是悠着点吧，这一天开十几个脚本，恨不得把网站搞炸不可;4;19;23;18388;0.0012508157494017839
53828;第一次听说网站，还要进群获取热;3;31;34;18388;0.00184903197737655
53832;既然推到我首页了就友情提示一下吧。蛆音娘吃瓜群众Novel的模型库存在争议，图片的生成“过拟合”。存在缝合拼贴情况，有抄袭和侵权风险，不建议商用。附上大佬的说明：httpsshareapiweibocnshare3420904004823840733529894htmlweiboid4823840733529894;7;112;119;18388;0.006471611920817925
53840;这声音听起来像是合成的，这让我想起了买软件淘宝还送了个AI声音制作，就是赚了我信息差的钱，我贴出来了，有兴趣的可以看一下吃瓜httpsspeechmicrosoftcomaudiocontentcreation;1;17;18;18388;0.0009788992821405265
53844;无需安装免费在线NovelAi智能绘画网站备注加群可获取网站，以及视频中的模型文件需要视频中模型资源请选择加入其中一个QQ群推荐加新群：5820475734112000推荐加新群：5784677732032000群里的免费AI在线网站还有6个，添加了最新的ORA50模型。感谢清运提供的技术支持主QQ群：57846777319822000群2445793647仅供学习参考群3：729375504群4149605857群5331879089群6285453196群737794193619822000如果需要赞助服务器的话，请你自己去公告上联系这个网站的作者。更新进度：高清放大和修复模糊图片的插件已安装下来就是请你们用群里面愿意合作的这个管理员的服务器吧，来满足你们免费绘画的梦想。他们一般网站上都有联系方式他们自己网站上都有联系方式的总有人跟免费的网站过不去。没办法，涉及到的利益太多了。如果大家需要赞助，请加群，然后联系目前现在还在坚持的网站作者，不要联系我，我的服务器下个月底就跑路了。总有人跟免费的网站过不去。没办法，涉及到的利益太多了。;1;19;20;18388;0.0010876658690450293
53846;上一个免费的AI大乘刚刚去世，仅存活4天，免费是没有出路的滑稽;4;55;59;18388;0.0032086143136828365
53851;有1說1阿婆用的ai語音硬說是偽音並開辦偽音課程多少有點。。。詐騙的嫌疑;1;14;15;18388;0.000815749401783772
53853;AI画画AI语音，生成gal，有没有搞头吃瓜;12;47;59;18388;0.0032086143136828365
53866;前面一个跑路了又来个新的吃瓜;1;11;12;18388;0.0006525995214270176
53868;一张图强制看三秒或其他几秒广告，100张那就是300秒加广告，不知道这样可不可行，这样才有更多经费啊大哭大哭;5;47;52;18388;0.0028279312595170763
53874;虽然但是要是让画师发现用这东西接稿的话，要被骂死的，玩玩就行了，千万别想着赚米哦;30;40;70;18388;0.0038068305416576026
53907;投币了希望网站可以长久下去呀;3;19;22;18388;0.0011964324559495323
53912;mad首页怎么全是ai;4;30;34;18388;0.00184903197737655
53917;up我该输什么tag才能出来正常的图啊，特地输了排除大尺度的，但还是每次出来的都是暴露的，感觉到了我那就只会出涩图了我就是想找点可爱的猫耳萝莉。。。。。。群友也没人告诉我怎么解决;2;11;13;18388;0.0007069828148792691
53923;刚准备学画画就碰到ai崛起，说实话有点迷茫，画画群里一些大佬还是鼓励我们去学，但是ai以后会不会真的取代画师，画师以后会不会没饭碗，都说不准，现在只能把画画当成兴趣来培养了保卫萝卜哭哭;14;21;35;18388;0.0019034152708288013
53940;无需安装免费在线NovelAi智能绘画网站备注加群可获取网站，网站目前依然可用中文输入全新模型支持涩涩，最新进度：添加草神，妮露可莉等原神新模型，内部集成tag查询和反查询群1：512908534网站作者和我都在群2149605857新群1群3331879089新群2群4149768994只有我一个群5732221684小群群6547028284交流用群7622153009实在进不来再进这个本视频大部分收益都会用来进行网站维做不了护，来方便大家继续免费在线生成图片。所以请不要吝惜你的三连和投币点赞，这对我们来说真的很重要总有人跟免费的网站过不去。没办法，涉及到的利益太多了。一项新的术更新总是面临着许多问题。之后我是真的想做公益，但是压力真的很大。有些国内的网站不支持瑟瑟，也没有什么新的模型，就可以开出所谓的高价月卡，价格更是比官网还要离谱。这是我最无法容忍的，不过想想也对，一个免费网站要是比他们做的都好。那也的确会遭到各种攻击。只能说现在就靠大家的点赞关注，投币还有意志力坚持。等哪天我的视频只剩白嫖怪了，那么估计也就没了。httpswwwbilibilicomvideoBV1ue41157cZspmidfrom33399900vdsource8d2f195424637ca347e218c3f6034a9c然后本视频点赞过1000，我会再开一个新群。就这样吧。;4;19;23;18388;0.0012508157494017839
53945;novaai我看咋需要充钱啊;1;3;4;18388;0.00021753317380900588
53947;这个AI配音是怎么弄得鸭？感觉不错噢;1;12;13;18388;0.0007069828148792691
53949;httpsdraftart1852294AI绘图中文免费网站;3;5;8;18388;0.00043506634761801175
53953;如果大家在找本地部署AI绘画的方法可以去这里：httpsborrowastepnetbai;1;5;6;18388;0.0003262997607135088
53955;已经三连请翻牌，或者跟我解释一下为什么11不等于2;2;6;8;18388;0.00043506634761801175
53959;我上次看到这个可以输入中文的AI绘画页面还是大乘。我有理由怀疑你这是不是直接套用大乘的网址来这骗赞嫌弃思考思考思考;3;8;11;18388;0.0005982162279747662
53963;请问大佬派蒙的语音合成用的是什么工具呢？暹罗猫小豆泥抱大腿;3;4;7;18388;0.0003806830541657603
53967;好家伙，三个群全满了;1;4;5;18388;0.00027191646726125733
53969;这网站不是要钱吗？;3;2;5;18388;0.00027191646726125733
53973;群都满了能不能私发一下群，谢谢;1;2;3;18388;0.0001631498803567544
53975;老哥你群满了，发短信要付费直接打水漂了哥，满了你倒是在群简介说一下啊;1;2;3;18388;0.0001631498803567544
53981;哭、在群里发涩图（其实不是非常色）被踢了;1;3;4;18388;0.00021753317380900588
53984;你说配音你自己伪声的，你自己信吗热;3;13;16;18388;0.0008701326952360235
53988;一个网站还要进群啊？再整个关注的公众号呗;10;20;30;18388;0.001631498803567544
54013;同求私网址;1;2;3;18388;0.0001631498803567544
54015;所以你为什么可以用派蒙的声音原神嗯原神嗯原神嗯;4;2;6;18388;0.0003262997607135088
54025;我更想要你的变音软件了;2;2;4;18388;0.00021753317380900588
54028;最近这么多ai绘画的视频，看起来是我们白嫖，其实是帮助他们训练ai;4;15;19;18388;0.0010332825755927778
54033;这个网站还在吗;2;1;3;18388;0.0001631498803567544
54036;为什么不直接把网站发在简介呢;1;1;2;18388;0.00010876658690450294
54038;全满，进不去;4;1;5;18388;0.00027191646726125733
54043;群都满人了，点赞求拉群;3;1;4;18388;0.00021753317380900588
54047;满了，大大;3;1;4;18388;0.00021753317380900588
54051;满了，求私热词系列知识增加;1;1;2;18388;0.00010876658690450294
54053;三连了群又满了（）;3;1;4;18388;0.00021753317380900588
54057;私网址打call;1;1;2;18388;0.00010876658690450294
54059;求私;2;1;3;18388;0.0001631498803567544
54062;所以说，我用AI画的画算不算侵权热词系列知识增加;1;2;3;18388;0.0001631498803567544
54067;能不能把选项可用的列出来啊doge，还有这个粉丝群进不去啊，答案不知道，我看完视频了还不知道笑哭;3;1;4;18388;0.00021753317380900588
54071;服了，非要加群;13;3;16;18388;0.0008701326952360235
54089;我还以为声音也是AI生成的。;2;1;3;18388;0.0001631498803567544
54097;nsfw可以画吗滑稽滑稽滑稽;1;1;2;18388;0.00010876658690450294
54099;这配音是软件吗，有点高级，有谁知道哦呼;1;1;2;18388;0.00010876658690450294
54103;我很震惊up，伪声这么大哭，还是我想多了;1;1;2;18388;0.00010876658690450294
54117;我更好奇这个ai配音在哪搞（）;1;1;2;18388;0.00010876658690450294
54121;进去了然后过了一天被踢出去了什么情况？;2;1;3;18388;0.0001631498803567544
54125;7个群全满了。。。一个一个试的保卫萝卜哭哭保卫萝卜哭哭保卫萝卜哭哭;1;1;2;18388;0.00010876658690450294
54129;加了，然后打不开网页不知道为啥，问了没说，不知道是不是没看到问了两次，感觉up只看得到别人发的妙啊;1;1;2;18388;0.00010876658690450294
54142;午马管理滥用职权，随意踢人;1;2;3;18388;0.0001631498803567544
54146;UP我想问个问题，最近做论文想做码头的实景展示，这个AI绘画可以做到吗？;1;1;2;18388;0.00010876658690450294
54149;可不可以出一期伪音教学微笑，翻了很多，这是我遇到配的最像的up主了;2;1;3;18388;0.0001631498803567544
54154;yysy大乘AI是真的好用，可惜崩了，看起来up这个是一样的吗手机上可以用吗？;1;1;2;18388;0.00010876658690450294
54156;大乘活了四天，up有加一些限制的想法吗doge;1;1;2;18388;0.00010876658690450294
54160;热词系列三连了全靠运气翻牌辣哈哈;1;1;2;18388;0.00010876658690450294
54172;有点假，生成一张花20分钟，而且一点都不像;1;2;3;18388;0.0001631498803567544
54184;无需安装免费在线NovelAi智能绘画网站备注加群可获取网站群1：861203201群2149768994群3622153009简单来说，直接输入文字就可以直接转化出图片来，也可以通过图片来转化图片。本视频大部分收益都会用来进行网站维护，来方便大家继续免费在线生成图片。所以请不要吝惜你的三连和投币点赞，这对我们来说真的很重要感谢：上学猫的支持如果你喜欢我的视频或者AI绘画感兴趣，请不要白嫖记得点赞补充说明一下。第一个是群里自己开的公益网站，如果你打不开了，或者无法使用了，那么就请使用第二个公益网站。如果需要赞助的话，找：上学猫，服务器是这位大佬开的。为了满足你们的口味，我真的好难哦，为什么你们都喜欢萝莉音呢？无法理解，反正也就这样了，真的是每做一次视频就折磨我一次了。为了你们的三连点赞，我也是拼了。;1;13;14;18388;0.0007613661083315206
54187;既然是绘画ai为什么不叫imageAIpictureAIdrawAIphotoAIpaintAIcanvasAIartAI起个名字都旁门左道;2;2;4;18388;0.00021753317380900588
54194;哎，我挤进去了。感谢命运;14;1;15;18388;0.000815749401783772
54209;刚在群里涩涩被踢了无语;4;1;5;18388;0.00027191646726125733
54215;UP主我想问下你这个配音是咋搞的啊好可爱哦;2;1;3;18388;0.0001631498803567544
54219;其实我并不是在意用哪个声音，我个人认为舒服就行，都可以的，伪音听着也up难受，个人建议观众没必要要求up只用哪一个音（我个人还是觉得原本的好）;2;1;3;18388;0.0001631498803567544
54222;我加群一直答案错误（明明是打2，之后就不对了），一直申请，把号给封了，现在加不了了大哭大哭;1;1;2;18388;0.00010876658690450294
54224;很难受，看到一些太太精心画的画，没上过热门，Ai绘画却接连上热门，很难受啊;2;1;3;18388;0.0001631498803567544
54227;up拿算力做慈善，但还是建议能自己装的自己装一个，现在有各种低配版本和教程，而且不算大，有电脑没必要白嫖脱单doge;1;1;2;18388;0.00010876658690450294
54232;不要白嫖不要白嫖不要白嫖;1;1;2;18388;0.00010876658690450294
54239;已三连。QQ群找不到求私聊。;10;0;10;18388;0.0005438329345225147
54251;这个AIweb是自己搭建的吗？跟主流web有啥区别？;1;0;1;18388;5.438329345225147e-05
54258;请问这个群在哪里加呢，我找不到;2;0;2;18388;0.00010876658690450294
54264;UP主，QQ都满人啦大哭;2;0;2;18388;0.00010876658690450294
54270;满了;2;0;2;18388;0.00010876658690450294
54280;群还在吗;2;0;2;18388;0.00010876658690450294
54283;是所有AI都不会画手和脚吗;4;0;4;18388;0.00021753317380900588
54304;up可以问一下吗？鄙人不想画画，想用AI写作功能，请问有没有啊笑哭笑哭笑哭;5;0;5;18388;0.00027191646726125733
54313;我擦，这是变声器声卡还是学的伪音三星堆;1;0;1;18388;5.438329345225147e-05
54317;辛苦你了，这么乐善好施的人，不应该被这样对待。;1;0;1;18388;5.438329345225147e-05
54319;没搜到群号。。。。;1;0;1;18388;5.438329345225147e-05
54323;还有群吗，，;1;0;1;18388;5.438329345225147e-05
54333;群都满了;1;0;1;18388;5.438329345225147e-05
54338;能直接发网址吗？群找不到;1;0;1;18388;5.438329345225147e-05
54341;这个技术只不过是总成上的一部分，就像PS软件中的画笔一样，要是集成画风模仿，快速背景，帧变化等等，一个人一个月制作一部动漫不是梦想想冰菓，想想那些有生之年，分分钟都有可能给哪个大up给干出来doge;1;0;1;18388;5.438329345225147e-05
54344;群都满了;1;0;1;18388;5.438329345225147e-05
54352;现在还有群进吗委屈;3;0;3;18388;0.0001631498803567544
54359;UP又满了这是我看的最火爆的项目了;1;0;1;18388;5.438329345225147e-05
54361;满了人啊aaaaa;5;0;5;18388;0.00027191646726125733
54369;再来一个吧大佬，已三连;2;0;2;18388;0.00010876658690450294
54373;可以输中文？;3;0;3;18388;0.0001631498803567544
54377;漫了;1;0;1;18388;5.438329345225147e-05
54386;还有新群没有大佬;1;0;1;18388;5.438329345225147e-05
54391;up1497开头的群满了;1;0;1;18388;5.438329345225147e-05
54397;861203201这个是qq群？;1;0;1;18388;5.438329345225147e-05
54400;满了大哭;5;0;5;18388;0.00027191646726125733
54406;满了委屈委屈委屈;1;0;1;18388;5.438329345225147e-05
54408;群满了笑哭;1;0;1;18388;5.438329345225147e-05
54410;你这派蒙的声音怎么弄的捂眼;2;0;2;18388;0.00010876658690450294
54413;已三连，脱单doge求私;1;0;1;18388;5.438329345225147e-05
54415;up全满了崩坏3lay了崩坏3lay了;2;0;2;18388;0.00010876658690450294
54419;试了好几个群都是满员，离谱;1;0;1;18388;5.438329345225147e-05
54421;在线版的话真的做得很好了支持;1;0;1;18388;5.438329345225147e-05
54423;点赞投币求拉群;1;0;1;18388;5.438329345225147e-05
54425;是不是可以考虑建立一个电报群了？没有人数限制的。也能管理。QQ群2000人的限制以下就满员了。;1;0;1;18388;5.438329345225147e-05
54427;2022年10月30日10点00分上面的公布的群都是满的。加不进去;1;0;1;18388;5.438329345225147e-05
54429;最新群也满了笑哭笑哭;1;0;1;18388;5.438329345225147e-05
54432;全部满员怎么办啊？;1;0;1;18388;5.438329345225147e-05
54434;三连求私;5;0;5;18388;0.00027191646726125733
54440;全满了UP主大哭;2;0;2;18388;0.00010876658690450294
54447;三连求私;4;0;4;18388;0.00021753317380900588
54453;都满了欸，三连求私;1;0;1;18388;5.438329345225147e-05
54467;额，大佬，我问一下，这个a卡能用吗;2;0;2;18388;0.00010876658690450294
54470;upup我想要派蒙的声卡;1;0;1;18388;5.438329345225147e-05
54472;不让进群还发什么群啊，11不等于2，等于什么？秒拒;1;0;1;18388;5.438329345225147e-05
54474;所以这个派蒙语音哪来的脱单doge;1;0;1;18388;5.438329345225147e-05
54485;呜呜呜哥满了三连了看看有没有机会放我;1;0;1;18388;5.438329345225147e-05
54505;三连求私;3;0;3;18388;0.0001631498803567544
54526;三连求私呜呜都满了;3;0;3;18388;0.0001631498803567544
54564;UP主这个确实良心，完全免费而且方便，但是这样子很容易被乱搞，有没有可能做验证码机制和单次图片生成限制来解决一下呢;1;0;1;18388;5.438329345225147e-05
54569;up主的伪音好厉害啊崩坏3赞;19;0;19;18388;0.0010332825755927778
54595;已加群，今晚试试，真的能生成就三连OK;6;0;6;18388;0.0003262997607135088
54605;7个群都满了，然后谢谢up;1;0;1;18388;5.438329345225147e-05
54638;已三连，求（晚上被踢出来了大哭（什么都没干）;1;0;1;18388;5.438329345225147e-05
54643;求问一下，为什么群问题回答2都是错的呀？;2;0;2;18388;0.00010876658690450294
54646;up你用的什么语音软件啊？;4;0;4;18388;0.00021753317380900588
54716;真可以用我iup主啊啊啊啊啊;3;0;3;18388;0.0001631498803567544
54720;将来会不会ai写歌了;1;0;1;18388;5.438329345225147e-05
54730;付费作画吗？;1;0;1;18388;5.438329345225147e-05
54745;全满了;2;0;2;18388;0.00010876658690450294
54758;我只想知道你的语音怎么搞得打call;2;0;2;18388;0.00010876658690450294
54763;我比较在意这个paimeng的声音怎么弄的脱单doge;1;0;1;18388;5.438329345225147e-05
54792;群满了，能否发个网站呢;3;0;3;18388;0.0001631498803567544
54814;好，支持;1;0;1;18388;5.438329345225147e-05
54863;微信搜索，马良ai绘画。novelai在线免费使用。;1;0;1;18388;5.438329345225147e-05
54909;只能画人物么;1;0;1;18388;5.438329345225147e-05
54943;up看看我，我拿完网站会自动退群的，已三连;1;0;1;18388;5.438329345225147e-05
54949;我加了群，一句话还没说把我踢出去了，什么鬼疑惑疑惑疑惑;4;0;4;18388;0.00021753317380900588
54956;三连求私，付费也行，别太贵就okdoge;2;0;2;18388;0.00010876658690450294
54968;求私网址脱单doge;1;0;1;18388;5.438329345225147e-05
54977;up厉害啊，我就路过，cy，等之后有空了就上去看看网站，希望到时候群里有空位了狂三星星眼;1;0;1;18388;5.438329345225147e-05
54985;在群里正常聊天给踢了无语，我是反啥天条了是咋滴。;1;0;1;18388;5.438329345225147e-05
54989;这到底是有多火啊这个ai绘图，果然科技的力量啊哦呼;3;0;3;18388;0.0001631498803567544
54993;UP主要不再开个新群吧，旧群实在挤不进去了，也不知道QQ群上限踢几个人能不能让别人进群酸了;2;0;2;18388;0.00010876658690450294
55006;为什么我从刚进群就经常讨论经常分享tag还能被踢？离谱;1;0;1;18388;5.438329345225147e-05
55033;相比这个Ai配音这么多种多样真的更让我震惊;4;0;4;18388;0.00021753317380900588
55046;我觉得能不能整个手机号注册账号，然后一个账号一天上限生成五十张一百张，这样脚本也没辙;3;0;3;18388;0.0001631498803567544
55064;这种AI绘画的底层逻辑应该都是GPU生成的吧那以后能不能直接在自己的电脑上个人使用呢？还是说个人使用AI成长太慢？;5;0;5;18388;0.00027191646726125733
55097;可以画涩图吗doge;1;0;1;18388;5.438329345225147e-05
55107;五群六群直接来吧;1;0;1;18388;5.438329345225147e-05
55124;我要完整的萝莉音可恶不要突然换了阿这冲到一半就突然变了;2;0;2;18388;0.00010876658690450294
55145;各位大佬，我找不到ai官网的网址，谁有啊？我看看官网价格决定一下要不要付费使用;1;0;1;18388;5.438329345225147e-05
55152;这个派蒙声音也是ai配的吗，ai越来越强大了;1;0;1;18388;5.438329345225147e-05
55187;861203201149768994;1;0;1;18388;5.438329345225147e-05
55202;有没有涩涩的词条啊？没有就算了;1;0;1;18388;5.438329345225147e-05
55209;这个网址怎么打不开;1;0;1;18388;5.438329345225147e-05
55217;热词系列三连我试试能不能生成一张想要的人物的看看;3;0;3;18388;0.0001631498803567544
55223;群满了啊酸了;1;0;1;18388;5.438329345225147e-05
55242;网址呢？;2;0;2;18388;0.00010876658690450294
55245;嘛，因为校园网太拉完全抢不过他们，所以我自己下了两个ai绘图工具，目前血压正常，没被ai气死，三连已经给了，up主加油吧雪狐桑好棒;1;0;1;18388;5.438329345225147e-05
55247;弱弱的问一下，最近看很多人把片转换成动漫图片，这个是可以添加参考图的嘛;1;0;1;18388;5.438329345225147e-05
55249;声音太可爱了;2;0;2;18388;0.00010876658690450294
55252;虽然有点不合理，但是真的好看啊嗑瓜子;1;2;3;18388;0.0001631498803567544
55254;吃瓜;3;1;4;18388;0.00021753317380900588
55260;摘掉眼镜，拿远手机，差不多看不出来;120;18268;18388;18388;1.0
55381;前两个还勉勉强强，看不出来，最后一个一眼坤坤;58;13831;13889;18388;0.7553295627583206
55440;第一个一眼就认出来了，第二个不知道这个梗，第三个化成灰我都认识;56;7686;7742;18388;0.4210354579073309
55497;最后一个就算是变成夸克我都认得doge;17;3421;3438;18388;0.18696976288884054
55515;纣王的不懈努力妲己终于怀孕了，不幸的是，有一天妲己散步的时候被一块石头绊倒了，栽了下去，流产了，纣王看到崩溃地大喊：“己你胎没己你石栽使胎没”大臣们都痛呼：“哦悲悲”;16;1838;1854;18388;0.10082662606047423
55532;那个山水画，化成灰都能一眼认出来笑哭;2;1278;1280;18388;0.06961061561888188
55535;最后面的那个化成灰我都认得阴险;4;882;886;18388;0.0481835979986948
55540;最后一个只要是人就能认出来一定是我们家鸽鸽;6;426;432;18388;0.023493582771372635
55547;说实话，前两个我都没猜出来，最后那个一眼doge;3;266;269;18388;0.014629105938655644
55551;别的不说，最后一张换成灰我都认得。dogedoge;1;211;212;18388;0.011529258211877311
55553;真正的ikun只有中份吃瓜;2;122;124;18388;0.006743528388079182
55556;卧槽最后一个我猜出来了;3;61;64;18388;0.003480530780944094
55560;第一题我还以为是一个脸色苍白女的嘴里冒出一个辫，看的我san值直掉;4;64;68;18388;0.0036980639547531
55565;近视眼表示，前面的那三张图有什么区别吗笑哭眼睛自动模糊化，然后就得到了原图。;7;36;43;18388;0.002338481618446813
55573;什么软件;29;34;63;18388;0.0034261474874918425
55604;BGM是什么？;4;13;17;18388;0.000924515988688275
55610;窗有雪丶哈哈哈快看这个大半夜笑出声;1;1;2;18388;0.00010876658690450294
55612;我就想说，这个软件在哪里？;5;15;20;18388;0.0010876658690450293
55618;就这么说，以后坤的骨灰打乱了，都得靠我们小黑子辨认脱单doge;2;771;773;18388;0.042038285838590386
55621;王二小同志最后一个化成灰我都认识;1;6;7;18388;0.0003806830541657603
55624;封面是我用AI生成的图，做视频的没有告知就拿走了？;3;7;10;18388;0.0005438329345225147
55634;婧然有源建议摘了眼镜看;1;1;2;18388;0.00010876658690450294
55638;绫小鑫其他的可以认不出，最后一张化成灰都必须认得;1;4;5;18388;0.00027191646726125733
55643;你已在杰难逃看到最后;1;1;2;18388;0.00010876658690450294
55648;脱单doge只因留;1;1;2;18388;0.00010876658690450294
55653;Lucifer所望皆为星辰不是无理数最后一个一眼就看出来了脱单doge;2;3;5;18388;0.00027191646726125733
55658;忧纪2化成灰我都认识;1;2;3;18388;0.0001631498803567544
55664;你的橘子是橙子;1;2;3;18388;0.0001631498803567544
55680;什么软件;1;2;3;18388;0.0001631498803567544
55686;联合国怎么说;4;3;7;18388;0.0003806830541657603
55691;圝讟最后一个化成灰我都认识;1;1;2;18388;0.00010876658690450294
55773;听过一位画师说过，对他们来说ai绘画是什么呢，是自己的孩子被一块一块切开然后跟别人的孩子拼凑出了新的尸体，一具没有灵魂的傀儡罢了他窃取了世界各地画手的灵感，却又不用担一份责任，用户协议上写着使用者若遭到侵权控告，后果自行承担，所以我不明白为什么还有人在用我不是一个画手，你说我圣母心泛滥也好，说我担心有的没的也好，存在并不全是合理，正是因为人们没有版权意识，也没有珍惜别人劳动成果的想法，并且妄想着不劳而获，所以才会诞生这种荒谬的东西，妄念也会成为存在的理由而我能做的，是尽量向他人普及，并做好自己，约束自己，如果他人不行，至少我不要做帮凶这个是在视频号复制的囧不要喷我，就单纯让大家知道而已;1;1;2;18388;0.00010876658690450294
55793;每天学习不划水;1;1;2;18388;0.00010876658690450294
55815;我上次在贴吧看到一副听说是ai画的画，，叫一家五口。。？笑哭;1;1;2;18388;0.00010876658690450294
55831;省流：up是小黑子;1;1;2;18388;0.00010876658690450294
55833;BGM是什么;2;1;3;18388;0.0001631498803567544
55838;第二张图有个小技巧：手机拿远，横屏，以45度角侧视，眯一下眼镜就能看到哈士奇了喜极而泣;2;1;3;18388;0.0001631498803567544
55853;联合国怎么说？;2;2;4;18388;0.00021753317380900588
55866;嗜睡阿花;1;0;1;18388;5.438329345225147e-05
55928;有时间去弄这些，还不如把这些精力放在科学研究上;1;1;2;18388;0.00010876658690450294
55940;求bgm;1;0;1;18388;5.438329345225147e-05
55956;这这为什么第二幅我一眼就看出来了？哦哦是我头像啊，那没事了doge;1;0;1;18388;5.438329345225147e-05
56019;陆凛丶;1;0;1;18388;5.438329345225147e-05
56024;rx78nt最后一张你认出来了吗？;1;0;1;18388;5.438329345225147e-05
56083;bili12265385635;1;0;1;18388;5.438329345225147e-05
56099;微眠的約束;1;0;1;18388;5.438329345225147e-05
56141;欣欢你呀最后一个一眼就看出来了doge;1;0;1;18388;5.438329345225147e-05
56187;这是什么软件？？;1;0;1;18388;5.438329345225147e-05
56190;什么软件;1;0;1;18388;5.438329345225147e-05
56199;无思之人的余火;1;0;1;18388;5.438329345225147e-05
56302;前面的我可能不知道，但是最后一个，就算我瞎了。都能摸出来是我家哥哥滑稽;1;0;1;18388;5.438329345225147e-05
56342;前两个死都看不出来，第三个仿佛DMA动了好像冥冥之中告诉我这是坤坤;1;0;1;18388;5.438329345225147e-05
56549;火章Piecklinks前两个都看不出来最后一个一眼就认出来doge;1;0;1;18388;5.438329345225147e-05
56552;下一期下一期打call;1;0;1;18388;5.438329345225147e-05
56593;白毛男二;2;0;2;18388;0.00010876658690450294
56659;亡屍千黎小丨安丶;1;0;1;18388;5.438329345225147e-05
56674;丛林法则;1;0;1;18388;5.438329345225147e-05
56752;只因坤坤的一眼看出doge;1;0;1;18388;5.438329345225147e-05
56815;Lothen5;1;0;1;18388;5.438329345225147e-05
56862;艾特评论;2;0;2;18388;0.00010876658690450294
56874;一天不抖腿浑身难受;1;0;1;18388;5.438329345225147e-05
56932;龙sir不会白给眯着眼乱杀;1;0;1;18388;5.438329345225147e-05
56973;DZ大致就行;1;0;1;18388;5.438329345225147e-05
56997;王乐乐Yvette;1;0;1;18388;5.438329345225147e-05
57024;撒撒撒拉嘿呦八嘎太君问你话呢;1;0;1;18388;5.438329345225147e-05
57039;qzy7777;1;0;1;18388;5.438329345225147e-05
57052;D丨O;1;0;1;18388;5.438329345225147e-05
57109;兔兔变大了星星眼弹幕有有个说没有原石病的世界，然后原石病变成了恐怖分子，变成了海嗣泛滥，反正这鬼地方总要闹事;12;368;380;18388;0.020665651511855558
57122;好像这个画风，这个ai吃的是什么我已经大概看出来了。;1;26;27;18388;0.0014683489232107897
57124;假的吧？阿米亚没那么大喜欢;8;104;112;18388;0.006090928866652165
57133;这，这不对吧这，我女儿没这么大呀（;1;45;46;18388;0.0025016314988035677
57135;我只喜欢蒂蒂;1;13;14;18388;0.0007613661083315206
57137;AI怎么敢把兔兔的环给取掉的啊doge;1;10;11;18388;0.0005982162279747662
57146;她才14咋就怎么大了捏doge;1;2;3;18388;0.0001631498803567544
57179;兔厨蚌埠住了;1;0;1;18388;5.438329345225147e-05
57205;你放seed的歌我怎么一定要给你点赞的记得下回上个拉拉的我给你投币doge;1;39;40;18388;0.0021753317380900587
57207;有的时候随机生成的好看的脸怎么锁住这张脸然后能让她改变动作;6;39;45;18388;0.002447248205351316
57214;水嫩多汁，奶香浓郁，蛋白质含量极高，小孩特别爱喝，隔壁的我都馋哭了doge;1;22;23;18388;0.0012508157494017839
57216;上个月就三连了，这个月还没给链接，究竟是我错付了。嫌弃;2;10;12;18388;0.0006525995214270176
57219;真的吗，三连就发原图吃瓜;1;4;5;18388;0.00027191646726125733
57221;已三连求图包;1;3;4;18388;0.00021753317380900588
57223;求图包脱单doge;2;2;4;18388;0.00021753317380900588
57227;求图包打call;1;1;2;18388;0.00010876658690450294
57229;已三连求图包星星眼;2;1;3;18388;0.0001631498803567544
57233;已三连求图私;1;1;2;18388;0.00010876658690450294
57235;链接星星眼;1;0;1;18388;5.438329345225147e-05
57237;已三连;1;0;1;18388;5.438329345225147e-05
57240;链接;1;0;1;18388;5.438329345225147e-05
57242;太不容易了笑哭，上一个mod连续三个视频被锁笑哭;1;0;1;18388;5.438329345225147e-05
57244;链接星星眼;1;0;1;18388;5.438329345225147e-05
57246;三连了求图包;1;0;1;18388;5.438329345225147e-05
57248;星星眼星星眼星星眼图包;1;0;1;18388;5.438329345225147e-05
57259;想问up用的是啥软件呀保佑;1;0;1;18388;5.438329345225147e-05
57286;这不是拍的照片吗。;1;0;1;18388;5.438329345225147e-05
57312;有全身照没吃瓜;1;0;1;18388;5.438329345225147e-05
57332;求图包脱单doge;1;0;1;18388;5.438329345225147e-05
57334;求图包;1;0;1;18388;5.438329345225147e-05
57336;现在关注以后就是老粉了，所以有没有下载链接嗑瓜子嗑瓜子嗑瓜子;1;0;1;18388;5.438329345225147e-05
57339;为什么那么大，dogedogedoge宝石;1;0;1;18388;5.438329345225147e-05
57342;求图;1;0;1;18388;5.438329345225147e-05
57346;图包脱单doge;1;0;1;18388;5.438329345225147e-05
57348;求图包;1;0;1;18388;5.438329345225147e-05
57350;求图包;1;0;1;18388;5.438329345225147e-05
57352;求图包;1;0;1;18388;5.438329345225147e-05
57354;求图包大笑;1;0;1;18388;5.438329345225147e-05
57356;求;1;0;1;18388;5.438329345225147e-05
57358;求图包;1;0;1;18388;5.438329345225147e-05
57360;球球神秘链接;2;0;2;18388;0.00010876658690450294
57363;热词系列三连图;1;0;1;18388;5.438329345225147e-05
57365;已三连，求图包微笑;1;0;1;18388;5.438329345225147e-05
57367;求图包;1;0;1;18388;5.438329345225147e-05
57369;求;1;0;1;18388;5.438329345225147e-05
57372;三连了;1;0;1;18388;5.438329345225147e-05
57375;三连求私;1;0;1;18388;5.438329345225147e-05
57378;求图，谢谢;1;0;1;18388;5.438329345225147e-05
57380;dogeup肯定是个大帅b求私图包;1;0;1;18388;5.438329345225147e-05
57382;求图包;1;0;1;18388;5.438329345225147e-05
57384;三连求私;1;0;1;18388;5.438329345225147e-05
57386;求图包;1;0;1;18388;5.438329345225147e-05
57388;doge已三连;1;0;1;18388;5.438329345225147e-05
57390;up求鼓掌;1;0;1;18388;5.438329345225147e-05
57392;求图包吃瓜;2;0;2;18388;0.00010876658690450294
57399;审核：你小子开高达是吧;1;0;1;18388;5.438329345225147e-05
57403;无聊不是涩涩无聊而是你这体现不出钻石骑士的特殊性，那谁那种基佬的感觉也是一种特色，而你这个有没有钻石根本无所谓。;2;0;2;18388;0.00010876658690450294
57406;已三连，需要图包;1;0;1;18388;5.438329345225147e-05
57408;图呢喜欢;1;0;1;18388;5.438329345225147e-05
57411;腿呢？腰呢？吃瓜;1;0;1;18388;5.438329345225147e-05
57420;已三连求al链接;1;0;1;18388;5.438329345225147e-05
57422;已三连，求私;1;0;1;18388;5.438329345225147e-05
57424;三连求私;1;0;1;18388;5.438329345225147e-05
57429;三连了星星眼;1;0;1;18388;5.438329345225147e-05
57433;已三连;1;0;1;18388;5.438329345225147e-05
57435;链接;1;0;1;18388;5.438329345225147e-05
57437;链接星星眼;1;0;1;18388;5.438329345225147e-05
57439;三连了求图包;1;0;1;18388;5.438329345225147e-05
57441;已三连求图包;1;0;1;18388;5.438329345225147e-05
57443;优秀，求个链接doge;1;0;1;18388;5.438329345225147e-05
57445;BGM是什么;1;0;1;18388;5.438329345225147e-05
57448;已三连，求图包吃瓜;1;0;1;18388;5.438329345225147e-05
57450;up私个链接，已三连;2;0;2;18388;0.00010876658690450294
57453;星星眼星星眼星星眼图包;1;0;1;18388;5.438329345225147e-05
57455;链接换硬币;1;0;1;18388;5.438329345225147e-05
57457;已投币求图包还有前几期的;1;0;1;18388;5.438329345225147e-05
57459;链接星星眼;1;0;1;18388;5.438329345225147e-05
57461;已赞，送你上首页;1;0;1;18388;5.438329345225147e-05
57463;太不容易了笑哭，上一个mod连续三个视频被锁笑哭;1;0;1;18388;5.438329345225147e-05
57465;幸好我画画是为了开心，那些靠画吃饭的画师才是真的惨，莫名其妙就要寄了。推上有几个ai作画的推主我都有关注，短短两个月他们已经能单独去让ai模仿那些名画师的画风了，很吊诡，就是，它不能创造新的东西，但是只要有新的风格一出来，它一吸收，之后碎石重组就能抢了你的饭碗，很恐怖你知道吧，你再怎么努力也只是它的养料，这可不是工业时代人和机器的关系，这是三角贸易时代农场主和奴隶的关系，更绝望的是你除非自己画出来只给自己看，不然你只要上传互联网你的图就有被碎石的可能，有人还说还有用3d辅助画画的，这完全不一样的朋友，你学3d辅助要时间吧，3d辅助玩上色总得自己上吧，ai能几秒直接出图，就没有任何门槛的。只能说这个对靠画画吃饭的画师就是一种巨人爬墙头看你的感觉，而且城里全是普通人没兵团，它饿了就抓几个嘎嘣一吃那种绝望，然后大家报团在一起努力显得自己很大，但是巨人都懒得看你一眼，该吃吃该睡睡。我还是保持悲观态度的，因为若是从利益方面讲，这玩意资本可是爱死了。;26;317;343;18388;0.018653469654122255
57492;以后新手过不了ai这一关过得了ai这一关的已经死绝了新手练34年过不了ai这一关大部分人就放弃了资金压力时间等等以后再无美术永远只看剩下的这些图然后新兴美术一出来就被喂图画师活不了没有新图老板活不了用户看腻了的美术电绘时代落幕dogedogedoge;23;145;168;18388;0.009136393299978247
57516;人家辛苦画的画都要去喂ai了，有些东西还是不要发明好呆;165;337;502;18388;0.027300413313030236
57683;钱是从甲方来的，那从甲方的视角看看，以前是设计草图就那几张沟通成本高的画师，我不合心意的话，还要付定金，合心意的话稿费也贵；现在是量大质也行的ai，不好的小细节丢给画师处理，钱花的也少，大量的图也总有符合我心意的。适者为强;18;76;94;18388;0.0051120295845116384
57702;不是，，这种图乍一看很不错但蹦的地方太多了，真想用，先不提版权的问题，有能力改这种细节量的画师你都不好找吃瓜;23;47;70;18388;0.0038068305416576026
57726;都好好看啊好多对xp的星星眼就是评论看得我高血压，什么叫职业画师的水平也不过如此啊疑惑;6;37;43;18388;0.002338481618446813
57733;只能说目前是当参考或者唬唬不懂角色设计的外行吧，游戏内能实装的角色设计都是精心编排过的，虽然看着差不多但跟这种元素堆砌其实是本质上的区别呆根本用不了的，外行自己玩玩图个乐还行;11;40;51;18388;0.002773547966064825
57745;只能说但行好事莫问前程，你要是天天问以后还能不能靠画画吃上饭，那我只能说你问再多你也吃不上饭，真正想画画谁天天在乎这个，互联网时代你有受众，你的价值就肯定比ai，感觉以后的游戏如果用上ai，美术这块就要卷画师知名度了;24;44;68;18388;0.0036980639547531
57770;虽然画风都好眼熟，但是衣服设计的真的好好看跪了跪了跪了;1;32;33;18388;0.0017946486839242985
57772;你不是在和ai一个人战斗，你是在和世界古往今来所有的画师战斗，所以完败是必然的。;3;32;35;18388;0.0019034152708288013
57776;对画画刚刚入门的我打击还蛮大的，但我还是不会就此放弃的，至少我认为手画和ai对我的意义还是不太一样的，玩ai远没有自己画画有意思，所以我至今一次ai也没用过，玩ai不如先把自己拉垮的人体再练练;6;28;34;18388;0.00184903197737655
57783;不要老说AI是拿别人东西拼凑，网上的小说那个敢说自己编的桥段在古今中外历史上没有一本书有类似情节的？创意性的工作做久了你就会发现，你认为的“创造”，比如你设计的角色发型，衣服，剧情等，又比如建筑的造型，画面场景，几乎100早就有人做过了，大家都只是挪用前人的东西罢了，跟AI没什么本质区别，只是他比你快还比你拼的好。;57;29;86;18388;0.004676963236893626
57841;这就行了？没看那些主流游戏的微博评论吗？玩家都是拿显微镜看图的，一点不对就开骂，这些ai的破图能用就有鬼了，当然，要是那些约立绘就花8、9百约的那些屎一样的游戏，还真有可能用这个，能免费出图可得把他们乐死了;1;12;13;18388;0.0007069828148792691
57845;不知道能不能画其他风格的，欧卡，宠物怪物之类，日韩妹子看多了好腻笑哭;2;2;4;18388;0.00021753317380900588
57851;ai这东西自己欣赏，偶尔分享se图奇葩图还行，拿去赚钱的话真的不行;3;10;13;18388;0.0007069828148792691
57855;随便一修，游戏插图，这年头，米真好赚doge;3;7;10;18388;0.0005438329345225147
57859;有一说一，确实还行，啥时候能生成动画，我想看喜欢的小说变成番剧doge;3;30;33;18388;0.0017946486839242985
57863;可以优化掉不少新手岗位了，老板又得笑了，不能商用？手动改几笔就能了;18;9;27;18388;0.0014683489232107897
57884;一股舟味怎么回事doge;1;12;13;18388;0.0007069828148792691
57886;虽然但是，这个ai撞车率可是比其他还要高;5;8;13;18388;0.0007069828148792691
57894;他们的素材库没有版权纠纷吧;5;3;8;18388;0.00043506634761801175
57900;资本家：多来点，人工麻烦从业者：草，我没饭吃了AI：我不会画手，给我找个妈妈教我画;1;5;6;18388;0.0003262997607135088
57905;这个真的这个效果太强了，如果是人类画师画的，已经够得上大厂了以画画为生的人，我都不知道以后五六年要怎么样了;3;1;4;18388;0.00021753317380900588
57909;同样悲观态度，一切东西都可以被数字化，量化，工业化，数据化是很恐怖的，生而为人特有的东西被夺走了，人存在的意义又是什么？现在不仅仅是绘画这一艺术在逐渐被AI学习，取代，以后呢？现在我所担心的不只是绘画，而是作为人的人格。很可怕，我很悲观辣眼睛;5;1;6;18388;0.0003262997607135088
57916;大家没有觉得这个作为练习参考很有用吗;2;1;3;18388;0.0001631498803567544
57920;其实我有个问题，如果以后很多游戏真的用AI生成的图做立绘，大家会买单吗？;4;1;5;18388;0.00027191646726125733
57925;这张粥味十足;1;2;3;18388;0.0001631498803567544
57927;为什么感觉很多舟味，还有那个护士喵很像饕餮酱崩坏3？;2;1;3;18388;0.0001631498803567544
57931;至少ai图机械和结构很糟糕，老老实实画机娘去了，不卷美少女了。tv困;1;2;3;18388;0.0001631498803567544
57933;更进一步生成动画，结合编故事的ai，以后想看什么故事直接输入几个关键词，ai自动编，故事无限延伸;1;1;2;18388;0.00010876658690450294
57935;工业革命工人砸机器现在机器还不成熟等工业革命完成的那天;3;1;4;18388;0.00021753317380900588
57941;立绘是人物站着的意思吗;1;2;3;18388;0.0001631498803567544
57944;我比较期待ai能做到给一本小说（甚至ai写小说）能产出一个电影剧本，然后生成人物设定，在生成分镜完成ai电影。;2;2;4;18388;0.00021753317380900588
57947;看起来某些方面的发展进化并不一定对人类有好处啊;1;4;5;18388;0.00027191646726125733
57952;立绘主要是是设计。乱搭配的看上去还可以。实际经不起考验。卖不掉;4;1;5;18388;0.00027191646726125733
57961;加了粥tag就顶胯草笑哭;1;1;2;18388;0.00010876658690450294
57965;工業化流水線生產的文化商品doge;1;3;4;18388;0.00021753317380900588
57973;AI与人类在二次元这一块，基本AI算是终结比赛了;10;3;13;18388;0.0007069828148792691
57984;只能说明目前的商业设计本质工业垃圾;1;1;2;18388;0.00010876658690450294
57998;我看了好多觉得缺少了什么，那就是人的情感，ai全是冷漠的感觉，ai能画出喜怒哀乐吗;1;0;1;18388;5.438329345225147e-05
58006;假设你觉得你的作品被Ai侵权了，你要去起诉，那首先你得搜集证据维权成本太高了;1;0;1;18388;5.438329345225147e-05
58009;画师药丸，唉;1;0;1;18388;5.438329345225147e-05
58014;我寻思国外这东西不都是联合抵制吗？怎么到这儿了还可以如此开放，以后你们中低层画手饭碗稀碎了可别怪世道冷漠，毕竟能拿大单的画师可不在乎这东西。;2;0;2;18388;0.00010876658690450294
58018;感觉同样的设计特别像，颜色你拿ps吸出来都差不多，AI设计还是容易审美疲劳;2;0;2;18388;0.00010876658690450294
58024;有一说一还挺好看，不过感觉每个差异都不太大，特别是那个血族还有泳装，审美疲劳了;10;0;10;18388;0.0005438329345225147
58039;唉，虽然绘画还不至于说被完全取代，但至少这种绘画方式是确确实实的慢慢在被替代下一个会是什么行业呢，突然就被ai爆杀;1;0;1;18388;5.438329345225147e-05
58041;细节再抠一抠，质量商用绰绰有余;1;0;1;18388;5.438329345225147e-05
58053;谢谢AI，素材参考真的太棒惹保卫萝卜哭哭;7;0;7;18388;0.0003806830541657603
58065;我觉得还行啊，之前对于初学者能拿到的临摹素材库大大增加了。ai喂出来的总感觉有些违和，商用应该还差点;7;0;7;18388;0.0003806830541657603
58078;什么显卡，上409会不会极快;4;0;4;18388;0.00021753317380900588
58086;原画师快10年了，今年开始陆续有项目引入AI绘制，资深的还好，问题是新鲜血液根本入不了行，AI辅助导致公司只需要资深画师修改调整就好，并不需要大量底层人才，现在新人原画基本是10个有9个没工作的状态，长远来看这对中国美术行业是毁灭性的打击，OKAI不影响我工作，甚至能让我工作更顺畅，但是作为从业者我觉得要么快点出相关法律，要么只能抵制AI绘画;45;617;662;18388;0.03600174026539047
58132;遥想当年，第一次在闲鱼上知道了有人会花钱买设子养设子，还有拼团养的，有的设子养下来据说要好几万，之前还有未成年人花十几万买设子后要求退款的新闻。我看不懂但我大为震撼。现在看来，绘圈的钱不好赚喽吃瓜;90;355;445;18388;0.024200565586251905
58223;冷知识，美国那边已经法律说ai绘图没有版权的，所以人都可以用，反正取之于民，用之于民脱单doge;41;127;168;18388;0.009136393299978247
58265;不拿出来卖还好说，自己几个玩玩还行，要拿出来卖算间接用别人的图盈利了吧，那样可能过两年就会算犯法了吧可能就颁布法律限制ai了，毕竟用来练习的图也是别人用时间画的，ai也其实就是识别图片色块拼接加滤镜，不是自己真正意义上的创新而是拼接出来的。;51;137;188;18388;0.010224059169023277
58317;这三视图只是看着像三视图，很多都对不上号，还是得有经验的重新整理拆分，这种三视图对能设计的3d没啥用，对美术功底差的3d来说能带沟里去笑哭;30;79;109;18388;0.00592777898629541
58349;不得不反思，ai究竟养活了多少不会画画还硬吃这碗饭的人;9;94;103;18388;0.005601479225581902
58359;不急，等个几年人才断层了，像中国动画一样，都依靠AI再也画不出自己的东西的时候，就有得乐了2233娘大笑2233娘大笑2233娘大笑;13;66;79;18388;0.004296280182727866
58374;笑死你们以为打击了绘圈，其实绘圈才是最抵制ai那个，ai绘画压根没打击到绘圈，打击到的只有老老实实在阿资手底下做苦力的商业画从业者不稳定发电机切割;2;26;28;18388;0.0015227322166630412
58377;之前给网易做设定，要求的三视图可比这个严，你要是没能力，用AI生，到时候那边主美叫你改，你都不知道怎么下笔，网易那边模型精度还是可观的，所以这边会要求毕竟细和准;1;13;14;18388;0.0007613661083315206
58381;想想现在在美院读书的大学生有点难受，好不容易上个美院他们绝大部分是当不了纯艺术家的（油画，国画等）他们自己也知道其实更多的工作都是和漫画动画，游戏，平面设计，传统插画，墙绘，室内设计，工业设计相关，除非完完全全转行当美编辑其实这工作文科生也能做。这种和时代接轨的工作大部分都是无纸化办公，AI能画三视图，过段时间什么都能画了。只是库不一样而已。那学美术的意义是什么？投入的时间太久了。还是说未来是高中最后一年传统练习，大学1年AI练习？剩下3年直接工作去？;1;2;3;18388;0.0001631498803567544
58384;确实合不合法，道德不道德都是虚的，ai已经势不可挡不可逆转未来也许人人都会用，但专业的人总该干专业的事;9;23;32;18388;0.001740265390472047
58398;Ai画图看起来感觉怪怪的，没有画师画出来的有感觉，最近收藏的ai画图都删了，不耐看酷仔;1;1;2;18388;0.00010876658690450294
58400;ai要是把画师都干下去了，没人给ai喂饭，只能一直吃老图，审美停止观众不买账，还歹找画师来喂图，但画师都退了，谁都别想好妙啊;12;22;34;18388;0.00184903197737655
58416;这玩意儿你也没法弄版权，生成出来了大家都能免费拿来用，说这个图是我的你也没辙tv坏笑;1;7;8;18388;0.00043506634761801175
58421;有些人还以为自己画不出来用ai就能赚别人的钱，呵呵真的做梦呢;3;18;21;18388;0.0011420491624972808
58425;跟盗版游戏一样，以后所有资源都要先收取高额费用比如会员制，免费看图不可能了，都不知道你们有什么好开心的;8;16;24;18388;0.0013051990428540352
58435;画师永远不会失业但是不会用ai的新手画师可能要失业。;2;10;12;18388;0.0006525995214270176
58439;这种ai的图可以拿来当非商用的oc养么;4;9;13;18388;0.0007069828148792691
58444;比原创更原创，你不说谁知道是ai;20;7;27;18388;0.0014683489232107897
58465;大佬用的三视图的tag是啥啊，我用niji生的好不稳定笑哭;3;5;8;18388;0.00043506634761801175
58469;好会设计衣服啊ai热词系列锤;10;10;20;18388;0.0010876658690450293
58480;挺好的，去年还有人说ai不可能画得明白手全是克苏鲁取代不了人类现在又开始换说法了星星眼期待ai绘画接下来的发展;2;4;6;18388;0.0003262997607135088
58498;我比较好奇up主是怎么出图的，你出的图很像游戏设计，这里是指相对于其他up出的图，更多的像是美宣的日系插画，注重刻画而不是设计，而up出的图虽然细节很模糊，但是整体的出图思路设计比重更多，是用了图生图还是单独练了游戏人设的lora啊;1;0;1;18388;5.438329345225147e-05
58521;ai绘图没有版权。也就是说，只要是AI，你截图拿去怎么用都可以藏狐;3;0;3;18388;0.0001631498803567544
58531;我希望ai绘画，能让绘画从一门工作，变成兴趣。我希望ai能做其他的任何事，但是它好像不能研究自己的画风，你猜猜谁可以做到。;11;0;11;18388;0.0005982162279747662
58544;请问这些服装也算ai生成的吗;1;0;1;18388;5.438329345225147e-05
58548;绘圈的钱不那么好赚了，这个设子可以当设计初稿，但是不能细看，可以让ai画个大概，然后自己画手，花纹和一些细节;1;0;1;18388;5.438329345225147e-05
58550;如果把它当做设子生成器然后让新人拿着自己设置出来满意的设子去找大佬约稿思考;2;2;4;18388;0.00021753317380900588
58560;作为一个想学画画的微笑灵魂出窍灵魂出窍我已经不知道还要不要坚持下去了囧囧;3;0;3;18388;0.0001631498803567544
58564;萌新问一下这是什么AI，还是novelai的插件弄得;2;0;2;18388;0.00010876658690450294
58568;讲真会做人设的大佬一直少，原神团队多少人，路人角色一直被垢病大众脸。;4;0;4;18388;0.00021753317380900588
58574;请问一下，我定制了正视图，那这个lord能根据这一张正视图生成图中角色的三视图吗？;2;0;2;18388;0.00010876658690450294
58579;我觉得更可能出现的现象是，花钱买初设，这样就有了这个人物的版权了，然后后续用ai自己设计各种服装。;1;0;1;18388;5.438329345225147e-05
58588;有人还在认为ai会超越一些画师吗;8;0;8;18388;0.00043506634761801175
58606;有几张挺喜欢的，想入了当设子;1;0;1;18388;5.438329345225147e-05
58614;这个ai吃显卡吗;4;0;4;18388;0.00021753317380900588
58623;仲夏夜silverdreamdoge;6;88;94;18388;0.0051120295845116384
58630;收藏比点赞多，你们都很诚实啊，喜欢这种是吧，行以后多整点这种;10;70;80;18388;0.004350663476180117
58641;你是哪来的勇气让AI画手tvdoge;1;32;33;18388;0.0017946486839242985
58643;能画那种大家都想看的吗？doge;3;8;11;18388;0.0005982162279747662
58647;BV1q8411L7s6这期怎么没人看啊，笑哭其实我感觉这期是我出的最好看的一套图了。果然大家都喜欢涩涩;7;7;14;18388;0.0007613661083315206
58655;经典不会画手doge;1;6;7;18388;0.0003806830541657603
58657;好像anmi喜欢;1;4;5;18388;0.00027191646726125733
58661;欲罢不能;1;3;4;18388;0.00021753317380900588
58665;热词系列三连;1;2;3;18388;0.0001631498803567544
58677;章鱼手;2;1;3;18388;0.0001631498803567544
58680;手太怪了;3;1;4;18388;0.00021753317380900588
58685;upup，请问有没有打画师tag？;3;1;4;18388;0.00021753317380900588
58694;涩了;1;1;2;18388;0.00010876658690450294
58697;蹲图包脱单doge;1;1;2;18388;0.00010876658690450294
58699;求tag星星眼;1;1;2;18388;0.00010876658690450294
58701;up求问，这个侧躺的tag是什么啊？我用onside人物是侧站着，而不是侧躺;1;0;1;18388;5.438329345225147e-05
58705;Up的bgm是哪个版本的？;1;0;1;18388;5.438329345225147e-05
58709;你这梦好大好白，做梦都要有压力了吗？tv微笑;2;0;2;18388;0.00010876658690450294
58713;就喜欢很大很白的;1;0;1;18388;5.438329345225147e-05
58716;无解不发专栏图;1;0;1;18388;5.438329345225147e-05
58729;可以画得再涩一点思考;1;0;1;18388;5.438329345225147e-05
58733;AI画手是真的有一手笑哭;1;0;1;18388;5.438329345225147e-05
58737;bgm是哪一版本的doge;1;0;1;18388;5.438329345225147e-05
58741;你这后台真硬啊，这居然没事吃瓜;2;0;2;18388;0.00010876658690450294
58747;这么大的吗害羞;1;0;1;18388;5.438329345225147e-05
58752;Ai真的能画出这个水平吗？打call;1;0;1;18388;5.438329345225147e-05
58756;怪不得要淘汰画师了笑哭;2;0;2;18388;0.00010876658690450294
58762;枝上凉初喜欢tv色;2;0;2;18388;0.00010876658690450294
58767;我是不是在什么软件上见过你doge;6;0;6;18388;0.0003262997607135088
58774;这是用那个ai作画软件画出来的啊，可以告诉我吗大佬水瓶座哭哭;3;0;3;18388;0.0001631498803567544
58778;可以分享一下头像吗谢谢;1;0;1;18388;5.438329345225147e-05
58784;希望up出一些手机壁纸尺寸的星星眼;1;0;1;18388;5.438329345225147e-05
58788;可以私发给我吗？我不太喜欢用百度网盘，太麻烦了。三连三连。对了，你可以发动态转栏的，这样你也方便我们也方便;2;0;2;18388;0.00010876658690450294
58794;点赞后等图包脱单doge;1;0;1;18388;5.438329345225147e-05
58796;脸一模一样啊另外感觉三国杀可以不用请画师了，直接用软件画就行;4;15;19;18388;0.0010332825755927778
58801;这衣服一看就不透气doge捂的太严实了;1;10;11;18388;0.0005982162279747662
58803;眼睛千篇一律，发饰和衣服挺多样;3;9;12;18388;0.0006525995214270176
58807;我还以为全会变成日风笑哭;1;4;5;18388;0.00027191646726125733
58810;先收集up主的美图，然后自己用脸部局部修图加lora进行调整，就能变为自己最喜欢的人物;1;3;4;18388;0.00021753317380900588
58812;衣服模型可以，脸缺少立体感;1;3;4;18388;0.00021753317380900588
58814;这才是。古风。古代大家归秀的风彩。赞赞赞。;1;3;4;18388;0.00021753317380900588
58816;衣服太多;4;2;6;18388;0.0003262997607135088
58822;每一个小娘子都是国色天香啊;1;2;3;18388;0.0001631498803567544
58824;手还是比较恐怖，如果后期手动改一下就好了;1;2;3;18388;0.0001631498803567544
58826;不够凶啊dogedogedoge;1;2;3;18388;0.0001631498803567544
58828;召唤神龙见首不见尾;2;2;4;18388;0.00021753317380900588
58832;没有衣服的？能私发给我？;1;1;2;18388;0.00010876658690450294
58834;既不富裕，也不慷慨3;1;1;2;18388;0.00010876658690450294
58836;还是有蛮多地方不太好，感觉违和，比如有些明明看着上身很直，但是居然是趴姿，怎么看怎么怪异;1;1;2;18388;0.00010876658690450294
58838;AI不会画手系列。辣眼睛辣眼睛;2;1;3;18388;0.0001631498803567544
58841;来人，把笔记呈上来doge;1;1;2;18388;0.00010876658690450294
58845;好家伙，经过这阵子的白嫖，手机里面这下真的佳丽后宫三千了。天天做壁纸，都左挑右选用哪个老婆好了。;2;1;3;18388;0.0001631498803567544
58848;好看，但是都长得一样，审美疲劳笑哭;2;1;3;18388;0.0001631498803567544
58851;还有几天时间能破万吗？;2;1;3;18388;0.0001631498803567544
58854;美腿呢？;1;1;2;18388;0.00010876658690450294
58856;天气热了，海南天气太热了;1;1;2;18388;0.00010876658690450294
58858;我喜欢0057的那个doge你小子指定有点副业doge;1;1;2;18388;0.00010876658690450294
58860;满满的干活呲牙;1;1;2;18388;0.00010876658690450294
58862;感谢大佬;1;1;2;18388;0.00010876658690450294
58864;三连了;1;1;2;18388;0.00010876658690450294
58866;好看星星眼;1;1;2;18388;0.00010876658690450294
58868;非常精致了;1;1;2;18388;0.00010876658690450294
58870;ai进步真快，手倒是越画越好了。;1;1;2;18388;0.00010876658690450294
58872;骗币高手星星眼喜欢;1;1;2;18388;0.00010876658690450294
58875;tag是什么;4;1;5;18388;0.00027191646726125733
58880;加油;1;1;2;18388;0.00010876658690450294
58882;感觉运镜呲牙;1;1;2;18388;0.00010876658690450294
58884;能处;4;1;5;18388;0.00027191646726125733
58889;求包谢谢星星眼星星眼星星眼;1;1;2;18388;0.00010876658690450294
58891;UP主加油;1;1;2;18388;0.00010876658690450294
58893;继续加油;1;1;2;18388;0.00010876658690450294
58895;UP主加油;1;1;2;18388;0.00010876658690450294
58897;币给你了，记得上图doge;1;1;2;18388;0.00010876658690450294
58899;已三连，蹲图包;1;1;2;18388;0.00010876658690450294
58901;图包云盘打call打call打call链接：httpscaiyun139commi0l5CM4Am77r8E提取码：kGST复制本段信息并打开中国移动云盘APP，免输提取码哦;38;51;89;18388;0.0048401131172503805
58940;你们要的竖屏壁纸来了打call;7;35;42;18388;0.0022840983249945617
58948;人工智能把我的审美提高了，这个人物设计已经比很多国漫的美女都漂亮，我居然有一种，怦然心动的感觉，斗破苍穹，制作组看一看AI设计的美女是什么样的？你设计的萧薰儿是什么样的？;7;52;59;18388;0.0032086143136828365
58956;我要百度云盘图包呲牙;3;16;19;18388;0.0010332825755927778
58961;会画手的AI;2;11;13;18388;0.0007069828148792691
58964;移动云盘没用过百度就有可惜了;1;1;2;18388;0.00010876658690450294
58967;脸幼了点，有没有成熟一点点的，这首翻唱曲子挺熟的，以前经常听，就是想不起名字了;1;1;2;18388;0.00010876658690450294
58978;下次狗卡出新皮肤武将不用请画师了，成本10086蒸蒸日上;2;3;5;18388;0.00027191646726125733
58983;授人以鱼不如授人以渔，所以up懂我意思吧doge;2;5;7;18388;0.0003806830541657603
58987;图包热词系列新年快乐热词系列新年快乐热词系列新年快乐链接：httpscaiyun139commi0l5CLjzZJLRdz提取码：vggU复制本段信息并打开中国移动云盘APP，免输提取码哦;1;1;2;18388;0.00010876658690450294
58992;点赞投币了打call;1;1;2;18388;0.00010876658690450294
58995;Up用的什么词条啊;1;2;3;18388;0.0001631498803567544
58997;BGM：《忍别离》;2;2;4;18388;0.00021753317380900588
59000;我要百度云网盘，不然不给关注三连doge;1;7;8;18388;0.00043506634761801175
59003;好看喜欢;1;1;2;18388;0.00010876658690450294
59012;估计那些游戏御用画师要失业了吧，比如;11;0;11;18388;0.0005982162279747662
59028;有度盘三连，没度盘点赞，，;1;0;1;18388;5.438329345225147e-05
59071;打不开，提示申请，正在处理，请稍后查看;2;0;2;18388;0.00010876658690450294
59083;为了拿图，专门下个移动云盘的我妙啊;1;0;1;18388;5.438329345225147e-05
59091;为什么都是一个脸型？眼睛大成这样很不合理;1;1;2;18388;0.00010876658690450294
59105;不是说ai画手不行嘛;1;0;1;18388;5.438329345225147e-05
59116;说为什么要给她穿衣服歪嘴歪嘴;1;0;1;18388;5.438329345225147e-05
59128;会画手的AI不是好AI偷笑偷笑偷笑;1;1;2;18388;0.00010876658690450294
59161;怎么下载啊，移动云盘不会复制;1;0;1;18388;5.438329345225147e-05
59163;亲，有百度云网盘的嘛，三连加关注;2;0;2;18388;0.00010876658690450294
59169;用什么模型做的？;1;0;1;18388;5.438329345225147e-05
59173;早上好，大佬出品，必是精品;1;0;1;18388;5.438329345225147e-05
59175;我发布了一篇笔记，快来看看吧;4;422;426;18388;0.023167283010659127
59180;这虎竟然有股凌然正气在脱单doge;34;3165;3199;18388;0.17397215575375244
59215;我只能说龙怎么画都是帅的;34;889;923;18388;0.050195779856428105
59250;我发现马，羊，兔这种很吓人，像平时就很吓人的虎，蛇反而看起来普普通通;10;662;672;18388;0.03654557319991299
59261;白虎有种权倾朝野的佞臣九千岁的感觉哈哈哈哈哈;6;530;536;18388;0.02914944529040679
59268;本来就是有点害怕，不知道哪个仁兄发了一句“吓不吓人？你坤哥”直接给我笑傻了，hahahahahahahahahahahahahahahahaha;11;588;599;18388;0.03257559277789863
59280;感觉不够中式，还是有种克苏鲁的感觉在里面，不过AI画的已经很好了;6;159;165;18388;0.008973243419621493
59287;我属马，但是我就没看到过马帅的，这种风格我感觉马怎么画都丑大哭大哭大哭;9;96;105;18388;0.005710245812486404
59297;怎么到狗子那里画风突然变萌了啊？大家都挺社会滴怎么就你拉了胯捏？doge吃瓜;1;58;59;18388;0.0032086143136828365
59300;都成了仙，但成的是道诡异仙;2;34;36;18388;0.001957798564281053
59303;ai？此ai是Adobe的ai还是智能ai的ai？智能ai绘画成这样也是挺“危”的，要是Adobe的ai画成这样作者牛逼大发了。这不带Photoshop修饰ai画成这样也是牛逼了;11;13;24;18388;0.0013051990428540352
59315;半夜怎么推这个囧现在莫名感觉家里很热闹;1;15;16;18388;0.0008701326952360235
59318;连花清瘟胶囊23虎子好帅;1;2;3;18388;0.0001631498803567544
59320;这不是黑暗，这是克苏鲁风格;9;18;27;18388;0.0014683489232107897
59332;一开始还是有点吓人的，结果突然想到造梦里的红眼小怪，在想打他会不会流泪doge;1;1;2;18388;0.00010876658690450294
59337;我是功德。;1;1;2;18388;0.00010876658690450294
59357;大大你居然b站也有号的太棒了太棒了太棒了打call超级爱你打call;4;2;6;18388;0.0003262997607135088
59362;可爱，想法式舌吻;1;2;3;18388;0.0001631498803567544
59378;我觉得可以不用标题起ai绘画，不用带这个字也有热度，因为这个画本身就很到位了，我也是做这行的，看得出来这绝对手绘了的doge可以说原封不动的ai成分很少，甚至可能没有;2;7;9;18388;0.0004894496410702633
59381;羊像成龙历险记里操控引力的那个;1;2;3;18388;0.0001631498803567544
59384;建议标上国旗水印小心高丽棒子;1;9;10;18388;0.0005438329345225147
59386;特别喜欢这一系列的，up啥时候能在动态里发一下图片呀？我是属马的，想做一个马的头像。星星眼星星眼星星眼星星眼星星眼;2;1;3;18388;0.0001631498803567544
59391;可不可以搞一个黑暗阴险又性感勾魂的蛇啊？不喜欢老太婆;1;10;11;18388;0.0005982162279747662
59430;什么软件啊？为什么我用的AI绘画软件就配的乱七八糟的辣眼睛辣眼睛;2;0;2;18388;0.00010876658690450294
59435;黎某Rese好帅啊，可以拿到游戏里当BOSS了;1;0;1;18388;5.438329345225147e-05
59472;我看完我都不想属兔了，你知道吗？;1;0;1;18388;5.438329345225147e-05
59499;精神支柱六花酱卡哇伊艾拉喜欢;1;0;1;18388;5.438329345225147e-05
59515;软件推荐下;1;0;1;18388;5.438329345225147e-05
59520;用的啥工具;1;0;1;18388;5.438329345225147e-05
59527;哏哏查你学厉;1;0;1;18388;5.438329345225147e-05
59558;土方十四蛋黄酱酱酱帅;1;0;1;18388;5.438329345225147e-05
59566;这真的是AI画的吗？需要人操作什么？;1;0;1;18388;5.438329345225147e-05
59586;我只想知道，AI绘画能统一风格吗？UP主是怎么做到每次生成都一种风格？;2;0;2;18388;0.00010876658690450294
59613;我去，好棒啊，难得看到这么有感觉的三连了;1;0;1;18388;5.438329345225147e-05
59623;虽然我觉得你可能不敢看完脱单doge;1;0;1;18388;5.438329345225147e-05
59658;有高清图吗？我看你动态里面的图和视频里的，清晰度完全不一样啊？笑哭三连了;1;0;1;18388;5.438329345225147e-05
59719;这次不会再失约好帅;1;0;1;18388;5.438329345225147e-05
59742;人间太吵了;2;0;2;18388;0.00010876658690450294
59748;我想好想变瘦赵老师从不破防;1;0;1;18388;5.438329345225147e-05
59759;七味香芋奶茶;1;0;1;18388;5.438329345225147e-05
59763;耶路撒冷的二舅子真的就看亿集;2;0;2;18388;0.00010876658690450294
59787;我觉得这是对中国文化的摸黑;1;0;1;18388;5.438329345225147e-05
59790;太捏吗的帅了，要是有相关的漫画就好了;1;0;1;18388;5.438329345225147e-05
59799;马国王是混沌还是馄饨清风丶Night6igol癞壳宝x0無言越面善的越吓人;3;0;3;18388;0.0001631498803567544
59861;配音要吐了换个唢呐;1;0;1;18388;5.438329345225147e-05
59890;阿婆，这个音乐是什么？;1;0;1;18388;5.438329345225147e-05
59896;这些动物都一个人样，我是说都像人，;2;0;2;18388;0.00010876658690450294
59909;想想猴哥在原著长什么样撇嘴;7;0;7;18388;0.0003806830541657603
59921;upup这是用的什么软件;2;0;2;18388;0.00010876658690450294
59934;卧槽，求原图做壁纸;1;0;1;18388;5.438329345225147e-05
59942;每一张都挺相似的，色调，人物这些，请问你喂的是那个画师的？;2;0;2;18388;0.00010876658690450294
59950;这白毛虎怎么有点像那个小时候看笑傲江湖里面用嘴吐杏仁的那个老头啊越看越像大笑大笑大笑大笑大笑大笑;2;0;2;18388;0.00010876658690450294
59962;努力和解;1;0;1;18388;5.438329345225147e-05
59978;多画几个坤哥的;1;0;1;18388;5.438329345225147e-05
59983;猪像岳云鹏dogedoge;1;0;1;18388;5.438329345225147e-05
59992;为什么都是老家伙没有年轻的;1;0;1;18388;5.438329345225147e-05
59995;光效越来越强了doge;8;4557;4565;18388;0.24825973460952797
60004;从女性变成了男性，两个人越靠越近doge;5;3307;3312;18388;0.18011746791385685
60010;变得越来越像之前漫画杂志的那种画风了，古老的回忆突然攻击我初音未来大笑Up可以发一发图吗？;15;915;930;18388;0.05057646291059387
60026;你这甲方有点难缠啊doge;1;827;828;18388;0.045029366978464214
60028;ai：这货咋还不满足，女的不要，给他换男的试试，还不行，那靠近点试试，;2;567;569;18388;0.030944093974331087
60031;最后变成了男的，果然ai的真谛是南通;4;542;546;18388;0.0296932782249293
60036;别的我没注意，我只知道这下巴越来越有杀伤力藏狐脱单doge;2;280;282;18388;0.015336088753534914
60039;AI的特点是，增加细节，色彩更鲜艳丰富，推翻前一张图片的不合理（AI表示还没学会的方面）处并改动。doge;1;165;166;18388;0.009027626713073745
60043;梅比乌斯：我整整改进了十五版，最后却跟我说还是第一版好？;1;45;46;18388;0.0025016314988035677
60045;ai绘画，不就是把别人辛辛苦苦画的喂给ai，ai再把这些画拼接吗星星眼星星眼星星眼，这种明目张胆偷的行为，这么多人明目张胆的弄，真好啊打call打call打call;16;26;42;18388;0.0022840983249945617
60067;最后成了卢姥爷和凯亚dogedogedoge;1;4;5;18388;0.00027191646726125733
60070;有点ky但是好像玑灵奥;3;3;6;18388;0.0003262997607135088
60079;求图保卫萝卜哭哭;1;1;2;18388;0.00010876658690450294
60082;请发图片到动态可以吗，好好看;2;1;3;18388;0.0001631498803567544
60088;卧槽我去试了下真特么绝了;1;1;2;18388;0.00010876658690450294
60127;现在是AI的绘画进步史？;1;0;1;18388;5.438329345225147e-05
60143;还是很好看呜呜，我要加油学画画;1;0;1;18388;5.438329345225147e-05
60148;upai原图发一下脱单doge;1;0;1;18388;5.438329345225147e-05
60156;这个脚本插件下载放哪个文件夹，原本的网址安装已经不可用了，把网页下载的脚本放在extensions也无法激活。;1;0;1;18388;5.438329345225147e-05
60158;请问这种情况怎么办啊;4;2;6;18388;0.0003262997607135088
60163;用的秋叶版，为什么少这么多选项;9;14;23;18388;0.0012508157494017839
60174;请教大佬，我放大后图片上明显能看出来一块一块的痕迹，也就是小块的接缝，这个要怎么处理？;1;0;1;18388;5.438329345225147e-05
60176;ESRGAN放大模型，放进对应文件夹重启httpspanbaiducoms1WrKVWE0kRzK6zbW2TdUyQwpwd6558提取码6558;5;11;16;18388;0.0008701326952360235
60182;为什么我1660ti这样设置后6小时起步啊？笑哭;6;5;11;18388;0.0005982162279747662
60189;大部分图片重做之后灰度变高，颜色不够鲜艳;2;4;6;18388;0.0003262997607135088
60192;大佬，这是什么情况呀;1;2;3;18388;0.0001631498803567544
60194;好像是RealESRGANx4plusanime6Bpth插件一直下载不下来;3;5;8;18388;0.00043506634761801175
60198;如果是已经第一次跑的时候开了高分辨率重绘，那我现在导入的时候，采样下面自动填的还是跑高分辨率重绘之前的分辨率。那么我其实上下两个长宽应该填实际的照片长宽还是跑高分辨率重绘之前的？;1;3;4;18388;0.00021753317380900588
60201;请教一下up我算法里没有RESRGAN4Xanime6B这个算法呀怎么安装？谢谢;5;4;9;18388;0.0004894496410702633
60207;1650，点开始之后就没反应了，控制台都没有出图的进度条，cpu和显卡也没有占用。求指点;3;3;6;18388;0.0003262997607135088
60211;效果太好了，只恨为什么不让我早两个小时看到这个视频，需要这样优化的图片我有一批，如果能早点看到就能优化了之后再拿去炼丹的，感觉效果会好不少。刚送进炼丹炉就看到这个视频了，焯酸了;1;0;1;18388;5.438329345225147e-05
60213;up，请问一下我的webui没有additionalnetwork怎么办啊，扩展里也搜不到，是新版去掉这个选项了吗？;1;0;1;18388;5.438329345225147e-05
60215;为什么会一次出两张图哦呼;3;0;3;18388;0.0001631498803567544
60219;大大为啥我安装了UltimateSDupscale后脚本里不显示阿;1;0;1;18388;5.438329345225147e-05
60221;这个插件容易在莫名其妙的地方生成个人脸;1;2;3;18388;0.0001631498803567544
60224;请问我按照以后，为什么在放大算法那一栏没有RESRGAN4XAnime6B这个选项的;1;0;1;18388;5.438329345225147e-05
60227;大佬可以做一期总爆显存的解决方法操作教学吗，理解你说的方法，但是不知道怎么操作;2;0;2;18388;0.00010876658690450294
60230;按照up的方法，卡在68不动了怎么办？大哭大哭大哭平时跑图还是很流畅的;1;0;1;18388;5.438329345225147e-05
60232;30708g显存，请问为什么会报这个错？在webuiuser里增加了nohalfvae还是这样;3;0;3;18388;0.0001631498803567544
60236;up主，我在用这个放大的时候，总会在画面中出现粉红色的斑点，一半会出现在皮肤上，或者高亮的边缘。这个怎么去掉吧;2;0;2;18388;0.00010876658690450294
60239;大佬为什么我的还是出现了黑块呀？都是按大佬的设置呀？;4;0;4;18388;0.00021753317380900588
60245;好家伙怎么说我显存不够;7;1;8;18388;0.00043506634761801175
60253;您好，我用这个放大16：9的图的时候满图都是脸是哪里设置不对么;2;0;2;18388;0.00010876658690450294
60256;RuntimeErrorGivengroups1weightofsize64333expectedinput14192192tohave3channelsbutgot4channelsinstead今天最新遇到的报错，貌似是关于3x3或者2x2的，也不知道怎么解决;2;0;2;18388;0.00010876658690450294
60260;大佬请问一下我最后的扩展点哪个都是无限loading请问是什么原因呢，挂t也没用，插件读取不出来，还能装你这个嘛;4;0;4;18388;0.00021753317380900588
60265;请问是哪个论坛呢？;1;0;1;18388;5.438329345225147e-05
60267;请问最底下的Seamsfix要勾选吗字面意思是接缝修复不勾会修复;1;0;1;18388;5.438329345225147e-05
60269;设置完之后，每次都会生成两张图;1;0;1;18388;5.438329345225147e-05
60279;照着步骤做不知道为啥出来的图和原图完全不一样了，不知道什么情况;2;0;2;18388;0.00010876658690450294
60282;脚本上哪下啊，QIUqiu;4;0;4;18388;0.00021753317380900588
60287;秋叶版的可以用吗;3;0;3;18388;0.0001631498803567544
60291;ValueErrorheightandwidthmustbe0这个是什么报错，高宽大于零，我有按要求设置呀。左下角seamsfix没法开第二个和第三个，一开就是有这个报错出不了图;2;0;2;18388;0.00010876658690450294
60294;每次弄完都会有黑色的区域怎么办啊？就是有时候跑图爆显存会出现的黑色的那种感觉;11;0;11;18388;0.0005982162279747662
60310;这个插件点击下载然后就没有反应了。请问有其他安装方法吗脸红;2;0;2;18388;0.00010876658690450294
60313;还是出现鬼影水什么情况啊UP;1;0;1;18388;5.438329345225147e-05
60317;算法我还是推荐用ESRGANx4，感觉RESRGAN4xAnime6B和SwinIR4x都会丢不少细节。;1;0;1;18388;5.438329345225147e-05
60320;您好，求问，为什么我算的时候会分成十几个块来算，这样会出现许多鬼影，身体是全是肚脐鬼脸笑哭。怎样才可以变成像您演示的一样分成4块呢？;2;0;2;18388;0.00010876658690450294
60330;大佬，我下不了UltimateSDUpscale，请问怎么手动安装啊，求求了;1;0;1;18388;5.438329345225147e-05
60335;重绘之后感觉画面相比原图有明显涂抹感，这个怎么改善呢？;2;0;2;18388;0.00010876658690450294
60339;能批量吗;1;0;1;18388;5.438329345225147e-05
60343;给我生成了两个肚脐;2;0;2;18388;0.00010876658690450294
60351;这个对于角色lora的支持好吗;1;0;1;18388;5.438329345225147e-05
60359;为啥我按步骤来跑不出来呢？没有报错但没有动（看控制台进度一直停在1）笑哭;1;0;1;18388;5.438329345225147e-05
60362;参数是不是有什么问题;2;0;2;18388;0.00010876658690450294
60367;学会了，而且非常好用，我这边只有4g显存，如果使用Hiresfix，只要分辨率超过10241024，基本就会提示cuda内存不够之类的，这个方法很好用。;3;0;3;18388;0.0001631498803567544
60372;有没有试过真人照片;2;0;2;18388;0.00010876658690450294
60377;大佬大佬，俺听说，画抱枕需要5000x16000或者4000x12000这样大，俺应该租多大的显存哇;9;0;9;18388;0.0004894496410702633
60387;up请教一下，放大到一定程度之后。就会百分之60左右失败，控制台显示modulesdevicesNansExceptionAtensorwithallNaNswasproducedinVAEThiscouldbebecausetheresnotenoughprecisiontorepresentthepictureTryaddingnohalfvaecommandlineargumenttofixthisUsedisablenancheckcommandlineargumenttodisablethischeck这种事什么情况哇，是我爆显存了吗;8;0;8;18388;0.00043506634761801175
60396;重绘完之后锐化了很对结构也变不好看了呜呜怎么解决呢;1;3;4;18388;0.00021753317380900588
60398;看吧，鼻子阴影和光亮交界处就会出现这个红点;9;0;9;18388;0.0004894496410702633
60408;香菱属性都变了笑哭;4;415;419;18388;0.022786599956493365
60413;没有全部变成塞尔达我不是很认可doge;6;241;247;18388;0.013432673482706112
60421;不太行，原本很阳光的角色都变得有点阴暗了，给人一种经历过一场大战，身边最爱最好的朋友都在自己眼中一个个死去之后的表情，可莉还好，不过可能是因为太小，不懂，成熟的人更加的悲伤，不成熟（火神）的人经历这件事之后变得更加成熟了;8;122;130;18388;0.007069828148792691
60430;那个迪卢克真的忍不住了，本来不相信ai能画出感情来的，那个迪卢克画的真的好有感觉，和他父亲在世时一摸一样，懵懂，对这个世界抱有希望，虽然是巧合，但也让我感觉到了非同寻常的震惊。我从来没见过有谁能把迪卢克早期人设画的这么好的;2;87;89;18388;0.0048401131172503805
60434;丹特丽安的书架洛天依;2;36;38;18388;0.0020665651511855556
60449;我不太喜欢这AI绘图之类的，不是说丑，就是那些线条啊，那些脸太大众化了。什么标准二次元脸，;1;1;2;18388;0.00010876658690450294
60459;bgm好好听，求星星眼星星眼;2;1;3;18388;0.0001631498803567544
60468;颗粒不是变成十块？;1;0;1;18388;5.438329345225147e-05
60494;托马感觉有点像战双里那个拿双枪的那个;1;0;1;18388;5.438329345225147e-05
60502;柒柒仔吖doge好康;2;0;2;18388;0.00010876658690450294
60512;美区appstore视频咋没了？;8;162;170;18388;0.009245159886882749
60521;现在的AI还满足不了害羞;11;129;140;18388;0.007613661083315205
60533;大家好，我是一个ai画家，我的画作有很多，基本十几秒到几十秒之间就能完成一副。希望大家多多支持，想要约稿的可以私信了解滑稽滑稽妙啊妙啊;1;56;57;18388;0.003099847726778334
60537;doge还以为是StableDiffusionDiscoDiffusionDalle;1;13;14;18388;0.0007613661083315206
60540;不知道是不是因为下错了还是什么，不是免费软件吗？我下的Wonder为什么一进去就找我要钱？加载慢的要死笑哭笑哭笑哭;2;8;10;18388;0.0005438329345225147
60543;这个也免费httpsdraftartexploredoge;1;2;3;18388;0.0001631498803567544
60565;根本进不去啊，一直转圈圈;1;6;7;18388;0.0003806830541657603
60568;励志走过所有ai绘画视频祝大家学会使用ai绘画之后都能将自己心中的想法通过画面表达出来打call，但记住不要拿着ai绘画去嘲讽或否定那些真正付出过时间、金钱、精力和热爱，努力追逐梦想的画师们欧OK（如对本视频有不好的影响将立刻删除）;7;15;22;18388;0.0011964324559495323
60579;三款软件分别是：dream、wonder、starryai;2;9;11;18388;0.0005982162279747662
60596;有那么一群人，他们默默的翻着评论区却不写下评语，把自己的故事藏在心里，一个人承受着喜怒哀乐。你好路过的陌生人，我顶你个肺dogedoge;4;24;28;18388;0.0015227322166630412
60601;素的也是可以的，但是不能一直素吃瓜;4;30;34;18388;0.00184903197737655
60606;这期质量好啊，感觉和104期差不多。目前觉得最好还是104的，什么时候再做一期104的，风动心动;1;15;16;18388;0.0008701326952360235
60608;我要扔子;1;9;10;18388;0.0005438329345225147
60610;难道这就是别人常说的肤白貌美么吃瓜;1;5;6;18388;0.0003262997607135088
60612;阿婆主下次也发点帅哥星星眼;1;6;7;18388;0.0003806830541657603
60615;还是大威天龙复合我的胃口打call;1;3;4;18388;0.00021753317380900588
60617;这期颜值很高哦;1;1;2;18388;0.00010876658690450294
60620;这样的多来点吧吃瓜吃瓜吃瓜;2;1;3;18388;0.0001631498803567544
60623;打call给心心打call;1;1;2;18388;0.00010876658690450294
60625;貌美如花绝世无双;1;1;2;18388;0.00010876658690450294
60628;你小子指定有什么外快doge;1;1;2;18388;0.00010876658690450294
60630;不行，我还可以的，来点大荤旧的;1;4;5;18388;0.00027191646726125733
60632;太棒了，up主用的什么配置，方便透露一下吗;1;1;2;18388;0.00010876658690450294
60637;这是什么衣服，好喜欢;1;0;1;18388;5.438329345225147e-05
60655;怎么免费解压呲牙;1;0;1;18388;5.438329345225147e-05
60664;很美，歌也好听;1;1;2;18388;0.00010876658690450294
60672;阿婆主竖屏版更有震撼力。;1;1;2;18388;0.00010876658690450294
60674;用什么软件做的呀，大神;1;0;1;18388;5.438329345225147e-05
60686;吃瓜;1;0;1;18388;5.438329345225147e-05
60695;星星眼;1;1;2;18388;0.00010876658690450294
60697;吃瓜;1;1;2;18388;0.00010876658690450294
60699;我朋友她们公司把AI流程跑通了，以前一组人画四个周出一张海报，现在5天就能出了，而且是一个人画草稿，半个人炼丹，一个人修AI图。但因为公司拉的业务有限，而现在出图效率又这么高，暂且不能扩大再生产，所以已经裁了一半设计师了大哭;2;35;37;18388;0.002012181857733304
60703;是不是要付费了呀up;3;3;6;18388;0.0003262997607135088
60707;那个机器人是怎么私信的呀;2;2;4;18388;0.00021753317380900588
60711;要钱咩？不用啊;1;1;2;18388;0.00010876658690450294
60714;可以做ui嘛;3;0;3;18388;0.0001631498803567544
60721;up可以图生图吗;2;0;2;18388;0.00010876658690450294
60724;要钱的吗;2;0;2;18388;0.00010876658690450294
60729;小姐姐，点了jointhebeta以后网页无法访问怎么办呀？;1;0;1;18388;5.438329345225147e-05
60733;小姐姐手机邮箱收到注册链接为什么我打不开笑哭;2;0;2;18388;0.00010876658690450294
60739;有利有弊吧我感觉。。ai真的是狠狠的打了技艺不精又收费超高的低劣画师的脸，但又让更多有技术但是没流量曝光度的中底层画师没饭吃。。最近看到这些真的是心情复杂;93;4111;4204;18388;0.22862736567326516
60833;若干年后，一条广告大师精作，古法纯手工绘画，100无ai参与藏狐藏狐;50;1396;1446;18388;0.07863824233195563
60884;ai绘画看似让人人都可以创作，实际上却是在扼杀更多人的创作能力，因为它生成的图片本身就画师们的创作成果。绘画本身的创造性在草稿的阶段占了80，而其他多数时候是机械性的修缮工作。也就是说，如果底层画师大量使用ai绘图，安心当一个ai修图师，就是抛弃了自身的创作能力，将自身异化成了ai的工具。而失去了创造性的绘画，无法达到质变产生新的价值，最终拉着ai绘画一起走向衰亡。;95;1047;1142;18388;0.062105721122471175
60980;为了社会的和谐稳定，建议对啤酒馆加大监管力度脱单doge;6;440;446;18388;0.024254948879704155
60987;我建议每个美术生都去学习如何在啤酒馆演讲嘘声嘘声嘘声;18;827;845;18388;0.04595388296715249
61006;如果你去细究ai的每一张图，你就会发现有些图绘画风格，细节，还有人物脸部特征细节，我在群里看到有一个人输入了红毛跟红瞳的，关键词，出来的是，爱莉丝，《无职转生》。不够味，就是老感觉差点东西，这个的话深有体会，群里发Ai色图，我起不来，但是一发画师画的就脱单doge大致是不懂细节描绘，比如说拉丝什么的。那么就帅气的观众朋友问了，其他图呢？比如说有一个水面上的，图那个水面更像是粘贴上去的，衣服对于水的描述很少，就会感觉很拙劣;37;623;660;18388;0.03589297367848597
61044;终究还是外行人的狂欢;53;531;584;18388;0.03175984337611486
61098;感觉AI可以取代大部分中低端画手思考目前是无法取代更高阶的艺术家，但我觉得当从中低端成长的路都已经被拦腰斩断，那该如何登上顶峰？这世界上没有那么多天才吧很多也是一步一步走上来的。。。那当这一阶段无法取代的艺术家老了或者死亡之后那不就会成为了一个巨大的断层了吧;55;482;537;18388;0.02920382858385904
61154;novelAI我记得被爆出来实锤了的抄袭吧。。。代码是抄的，而且大部分训练画作都没有经过画师许可就被当做AI训练投喂了呆;31;503;534;18388;0.029040678703502285
61186;ai为啥要叫绘画而不是制图呢微笑;10;184;194;18388;0.010550358929736785
61197;说实话，我认为吧，都是按照各自的需求，人工画的虽然收费，可是大部分都还是学生，都是靠自己的一技之长赚钱的虽然画的不一定有ai那么好，可是背后的他们也是付出了很多热情，精力，与ai绘画不同，ai绘画不满意的话可以重新画，用不了多少时间，人工的画就是要重新花时间去画了。不过up推荐的上色工具什么的也是很好的先不说半人工半ai作画，看黑白漫画补色也是很实用的好吧打call打call打call;13;201;214;18388;0.011638024798781814
61211;问题三说一下我的看法，就画画来说取代不了，参考柯洁和a狗，围棋是有一定的规则的判定胜利，但是美不一样，美学的范畴和审美的界定让ai永远无法取代人;44;154;198;18388;0.010767892103545791
61256;元帅你知道这一面包多少钱吗，50万马克这些钱马车都装不下十一周年YYDS;6;118;124;18388;0.006743528388079182
61263;我指定骂，本来可以从有一定程度上绘画技术的画师接单，至少能吃得起饭，独立自足，不用给爱瞎比比的老板打工，更是没啥时间提升自己，现在好了，画的一般的，不如ai快，效果好，谁找你约单，但是去找相关工作，人嫌你没有工作经验，太多行业都是，只招熟手，有3年工作经验，新手根本没地方干活，就说有几个说招聘新手和毕业生的，新手你来3个月内不给工资，等你有能力自己做东西了，再给你发工资，或者给你一个最低标准的工资，新手难入行，缺人才，肯定是缺人才，没有好的方法让新手入行就业，上完大学毕业再让老板叼几年，让他天天指着你说你做的不行，也不说哪里不行，就让你自己体会，;21;208;229;18388;0.012453774200565586
61285;为什么那么多美术生破防疑惑艺术类专业出来大部分都不是画画的啊疑惑室内设计环境设计工业设计建模都是短时间内无法用AI替代的工种。AI无法代替人对环境进行考察和反馈，工业设计也无法通过简单的取材培训样本，而且基础美术压根不是用来培养以后画画的手法的，而是培养美术思维和色彩敏感度的;46;286;332;18388;0.01805525342614749
61333;ai绘画有啥的，人们照样听不出来EMI做的曲子和巴赫的曲子有啥区别，微软小冰不也照样出版了自己的诗集吗？还是说目前有什么工作是ai永远替代不了的呢？;11;52;63;18388;0.0034261474874918425
61345;当人们不再绘画，ai也将停止进步;21;44;65;18388;0.0035349140743963455
61367;Ai绘画取代人类是迟早的事，不要因为不想接受现实去寻找否认的解。Ai哪怕作为一种工具，将来会让中低层画师不需要那么高的水平就可以做出东西。也就意味着，这一行的门槛变低了，即更多的人可以去做这件事，本来电子美术就已经饱和了，不是每个人都是cm阮佳黄光剑。更不要觉得我卧薪尝胆能到达至高无上的水平，每个人都是这么想的，大部分都失败了。说句真实的，你拼死拼活天天画到晚上2点，23年达到某个水平，去所谓的大城市去给别人打工，运气好的能干到快三十，然后拖着一身熬夜，画画的工伤回家养病，结果你除了画图什么也不会，而且你辛辛苦苦拿青春和努力挣来的钱几乎都用在房租和衣食住行上了，根本没有积蓄。现在年轻才俊辈出，加上科学技术的提升，现在的Ai已经拥有雏形了，不要跟我讲Ai只会拼，科学进步是迟早的事。你手工熬夜好几天，甚至几周几个月的图别人可能一晚上就弄完了，明白了吗，这就是信息孤岛。ps画图本身就是资本衍生出的一场闹剧罢了，本身家庭条件不怎么样的大学生，还为了别人渲染出来的美好未来无意义的奋斗着，不惜花8000，10000多的钱去报名一期的课程，总是幻想着有朝一日能通过接单挣回来。不可能。劝你们不要把热爱当工作，不要为了自己的一腔热血赌上一家人的心血，好好学习，提升自我才是硬道理。大城市的光辉只属于当地人，你们只是过客。我说的比较露骨，但更加真实，希望尽快认清现实。;24;66;90;18388;0.004894496410702632
61392;但是大多数人是普通人，ai更多是用于流水线取代我们这些最普通的人。比如小的广告门市完全可以用ai作画，毕竟他的客户也没有那么高的要求;1;23;24;18388;0.0013051990428540352
61394;很讨厌评论区一些人仗着AI高高在上地嘲讽画画的人，AI不是你造的，AI的图是侵权的，AI侵权的图是无数画师辛苦努力的创造，一群圈外人在这高谈阔论，说到底是利益不相关。;2;70;72;18388;0.003915597128562106
61398;是时候加紧产权立法了热;23;12;35;18388;0.0019034152708288013
61422;前几天有一个问卷，从4张画中选出1张ai画的，20题我答对12题，但是排名是7万人中的前9千。感觉现在ai画的画通过筛选真就可以碰一下人画的了。;11;58;69;18388;0.003752447248205351
61434;只要画的抽象ai就代替不了;5;12;17;18388;0.000924515988688275
61440;这个up分享的东西确实离谱吃瓜我三连了你们呢？;7;40;47;18388;0.0025560147922558192
61448;ai无法取代高级人才，但怎么可能所有人都是高级人才，其次别整乌托邦那一套稍微有点脑子都不会像到乌托邦，假如ai替代所有底层人力工作社会是第一个崩溃的，你是不是想说不用货币？现代所有的一切都有货币作为体系底层权的前提也是钱，没有货币纯靠兴趣爱好来推动社会发展？其次环境大改变要么就是赛博朋克要么就是所有人摆烂自行灭亡，ai能在一个领域树立那就还会有更多被ai取代反正以我那可悲的大脑和眼界看不透。;5;34;39;18388;0.002120948444637807
61454;我觉得ai可以让画画从工作变成纯粹的爱好，但我觉得ai掌握在大公司手里是很恐怖的，各位画师不如想想怎么把ai公有化，但感觉除了公平问题还会有很多其他问题，很难避免有一些坏人拿ai干坏事热;3;11;14;18388;0.0007613661083315206
61458;画师大哭人工智能不会吧，真哭啦doge;2;33;35;18388;0.0019034152708288013
61461;ai可以取代一切，这只是时间问题并且不会太过遥远，在这里说这些真不如多加把劲在被彻底取代之前得到足够的生活资源;11;13;24;18388;0.0013051990428540352
61474;关于ai绘图卖钱的讨论真的看烦了，我想提醒的是看东西要看大的方向，这不只是艺术方面的问题了，ai是科研团队搞出来的，被黑客破解被迫开源，劳动果实被窃取，ai学习的画是无数人花费不计其数时间综合创作的，是人创造的价值，如果按照他们的说法ai真的算得上是创作的话，ai画的东西就是结合大众价值再创造的价值，也不是那些卖家自己的劳动果实，而他们居然要用偷取行为所应付出的代价妄图洗白自己的行为，这件事情就不单单是绘画艺术相关的，如果让他们成功了，绘画行业被毁了，ai这一套换到其他行业，终究又是重蹈覆辙，让吸血虫更加壮大。如果你想和别人辩论这事，也得把眼界放宽，别情绪化影响容易让目光变得狭隘，在狭隘的角度看事情哪怕是一点点的小东西也会被放得很大，比如他们所谓的“电费、显卡”等东西，明明放开看就是小偷携带的道具，但是被包装成好像是所谓的付出似的，这时候如果不跳脱这个语境很容易被个例击溃，因为个例在划好的圈子里会显得很大，但是你真的多角度去看这个个例，就会感慨其明明微不足道;8;25;33;18388;0.0017946486839242985
61483;有时候，不是想看画，而是想看某个人画的画，看的是画家的思想，我想吃的不是饺子，而是我老妈包的饺子;4;10;14;18388;0.0007613661083315206
61489;啥也用ai，他妈的，人类快灭绝了算了;1;21;22;18388;0.0011964324559495323
61494;别急ai绘画还有很大的进步空间再过个两三年你们现在说的ai的一些问题到时候看着吧;8;21;29;18388;0.0015771155101152925
61503;讲真你要是用ai画的呆毛王看下去有些真的没啥感觉（武内脸看麻木了，看到大部分呆毛没有武内脸特色就觉得违和笑哭）;3;21;24;18388;0.0013051990428540352
61507;AI画画的归途终究是作为人类的工具，大家千万不要杞人忧天，自乱阵脚，这么多UP主都说了，我们为什么偏还要担心这些，我们难道不能团结起来自发维护圈中的风气吗？我们中国人就这么脆弱吗？我们就这么不堪一击吗？5000年的历史，一百多年的革命，现代教育难道就只教会了我们逃避吗担心被替代就去让自己无法被替代，去战斗，去练习，面对舶来品，我们却如同和一百多年的人，愚味，胆怯，我们新生代为什么就不来拿出底气和血性让长辈和外人高看我们我们绝不会向AI画画妥协，也绝不会允许人文主义的没落。人在状态最好时是最高贵的动物，但如果违背法律和正义，他会变成最恶劣的动物心存奸险命数变狗驴岂能称至尊;28;36;64;18388;0.003480530780944094
61536;凡事都是有利有弊的，看利谁弊谁了，有些画师开始痛骂，有些怎么就没啥影响呢？你说是吧画个bulingbuling大眼睛就敢拿去卖的还不如让ai取代了doge;5;16;21;18388;0.0011420491624972808
61542;建议去欧洲，到那边喝酒，如果看见禁酒令的话马上进去doge;2;16;18;18388;0.0009788992821405265
61546;其实这看似是ai和人类的矛盾，实际上是落后生产关系和社会化大生产的矛盾;3;8;11;18388;0.0005982162279747662
61550;ai绘画都根本没法正常登录怎么可能会对画师产生冲击疑惑疑惑疑惑;1;8;9;18388;0.0004894496410702633
61552;如果我从事这行业我会找一堆借口让甲方觉得我更优秀，但我就是个普通人我会完全支持ai绘画;17;20;37;18388;0.002012181857733304
61570;废话少，三连支持真不错哈只要ai没有思想，就永远取代不了人类，只是一个工具;1;8;9;18388;0.0004894496410702633
61572;当年嚷嚷着希望笔自己画画的是你们这群画师。现在抵制AI的也是你们只希望自己的笔会画画是吧？就像有些画师，自己的SAI和PS都是破解版，然后大谈绘画版权。只能说很抽象，行为艺术吧也许。;81;62;143;18388;0.00777681096367196
61654;我是美术生最近在研究希特勒发家史热;2;16;18;18388;0.0009788992821405265
61657;笑死，刚准备好走画师路线，tmd突然就杀出一个ai绘画热;2;10;12;18388;0.0006525995214270176
61660;在我眼里，没有拿起笔的，都不配叫创造;7;13;20;18388;0.0010876658690450293
61668;方便面代替不了厨师，但是能代替大部分普通人;1;7;8;18388;0.00043506634761801175
61670;建议禁止商用;2;7;9;18388;0.0004894496410702633
61673;AI是辅助人类，而不是替代人类藏狐;17;13;30;18388;0.001631498803567544
61691;AI雀氏挺打击人的，现在我完全是为了画同人画自己喜欢的CP坚持下去的，等过一阵AI能做到这个的时候我也差不多该放弃了笑哭;1;13;14;18388;0.0007613661083315206
61694;美术生：放弃思考，闪击波兰微笑;1;12;13;18388;0.0007069828148792691
61696;无所谓，看到绘圈逆天小画家被薄纱还是挺乐的。;1;10;11;18388;0.0005982162279747662
61698;作为绘画一般般的新手，有点想要抵制AI绘画，这玩意儿有商业价值，但无法代替强大的画师，却又把进步的道路变得极为狭窄，合着净给这儿恶心我们这些中低阶段的画画人呐辣眼睛;4;6;10;18388;0.0005438329345225147
61708;认为AI会取代999的专注于画画的画师，取代不了教画画的老师，不过也快了，因为当AI绘画像围棋那样，人人都能用，那谁还要学画画？你可以说绘画画出自己的风格活下去，但内卷被AI来一个百倍加速，总不可能靠着自己吃自己活下来吧？;2;5;7;18388;0.0003806830541657603
61712;肯定不能绝对取代人，行内的人还是会选择专业画师，但是出来的问题就是行外人事实上并不能很好的分辨出到底细节在什么地方，他们与其选择高昂的定制费用会觉得不如去选择ai作画，这就成了绘画界内和界外的严重行业壁垒，必然会导致界业单量减少，很多画师吃不上饭的现象;5;5;10;18388;0.0005438329345225147
61718;人类不管是体体能和力量，就连智慧和精神世界都要被机械和ai窃取剥夺啊，那么下一个该剥夺就是人性了吃瓜;1;5;6;18388;0.0003262997607135088
61720;虽然但是美术专业可远不止是画画啊辣眼睛;12;5;17;18388;0.000924515988688275
61733;无版权才是最大的问题，ai学习的画有几张付钱了？;24;5;29;18388;0.0015771155101152925
61758;我很喜欢画画，喜欢到疯的那种，但是现在ai的出现，让我有点伤心酸了;2;5;7;18388;0.0003806830541657603
61761;为什么突然高产了，哦原来变短了脱单doge;1;5;6;18388;0.0003262997607135088
61763;不如一起学编程，卷死互联网吃瓜;1;4;5;18388;0.00027191646726125733
61766;咱不太会说话，就我个人总结点要点：1ai目前无法对佬极人物构成太大影响，但这只是时间问题，已经有人能把ai训练成老累的画风了，老累也慌了2ai对中低层，绘画爱好者是灾难性打击。不要忘记，所有的佬一开始都并不是佬，都是从中低层画师，绘画爱好者一步步走上来的。没有了新鲜血液这行还怎么发展3ai绘图本身没有错。ai绘图可以帮助个人式的动画制作组，减少人员压力和财政压力。也可以帮助画师进行大概念创作，最后由画师进行修改，细节刻画，可以减少画师压力。但使用ai绘图的人要是没按什么好心（如上文“抄袭”事件），ai不受控制的发展就寄了。4绘图说小不小，说大不大，它能直接影响人类审美。学过历史我们都知道，审美通常跟着科技一起进步，甚至可以说是审美促进了科技的进步。ai剿灭了中下层画师，没有新鲜血液，在吸收完所有顶级画师后，ai画风也就差不多了。画风无法创新，审美无法提高，科技发展势必会受到影响5最重要的一点，ai可能会导致大部分画师落榜淘汰，所以让我们想想，上一个落榜美术生干了什么事;3;4;7;18388;0.0003806830541657603
61771;哈，无所谓了，连文艺工作ai都能全部替代的话，人类早晚灭绝鼓掌;4;4;8;18388;0.00043506634761801175
61778;ai干掉画师只是第一步，什么时候ai可以干掉程序员，我的梦想就可以开始实现了。;3;4;7;18388;0.0003806830541657603
61782;艺术是取代不了人，除非发展到ai有人的情感等复杂情绪，不然只能是复刻模仿;2;4;6;18388;0.0003262997607135088
61787;ai作画的素材是画师的心血，但是ai作画得成果却与画师无关，尤其是大部分利益都是ai公司踩着法律的边界窃取画师的成果（复制）;3;4;7;18388;0.0003806830541657603
61791;我觉得ai应该不能像人创造出前所未有的艺术作品，这可能是艺术道路上唯一人比机器厉害的地方。;9;4;13;18388;0.0007069828148792691
61801;AI绘画没有灵魂，但灵魂都是人赋予的。;6;4;10;18388;0.0005438329345225147
61808;美术生只是破防，最先进的AI翻译让外语专业预感到要没饭吃了藏狐，通过和人类相似的学习模式训练成的AI要比传统的修正型AI要强大太多，除了传统的文学作品翻译还有一些差距外，工科论文，科学杂志，这些翻译的准确度吊打常规本科生，以后学外语除了留学基本没有活路了。;1;5;6;18388;0.0003262997607135088
61820;UP主，你那个线稿自动上色的，点开后被win防火墙给拦了，吓得我点了拒绝，结果，无论点多少次，运行后打开的界面都是一片空白，一片空白，里面什么也没有，而且我也不知道另外一个文件style2paintsmaster是干什么用的，也没有安装说明啥的，我什么也不懂啊哭哭;1;3;4;18388;0.00021753317380900588
61825;怎么说呢，我觉得如果绘画算艺术的话我还是支持人的作画的，我认为画作是某人心血的证明吧，虽然现在你给我两幅画我也分辨不出哪副是人画的哪副ai画的。。。。热;1;3;4;18388;0.00021753317380900588
61828;还有人拿围棋来比较，笑死我了，你围棋有规则，最终要分胜负和，难道你画画也是为了分胜负是吧;1;3;4;18388;0.00021753317380900588
61837;我只感觉到这东西快把pixiv给毁了;1;3;4;18388;0.00021753317380900588
61840;还好我是学工科的，ai不能在没电的地方用大哭大哭大哭这么一说好像我的工作环境很恶劣一样;1;3;4;18388;0.00021753317380900588
61842;唉最近火热的AI画画成功消灭了我想学画画的念头，而且钱也花了，但就是没动力画啊;3;3;6;18388;0.0003262997607135088
61846;工具嘞doge速速交出;1;3;4;18388;0.00021753317380900588
61848;讲个笑话：在某个平行世界，pr一直没有被发明，于是存在这么一个职业：剪辑师，通过修改视频文件编码来进行剪辑。时间向前走，平行世界的Premiere终于被发明出来了，于是剪辑师很快被取代了，然后他们振臂高呼：“这样剪出来的视频是没有精神的”很抱歉我的笑话可能不太好笑。谢谢您的观看微笑;6;6;12;18388;0.0006525995214270176
61855;个人认为，有了AI作画，做动漫1秒画20张的时代可以过去了。动漫制作反会迎来一段上升期。;4;4;8;18388;0.00043506634761801175
61866;大家也不是未来来的，也都不知道未来的世界咋样，就做好每天的事就行了，不必担心ai绘画偶像梦幻祭2加油;1;2;3;18388;0.0001631498803567544
61871;可以看看我的动态;1;2;3;18388;0.0001631498803567544
61873;想想电脑和智能手机的发展速度不懂那些嘲讽画师的，感觉发展多一段时间，AI可能可以胜任很多行业的各种岗位，为啥有人会盲目自信未来几十年、甚至十年，自己不会因AI而失业或转行;3;2;5;18388;0.00027191646726125733
61877;我超上色可太好了，以后看本子都是全彩本给心心;1;2;3;18388;0.0001631498803567544
61891;妙啊把混子替换掉了，混子就急了思考真正有本事不会担心这些，;1;2;3;18388;0.0001631498803567544
61897;不是画的好不好的问题，有没有想过，以后ai起来了的话，我找一个人接我的单，我怎么能判断这个人不是ai画的既然不能判断我是不是就不会找那些没名气的，只找人气高的，没名气的没人找，那我学画画干嘛？进公司都没人要，按现在这种资本家的嘴脸还会招人上班;1;2;3;18388;0.0001631498803567544
61899;现在的面包可没有50万一个doge;1;2;3;18388;0.0001631498803567544
61904;我认为应该立个法律Ai的美术能力数据的采集。不能从互联网上别人的画里面来抄，而是由ai公司自己去雇人投喂这些美术设计用别人的绘画技巧和美术设计来构建自己AI美术系统是非常的不合理的;1;2;3;18388;0.0001631498803567544
61907;作为一个美术生我的理解是画画延续了这么久我觉得无论画什么目光都不应该局限在像或不像至少像是本分这只是ai能做到的最高点了但是人可以在像的基础上去投入自己的感情每一笔都是不一样的情感我觉得这才是绘画一直延续下去的原因;1;2;3;18388;0.0001631498803567544
61917;瑟图ai不行dogedoge;2;2;4;18388;0.00021753317380900588
61920;龙嘴虎眼ai绘画做不到吧。;2;2;4;18388;0.00021753317380900588
61924;看看某些圈子的画和价格，只能说ai正义薄纱;3;2;5;18388;0.00027191646726125733
61928;什么时候出AI炒股？让AI画个青眼白龙全动作精灵图（包括但不限于行走、起飞、滑行、降落、攻击、技能），画不出来，两张青眼白龙都长的不一样（而且和原版的都不一样），更别说一个动作要个5帧8帧。如果能做到，麻烦教教我，输入什么tag能生成;4;2;6;18388;0.0003262997607135088
61933;我有一个大胆的想法doge;1;2;3;18388;0.0001631498803567544
61937;你太小看甲方了doge;1;2;3;18388;0.0001631498803567544
61939;都没找到可以画涩图的ai绘图工具无语;3;2;5;18388;0.00027191646726125733
61943;涌入啤酒馆是什么意思囧;1;2;3;18388;0.0001631498803567544
61945;一幅画的价值很大程度上取决于画师的名气，AI最多取代到中层画师，对于真正的艺术家有什么威胁;2;2;4;18388;0.00021753317380900588
61951;一句话：没有灵魂;4;2;6;18388;0.0003262997607135088
61956;还好吧，我觉得能让艺术成为艺术，体现艺术的思想，而不单单是表象;1;2;3;18388;0.0001631498803567544
61958;可以画一些涩涩的吗傲娇;1;2;3;18388;0.0001631498803567544
61960;AI能画出有趣的咩？;1;2;3;18388;0.0001631498803567544
61962;你变短了滑稽滑稽;2;2;4;18388;0.00021753317380900588
61965;20w粉了暑假还是3w;2;2;4;18388;0.00021753317380900588
61970;ai不就是对已知图库缝合模仿嘛，它还能搞原创？没有各种词条和风格指定它能画个杰宝;2;3;5;18388;0.00027191646726125733
61973;ai生成的就少股灵气，调试也很废人，能不能调出我想要的就全凭运气，关键还画不了男人（真就画女硬说男了）目前的话玩玩还不错，或者碰到合适的修改一下当草稿用也可以省点时间;4;3;7;18388;0.0003806830541657603
61978;画师爱怎么看就怎么看，要么转行要么提升。他还能发动二战不成;3;4;7;18388;0.0003806830541657603
61984;AI画的我老婆（爱莉希雅）一眼就能看出不对味dogedogedoge;1;1;2;18388;0.00010876658690450294
61988;现在AI不会画人物的手doge;1;1;2;18388;0.00010876658690450294
61991;就目前来说，有亿点AI制胀;1;1;2;18388;0.00010876658690450294
61994;之前在哪看的，ai无法取代两种工作，具有创造性的，或者需要人类情感支持的;1;1;2;18388;0.00010876658690450294
62002;讲个笑话，当初相机发明出来的时候也是一群人说绘画要被替代了，如果真的有一天绘画可以被ai替代，那么人也可以被ai替代;1;1;2;18388;0.00010876658690450294
62032;我直接给结论吧：真的可以取代人，但是手和眼睛要修一下。光影效果人类一败涂地。想象力一败涂地，人工只需要修细节。;1;1;2;18388;0.00010876658690450294
62048;噶了韭菜根还想割韭菜？到时候等着吃土吧doge;4;1;5;18388;0.00027191646726125733
62066;我对于美术工作者的现状来看，就是如果你真当回事了，我觉得这就很不及格，对此忧虑的点有三个，一是，低质量高价格的坑爹画手描图，描ai的，这个问题是真的有问题，你如果不去理解光影人体，你的能力是不会提升的，ai可帮不了你提升美术能力，其二，就是如果它能帮画师提高效率目前看不能，只能拿来玩，那么如果你多了50的效率，那恐怕老板不会提升你的薪水，而是裁掉另一个，其三是法律问题，很显然盗图，未经允许使用创造者的图，甚至大规模侵犯众多人的利益，我这么说，股市ai成熟的多，也更简单有效，只要它能得到每个公司内部所有数据，它就能比任何金融专家金融专家并不可能活的所有数据更准确强大，但是这是违法的，会被数以万计十万计的公司告到稀烂，画师这方面，仅仅是目前没有商业行为，闲鱼骗人的别算他们了以及没有导火索事件;1;1;2;18388;0.00010876658690450294
62075;仔细想想，我们不是说AI制造机械吗？那为什么还有那么多工人12个小时工作呢？;1;1;2;18388;0.00010876658690450294
62080;呃有没有人能把一拳超人原作拿去让AI搞一下;1;1;2;18388;0.00010876658690450294
62083;我有个大胆想法，用AI画本子dogedogedoge;1;1;2;18388;0.00010876658690450294
62089;我想要;3;1;4;18388;0.00021753317380900588
62100;对上层画手影响不大但是打击中下层画师;1;1;2;18388;0.00010876658690450294
62109;ai可以制造商品，但不能创造艺术;3;1;4;18388;0.00021753317380900588
62114;ai不会画手，一堆图手都成海嗣触手了doge;1;1;2;18388;0.00010876658690450294
62119;并没有什么取代不了的，只要有足够的数据就能取代;1;1;2;18388;0.00010876658690450294
62121;我们老师打分一直不看画技，其他都看。最看重创意。我之前不太理解，起码画技应该也算一部分比重吧。现在知道，我们老师深谋远虑那会儿ai还没发展起来。;3;1;4;18388;0.00021753317380900588
62138;我以为画画是跟着步骤，先给草图再给上色，再精画不会画画的瞒不住的。;1;1;2;18388;0.00010876658690450294
62140;ai能不能就是那方面的脱单doge然后实现个人编程，想看什么内容都可以自己来，自己当导演脱单doge有可能吗有可能吗？？？;2;1;3;18388;0.0001631498803567544
62153;有技术的画师不怕，怕的是那些不扣细节的画师，ai画的图细节不行，层次感很差，想要ai画出高质量的图要很多关键词，但是和那些高水准画师画的依旧有差距;2;1;3;18388;0.0001631498803567544
62164;AI能画那种？;1;1;2;18388;0.00010876658690450294
62182;画不了涩图，有什么用微笑;4;1;5;18388;0.00027191646726125733
62187;首页通知书脱单doge;1;1;2;18388;0.00010876658690450294
62196;我认为ai绘画可以起到事半功倍的作用，先让ai画出来然后人工修饰改一下细节;1;1;2;18388;0.00010876658690450294
62206;我大专自学了厚涂，本来想着自己接单赚点零花钱，没想到ai直接生成比我画的好多了辣眼睛这是要逼死底层人的节奏啊热;1;1;2;18388;0.00010876658690450294
62210;你应该拿当年相机的出现和现在ai绘画的出现对比。;1;1;2;18388;0.00010876658690450294
62212;AI能做AI吗？;1;1;2;18388;0.00010876658690450294
62215;up你好，可以分享情绪检测的部署视频吗，求求你了;1;1;2;18388;0.00010876658690450294
62222;等AI能驾驭jojo，刃牙，拳愿，游戏王等一众画风的时候再说罢藏狐doge;1;1;2;18388;0.00010876658690450294
62224;21;1;1;2;18388;0.00010876658690450294
62231;ai画不出痞藏狐;2;1;3;18388;0.0001631498803567544
62234;AI绘画必定代表不了人，但AI绘画的存在是必然的，而且我也看到个人觉得最好的用法等会回来补后续。;3;1;4;18388;0.00021753317380900588
62240;拜托，我是手绘人滑稽滑稽滑稽;1;1;2;18388;0.00010876658690450294
62243;不画画话就当兵了;1;1;2;18388;0.00010876658690450294
62245;这东西怎么用啊;5;1;6;18388;0.0003262997607135088
62253;ai的能力取决于它拥有的库，像NA就对血腥一窍不通;4;1;5;18388;0.00027191646726125733
62259;感觉现在ai在细节上各种崩，就是因为它还差一点，它还只会画画，我现在指导的萌新各种匪夷所思的崩，基本上就是源自于他们还不能意识到自己画的东西到底是怎么个结构;5;1;6;18388;0.0003262997607135088
62265;鹿鸣下围棋，这就有意思了;3;1;4;18388;0.00021753317380900588
62272;话说是不是ai绘画ai补帧ai声音克隆，就能做出一部质量一般的番啊;4;1;5;18388;0.00027191646726125733
62277;ai会取代的，如果未来不能，将会有ai加仿生人来取代;1;1;2;18388;0.00010876658690450294
62281;没有绘画基础也能轻松快速得到基础的美术资源这玩意真的很强给心心;1;1;2;18388;0.00010876658690450294
62284;这玩意更像中国松茸进入欧洲;4;1;5;18388;0.00027191646726125733
62289;柯洁;1;1;2;18388;0.00010876658690450294
62291;这东西最终发展方向就是一个工具;3;1;4;18388;0.00021753317380900588
62295;好的捏雪狐桑好棒;1;1;2;18388;0.00010876658690450294
62297;doge最近在玩这个弄了3个其中up主一个跑路了毕竟是免费的金主大概花了12w美元;5;1;6;18388;0.0003262997607135088
62304;源头是画师，画师不公开直播画就可以了。AI那玩意靠画师的图。呲牙滑稽;2;1;3;18388;0.0001631498803567544
62307;主要是细节有问题，比如手指这类都不太对嗑瓜子;2;1;3;18388;0.0001631498803567544
62310;那音乐家是不是也被音乐播放设备给替代了啊，本就是时代在进步，艺术生唱衰只是开始，还有更多的职业会被人工智能取代;5;1;6;18388;0.0003262997607135088
62316;那能画出来我女朋友吗脱单doge;2;1;3;18388;0.0001631498803567544
62319;能力不行就是要被取代的doge;3;1;4;18388;0.00021753317380900588
62323;整的不错打call;1;1;2;18388;0.00010876658690450294
62325;最近就想弄这呢，谢谢小gay，爱你啾脱单doge;1;1;2;18388;0.00010876658690450294
62327;呜呜呜呜;1;1;2;18388;0.00010876658690450294
62329;吃瓜吃瓜吃瓜;1;1;2;18388;0.00010876658690450294
62331;第一啊，快救救孩子吧;1;1;2;18388;0.00010876658690450294
62333;真的被取消了。;1;1;2;18388;0.00010876658690450294
62335;up，我下载了不会用啊大哭大哭;6;1;7;18388;0.0003806830541657603
62347;如果你参考了装饰品机械化生产链和手工装饰品之间的关系。那么，你就不会觉得ai绘画会毁了画师无语;8;3;11;18388;0.0005982162279747662
62356;画师临摹行，ai学习不行，怎么的，你们这些小画家临摹前和画师申请版权了是吧？你学画画接稿自己画那算不算学习素材库然后商用啊，搁着双标了是吧;1;3;4;18388;0.00021753317380900588
62358;取关了取关了，文件这么大还存百度网盘辣眼睛;4;2;6;18388;0.0003262997607135088
62365;转发：如果AI绘画会淘汰掉画师的话，我估计自设生物绘画和up这样的古生物复原画师肯定是AI最难攻下的领域支持，因为这些领域涉及到了复杂的解剖学和想象力。靠几块骨头推测恐龙生存场景，就目前来看AI做不到。首先恐龙的骨头应该放在哪里，一个科学家有一个想法。放到库里AI直接做个外星生物出来。再往骨头上加肉，人类还有皮包骨复原，活体复原，艺术复原，影视复原这些最后蒙皮肤鉴于恐龙不存在，这就是纯创造性的东西了。人类的想象力可以把磷虾的颜色堆到阿根廷龙上并且用审美让它好看，AI就很难做到。当然我很相信AI作画的想象力能有跨越式进步，别忘了这玩意两个月前还只能画克苏鲁大笑PS：这个AI绘画里的恐龙只有一个tag“dinosaur”所以无论输什么进去它都只能输出拼贴魔改版混合动物笑哭;1;1;2;18388;0.00010876658690450294
62367;AI影响的是下游，高手永远无可替代;2;1;3;18388;0.0001631498803567544
62376;ai和人都得学习，别一踩一捧了;2;2;4;18388;0.00021753317380900588
62380;只是b站用户大多都看这种立绘类型的，但美术包含的太多了，大学也多学习的是美术的视觉传达感。对于环境设计，视觉传达等很多只能说是工具。比方设计广告，这个是完全不敢靠AI去搞的。但是对于这种立绘的这门行业冲击也大，很多游戏公司，外包团队都会受到影响。;1;1;2;18388;0.00010876658690450294
62391;爱死你了，gay;1;1;2;18388;0.00010876658690450294
62397;这人工智障硬生生的把华北平原画成了珠穆朗玛doge;3;166;169;18388;0.009190776593430499
62403;我觉得动漫里穹妹的比例有点奇怪啊，看下悠之空里的穹。个人认为更好看一些;8;41;49;18388;0.002664781379160322
62415;麦克阿瑟曾评论过历史上著名的玄关之战，后面我忘了;1;3;4;18388;0.00021753317380900588
62422;大了;1;3;4;18388;0.00021753317380900588
62459;想起刚发明出照相机的时候，人们觉得照片好，画师们就直接改画风变抽象了doge;3;2223;2226;18388;0.12105721122471177
62463;AI吃的图再多画出来的画也不会拥有灵魂所以我现在换专业还来得及吗原神哭哭;1;1089;1090;18388;0.0592777898629541
62465;不会，画师不会失业的，AI绘画风格很少，基本相似，且完成度不如您，AI绘画技术画出来的是没有灵魂的，您画出来的不仅有灵魂还特别惊艳，您的绘画技术已经超过AI技术八百个宇宙了，将来AI统治宇宙都统治不了您，所以你不用担心这个问题。最后，爸爸您画的真牛掰，我先舔个一辈子喜欢喜欢喜欢;1;601;602;18388;0.03273874265825538
62468;AI不都是考吃画师的画来合成的吗？总感觉AI的画很僵硬，完全没有画师的那种感觉辣眼睛;3;1126;1129;18388;0.061398738307591905
62472;别说AI统治画圈了，您这个技术AI统治世界了都能活下来脱单doge;3;2636;2639;18388;0.14351751142049163
62476;加油样本不够;1;2;3;18388;0.0001631498803567544
62479;ai都是拼接抄袭原创画师的，如果没有了画师，这些ai迟早会枯竭，不希望艺术被ai这种毫无创意的东西占领;1;6;7;18388;0.0003806830541657603
62488;尊豫;1;1;2;18388;0.00010876658690450294
62505;AI风格特别少，而且又不会画手，也不会抓细节;1;82;83;18388;0.004513813356536872
62508;已经报完课程了星星眼希望得到老师很好的指导qwq;3;26;29;18388;0.0015771155101152925
62539;猕安库画风好美;1;0;1;18388;5.438329345225147e-05
62556;用户554566这位妈咪好牛啊啊啊啊啊啊啊;1;0;1;18388;5.438329345225147e-05
62592;作者大大最后一张图使我在追的漫画里的主角唉脱单doge;2;0;2;18388;0.00010876658690450294
62604;kai卍凯bili97790176236bili20528220224喜欢喜欢喜欢喜欢喜欢喜欢喜欢喜欢喜欢喜欢喜欢;1;0;1;18388;5.438329345225147e-05
62710;原来是你;1;0;1;18388;5.438329345225147e-05
62716;我有一点好奇，ai绘画难道不是人构建的吗;1;0;1;18388;5.438329345225147e-05
62731;无期年;1;0;1;18388;5.438329345225147e-05
62743;寒烟凝碧丶美炸了;1;0;1;18388;5.438329345225147e-05
62796;现在让我们看看人工队这边的情况;48;1116;1164;18388;0.06330215357842071
62845;制作新角色：ai出草图，画师先期细化，多图后训练模型，进入流水线生产阶段，这下半自动了;19;648;667;18388;0.03627365673265173
62865;滑稽我之前尝试用AI生存纳西妲，结果它一个劲给我出荧妹，还是贼色的那种，明明没有输入啥瑟琴tag;31;352;383;18388;0.020828801392212312
62897;我已经能想象到有人开始把各大网站图库从头扒到尾然后拉满硬件训练AI，拉一个AI绘图矿场接单出商图的景象了。然后动不动出图的时候因为用的参考图的原因，被发现和哪个画师的哪个作品构图光影相差无几，但画师却毫无还手之力的情况。到时候这公司就叫;52;543;595;18388;0.03235805960408963
62950;补充说明：1、第一步说的重命名VAE模型文件非常关键（如果你本来就没有VAE文件就无所谓），如果带着VAE训练效果会非常糟糕；训练结束后重新加载回来2、Deepdanbooru需要在启动项添加deepdanbooru（在webuserbat的COMMANDLINEARGS一行添加，或者直接pythonwebuipydeepdanbooru，如果对自己硬件有足够信心可以加上precisionfull）3、最新版的TextualInvasion选项改成了Train，内部格局稍微发生了变化，但是具体操作没变，可以继续参照视频做法4、0310时说的initializationtext，如果要填，仅限一词，对于人物可以是1girl或者1boy，对于画风就写style就行了;25;183;208;18388;0.011311725038068305
62976;省流要12G才能玩，等后续大佬出底显存模型;26;89;115;18388;0.006254078747008919
63003;佬你这个是哪个ai语音;9;46;55;18388;0.002991081139873831
63013;6G显存提示CUDAoutofmemory的可以把分辨率改为448448就可以正常运行了;9;38;47;18388;0.0025560147922558192
63023;ai不能称之为绘画吧，毕竟从始至终没动过一笔，生成的不能叫画，叫图更合适思考;69;72;141;18388;0.007668044376767457
63093;卧槽，这意味着什么，当我们有想法的时候，AI可以帮我们生成预稿，然后我们在此基础上修改就可以了。可以极大的简化先草稿，线稿，色块，等步骤。脱单doge;4;35;39;18388;0.002120948444637807
63098;等小显存神丹，渣显卡玩不起;1;30;31;18388;0.0016858820970197955
63100;配音是AI吗？我已经开始怀疑了;5;38;43;18388;0.002338481618446813
63106;感谢教程给心心有个问题想问一下，训练画风原图是各种形状的，用他的自动切分切成上一半下一半（比如说立绘基本上都变成上面是上半身下面是下半身）基本上都把图片切碎了这样的素材能用吗还是需要人一张张改成512保证图内容不被切碎正常进去;8;26;34;18388;0.00184903197737655
63115;我在想如果我故意画6指会不会被人当成ai画;20;30;50;18388;0.0027191646726125733
63136;我算半个学AI的，但是我还是很反对随便拿图去训的挑数据集的时候严谨一点，看看有没有授权总是没错的。有些人说又没有商用，你急个什么，是，你是没商用，但当你无私地把使用画师辛苦创作且不允许用于AI训练的画作训出来的权重和成果在网上共享出来，或者你的某位好友分享出来的时候，总有人会用某宝上白嫖某站画师图片的抱枕店还少吗？别站着说话不腰疼，到时候多少画师得失业？合着这是没动到你的蛋糕是吧？你要真这么想那我祝愿你以后所在的行业人工智能走在行业最先列。;67;255;322;18388;0.017511420491624973
63204;TracebackmostrecentcalllastFileDAI1012stablediffusionwebui2pythonlibmultiprocessingprocesspyline314inbootstrapselfrunFileDAI1012stablediffusionwebui2pythonlibmultiprocessingprocesspyline108inrunselftargetselfargsselfkwargsFileDAI1012stablediffusionwebui2modulesdeepboorupyline35indeepbooruprocessmodeltagsgetdeepboorutagsmodelFileDAI1012stablediffusionwebui2modulesdeepboorupyline87ingetdeepboorutagsmodelimportdeepdanbooruasddModuleNotFoundErrorNomodulenameddeepdanbooru;16;23;39;18388;0.002120948444637807
63221;没用的，现在个人才能喂多少图，工作室或者专门训练模型的直接用爬虫，能爬多少图只取决于别人网速和磁盘速度藏狐;3;22;25;18388;0.0013595823363062867
63225;现阶段还是模仿各类画师的手法，之后像阿帕狗升级自己跟自已练习时，那类只会玩套图的画师你们又要说什么了呢;13;46;59;18388;0.0032086143136828365
63239;大佬们，想想求救一下低显存模式怎么开启大哭;3;4;7;18388;0.0003806830541657603
63244;做视频的适合一直输的绿发，做完才想起来草神是银发，只能说衣服太绿影响了我笑哭看视频发现AI一直在试图把头发拉白捂脸;8;34;42;18388;0.0022840983249945617
63253;我8G显存1070成功训练了Up太强了我用的另一个up版本很稳定web是最新的小电视赞;31;14;45;18388;0.002447248205351316
63285;谢谢教学，学会了;1;3;4;18388;0.00021753317380900588
63287;此时一个动画专业大四毕业生一般路过并留下了泪水，还没找到工作就要失业了（悲）;3;13;16;18388;0.0008701326952360235
63291;如果你要使用的是独立研究员星空这为up的整合包进行词条锻炼的话，请根据你平时使用的启动脚本修改webuiuserbat。例如，你平时使用的是6G版本，打开6G的bat可以看到它为你添加了一句medvram，复制下来。打开webuiuserbat，更改成我这样：setPYTHONpythonpythonexesetVENVDIRpythonsetCOMMANDLINEARGSmedvramdeepdanbooru即可。最后一行是自定义指令，因为你是使用6G版所以把6G版的参数填入，deepdanbooru是安装并启用deepdanbooru。VENVDIR是venv的路径，由于整合版自带python并未使用venv，故直接填入python目录路径。两个路径参数均为相对路径，按理来说大伙可以通用。Installingdeepdanbooru时如果报错openssl错误则是网络问题，自行解决，可尝试steam等工具加速GitHub。用“pythonwebuipy”启动webui的话就算你为该版本的python安装好了deepdanbooru也无济于事，python也不知道该赋怎么样的参，还是bat和sh方便;49;45;94;18388;0.0051120295845116384
63341;请问如果想训练AI画一种表情的话Prompttemplatefile应该填什么文件名;4;3;7;18388;0.0003806830541657603
63348;30606g成功了320320的分辨率就可以，训练2000次就已经很不错了星星眼;4;3;7;18388;0.0003806830541657603
63353;覆盖安装了113版本的webui，并且在webuiuser里添加了deepdanbooru，但是train里面仍然没有这个选项。我之前使用的整合包是这里下载的：httpsb23tvZuaiIIZ是不是这两个版本不兼容啊保卫萝卜哭哭;30;3;33;18388;0.0017946486839242985
63384;Expectedalltensorstobeonthesamedevicebutfoundatleasttwodevicescpuandcuda0whencheckingargumentforargumentindexinmethodwrapperindexselect预计所有张量都在同一设备上，但发现至少有两个设备，cpu和cuda：0（在方法wrapperindexselect中检查参数索引的参数时）这种情况有解决的方法吗;11;3;14;18388;0.0007613661083315206
63396;懂了，以后我画的图将会打满水印;15;27;42;18388;0.0022840983249945617
63412;能不能请问下批量裁剪图片您用的哪个工具或网站？我之前收藏过一个网站，不小心弄丢了。。;9;3;12;18388;0.0006525995214270176
63423;请问一下，用这个功能要多少显存tv难过;18;12;30;18388;0.001631498803567544
63444;Up主能成功是因為他選擇的是草神，原神裡面的人氣角，當紅遊戲的人氣角不缺同人圖。如果是冷門遊戲的角色就非常麻煩，根本沒有幾張同人圖;1;2;3;18388;0.0001631498803567544
63446;大佬，embedding训练好了pt文件，但是只要一加上对应关键词就无法正常出图了，报错ValueErrorcannotconvertfloatNaNtointeger，去掉对应关键词就正常，请问这是什么原因啊？;2;2;4;18388;0.00021753317380900588
63449;learningrate太高容易让图片被撕裂成古神太低又容易变成互不相干的东西。还是看情况调着来。而且这里可以设置区间的，我看见github上写的，比如00007500000021200000006（去掉方括号），这代表着500次迭代满之前用00007的学习速率，1200次迭代满之前用00002的学习速率，之后就一路用000006到结束。而且还有，那个numberofvectorspertoken越高，这个rate就得越低的样子？要是token低一些下来之后，rate还是没变的话就好像啥都学不到的，会出来不相干的东西。看起来rate是可以多加几个间隔的，总之看情况来，learningrate好像是前期刚开始急促一点好，后期缓一点好？我不是这个专业的所以不知道。欢迎解惑。;9;7;16;18388;0.0008701326952360235
63459;训练两个小时完了之后才发现没把一开始的vae改名，生成的全是抽象派画风，麻麻子;1;7;8;18388;0.00043506634761801175
63461;要是AI真的能取代画师，那估计设计行业被取代都是迟早的事;3;2;5;18388;0.00027191646726125733
63465;显存不够的可以在COMMANDLINEARGS一行添加medvram加在deepdanbooru后可以跑训练;5;2;7;18388;0.0003806830541657603
63472;收藏永远在增长，学习从未开始。doge我们不生产知识，我们只是知识的收藏家妙啊;1;7;8;18388;0.00043506634761801175
63474;我不想被替代;6;2;8;18388;0.00043506634761801175
63484;第一步创建文件就创建不了怎么办;1;5;6;18388;0.0003262997607135088
63486;launchpyerrorunrecognizedargumentsdeepdanbooru这是怎么回事啊;3;2;5;18388;0.00027191646726125733
63490;您好，想问问这种方法能不能训练对于特殊XP涩图的生成，因为实在太小众了，所以如果AI可以做到真的非常不错。;1;4;5;18388;0.00027191646726125733
63492;RuntimeErrorCUDAerrorCUBLASSTATUSALLOCFAILEDwhencallingcublasCreatehandle有没有大佬说说这怎么整啊，显存81n卡，没什么问题吧热;2;2;4;18388;0.00021753317380900588
63495;太好了，可以快速畫漫畫劇情了;1;2;3;18388;0.0001631498803567544
63497;画师问一下up，你用这些图获得画师授权了么？很多画师已经声明禁止自己的图被拿去训练了，是不是有些跳脸了？;72;57;129;18388;0.007015444855340439
63570;这个解说也是AI吗？好强啊;6;2;8;18388;0.00043506634761801175
63584;为什么我的pt大小不变辣眼睛一万步了已经;1;1;2;18388;0.00010876658690450294
63589;有人能代跑一下吗4g显存没法训练東雪蓮对不起;2;1;3;18388;0.0001631498803567544
63593;我发布了一篇笔记，快来看看吧关于WEBUI整合包，我个人建议试试评论区大佬Rebootbot推荐的独立研究员星空BV1aN4y1A7j1的整合包，然后再过来试试这个。有些httpswwwbilibilicomh5noteappviewcvid19159016pagefromcomment;6;1;7;18388;0.0003806830541657603
63600;不同画风可以训练吗;1;1;2;18388;0.00010876658690450294
63603;必须用WEBUI么笑哭求个WEBUI一键部署喜极而泣;1;1;2;18388;0.00010876658690450294
63605;为什么我更新了git最新的后，还是没有0426的第四个选项（preprocessimages，就是第一个是反转图片，第四个应该是给图片列出tag？），顺便再问问style保存过的预读怎么删除啊？;1;1;2;18388;0.00010876658690450294
63607;幫大家踩了個雷在命名embedding的名稱時先去檢查是否使用在txt2img會有高度影響跑了一個下午模型完全沒有進展;1;1;2;18388;0.00010876658690450294
63609;在createanewembedding那里直接报错RuntimeErrorExpectedalltensorstobeonthesamedevicebutfoundatleasttwodevicescpuandcuda0whencheckingargumentforargumentindexinmethodwrapperindexselect了;2;1;3;18388;0.0001631498803567544
63612;如果是别人训练好的pt，应该放到哪个文件夹呢？也是embedding吗？;4;1;5;18388;0.00027191646726125733
63617;为什么我在镜像那一步镜像出来的是txt文件啊;1;1;2;18388;0.00010876658690450294
63619;训练出来的草神的模型不分享一下嘛？;1;1;2;18388;0.00010876658690450294
63622;为什么结束以后确实能生成小草神了可是生成出来的全是证件照一样的，没有全身;4;1;5;18388;0.00027191646726125733
63627;小显存的痛太痛了;1;1;2;18388;0.00010876658690450294
63629;up有云端版的方法吗;1;1;2;18388;0.00010876658690450294
63631;RuntimeErrorCUDAoutofmemoryTriedtoallocate79400MiBGPU0600GiBtotalcapacity383GiBalreadyallocated36756MiBfree389GiBreservedintotalbyPyTorchIfreservedmemoryisallocatedmemorytrysettingmaxsplitsizembtoavoidfragmentationSeedocumentationforMemoryManagementandPYTORCHCUDAALLOCCONF这边现实我明明还有近3G的显存没用为什么还是爆显存了？调任何参数都没办法，请问有救么？减少训练用的素材数量能够减轻显存压力么？;21;1;22;18388;0.0011964324559495323
63653;请问一下，是什么显卡，生成的好快啊;1;1;2;18388;0.00010876658690450294
63656;纯好奇，总有人说用别人的画做素材训练很无耻，想问一下那些人工画画，但是模仿别人画风的怎么说呢？;1;1;2;18388;0.00010876658690450294
63658;UP您好，请问训练的新模型是以什么样的形式保存在哪个文件里，我想把训练成果分享给朋友可行吗？;8;1;9;18388;0.0004894496410702633
63668;怎么感觉到后面变成初音了。。。;1;1;2;18388;0.00010876658690450294
63674;请问一下，如果训练画风的话，漫画黑白图能用做素材吗？学习完成后用在彩图上会有效果么？;2;1;3;18388;0.0001631498803567544
63677;话说可以把别人训练的新模型和老旧的模型合并吗2233娘喝水我对这方面毫无研究2233娘郁闷;5;1;6;18388;0.0003262997607135088
63687;抵制AI呼吁“AI不扩散化”不要嘲笑今天AI威胁画师，明天AI就有可能威胁你的行业不要把Ai比喻为织布机，织布机可不会塞了原料后人一声令下提好要求就自己开始工作，而AI驾驶系统、AI制图、AI翻译、AI配音会。真正的商用级AI是资本的工具，人家花点小钱能大大缩减岗位数量，那不是给你用的工具。欢迎AI焦虑者给我点个关注;1;2;3;18388;0.0001631498803567544
63709;好厉害，但是听不懂大哭;1;0;1;18388;5.438329345225147e-05
63714;up，用3d模型训练的效果怎么样啊，会不会不好;1;0;1;18388;5.438329345225147e-05
63717;已经预料到以后画师的生存环境了，这科技进步有时候真不是一件好事啊;2;0;2;18388;0.00010876658690450294
63725;已经训练了自己的古月娜模型，其实个人感觉，如果训练人物，步骤越多越好，我用70张图片训练了35000step，500epoch，效果非常还原，但拿10000step的测试，效果差了不少，也许对于人物可能就是需要过拟合？;1;0;1;18388;5.438329345225147e-05
63727;有没有大佬知道为什么没有usedeepboorucaptionasfilename这个选项啊辣眼睛求教;1;0;1;18388;5.438329345225147e-05
63732;这个T2S是什么啊，语气很自然;1;0;1;18388;5.438329345225147e-05
63734;我是真的不理解但凡是了解过一点点当下的深度学习和最基本的脑科学都不至于吹这个ai作画还拿过来跟真正的人脑比。热知识：扩散模型的底层原理这个《作画》ai完全不学习任何绘画技法;2;0;2;18388;0.00010876658690450294
63739;RuntimeErrorCUDAoutofmemoryTriedtoallocate51200MiBGPU0800GiBtotalcapacity497GiBalreadyallocated42797MiBfree532GiBreservedintotalbyPyTorchIfreservedmemoryisallocatedmemorytrysettingmaxsplitsizembtoavoidfragmentationSeedocumentationforMemoryManagementandPYTORCHCUDAALLOCCONF8g显存embeding过程他出现了这个错误，我选择的1k步，其他配置都按照视频里来的;1;0;1;18388;5.438329345225147e-05
63744;你们没注意到up的声音是合成的吗;1;0;1;18388;5.438329345225147e-05
63752;请问一下我训练模型的时候突然发现自己的C盘内存空间突然多了好多个g，这些文件具体在哪个文件夹呢，能不能搬到其他盘不受影响;2;0;2;18388;0.00010876658690450294
63758;怎么把大图片尽可能保留尺寸变成512512呢。。;1;0;1;18388;5.438329345225147e-05
63763;彩云小梦出来几年了小说家不还是没失业;1;0;1;18388;5.438329345225147e-05
63765;这个设置好的数据能保存么，我每次重新打开都得重设;1;0;1;18388;5.438329345225147e-05
63769;没有自动标注啊，新版少了第四的选项，选择第三个选项，还是没有自动标注;1;0;1;18388;5.438329345225147e-05
63771;我在想有没有代跑训练的，我看人家直接用现成的pt文件放到embeddings目录，可以跑出一样的效果;1;0;1;18388;5.438329345225147e-05
63774;2070训练跑的是cpu，gpu根本不动。。。晕;1;0;1;18388;5.438329345225147e-05
63778;为什么我训练出来的效果像古神一样辣眼睛;1;0;1;18388;5.438329345225147e-05
63789;我的预处理后图片不会自动重命名，是图片文件和带标签的txt并列在一起，有没有什么办法，还是说我deepdanbooru没安装好思考;1;0;1;18388;5.438329345225147e-05
63791;不需要部署和硬件配置的训练模型方法在我的视频里有哦脱单doge;4;0;4;18388;0.00021753317380900588
63799;他说我CUDA内存不足怎么搞3070laptop保卫萝卜哭哭保卫萝卜哭哭;2;0;2;18388;0.00010876658690450294
63803;有一个问题，我训练画风的时候，就是有很多地方画的很差，比如手指，脚，那个地方，是我给的数据集不够好还是模型对这些地方没有理解，可以优化吗？;7;0;7;18388;0.0003806830541657603
63811;大佬，报错说我cuda内存不足怎么解决，我是2060的16显存的显卡。RuntimeErrorCUDAoutofmemoryTriedtoallocate25600MiBGPU0600GiBtotalcapacity472GiBalreadyallocated0bytesfree508GiBreservedintotalbyPyTorchIfreservedmemoryisallocatedmemorytrysettingmaxsplitsizembtoavoidfragmentationSeedocumentationforMemoryManagementandPYTORCHCUDAALLOCCONF;1;0;1;18388;5.438329345225147e-05
63815;Upup你好，这算是什么方面的知识，感觉好神奇，想深入了解;5;0;5;18388;0.00027191646726125733
63822;16系显卡这个错误怎么办？ValueErrorcannotconvertfloatNaNtointeger;2;0;2;18388;0.00010876658690450294
63825;妈的跑了两个晚上发现没改vae，全白跑了，气死我了;19;0;19;18388;0.0010332825755927778
63845;RuntimeErrorCUDAoutofmemoryTriedtoallocate51200MiBGPU0600GiBtotalcapacity496GiBalreadyallocated0bytesfree532GiBreservedintotalbyPyTorchIfreservedmemoryisallocatedmemorytrysettingmaxsplitsizembtoavoidfragmentationSeedocumentationforMemoryManagementandPYTORCHCUDAALLOCCONF;4;0;4;18388;0.00021753317380900588
63850;那么未来有没有可能出现AI动画笑哭;1;0;1;18388;5.438329345225147e-05
63856;问一下，up主是什么显卡，我照着做直接显存占满不能开，8G显卡也不行吗热;9;0;9;18388;0.0004894496410702633
63866;如果那个vae文件名不改的话，就是训练novelai前不管文件名的情况下，直接训练有什么后果呀灵魂出窍有除了改名以外的方法解决吗每次训练都改名感觉好麻烦;1;0;1;18388;5.438329345225147e-05
63868;这个声音听起来像机器人特别是说novelai的时候;1;0;1;18388;5.438329345225147e-05
63870;novelai本地版咋训练啊;3;0;3;18388;0.0001631498803567544
63874;话说1650ti是不是显存不够;1;0;1;18388;5.438329345225147e-05
63877;问一下为啥我训练完了然后人物身上衣服啥的就一直是跟训练图很相似的那套，不能换其他衣服吗，打了nsfw的tag也没变化;2;0;2;18388;0.00010876658690450294
63880;有人知道ERRORCouldnotfindaversionthatsatisfiestherequirementtensorflow2100fromversionsnoneERRORNomatchingdistributionfoundfortensorflow2100怎么解决吗，镜像都试过了还是安装不上;3;0;3;18388;0.0001631498803567544
63884;大佬们喂270张要多少步啊;1;0;1;18388;5.438329345225147e-05
63886;想问怎么删除跑的不好的词条啊;1;0;1;18388;5.438329345225147e-05
63889;up是妹子？脱单doge;1;0;1;18388;5.438329345225147e-05
63893;有人知道训练完以后怎么还原吗？不想要这次训练的成果怎么办。;1;0;1;18388;5.438329345225147e-05
63895;吃瓜吃瓜吃瓜可以分享一下你的Style文件吗吃瓜吃瓜吃瓜;5;0;5;18388;0.00027191646726125733
63903;数据预处理中使用deepdanbooru对硬件要求高吗;1;0;1;18388;5.438329345225147e-05
63905;开头点击Createembedding后右边文本框直接出现红色的erro没法继续是怎么回事啊？;4;0;4;18388;0.00021753317380900588
63910;rtx20504G显存好像跑不了训练了，64x64也会爆显存;1;0;1;18388;5.438329345225147e-05
63913;一般训练多少次才有效了，我扔了100多张图，5000次，居然一点效果没有，而且pt文件也只有4kb，真奇怪大哭脸红;4;0;4;18388;0.00021753317380900588
63918;需要视频中的训练图片;1;0;1;18388;5.438329345225147e-05
63920;求救，请问我在训练时它默认使用集显了怎么办？我已经在英伟达控制面板设置成独显优先了，可它还是只用集显，然后显存爆满开寄大哭;1;0;1;18388;5.438329345225147e-05
63923;ApplyingcrossattentionoptimizationDoggettx出现这个怎么办;1;0;1;18388;5.438329345225147e-05
63925;colab上最后一步没法跑不知道哪里出错了RuntimeErrorCUDAerrorunspecifiedlaunchfailureCUDAkernelerrorsmightbeasynchronouslyreportedatsomeotherAPIcallsothestacktracebelowmightbeincorrectFordebuggingconsiderpassingCUDALAUNCHBLOCKING1;2;0;2;18388;0.00010876658690450294
63928;有些人事不关己高高挂起啊，得了，我也放弃抵制了，但有人能给我指指路吗？我还能干什么？我该干什么？我就想挣个钱混口饭啊，再给我一次机会，我可不tm学绘画这坑人玩意，这下好了，两年后毕业直接失业了;2;0;2;18388;0.00010876658690450294
63933;这个声音是AI发音吧，这个声音也好听诶，是怎么弄的呀？;2;0;2;18388;0.00010876658690450294
63936;用BLIP标注和用deepdanbooru标注区别大么？初音未来问号;1;0;1;18388;5.438329345225147e-05
63938;能不能在谷歌colab上跑模型，然后导出来弄到本地音律联觉欢迎;3;0;3;18388;0.0001631498803567544
63944;卡在训练这一步爆显存了6GB的显存;2;0;2;18388;0.00010876658690450294
63947;up按你说的改了vae文件名但是我试了下还是能正常生成图，我到底卸载了没有啊;1;0;1;18388;5.438329345225147e-05
63949;尝试ai识别甘雨，扔进去50张画训练了5000次，感觉不太像藏狐;2;0;2;18388;0.00010876658690450294
63954;不知道为什么c盘少了好多空间，现在C盘没内存咋办笑哭;2;0;2;18388;0.00010876658690450294
63958;想问下训练的模型不满意想删了去哪删;2;0;2;18388;0.00010876658690450294
63961;如果是模仿画风需要开deepdanbooru选项吗;1;0;1;18388;5.438329345225147e-05
63969;大佬们最后一步训练时弹这个“TypeErrornotsupportedbetweeninstancesofstrandint”是什么问题啊;2;0;2;18388;0.00010876658690450294
63972;能不能在训练完一名角色一套服装的embeding基础上继续训练另一套服装，需不需要补充文字描述，文字描述在文件名里就行了吗;1;0;1;18388;5.438329345225147e-05
63977;ValueErrorcannotconvertfloatNaNtointeger训练完之后出图报错，有大佬知道怎么解决吗;1;0;1;18388;5.438329345225147e-05
63980;up，请问我在服务器上训练好了模型是只有pt那一个文件吗？我把它移到自己电脑上再装上deepbanbooru启用，生成图片却是二维码。。。还是说使用这个生成的模型也需要8GB以上显卡（我显卡是4GB），模型在服务器测试可用;7;0;7;18388;0.0003806830541657603
63990;RuntimeErrorExpectedalltensorstobeonthesamedevice，butfoundatleasttwodevices，cpuandcuda0whencheckingargumentforargumentindexinmethodwrapperindexselect出现了这样的报错，请问您知道怎么解决这个问题吗？万分感谢;17;0;17;18388;0.000924515988688275
64010;大佬，NAIFU能用这个么;1;0;1;18388;5.438329345225147e-05
64012;up，我装完了deepdanbooru之后但是在处理图片界面没有相关选项，请问是不是没有装好？笑哭;2;0;2;18388;0.00010876658690450294
64015;大佬问下，我在处理图片那里显示有第四个deepdanbooru选项，但是选了以后处理的时候显示找不到modeldeepdanbooru，是为啥啊;2;0;2;18388;0.00010876658690450294
64019;up问下爆显存了怎么有什么办法不;1;0;1;18388;5.438329345225147e-05
64022;up是什么配置？我这里点开始TrainEmbedding显示显存不足;1;0;1;18388;5.438329345225147e-05
64024;设置里有CLIPUnloadVAEandCLIPfromVRAMwhentraining训练时从显存中清除VAE启用apply后是不是不用可以不用重启直接训练;3;0;3;18388;0.0001631498803567544
64028;想问一下，训练好了一个embedding之后，如何继续增加新的图片进行训练？;2;0;2;18388;0.00010876658690450294
64031;问下我刚更新到最新版本，置顶的操作也做完了，Usedeepboorucaptionasfilename这个选项还是没有;2;0;2;18388;0.00010876658690450294
64035;问一下怎么回调啊，是不是直接把步数pt和对应的图片删掉然后用后面的补上就行了;12;0;12;18388;0.0006525995214270176
64052;卧槽。今天这个自助hyper都加上去了？a111真能抗压力啊。这么被人控诉偷代码都能逆流而上;1;0;1;18388;5.438329345225147e-05
64055;preprocess点了后一直loading是怎么回事;3;0;3;18388;0.0001631498803567544
64059;up您好，关于SD绘画AI的个人模型训练操作过程我个人遇到了一点问题想要咨询一下我个人使用的是笔记本电脑Y7000P8875H2060在创建Createembedding时一直显示error，CMD界面报错为：RuntimeErrorExpectedalltensorstobeonthesamedevicebutfoundatleasttwodevicescpuandcuda0whencheckingargumentforargumentindexinmethodwrapperindexselect从混合模式改为独显直连之后依然无法解决另附全过程显示的代码请问要如何解决呢？;7;0;7;18388;0.0003806830541657603
64068;如果有多个embedding，训练时会建立相互之间的关联吗？;1;0;1;18388;5.438329345225147e-05
64072;大佬如果已经训练完，加训，应该怎么做？;13;0;13;18388;0.0007069828148792691
64088;UP您好，我想咨询一下第二步的最后您视频里说，如果要训练novelAI的embedding，选最后一个Usedeepboorucaptionasfilename如果要训练用于stablediffusion的embedding，就选第三个UseBLIPcaptionasfilename我这里没有理解我用这个软件，他到底是啥？我理解是stablediffusionwebui，他跟stablediffusion是一个东西吗？如果是，是不是应该选第三个。视频里我看选的是第四个？请问怎么判断我这个软件是stablediffusion还是novelAI？;6;0;6;18388;0.0003262997607135088
64096;想问一下自动标注的tag顺序对结果影响大吗，准备用脚本固定一下前几个词条数据;4;0;4;18388;0.00021753317380900588
64102;UP主问一下在线上部署的可以使用吗;13;0;13;18388;0.0007069828148792691
64117;请问什么叫做拟合现象？;6;0;6;18388;0.0003262997607135088
64126;话说这正方形图片有尺寸要求吗;2;0;2;18388;0.00010876658690450294
64130;GTX1080点开始训练直接爆显存了。这个玩法是不是得306012GB起步;2;0;2;18388;0.00010876658690450294
64133;怎么才能判断过拟合了？tv疑问;1;0;1;18388;5.438329345225147e-05
64135;画风训练张数和运算步数的关系，up可以给个大概的范围吗;5;0;5;18388;0.00027191646726125733
64141;整不明白啊老师，Deepdanbooru是必须的吗，我下了一些别人的训练文件完全无效啊;7;0;7;18388;0.0003806830541657603
64151;WARNINGtensorflowNotrainingconfigurationfoundinthesavefilesothemodelwasnotcompiledCompileitmanually图像处理这里无法自动给图片文件自动添加描述是怎么回事，只能输出一个txt的描述文件，也看网上的解决方法把evaluatepy中compile改成false了还是这样tv笑哭;1;0;1;18388;5.438329345225147e-05
64155;这样训出来的人物是个整体是不能换衣服了是吗？有什么方案吗;1;0;1;18388;5.438329345225147e-05
64160;大佬的设备是啥？显存多大？这样训练一次需要多久？;2;0;2;18388;0.00010876658690450294
64163;我想问下，这个训练好了是只有自己可以用还是说所有用这个ai的都能用到？自己拿进去训练的图会进入类似于“总库”的地方吗？求大佬告诉我万分感谢;6;0;6;18388;0.0003262997607135088
64171;up，我现在啥都不干显存都满了，原来能画图现在都画不了了，这咋办大哭;9;0;9;18388;0.0004894496410702633
64185;RuntimeErrorSizesoftensorsmustmatchexceptindimension1Expectedsize20butgotsize19fortensornumber1inthelist这个报错是为什么呀;2;0;2;18388;0.00010876658690450294
64191;请问下up，训练好的信息存储在哪个文件里？;2;0;2;18388;0.00010876658690450294
64194;upup本地生成速度慢是什么原因阿，20步数也要好久，有没有提升速度的设置阿;1;0;1;18388;5.438329345225147e-05
64204;为什么我的settings里没有lnterrogatedeepbooruscorethreshold你们的版本是哪里下的脱单doge;4;0;4;18388;0.00021753317380900588
64212;弱弱问下大佬WEBUI这个东西会不会在打开的时候自动更新，我的WEBUI在setting中InterrogateOptions选项卡和大佬您的有点不同;1;0;1;18388;5.438329345225147e-05
64216;CUDAoutofmemoryTriedtoallocate25600MiBGPU0600GiBtotalcapacity472GiBalreadyallocated0bytesfree508GiBreservedintotalbyPyTorch热;4;0;4;18388;0.00021753317380900588
64221;出现FileNotFoundErrorWinError3系统找不到指定的路径。textualinversion20221013nahidapromptembeddings;12;0;12;18388;0.0006525995214270176
64238;这个解说语音是TTS吗，我怎么感觉有好几个音没有达到音准。;1;0;1;18388;5.438329345225147e-05
64240;点create直接报error是什么问题;2;0;2;18388;0.00010876658690450294
64243;能在云端部署吗，有没有云端生成的方式;2;0;2;18388;0.00010876658690450294
64249;同人都交给ai来画了，将来谁设计角色辣眼睛;2;0;2;18388;0.00010876658690450294
64256;InterrogateOptions下的那个选项我用的版本里没有，请问你现在用的是哪个版本？我感觉我安的版本有点乱套了。;1;0;1;18388;5.438329345225147e-05
64258;up最大显存8G的显卡就做不了这个embedding吗大哭;8;0;8;18388;0.00043506634761801175
64267;这是直接生成jpg之类的图片还是psd这种的源文件;1;0;1;18388;5.438329345225147e-05
64269;我也训练了很多，一般是DB和文本反转都训练，感觉用DB训练风格效果好一些;6;0;6;18388;0.0003262997607135088
64277;省流;5;139;144;18388;0.007831194257124212
64283;都做到这个程度了，不妨大胆一点;3;67;70;18388;0.0038068305416576026
64287;土包链接：httpspanbaiducoms1Y2SS7iyf7NQ7LXCCVDwoBgpwd06g9;3;47;50;18388;0.0027191646726125733
64291;有没有更刺激一点的指路。比如涩涩的。;1;5;6;18388;0.0003262997607135088
64294;说了很多次，转发视频要留名字，有这么难吗;6;4;10;18388;0.0005438329345225147
64301;这种应该不是“画”的吧？是有原图，然后AI拼接修图的？;7;3;10;18388;0.0005438329345225147
64309;sq行业大洗牌doge;1;2;3;18388;0.0001631498803567544
64316;这些人物比例没几张正确的;1;1;2;18388;0.00010876658690450294
64319;和头一样大就离谱了，不科学吃瓜;1;1;2;18388;0.00010876658690450294
64321;索佬依旧稳定发挥doge;1;1;2;18388;0.00010876658690450294
64323;怎么图片变了？我昨天看不是这些图啊;1;0;1;18388;5.438329345225147e-05
64328;你好，请问你可以把她们做成娃哈哈吗，我想谢谢她们脱单doge;1;0;1;18388;5.438329345225147e-05
64332;为什么显示提取码错误啊;1;0;1;18388;5.438329345225147e-05
64342;0020为什么ai画的手看起来都很恐怖的感觉甚至还有6指的无语无语无语;2;0;2;18388;0.00010876658690450294
64347;跟真人一样;1;0;1;18388;5.438329345225147e-05
64352;币给了;1;0;1;18388;5.438329345225147e-05
64355;这个其实就是用到了ai绘画中对抗技术的拼图;2;0;2;18388;0.00010876658690450294
64374;解压是？;1;0;1;18388;5.438329345225147e-05
64377;喜欢你的视频;1;0;1;18388;5.438329345225147e-05
64380;加油，已经三连，求图包;1;0;1;18388;5.438329345225147e-05
64396;发不出去什么鬼？;1;4;5;18388;0.00027191646726125733
64409;被吞了;1;0;1;18388;5.438329345225147e-05
64414;怎么总感觉像周姐;4;19;23;18388;0.0012508157494017839
64419;有没有不穿的;2;5;7;18388;0.0003806830541657603
64422;太模糊了每个1兆多为什么这么糊;1;1;2;18388;0.00010876658690450294
64425;打call有图包必三连;1;2;3;18388;0.0001631498803567544
64429;AI真棒;1;0;1;18388;5.438329345225147e-05
64434;有没有软件doge;2;0;2;18388;0.00010876658690450294
64437;脱单doge;1;0;1;18388;5.438329345225147e-05
64439;图片放大后好糊啊;1;0;1;18388;5.438329345225147e-05
64444;中餐或成ai克星;68;8542;8610;18388;0.46824015662388513
64513;AI目前的几大门题，手部不会画，腿偶尔出问题，画面丰富度较低，人物的色彩都很平滑，背景都很单调，甚至就没有背景，不会画男性剩下的问题集中在，全都是涩涩啊喂;58;4518;4576;18388;0.24885795083750273
64572;AI画手部画的贼拉，还有腿经常容易出毛病，但是不露手的就很神，区分不出来;44;2468;2512;18388;0.1366108331520557
64617;仔细一想，人学会用筷子吃面也需要个过程;22;1679;1701;18388;0.09250598216227975
64640;这个表情真的是吃面的表情吗;20;582;602;18388;0.03273874265825538
64661;ai直接把面条和吃东西联系起来了，没有给它一个用工具筷子叉子的学习过程，它自然会以为是用手抓;1;458;459;18388;0.024961931694583425
64663;ai，你们人类真难伺候，吃东西不就是把能量从接口摄入的行为吗？;6;249;255;18388;0.013867739830324124
64670;个人不喜欢ai画家这些东西出现总会给一些人搞事的机会热热;3;89;92;18388;0.005003262997607135
64674;ai理解的吃还是拿着食物往嘴里放，不如说婴儿吃面也这样吃;5;180;185;18388;0.010060909288666521
64680;已经有画师为了嘲讽AI画了个叉手的图，用AI识别后手部变成了一坨扭曲的如同乱成一团的耳机线一样的动作doge;1;235;236;18388;0.012834457254731346
64682;励志走过所有ai绘画视频祝大家学会使用ai绘画之后都能将自己心中的想法通过画面表达出来打call，但记住不要拿着ai绘画去嘲讽或否定那些真正付出过时间、金钱、精力和热爱，努力追逐梦想的画师们欧OK（如对本视频有不好的影响将立刻删除）又：有被笑到喜极而泣;3;189;192;18388;0.010441592342832281
64686;一抓一大把喜极而泣喜极而泣喜极而泣;3;118;121;18388;0.006580378507722428
64690;因为AI并不理解“逻辑”，其实任何一件具体的事它都拼不出来。;25;95;120;18388;0.006525995214270176
64716;你去让ai画美少女抠鼻子，估计直接是一团浆糊，根本没人画这个抠鼻;13;69;82;18388;0.00445943006308462
64730;如果给ai喂一堆垃圾，按道理来说是不是会拉低ai水平doge;13;59;72;18388;0.003915597128562106
64744;说白了就是danbooru没有吃拉面的tag，ai的学习方法和人不同，他不会去学底层的知识，不会学骨骼肌肉，生活常识。自然不懂筷子用法。他只是在一堆带eattag的画中找规律然后重现出来。;1;37;38;18388;0.0020665651511855556
64746;与其说是吃面不如说是复杂精准的交互动作目前AI还没学会（吃面涉及到手指与筷子的交互，人与餐具的交互动作），AI在画面大效果上做的很好了，反而是底层的人物动作交互逻辑有很大的问题。;3;62;65;18388;0.0035349140743963455
64750;弹幕里面“用ai绘画的不怕以后被失业”绷不住了，先不说ai绘画会不会导致人失业，这话的逻辑是真的蠢;12;27;39;18388;0.002120948444637807
64763;是因为学习材料不够丰富吧嗑瓜子;3;5;8;18388;0.00043506634761801175
64767;我看过一个更离谱的，是一个穿兜帽衫的，可能由于兜帽比较圆，ai把兜帽画成了第二个碗，特别生草;2;16;18;18388;0.0009788992821405265
64770;训练集里资料不多罢了，等两年呗;3;5;8;18388;0.00043506634761801175
64774;印度的ai喜欢直接用手抓着吃;1;5;6;18388;0.0003262997607135088
64776;只要露出手指就容易辨别;1;5;6;18388;0.0003262997607135088
64778;近期热点：1、AI绘画2、被强行开源的AI绘画微笑微笑微笑绘画区和计算机区或均被AI绘画攻陷微笑微笑微笑;30;25;55;18388;0.002991081139873831
64809;尊敬的顾客，欢迎来到评论区人工智能餐厅。自从人工智能普及后，我辞退了所有员工，我一个人就可以经营得很好了。以下是菜单：稞鸡浸布街坊生掺梨汁布鸡蒸七鸡马扯腹芝士供橘腐竹供橘豆拐籽苯蛹煲诶艾豆式烩圈削花甲豆哺怒鲤塔针削鸭滴制梅蛹布罐卧食煤油芹荃煤油荔枝煤油温花火盖泼肪本店承诺所有菜品皆由AI烹饪;8;22;30;18388;0.001631498803567544
64818;小问题，人类再进化进化，应该就会有吃播这么吃了脱单doge;5;21;26;18388;0.0014139656297585382
64824;TMD，这面吃的让我怀疑你不说是没关nsfw辣眼睛;3;31;34;18388;0.00184903197737655
64828;有没有一种可能，有人用AI画完会再次修图doge;1;16;17;18388;0.000924515988688275
64830;下个月ai就能改正过来了;2;4;6;18388;0.0003262997607135088
64833;我们群有个人AI绘画画出个古神来八个奶七条腿;1;4;5;18388;0.00027191646726125733
64835;有点掉san;1;4;5;18388;0.00027191646726125733
64837;ai特有不会画手;1;9;10;18388;0.0005438329345225147
64839;目前还是绝大部分可以一眼ai的，画风诡异的几乎没风格，;1;9;10;18388;0.0005438329345225147
64841;阿三我怎么分辨不出来？;2;10;12;18388;0.0006525995214270176
64844;啊啊啊啊啊我感觉这些AI做出来的图看着好诡异啊，可能是因为虽然是人，但身体的逻辑性是错的，就有点恐怖灵魂出窍;1;7;8;18388;0.00043506634761801175
64846;虽然但是，稍微合理怀疑一下，不管你输入什么（只包含一些名称，不包括奇怪的），除非表明是男性，不然AI最先生成的永远是女生;6;8;14;18388;0.0007613661083315206
64853;吃面的动作很多时候更像是，，doge;1;4;5;18388;0.00027191646726125733
64855;ai画人手不行，画其他亚人的带动物特征的异形手更是难绷还要就是ai调教不好打光会很神必，不过我还是想不明白为什么会有人给ai制图打码。这不是吃饱了撑的闲出屁了呢？;1;10;11;18388;0.0005982162279747662
64857;ai虽然说细节问题很大，但是给我们画个头像还是绰绰有余的doge;1;4;5;18388;0.00027191646726125733
64859;这tm看着好诡异啊，有种恐怖的感觉;1;4;5;18388;0.00027191646726125733
64861;小当家干脆面是吧;1;4;5;18388;0.00027191646726125733
64863;三条腿，四只手，腰部扭曲180度正常现象;1;4;5;18388;0.00027191646726125733
64865;目前ai画图的训练方式是一整张图训练，没有具体细分对特定人体部位。现在手部崩坏很多，而吃面这种需要手持特殊道具类的对ai来说就更加难以蒙对了。理论上当然可以训练一个专门画吃面的ai。但我觉得这样太蠢了。能不能先针对性训练只做手部绘画的ai，在训练一个整合各个部位的图的ai，把其它各个部位ai的图合到一起思考;1;13;14;18388;0.0007613661083315206
64867;看来ai还没学会用筷子doge;2;4;6;18388;0.0003262997607135088
64870;把面换成触手应该挺掉san的doge;2;4;6;18388;0.0003262997607135088
64873;我的AI拿可乐罐装面条;3;7;10;18388;0.0005438329345225147
64877;应该去画枪，各种反人类玩意;1;4;5;18388;0.00027191646726125733
64879;好奇怪，不知道为什么ai的画很好认就像看一眼就是ai画的那种感觉（大部分）委屈;7;4;11;18388;0.0005982162279747662
64887;弃之，食筷辣眼睛;1;12;13;18388;0.0007069828148792691
64889;图灵测试是吧？;1;9;10;18388;0.0005438329345225147
64891;AI绘画这面让人真的绷不太住;1;15;16;18388;0.0008701326952360235
64893;手和线条成为了ai最大的敌人思考;3;6;9;18388;0.0004894496410702633
64897;c，好好笑笑哭没有一个的手是正常的笑哭;1;3;4;18388;0.00021753317380900588
64899;这封面感觉在哪儿见过啊脱单doge滑稽;1;3;4;18388;0.00021753317380900588
64901;手抓面哈哈哈哈;1;6;7;18388;0.0003806830541657603
64903;你就说吃没吃吧;1;6;7;18388;0.0003806830541657603
64905;因为没有画画过的人，审美能力就像一坨大便，AI学习的东西就是大便了，所以说再怎么画都是大便;7;5;12;18388;0.0006525995214270176
64913;ai只是通过分享图片规律对应的大数据的算法，进步只不过是精确到一个像素和更大量的数据库，可别忘了人可不单单同过图片和别人的画来创造的，人是可以感知的这个世界的，听觉，触觉，味觉，等等方面，除非ai可以进化到有自我意识。;1;5;6;18388;0.0003262997607135088
64915;用ai的人都不怕以后自己被失业？;40;7;47;18388;0.0025560147922558192
64956;等一个ai提取真人动作融入绘画doge;1;5;6;18388;0.0003262997607135088
64958;搞不懂吃面脸红什么？滑稽;1;2;3;18388;0.0001631498803567544
64960;第1000条评论;1;2;3;18388;0.0001631498803567544
64962;其实矛盾点并不在消费者和画师之间，而是AI公司挪用了画师的作品喂AI，再出售服务，本质上是商用侵权。如果要用画师的作品喂AI，AI公司应该付钱给画师，像专利一样按月付或者买断都可以，然后才给消费者AI绘图服务。;1;2;3;18388;0.0001631498803567544
64964;円香酱你怎么了;1;2;3;18388;0.0001631498803567544
64966;逆天。;1;2;3;18388;0.0001631498803567544
64968;吃面这一块儿还是得看陈佩斯老师;1;2;3;18388;0.0001631498803567544
64970;总的来说还是因为喂的图片太少了，一个人只能有两只手，而且有些画师可能会有意无意的把画中的手藏起来，所以画成这样感觉也正常吃瓜;2;2;4;18388;0.00021753317380900588
64973;为什么吃面这么脸红了除非吃的不是面是（自行脑补dogedoge）;2;2;4;18388;0.00021753317380900588
64976;AI理解不了筷子，就正如人类理解不了AI呀笑哭;1;2;3;18388;0.0001631498803567544
64978;手抓面;5;2;7;18388;0.0003806830541657603
64984;说实话ai现在还是挺好识别的吧，都一个画风，一般p战上几张图一起一眼就能找出来ai图;1;2;3;18388;0.0001631498803567544
64986;AI绘画透视问题，人体比例，整体大小比例都有问题，;1;2;3;18388;0.0001631498803567544
64988;哈哈哈哈哈哈哈原来AI也不会画手;1;2;3;18388;0.0001631498803567544
64990;大部分情况看一眼肢体就可以鉴定出来了，所以我现在倾向于想办法让AI画图的时候把手给藏起来笑哭;1;2;3;18388;0.0001631498803567544
64992;我看过一个围巾，像个碗一样兜着面条吃面条，然后手拿着筷子还很奇怪，夹着筷子，另一个手指就像一个放汤的;1;2;3;18388;0.0001631498803567544
64994;有个担忧，中歺危机。;4;2;6;18388;0.0003262997607135088
64999;ai不能理解什么是筷子doge;1;2;3;18388;0.0001631498803567544
65001;人类：手ai：手;1;2;3;18388;0.0001631498803567544
65003;AI：菠萝披萨;3;2;5;18388;0.00027191646726125733
65007;十分甚至九分离谱的手视频卫星;1;2;3;18388;0.0001631498803567544
65009;ai画不出你准确想要的构图也画不出你准确想要的风格包括任何一个新事物都不能画，这些只能和画师交流才能有结果所以目前稍微有点能力的画师都不会丢饭碗的;1;2;3;18388;0.0001631498803567544
65011;谁要来AI去画正经的东西啊？虽然说不能很好的处理手部，但我可以用AI生成背手的捆dogedogedogedoge;2;2;4;18388;0.00021753317380900588
65014;感觉很恐怖灵魂出窍;1;2;3;18388;0.0001631498803567544
65016;：请跟我们走一趟。;1;2;3;18388;0.0001631498803567544
65018;就一缝合抄袭操作，坚决抵制辣眼睛;1;2;3;18388;0.0001631498803567544
65020;？热词系列知识增加;1;2;3;18388;0.0001631498803567544
65022;上次看到一個ai畫的，女生整個腦袋在麵碗裡面？？？到底而且是誰教ai人類吃面要用三根筷子的啦;1;2;3;18388;0.0001631498803567544
65024;不懂就问这是进了二郎真君的庙了吗;1;2;3;18388;0.0001631498803567544
65026;不要小看人类啊一把抓起泡面塞嘴里;1;2;3;18388;0.0001631498803567544
65028;ai只会越来越厉害别说ai哪里有确定只是你电脑算力不够或ai图吃少了;1;2;3;18388;0.0001631498803567544
65030;求BGM;1;2;3;18388;0.0001631498803567544
65032;面像是她们吐出来的一样（）;1;2;3;18388;0.0001631498803567544
65034;ai正在逐渐适应人类社会生活习惯doge;1;2;3;18388;0.0001631498803567544
65036;手全是鸡爪子，我看到有张图，直接只有一只脚，就很离谱。;1;2;3;18388;0.0001631498803567544
65038;円香吼吼吼脱单doge;1;2;3;18388;0.0001631498803567544
65040;笑飞了;1;2;3;18388;0.0001631498803567544
65042;（拿着筷子吃面条）;1;2;3;18388;0.0001631498803567544
65044;不要小看人类啊ai徒手抓面doge;1;2;3;18388;0.0001631498803567544
65046;说实话ai绘画很好认，能直接看出来，不只是吃面妙啊;1;2;3;18388;0.0001631498803567544
65048;怎么感觉这样更涩了脱单doge;1;2;3;18388;0.0001631498803567544
65050;不懂得筷子;1;2;3;18388;0.0001631498803567544
65052;我比較想看洗澡doge;3;2;5;18388;0.00027191646726125733
65056;我承认我想歪了，我的错跪了;1;2;3;18388;0.0001631498803567544
65058;円;1;2;3;18388;0.0001631498803567544
65060;刚刚在E站看见这个的misc，现在B站就给我推这个？三星堆;1;2;3;18388;0.0001631498803567544
65062;第一张图，那白色是认真的吗？;4;2;6;18388;0.0003262997607135088
65067;几万年前第一个发明并且使用筷子的人脑抽了，这个世界将会怎样doge;2;2;4;18388;0.00021753317380900588
65070;uni赤这不来整个活吃瓜;3;2;5;18388;0.00027191646726125733
65074;野蛮人精华近战伤害18暴击5攻速10“被迫臣服老对手的礼物，它从一群徒手吃面的女性抢来”;3;2;5;18388;0.00027191646726125733
65078;ai画的手真奇怪;1;2;3;18388;0.0001631498803567544
65080;独一无二的阿狸766号草爆笑了;6;2;8;18388;0.00043506634761801175
65087;推荐通知书尊敬的up主，您好，由于您的作品过于出色，现已放上推荐页面，希望您的作品能做得更好。bilibili观众认证;1;2;3;18388;0.0001631498803567544
65089;让ai理解筷子还是有点太高深了;1;2;3;18388;0.0001631498803567544
65091;手抓面是吧;1;2;3;18388;0.0001631498803567544
65093;樋口円香笑麻了妙啊;1;2;3;18388;0.0001631498803567544
65095;ai：别急，这就偷;1;2;3;18388;0.0001631498803567544
65097;还挺有意思的;1;2;3;18388;0.0001631498803567544
65100;模型的训练集数据有问题;1;1;2;18388;0.00010876658690450294
65102;我觉得手的问题未来可以解决，我猜想绘画ai不懂手的交互，那未来可不可先匹配差不多的3d模型，模型运算出正确情况，然后ai在根据3d建模的结果匹配画手的图案。瞎想的;1;1;2;18388;0.00010876658690450294
65104;乐死我了大笑;1;1;2;18388;0.00010876658690450294
65106;叁柅安;1;1;2;18388;0.00010876658690450294
65108;更明显，AI缺少生活经验呢建议来地球待会当然还有视频作者doge问候一下Up，您在地球住还适应吗？;1;1;2;18388;0.00010876658690450294
65110;AI觉得筷子是种手部装饰品;1;1;2;18388;0.00010876658690450294
65112;？fob热词系列知识增加;1;1;2;18388;0.00010876658690450294
65114;让AI画倒立，裙子不反重力的那种，它能画出一个算我输;2;1;3;18388;0.0001631498803567544
65117;还有汉服我今天用draft，意间等试过了，不管你写入多少正确的关键词，它生成的汉服都是非常不标准的;1;1;2;18388;0.00010876658690450294
65119;“ai不会画手”;1;1;2;18388;0.00010876658690450294
65121;ai手不会画;1;1;2;18388;0.00010876658690450294
65123;ai是懂吃面的滑稽滑稽;1;1;2;18388;0.00010876658690450294
65125;如果说AI都是缝合的，那么这种吃面，画手之类的缝不出来吗？;1;1;2;18388;0.00010876658690450294
65127;你可以看到古神级别的手，基本上就是了;1;1;2;18388;0.00010876658690450294
65129;属于是数据不足了，画吃面的图的的确少;1;1;2;18388;0.00010876658690450294
65131;对于现在的ai来说，不怕有问题，就怕发现不了问题，有问题就能解决，迟早技术会变得更好。;2;1;3;18388;0.0001631498803567544
65134;6;1;1;2;18388;0.00010876658690450294
65136;可爱;1;1;2;18388;0.00010876658690450294
65138;练铁砂掌呢难过;1;1;2;18388;0.00010876658690450294
65140;筷子，手，AI一生之敌;5;1;6;18388;0.0003262997607135088
65146;区区Ai，不要把我看扁了啊（抓起刚泡好的面）;1;1;2;18388;0.00010876658690450294
65148;你把面一换，就说的过去了doge;4;1;5;18388;0.00027191646726125733
65153;枪械也不会画;1;1;2;18388;0.00010876658690450294
65155;0;1;1;2;18388;0.00010876658690450294
65157;太掉san了;1;1;2;18388;0.00010876658690450294
65159;神秘的东方力量;1;1;2;18388;0.00010876658690450294
65161;新的xp系统出现了doge;1;1;2;18388;0.00010876658690450294
65163;笑死，ai连手、人物吃面、游泳、古生物等都不会画，还想替代画师，先把这些搞好再说吧;1;1;2;18388;0.00010876658690450294
65165;望月youse;2;1;3;18388;0.0001631498803567544
65168;BuStUpperkon哈哈哈哈哈哈哈哈哈哈哈哈哈哈;3;1;4;18388;0.00021753317380900588
65172;球老哥们给个ai画图的网站吧脱单doge脱单doge;1;1;2;18388;0.00010876658690450294
65174;新型图灵测试;1;1;2;18388;0.00010876658690450294
65176;逆天;1;1;2;18388;0.00010876658690450294
65178;筷子哪有手用着方便doge;1;1;2;18388;0.00010876658690450294
65180;试试输入“轮椅”，人长轮椅上了笑哭;1;1;2;18388;0.00010876658690450294
65182;哈哈哈哈哈;3;1;4;18388;0.00021753317380900588
65186;AI绘画并不是缝合。与其说是缝合，不如说是AI临摹别人的画，模仿其他人的手法画出了自己的话。不过这样子做到底是侵权还是不侵权？假设一个人每天都临摹另一个人的画，过了一两年后自己画出来的画就变得和那一个人很相似，那他现在拿自己的画赚钱，这是否是侵权了他临摹画的那个人呢？;1;1;2;18388;0.00010876658690450294
65188;AI画手真的不行，太拉了;1;1;2;18388;0.00010876658690450294
65190;别说，在生草这一方面ai也不如人类;1;1;2;18388;0.00010876658690450294
65192;打开印度市场OK;1;1;2;18388;0.00010876658690450294
65194;手抓面确信;1;1;2;18388;0.00010876658690450294
65196;有谁和我一样，第一个画面想歪了;1;1;2;18388;0.00010876658690450294
65198;画面丰富度以及背景可以调的很好。;1;1;2;18388;0.00010876658690450294
65200;感觉在鉴定一些伪人;1;1;2;18388;0.00010876658690450294
65202;看我一个太阳风暴让Al全部报废;3;1;4;18388;0.00021753317380900588
65206;所以最好自己得会点画，ai才能用的6。;1;1;2;18388;0.00010876658690450294
65208;看到了吧，手画不好真的不是我的锅人工智能都学不会doge;1;1;2;18388;0.00010876658690450294
65210;有一说一ai未来能做的事太多了;1;1;2;18388;0.00010876658690450294
65212;但是一般没人会约吃东西的商稿;1;1;2;18388;0.00010876658690450294
65214;我也没见过有几个画师画吃面的图，太少了，AI没得学，但是mdk做梦也不会想到就因为这个张热搜吧;1;1;2;18388;0.00010876658690450294
65216;不加吃面tag不就行了这还能成辨认方式？;1;1;2;18388;0.00010876658690450294
65218;没绷住;1;1;2;18388;0.00010876658690450294
65220;职业吃面选手円香;1;1;2;18388;0.00010876658690450294
65222;月初：ai杀疯了，完犊子了月末：看ai画嗦面jpg;1;1;2;18388;0.00010876658690450294
65224;至于ai不会画手这件事，让我想到了某个不不喜欢画手所以就画了俩个小丫丫的画师脱单doge;1;1;2;18388;0.00010876658690450294
65226;Immortals巨好听;1;1;2;18388;0.00010876658690450294
65228;这种问题可能过两个月就被优化了;1;1;2;18388;0.00010876658690450294
65230;这是什么网站;3;1;4;18388;0.00021753317380900588
65234;AI地方美食手抓面;1;1;2;18388;0.00010876658690450294
65236;ai还画不好猫耳女仆，尾巴老是飞在一旁;1;1;2;18388;0.00010876658690450294
65238;好恐怖;1;1;2;18388;0.00010876658690450294
65240;我一眼都能看出来偷的哪个太太的图;1;1;2;18388;0.00010876658690450294
65242;好二呀;1;1;2;18388;0.00010876658690450294
65244;这AI是印度的吗，吃什么都用手抓doge;1;1;2;18388;0.00010876658690450294
65246;因为吃和面是两个不同的tag，学吃的时候大多数都是手拿着吃的，结果画吃面的时候就大概率出手抓面，按这么想其实也有极小概率出用筷子吃苹果。历史上出过类似问题，解决方法叫特征交叉。;7;1;8;18388;0.00043506634761801175
65254;等模型训练多了感觉就解决了;1;1;2;18388;0.00010876658690450294
65256;画师新工作，画面;1;1;2;18388;0.00010876658690450294
65258;求BGM？;2;1;3;18388;0.0001631498803567544
65261;和触手同理doge;1;1;2;18388;0.00010876658690450294
65263;ai一画高跟鞋底部就出问题傲娇;1;1;2;18388;0.00010876658690450294
65265;面条换牛奶，将是绝杀;1;1;2;18388;0.00010876658690450294
65267;ai特有的不会画手恼;1;1;2;18388;0.00010876658690450294
65269;在贴吧看到圆香吃面条的图的时候真的很震惊，因为前不久c100上那个圆香本我非常喜欢辣眼睛囧囧;3;1;4;18388;0.00021753317380900588
65273;汐一牛;3;1;4;18388;0.00021753317380900588
65277;疯狗侠AZ;1;1;2;18388;0.00010876658690450294
65279;ai不会用筷子哈哈哈哈哈哈;1;1;2;18388;0.00010876658690450294
65281;upup我想问问円香的tag是什么微笑微笑微笑;1;1;2;18388;0.00010876658690450294
65283;ai嘛，目前只能满足较低层次的需求;1;1;2;18388;0.00010876658690450294
65285;我超，円;1;1;2;18388;0.00010876658690450294
65287;其实就是素材库和训练时间问题呗;1;1;2;18388;0.00010876658690450294
65289;就是说，有些图的嘴型和我在某些地方看别人吃某些东西的时候画的嘴型一模一样啊，这是从哪学来的辣眼睛;1;1;2;18388;0.00010876658690450294
65291;因为素材不够微笑;1;1;2;18388;0.00010876658690450294
65293;果然ai也觉得手难画;1;1;2;18388;0.00010876658690450294
65295;姑姨早茶？酱紫画;5;1;6;18388;0.0003262997607135088
65301;超越尝试笑哭看来AI还不知道人类是怎么吃;1;1;2;18388;0.00010876658690450294
65303;哥布林窝的女骑士啊;1;1;2;18388;0.00010876658690450294
65305;去sky餐厅整点薯条;2;1;3;18388;0.0001631498803567544
65308;云尔东;2;1;3;18388;0.0001631498803567544
65311;看AI绘画像看鬼片一样，毛骨悚然;1;1;2;18388;0.00010876658690450294
65313;相信我，很快的ai从完全不会画到现在才几年可能一年两年之内这些都能克服;6;1;7;18388;0.0003806830541657603
65320;让ai画一个千手观音吃面嗑瓜子;1;1;2;18388;0.00010876658690450294
65322;什么网站捏;1;1;2;18388;0.00010876658690450294
65324;枪械食品特定服饰ai目前都是不能做好的，毕竟只是单纯对色块进行计算没有理解到这些物品的整体性;1;1;2;18388;0.00010876658690450294
65326;ai出的图分辨率都不高;1;1;2;18388;0.00010876658690450294
65328;她们在吃一种很新的面;1;1;2;18388;0.00010876658690450294
65330;不知怎的，看着有点怪诞;1;1;2;18388;0.00010876658690450294
65332;我说这几天円香tag下面全是吃面给我看笑了;1;1;2;18388;0.00010876658690450294
65334;不知道为啥，感觉有点吓人;1;1;2;18388;0.00010876658690450294
65336;得看ai高不高级;1;1;2;18388;0.00010876658690450294
65338;那ai应该也画不好绳子吧？tv白眼;1;1;2;18388;0.00010876658690450294
65340;什么手抓面哈哈哈哈哈哈哈哈哈哈哈哈哈;1;1;2;18388;0.00010876658690450294
65342;挺好的，鬼畜。可以有很奇怪的灵感;1;1;2;18388;0.00010876658690450294
65344;某种层面上甚至超越了人类;1;1;2;18388;0.00010876658690450294
65346;太牛逼了，哈哈哈;1;1;2;18388;0.00010876658690450294
65348;哈哈哈哈哈哈哈哈哈哈哈哈哈哈;1;1;2;18388;0.00010876658690450294
65350;擁有北極星尤木长纪好好笑哈哈哈哈哈哈哈哈哈脱单doge;4;1;5;18388;0.00027191646726125733
65355;有点想看麻婆豆腐了笑哭笑哭笑哭;1;1;2;18388;0.00010876658690450294
65357;有点像还没有脱离用手进食的本能的人形生物囧;1;1;2;18388;0.00010876658690450294
65359;吃个面脸红个泡泡茶壶;1;1;2;18388;0.00010876658690450294
65361;我知道为什么会发生这种事。因为AI的搜索图库里是没有用筷子吃面条这种图的。你要是说什么白毛，福瑞或者是机甲，它都可以搜出来。;1;1;2;18388;0.00010876658690450294
65363;哈哈哈哈哈哈哈;1;1;2;18388;0.00010876658690450294
65365;有点涩;1;1;2;18388;0.00010876658690450294
65367;AI画的女生全都有蜜汁腮红辣眼睛辣眼睛;1;1;2;18388;0.00010876658690450294
65369;可能是ai研发者主要是西方人，对东亚的筷子文化不是很熟悉;1;1;2;18388;0.00010876658690450294
65371;ai的辨识度还是蛮高的;1;1;2;18388;0.00010876658690450294
65373;ai两个瞳孔画不了一样基本都是画风不一纹理不一或者一个有高光一个没高光高光形状不一样的Catstudy;1;1;2;18388;0.00010876658690450294
65376;猪蹄是认真的吗？辣眼睛;1;1;2;18388;0.00010876658690450294
65378;看完之后觉得有点诡异，我考，好像全人类开始一起抵制人工智能，类似于那种电影最开始的预备战时期（（;1;1;2;18388;0.00010876658690450294
65380;JYAMA;1;1;2;18388;0.00010876658690450294
65382;AI不是画图而是把多个他人的素材切割拼接出来，所以手这种角度一错就很诡异的人体构造就很容易扭曲;1;1;2;18388;0.00010876658690450294
65384;用ai作画发出来不标是ai作画的人都是什么（）啊热;1;1;2;18388;0.00010876658690450294
65386;就是想要亚撒西;1;1;2;18388;0.00010876658690450294
65388;ai是不是不能理解面条筷子头发以及吃这些设定;1;1;2;18388;0.00010876658690450294
65390;干净又卫生啊兄弟们;1;1;2;18388;0.00010876658690450294
65392;五根筷子取材自冬泳怪鸽，她直播时一只手五根筷子。;1;1;2;18388;0.00010876658690450294
65394;哈哈哈哈哈ai分不出面条和筷子;1;1;2;18388;0.00010876658690450294
65396;吃别的就没有问题了吗;1;1;2;18388;0.00010876658690450294
65398;离谱;1;1;2;18388;0.00010876658690450294
65400;EuryWestwood被ai逻辑气死前;3;1;4;18388;0.00021753317380900588
65404;傻白假发子;2;1;3;18388;0.0001631498803567544
65407;哈哈哈哈，每一幅都有一个怪的地方笑哭;1;1;2;18388;0.00010876658690450294
65409;弦年Ahren好怪哦，再看一眼;5;1;6;18388;0.0003262997607135088
65415;为啥我看出了一丢丢的惊悚片的感觉笑哭，一群人失了魂以后机械地重复把食物塞进嘴里的动作，哪怕自己早就吃不下了跪了;1;1;2;18388;0.00010876658690450294
65417;为什么ai学不会筷子吃面？ai对于一些长条形的东西区分度似乎是不太行，最经典的问题就是手指。因为长条形这种东西主要出现在头发上，而手有很多时候因为是兽娘魔物娘导致有时候并不是手指。再加上筷子和面条都是长条形的东西，ai就更加困惑了小电视笑;1;1;2;18388;0.00010876658690450294
65419;柯赜仔细看有点掉san值。。。;1;1;2;18388;0.00010876658690450294
65421;哈哈哈;1;1;2;18388;0.00010876658690450294
65423;看四肢就好了doge;1;1;2;18388;0.00010876658690450294
65425;哈哈哈哈哈哈哈哈哈哈哈哈哈;3;1;4;18388;0.00021753317380900588
65429;猴子捞面;1;1;2;18388;0.00010876658690450294
65431;你可以试试看食谱上的配料比如高筋面粉500g蜂蜜2勺之类的前两天看到有个人用这个ai做菜笑哭笑哭笑哭;1;1;2;18388;0.00010876658690450294
65433;不是手吗;1;1;2;18388;0.00010876658690450294
65435;笑得想死;1;1;2;18388;0.00010876658690450294
65437;我食面円香dogedogedoge;1;1;2;18388;0.00010876658690450294
65439;我感觉AI和画师的关系就像是老师和学生，到后期AI应该就会学习关于日常细节动作的刻画了那仔细一想没有画师AI是不是就没法进步了热词系列知识增加;15;1;16;18388;0.0008701326952360235
65455;太吓人了;1;1;2;18388;0.00010876658690450294
65457;那用得着吃面，看手就好，出一百张图，没有一张的手是正常的，不是黏连就是畸变;1;1;2;18388;0.00010876658690450294
65459;plaeyr;1;1;2;18388;0.00010876658690450294
65461;试试倒立;1;1;2;18388;0.00010876658690450294
65463;过几个月就不会这样了;1;1;2;18388;0.00010876658690450294
65465;AI的问题;5;1;6;18388;0.0003262997607135088
65471;绘画ai在线学吃面;1;1;2;18388;0.00010876658690450294
65473;训练集的问题，我加1w的吃面图，用超算搞上个几天，肯定就没问题了;1;1;2;18388;0.00010876658690450294
65475;印度程序员doge;1;1;2;18388;0.00010876658690450294
65477;基本上AI现在的水平只适合画大头，稍微复杂点的动作就弄不动了，目前看来那种画得稀烂还敢要几百的大头“画师”们真的可以下岗了;5;1;6;18388;0.0003262997607135088
65483;蚌埠住了;1;1;2;18388;0.00010876658690450294
65485;哈哈哈哈哈哈;1;1;2;18388;0.00010876658690450294
65487;这是人类的一次大胜利;1;1;2;18388;0.00010876658690450294
65489;笑拉了;1;1;2;18388;0.00010876658690450294
65495;看样子ai是没吃过面（;1;1;2;18388;0.00010876658690450294
65497;感觉原图手持的食物都是蛋糕披萨面包，而ai直接素材替换的;1;1;2;18388;0.00010876658690450294
65502;说实话把她们嘴里的面换成两蛋一肠都毫无违和感辣眼睛;1;0;1;18388;5.438329345225147e-05
65509;不像校花，像只因;6;47;53;18388;0.002882314552969328
65516;壁纸在简介里自取星星眼，求一键三连，主页还有很多精美视频壁纸哦;5;26;31;18388;0.0016858820970197955
65522;当然是书好看，一个皮囊岂能比得上数千年人类智慧的结晶？;1;13;14;18388;0.0007613661083315206
65524;全都突出一个大字;1;11;12;18388;0.0006525995214270176
65529;有点黑doge;1;1;2;18388;0.00010876658690450294
65533;图可以妙啊，要是视频的过渡效果，换成正常的切换就好了，有点晕这个过渡效果笑哭;1;1;2;18388;0.00010876658690450294
65536;看好扔字;1;0;1;18388;5.438329345225147e-05
65538;美女看书，我看美女看书，好看吃瓜;1;0;1;18388;5.438329345225147e-05
65540;这个AI手画的还行;1;0;1;18388;5.438329345225147e-05
65542;诶，手居然没什么违和感了。不过背景不太适合人物，这样的应该出现在各位帅比床上才对doge;1;0;1;18388;5.438329345225147e-05
65544;哟西，图包滴有，关注三连大大滴有。;1;0;1;18388;5.438329345225147e-05
65546;有没有福利图？doge;1;0;1;18388;5.438329345225147e-05
65548;完美，细节;1;0;1;18388;5.438329345225147e-05
65550;想要tag;1;0;1;18388;5.438329345225147e-05
65552;和周姐好像;1;0;1;18388;5.438329345225147e-05
65554;书能给我力量，你只能令我流失力量doge;1;0;1;18388;5.438329345225147e-05
65557;啥软件画得;1;0;1;18388;5.438329345225147e-05
65559;那个图9我看来看去也没看懂是怎么个图;1;0;1;18388;5.438329345225147e-05
65561;看好扔字;1;0;1;18388;5.438329345225147e-05
65563;有没有福利图？doge;1;0;1;18388;5.438329345225147e-05
65565;我来看下doge;1;0;1;18388;5.438329345225147e-05
65567;已三连等个大大链接;1;0;1;18388;5.438329345225147e-05
65569;封面周淑怡是吧;1;0;1;18388;5.438329345225147e-05
65571;这个AI手画的还行;1;0;1;18388;5.438329345225147e-05
65573;哟西，图包滴有，关注三连大大滴有。;1;0;1;18388;5.438329345225147e-05
65575;图呢，链接没有这个图;2;0;2;18388;0.00010876658690450294
65578;完美，细节;1;0;1;18388;5.438329345225147e-05
65580;我希望ai发展是替代一些枯燥乏味的事，而不是遏制想象创新思考;40;4243;4283;18388;0.23292364585599304
65621;我从来没在意ai该画画就画画，机器人始终机器人;24;1351;1375;18388;0.07477702849684577
65646;ai不用取代米山舞，能取代我就足够逼我转行了;23;1641;1664;18388;0.09049380030454644
65670;虽然我不认可ai绘画，但是不得不说米山舞已经是业内top级的画师了，这样的比较毫无意义。其次就是ai的发展速度真的很离谱，就才是初步阶段，一年后估计就要开始翻天覆地的。不用多时ai绘画会超过业内保守估计90的画师了。纠结ai的能力是没有意义的，真正要指责的是滥用ai作为商业侵犯原创画师权益这件事情。;2;602;604;18388;0.03284750924515989
65673;bro，你拿业界最顶尖的画师与ai比我玩ai画图一周了，说实话，如果只是头像的话可以完爆寻常画师，ai也是可圈可点的;73;2132;2205;18388;0.11991516206221449
65747;AI不需要画得最好AI只需要做到性价比最高找绘画大佬，花1w的钱就出1w的图找ai，几秒钟就能出几百块质量的图，成本是多少？本地部署只需要出电费罢了;59;785;844;18388;0.04589949967370024
65807;AI已经把未来的“米山舞”们扼杀在摇篮里了，任由AI发展下去，底层画师很难生存的;2;281;283;18388;0.015390472046987165
65810;噗，抵触的从来不是ai，而是自己没有本事却利用ai去跟顶流画师齐平的草履虫doge;49;539;588;18388;0.031977376549923865
65860;感觉ai绘画压根不是一个技术问题，而是一个版权问题，谁允许ai用人家画师的画作了呢？;9;427;436;18388;0.02371111594518164
65870;救命，不要再把米山舞的画喂给ai啊啊啊啊笑哭取代我到也无所谓，我本来就烂，但是如果ai真的学到了那种张力表现，这个破世界怕不是要搞文艺复兴了笑哭;27;263;290;18388;0.015771155101152925
65898;米山舞根本取代不了，Ai目前的二次元画风让我产生审美疲劳辣眼睛;15;113;128;18388;0.006961061561888188
65914;AI前几个月前还什么都画不出来，现在已经超越不少中端画师了，这学习速度已经超越绝大部分人。看看再几个月后ai能成长到什么地步。;34;143;177;18388;0.00962584294104851
65949;绘画ai就这么容易训练，但写作ai怎么训练，喂进去多少网文，还是人工智障辣眼睛;8;72;80;18388;0.004350663476180117
65958;听劝自己创作的和机器人画的能一样嘛，灵魂的画作需要你们的小手去画，up准备了500多个百个画师合集，画师名字都给宝子们陈列出来了，画师psd源文件，绘画过程图，图集，线稿，米山舞，anmi鬼刀，望月，老累，眠狼，国外国内的画师等等打call打call打call打call快来学习;7;165;172;18388;0.009353926473787253
65966;拿ai跟顶尖画师比就已经说明问题了。更不用说现在ai还产生了很多不良的影响，比如有的人把大佬的作品喂给ai然后用于商业用途，或者发在网上赚取流量或粉丝，这种侵权问题管起来非常麻烦。然后ai是在不停进步的，几个月前还不能画色图，现在已经有人开始尝试了，成没成功不知道。ai的进步速度是人永远比不上的，它的效率比人高的多，如果不及时发布一些法律来监督我觉得后果挺可怕的;19;292;311;18388;0.016913204263650207
65986;AI目前段位在铂金，你这直接拿王者这还是峡谷之巅的王者这能比么笑哭;16;148;164;18388;0.00891886012616924
66003;如果未来的某天，AI真的代替了人类在绘画与动漫领域大放光彩，成为主角，我会怀念曾经与现在，我认为每个人都有无限的可能去创造，我不希望这种火苗被掐灭或者变得微弱，说实在我不喜欢AI在绘画或者艺术领域等的发展太高，科技可以在很多地方改变我们的生活，让我们生活更加便利，但我希望能留下几个角落留给人类去亲自创造，表达爱，有个灵魂慰藉的地方。已经不明白科技给人类带来的到底是什么了，是幸福？不全是吧。对我来说现在AI绘画带来的更多是下面普通画手们的苦恼，还有对这个行业未来的不好的影响。;1;78;79;18388;0.004296280182727866
66005;取代不了顶尖画师而已;6;27;33;18388;0.0017946486839242985
66012;只能说目前，因为AI的进步速度真的可怕。要知道隔壁下棋的当年也被阿尔法狗打败了，而几年后阿尔法狗又被新AI阿尔法源以0：100的比分打败了;7;50;57;18388;0.003099847726778334
66020;现在的ai绘画作品确实是有所欠缺，无论是绘画风格还是用色，意境，都还不能达到世界顶级的level，但是你如果换个角度思考，ai绘画出现才多长时间世界的顶级画师们练了几年拿一个还不成熟的新手作画与米山舞的作品相比，这不就像把高中数学题拿给一年级小学生看如果ai作画再发展几年，我们看到的肯定不会只有现在这个水平，到时候您还能说出降维打击这种话吗而且你这个视频是归类在画师推荐这一目的的吧，否认一方以反衬另一方的方式真的好吗，你怎么就能确定被否认的一方不会生气我并不偏向哪一方，我只是觉得你的观点过激。;1;16;17;18388;0.000924515988688275
66022;你们最喜欢的画师是谁？？？热词系列递话筒热词系列递话筒热词系列你细品;12;13;25;18388;0.0013595823363062867
66035;先说一嘴，不要去拿别人的图去喂ai为了分享米山舞老师的图踩ai绘画，这种感觉就是拿博士生跟小学生比谁的知识储备多。ai绘图画的不是挺好的吗不太理解。而且绘图不就是图个乐的玩意吗;1;12;13;18388;0.0007069828148792691
66038;ai取代的是中下甚至中段画师，对大佬没有任何影响;12;48;60;18388;0.003262997607135088
66051;别忘了金政基的画都被人喂出来一个ai，米山舞的画应该已经有人在训练了，推上有些知名画师已经被ai整破防了吃瓜吃瓜;1;51;52;18388;0.0028279312595170763
66056;该画画呗，一帮不画画的外行人搁那扯啥，看着都好笑，屁事没有就纯纯看乐子。还有，如果ai能打消一部分人对美术的热爱，恕我直言，这类人并不适合学画画，我本人并不支持ai，但只是想从画里掏钱或满足自己的虚荣心，我觉得，ai倒成了好东西，把这种人都扫出去最好吃瓜;3;53;56;18388;0.0030454644333260824
66060;放心吧，隔不了不久就能给你技术突破了，到时候顶尖画师也不用了，大家都喝西北风去吧胜利爱心胜利;30;15;45;18388;0.002447248205351316
66093;现在的AI绘画画风单一没有张力，人物表情很平淡，看了很多个AI的画，表情基本都一致，看不出有什么感情，而且手部都怪怪的;5;31;36;18388;0.001957798564281053
66099;是，世界上没有那么多米山舞，但是AI绘画的过度发展必然会扼杀未来的米山舞;4;39;43;18388;0.002338481618446813
66104;说话前给自己留点后路吧脸不疼吗？我没见到AI多狂妄倒是见到人性多狂妄;3;9;12;18388;0.0006525995214270176
66108;ai哪天能把图层分出来我再承认ai可以取代画师，在此之前全都是屁三星堆;6;28;34;18388;0.00184903197737655
66115;大约5个月后，情况迥然不同了。;1;6;7;18388;0.0003806830541657603
66117;你们是喜欢AI绘画呢还是米山舞大大的画呢？？？吃瓜吃瓜吃瓜;2;11;13;18388;0.0007069828148792691
66122;很悲哀的情况就是，AI很难取代米山舞等画师，但是取代你足够了捂脸;1;20;21;18388;0.0011420491624972808
66127;拿一个兴起1年的ai跟业界顶尖画师比还没说明问题么？柯洁跟阿尔法持续了多久？结果如何？而且在座的各位，应该见过顶尖ai的作图，真的跟对比视频里的ai是一个等级么？不说别的，你看完这个视频，他下面的推送里，也有比视频里ai强百倍的图。ai会取代画师么？不会。是因为米大师画的比他好么？不是的，是因为ai需要他。甚至说句讨人嫌的话，你把米山舞的名字输进去，ai一天画出2000幅仿风格，你分不出哪张是ai哪张是他的。这还是个婴儿ai。;4;13;17;18388;0.000924515988688275
66133;今天就看到一个回复普通画师啊啊啊啊，ai抢我饭碗。大佬画点ai不会的doge;1;5;6;18388;0.0003262997607135088
66135;专业信息工程的业余画手原神嗯我觉得版权问题可不是个小问题哦，训练集里塞了多少无授权的东西才弄出这个玩意儿，不能商用的话就只能拿来玩？;3;12;15;18388;0.000815749401783772
66141;问一下这个世界有比米三舞更强的人吗;18;6;24;18388;0.0013051990428540352
66160;现在有多狂未来就有多惨;5;10;15;18388;0.000815749401783772
66167;基础术士都没学完，画出来当然一般。把结晶法及其变种菱镜法加上试试看？当然，可能还是比不过顶尖画师，但是比你这幅要好看的多的多。;2;10;12;18388;0.0006525995214270176
66170;看看最新ai作品，有一部分手部已经有骨骼了，你学一百年不如人家学一百秒，但你的极限是一百年;3;5;8;18388;0.00043506634761801175
66177;画师只是一群喜欢画画并努力的人，怎么搞得好像全民公敌一样？天天说要取代取代。好像真被代替了外行人就很高兴一样;1;3;4;18388;0.00021753317380900588
66179;想起来该开始ai绘画刚出来时朋友对我跟随互联网的趋势发癫的样子发出了灵魂的一问：“绘画对你来说到底是商业还是兴趣？”直接给我问沉默了，后来想了好久，到现在也没有想明白。;1;3;4;18388;0.00021753317380900588
66182;你怎么不拿momoko的模型跑的图来说了？;1;3;4;18388;0.00021753317380900588
66191;这忽然让我想到了当年改革开放有轨电车普及时一些车夫卧轨抗议。不过反正我只知道ai的发展和学习不会因为人们的抗议而停止。;4;4;8;18388;0.00043506634761801175
66197;那你就太小看ai了;11;4;15;18388;0.000815749401783772
66209;“人工智能对人类的冲击，并不是史无前例的。自动化、流水线人一直被机器威胁着。我们应该比任何人都清楚，不能因为人的原因，阻碍科技的进步啊。科技已经淘汰了很多人，将来还会继续淘汰更多人。时代前进的车轮，是无法停止、无法被阻拦的。”;6;5;11;18388;0.0005982162279747662
66217;ai不能取代所有画师，但是一大部分画师可以被ai取代辣眼睛;1;2;3;18388;0.0001631498803567544
66219;AI，如果研究出来帮我们画手补助的话，应该还行，抢我们工作是啥意思？而且他也没有想象力和艺术感。唉，如果能代替我去上班就好了，去帮我转钱搬砖，然后我画梦想他工作，如果研究机器人来搬砖造房子的话，那房子会不会便宜很多？把一些很累的活让机器人来干，让机器人制造食物种粮食，那该多幸福啊，人类就不用上班就可以天天享受做喜欢的事，嗯找个机器保姆也不错啊而不是来抢的画师的饭tv难过画师本来就赚不到啥钱，;1;2;3;18388;0.0001631498803567544
66225;NovelAIAI绘画不说AI画的你可能都不信12哔哩哔哩httpsb23tvhae2M1R;1;2;3;18388;0.0001631498803567544
66230;如果大部分人类想着以后绘画就依靠AI去画画，那么人类画师干脆就停下脚步别去思考了怪我咯怪我咯;4;2;6;18388;0.0003262997607135088
66235;实话说，越来越期待ai的未来了，这是时代的进步;2;2;4;18388;0.00021753317380900588
66241;我很好奇中低层画师的收入来源有哪些部分，AI的出现是让哪部分受到了打击;1;2;3;18388;0.0001631498803567544
66243;AI永远打不过真正的大佬;6;2;8;18388;0.00043506634761801175
66250;米山舞的级别猜猜看ai需要多久达到;2;2;4;18388;0.00021753317380900588
66256;视频不错;1;1;2;18388;0.00010876658690450294
66259;取代不了米山舞，可以取代唯w;1;6;7;18388;0.0003806830541657603
66279;我记得有一幅调了好几个月的ai画的画还得奖了，你怎么不拿那幅画和米山舞比无语;6;1;7;18388;0.0003806830541657603
66290;画师永远超越不了ai绘画，不要问，问就是ai绘画就相当于智能搜资源形成图书馆一样，然后将其全部作品特点什么的全部收集甚至融合交汇改造等，还有一件事提醒就是ai绘画才出了多久，要是给时间发展或许未来全部都有可能ai绘画，甚至ai动漫什么的;1;1;2;18388;0.00010876658690450294
66294;鉴别是不不是AI的唯一真理让它画用筷子吃面条哒;1;1;2;18388;0.00010876658690450294
66296;所以米山舞到底是不是右翼。。有说辟谣的有说是的我现在懵掉了;2;1;3;18388;0.0001631498803567544
66302;实话说，我觉得过几年就没什么ai画不出来的了，只不过现在ai还没有吃够顶级大佬的画而已;1;1;2;18388;0.00010876658690450294
66306;拒绝ai偷画师画作进行训练，但是我可以分享ps源文件哦呼;2;2;4;18388;0.00021753317380900588
66309;AI应该能代替一部分画师了，但那些顶尖的肯定代替不了;1;2;3;18388;0.0001631498803567544
66311;ai最恐怖的是它在飞速进步，每时每刻;4;2;6;18388;0.0003262997607135088
66317;AI的效率和成本不是人类能匹敌的，以后甲方资本肯定更喜欢AI。AI一天能出一万张稿件，人类哪个画师能做到？;5;2;7;18388;0.0003806830541657603
66328;已经有很多大佬拿米山舞的图训练AI模型了而且效果还不错吃瓜吃瓜吃瓜吃瓜吃瓜吃瓜吃瓜;2;1;3;18388;0.0001631498803567544
66338;ai侵犯了了版权;1;1;2;18388;0.00010876658690450294
66340;你都和米山舞比了还有啥好说的;1;1;2;18388;0.00010876658690450294
66350;AI怎能与神明并肩;1;0;1;18388;5.438329345225147e-05
66361;在座的各位你们说为什么画画叫画画，画画的乐趣就在画出来的过程啊喂;5;0;5;18388;0.00027191646726125733
66369;但是AI会不断进步啊;2;0;2;18388;0.00010876658690450294
66378;AI太简洁了，细节太少，而且有些三头六臂的，基因突变了已经是doge;2;0;2;18388;0.00010876658690450294
66383;至少ai目前还画不出来漫画;1;0;1;18388;5.438329345225147e-05
66391;无聊，真要米山舞比不过AI了，绘圈当场就崩溃找理由了;9;0;9;18388;0.0004894496410702633
66402;说到这个，前几天在lofter上刷到了一个博客，里面所有都是ai创作出来的画，但人家不说，我根本看不出来，人家博主显然是用到淋漓尽致了，每一张的效果都不像视频里展示的那几张那么呆板所以这是要考验使用者tag运用技术了doge;2;0;2;18388;0.00010876658690450294
66407;不应该将用手锄地和用锄头锄地相比较，ai是工具，米山舞画了十几年画出这种水平，而用ai几小时就可以达到这水平的一半。而且米山舞画一张图的时间够ai生成成千上万张图了。更何况谁说ai不会进步？ai绘画引起关注才几个月的时间吧，就已经从古神风格进化成这样了。现在ai拼接的是画面，但当未来ai拼接的精细度到达线和像素的水平时，你们又如何鉴定这是否抄袭呢，这样程度的ai难道就不是原创吗？;2;0;2;18388;0.00010876658690450294
66410;别急，马上AI就剽窃米山舞的图;3;0;3;18388;0.0001631498803567544
66414;但业界有几个米山舞根本不担心自己的画被擅自拿去喂ai呢？非利益相关;1;0;1;18388;5.438329345225147e-05
66417;取代不了米山舞，但是可以把米山舞当素材库。;3;0;3;18388;0.0001631498803567544
66422;ai怎么学都学不到情感，无法引起共鸣;7;0;7;18388;0.0003806830541657603
66432;你不会以为人人都是米山舞吧偷笑;1;0;1;18388;5.438329345225147e-05
66451;ai画画是不是大量原画拼凑出来的呀;3;0;3;18388;0.0001631498803567544
66457;让我来告诉你们，很久以前，有一个命题叫无限猴子，那时候的人们有一个想法，假如在无限的时间里有一群拥有无限寿命的猴子在用打字机不停的打字，那么有一天它们会碰巧打出一部哈姆雷特吗？你的答案是什么？如果回答是肯定的话，你也有一些疑问，比如，这群猴子效率低，太慢了，现实中不可能有无限寿命的猴子之类的，可是假如它的寿命是电源的话就几乎达到了长寿，它的速度如果能每秒钟出百万千万乃至亿万本书的话，哪怕里面只有一部杰作呢？岂不就是远远的超出了人类呢？那个年代的人们受技术影响只能想象出打字飞快的猴子，我们这个年代的人受技术影响也只能想象出现在的ai罢了，既然猴子能打出哈姆雷特，为什么它们不能画出蒙娜丽莎呢？更何况ai比猴子效率更高，寿命更久还拥有更强大的学习能力，所以我的结论就是，ai迟早会取代人类，就算是最顶级的大师也会甘拜下风，只不过技术还没达到那种地步罢了。;2;0;2;18388;0.00010876658690450294
66466;别乱玩我的机器人万一真引战了doge;9;383;392;18388;0.021318251033282574
66476;偷窃别人的图还不用被告侵权，哈哈，以后再这样搞就没人做画师了，也没有新的动漫作品诞生了，一起摆烂吧吃瓜;30;554;584;18388;0.03175984337611486
66507;因为wlop人家是程序员，本来就不靠这个吃饭。;9;384;393;18388;0.021372634326734828
66517;突然想到如果以后ai多了网上一天冒出几万几十万张图，然后每个人发张图瞬间被别人的图刷屏耍走了，那是不是不止审美疲劳而是搞得大家都没得玩了，毕竟你的图连在别人眼里停顿的时间可能都没了。;7;276;283;18388;0.015390472046987165
66525;属于是剽窃了你的画还砸了你的饭碗吃瓜;4;221;225;18388;0.01223624102675658
66530;如果不是像金政基那样的脑容量和多核CPU兼人形打印机，还是乖乖用ai吧，毕竟3d辅助都用了，参考线都用了，参考图也找了，就算是默写，也是自己见过的，就算没见过也是自己见过的东西拼出来的，所以，大胆的用吧，只要有能源，电脑、blander、人工智能。。。就是你的机械臂，你的装甲，浩克那么强，不照样被钢铁侠打趴下了doge;20;107;127;18388;0.006906678268435936
66551;鬼刀算很开明的大佬，他有几个作品是blender3d辅助绘画的，ai绘画起来了，他一定是接纳的态度打call;17;103;120;18388;0.006525995214270176
66569;ai真要用的灵活还是得画师来用，目前还是大锅炖，因为想要细化东西就需要添加关键词，而人体结构透视正常人肯定没画师理解的多，对于画师来说只是减少工作一些繁琐的过程;6;68;74;18388;0.004024363715466608
66576;ai绘画现在用来做辅助参考挺好用的，但是替代人类为时尚早;2;30;32;18388;0.001740265390472047
66579;对Ai绘画感兴趣的朋友，可以加入我们的Ai艺术绘画交流群550559821，我在群里搭了免费的Ai机器人，大家进来打字就可以玩AI。;12;33;45;18388;0.002447248205351316
66592;围棋ai下赢围棋九段之前，大佬们也是很欢迎ai来挑战他们的。doge;6;41;47;18388;0.0025560147922558192
66600;我至今没明白这能辅助画师什么，那些所谓聪明人这么拿技术挤兑人的话离灭亡也不远了;6;41;47;18388;0.0025560147922558192
66607;wlop大佬虽然人气很高，但是真的称不上是顶尖画师，顶流并不代表顶尖，真要说顶尖怎么也得是黄光剑，阮佳那一批大佬才对。;6;35;41;18388;0.00222971503154231
66614;这对于原创来说ai还真不一定是啥好东西就好像你辛辛苦苦画了张画，结果人家反手给你来个ai，而且现在对于ai的界定还蛮模糊笑哭不大有利于保护原创;1;22;23;18388;0.0012508157494017839
66616;ai最终还是工具的。以前19世纪机械出来了，很多人感觉非常糟糕，觉得工人要被淘汰了藏狐;46;24;70;18388;0.0038068305416576026
66663;有几张脸崩的跟驴一样喜极而泣;1;14;15;18388;0.000815749401783772
66665;ai作画也有审美鸿沟的，画画好的人用ai纯生成的图肉眼可见比外行有设计感。况且ai作画技术上的难度基本为零，最后拼的还是画师的审美和画技原神喝茶并且参考图功能再完善一下，就可以画师画完构图，导入后生成精准作图。人人都站在台阶上，台阶就相当于不存在doge;5;16;21;18388;0.0011420491624972808
66673;支持ai就是格局，不支持ai就不是格局了吗热;1;5;6;18388;0.0003262997607135088
66677;ai毁的是中低层画师啊，他们的工资会受到很大影响，入行的也会缩减，ai让刚入行，刚学的人会有很大的冲击;3;10;13;18388;0.0007069828148792691
66685;你画一张几天到一个月AI一天能画几千甚至几万张;6;3;9;18388;0.0004894496410702633
66692;主要他自己就是程序员doge;1;3;4;18388;0.00021753317380900588
66694;我想看看ai画吉成曜那种类型的画是什么样子的。;1;3;4;18388;0.00021753317380900588
66699;ai可别把路走偏了啊;1;9;10;18388;0.0005438329345225147
66701;wlop不靠画画吃饭的吃瓜;4;5;9;18388;0.0004894496410702633
66709;作为一个刚刚入行没一年的新人画师，因为ai的原因，我失业了，我身边有很多画师设计师朋友都失业了。我们平时那么卷最后还是失业了，现在没办法了，我们只能去别的行业卷了。估计再过两年，原画和插画行业要消失了，其他行业也会越来越卷doge。想进这行的人建议别来，工作又累工资又低，还没有前途，人怎么能干过ai呢doge？;3;6;9;18388;0.0004894496410702633
66721;已经看到有人卖ai作图了，笑死，甚至130一张。;2;5;7;18388;0.0003806830541657603
66724;首先人家叫wlop不叫鬼刀;5;6;11;18388;0.0005982162279747662
66735;讲道理人体五官标准对电脑来说不是应该很简单嘛为啥老画不准;13;2;15;18388;0.000815749401783772
66750;我在想是不是在AI里输入了鬼刀关键词;1;2;3;18388;0.0001631498803567544
66763;有什么可抵制的新形态的画笔罢了新兴事物总是被抵制当年还有人抵制4g网络呢;1;2;3;18388;0.0001631498803567544
66769;wlop还是挺会说话的，不像有的画师发现这种状况就先急眼了吃瓜;2;1;3;18388;0.0001631498803567544
66809;更想问问现在抵制这抵制那的，是怎么看乌合麒麟的拼贴画doge，大佬借助3d借助渲染太常见的做法了;1;0;1;18388;5.438329345225147e-05
66812;笑哭鬼刀是漫画的名字啦;1;0;1;18388;5.438329345225147e-05
66817;老哥，怎么才能做出这样的效果呀，我用默认模型，弄出来都是漫画那种;18;41;59;18388;0.0032086143136828365
66836;图的确很好看，就是不够慷慨，有没清凉亿点点但不是过于清凉的？;7;32;39;18388;0.002120948444637807
66844;玩了几天ai，肾有点不笑哭舒服;5;16;21;18388;0.0011420491624972808
66850;可惜了C站上面koreanDollLikeness这个模型被撤掉了这个模型的作者的其他模型作品也撤掉了蛋疼还没下载就没了不知道哪位b友可以分享一下;19;28;47;18388;0.0025560147922558192
66870;细枝挂硕果doge;1;11;12;18388;0.0006525995214270176
66872;胸怀大痣，这ai好懂啊;1;5;6;18388;0.0003262997607135088
66875;koreanDollLikeness的v10和v15都有谁要的V我。;1;0;1;18388;5.438329345225147e-05
66878;这个网站可以用chilloutmix和koreandoll滑稽滑稽滑稽;1;0;1;18388;5.438329345225147e-05
66880;up有没有这个lora的网盘啊。。。这个下载了doge三连给你;1;0;1;18388;5.438329345225147e-05
66882;兄弟们，怎么打开civital那个网站的18内容呀，每次打开都让我登陆，然后就链接中断，这大大影响了我的学习成绩脱单doge;4;1;5;18388;0.00027191646726125733
66891;为什么我就是生成不出这张脸啊chilloutmixkoreanDollLikeness我都有;2;0;2;18388;0.00010876658690450294
66909;up求个原图;1;0;1;18388;5.438329345225147e-05
66912;兄弟下载的图包怎么打开啊;3;5;8;18388;0.00043506634761801175
66916;up，给个原图;1;0;1;18388;5.438329345225147e-05
66918;这个lora是什么意思？;3;0;3;18388;0.0001631498803567544
66922;咒语给一份，一定要有衣服遮掩的pls;2;1;3;18388;0.0001631498803567544
66927;大佬，有群吗？求带;1;0;1;18388;5.438329345225147e-05
66930;网站503了，难受;2;5;7;18388;0.0003806830541657603
66934;为什么我前几张生成的图片很好，到后面生成的人脸就变了，而且越变越丑;1;0;1;18388;5.438329345225147e-05
66936;up能把lora分享一下吗星星眼;1;0;1;18388;5.438329345225147e-05
66938;up能出一个参数调整的教程么，我做的效果远远不如你的好dogedogedogedoge打call;2;1;3;18388;0.0001631498803567544
66941;请问up用的是什么vae;1;2;3;18388;0.0001631498803567544
66943;这个lora如果下载下来是safesence文件的话放到哪里？还是lora吗;3;0;3;18388;0.0001631498803567544
66947;底模是在c站搜吗？好像没看到藏狐;5;0;5;18388;0.00027191646726125733
66953;咒语呢;1;0;1;18388;5.438329345225147e-05
66955;为什么AI能懂什么叫胸有大志;1;0;1;18388;5.438329345225147e-05
66957;那么，今天的小破站就逛到这里了;1;1;2;18388;0.00010876658690450294
66959;up，这个的内存要多大啊？;11;0;11;18388;0.0005982162279747662
66971;up，这个模型在哪搞啊脱单doge;1;1;2;18388;0.00010876658690450294
66974;koreanDollLikeness，怎么加描述呀;4;0;4;18388;0.00021753317380900588
66979;这个音乐好耳熟doge;1;0;1;18388;5.438329345225147e-05
66981;罗辑：大史，你去帮我找找这个图里的妹子。;8;661;669;18388;0.03638242331955623
66990;550a现在只能制作照片，过段时间550w出来就可以ai制作动画了，普通动画画师可以退了，新的职业一定是ai调教师。;7;197;204;18388;0.0110941918642593
66998;这ai画的人体比我还好tv笑哭tv笑哭;20;100;120;18388;0.006525995214270176
67019;小小红你让我陷入疯狂我要狠狠欺负你必须强迫你穿罗体围裙跳舞跳到掉小珍珠;2;59;61;18388;0.0033173809005873395
67022;真不错，比真人cos好看多了，但是一听说是ai画的不知道为什么就兴致大减;15;81;96;18388;0.005220796171416141
67038;已经到这种程度了吗，以后是不是可能有ai做的影视作品;10;42;52;18388;0.0028279312595170763
67049;017这胳膊;2;43;45;18388;0.002447248205351316
67053;看我这张小红怎么样;1;12;13;18388;0.0007069828148792691
67055;彻底打消了我想学画画的念头;2;19;21;18388;0.0011420491624972808
67058;坤儿蠢蠢欲动了。谢谢;1;11;12;18388;0.0006525995214270176
67061;小红可是俺们山东的骄傲;4;15;19;18388;0.0010332825755927778
67068;b站里我见过cos小小红最传神的是叽叽的朋友圈脱单dogeOK;2;16;18;18388;0.0009788992821405265
67074;不是说明天发嘛，这么晚还不睡;3;12;15;18388;0.000815749401783772
67078;低荧陆吾陆再也不会路过的小学生乙游手好闲的陈皮;1;3;4;18388;0.00021753317380900588
67084;博主，你偏心，帕瓦和玛奇玛都有百度网盘，小小红怎么没有，专栏上的图不全星星眼星星眼星星眼;1;1;2;18388;0.00010876658690450294
67100;杨幂吧;1;0;1;18388;5.438329345225147e-05
67107;ai不看手都还行辣眼睛;1;0;1;18388;5.438329345225147e-05
67109;把手剁了就是完整体了;1;0;1;18388;5.438329345225147e-05
67113;生成的已经很逼真了，赛博女友指日可待doge;1;0;1;18388;5.438329345225147e-05
67119;雨天橙子君;1;1;2;18388;0.00010876658690450294
67122;你是个爪爪大潮，给我找找图里的妹子;1;0;1;18388;5.438329345225147e-05
67129;什么时候能ai拍片;1;0;1;18388;5.438329345225147e-05
67133;这还学啥呀现成的多好脱单doge;1;2;3;18388;0.0001631498803567544
67138;请问大佬能做下大户爱的cospaly嘛谢谢辛苦啦;1;2;3;18388;0.0001631498803567544
67149;艹了怎么那么像我同桌;2;0;2;18388;0.00010876658690450294
67158;我觉得不够瑟呲牙;1;0;1;18388;5.438329345225147e-05
67170;汀洲汀洲;1;0;1;18388;5.438329345225147e-05
67174;场景衣服动作很多，但是表情好像都差不多;1;2;3;18388;0.0001631498803567544
67181;想知道有没有不穿衣服版本的;4;0;4;18388;0.00021753317380900588
67194;像一个女优思考但我名字忘了;2;0;2;18388;0.00010876658690450294
67212;最关键的，我tm的觉得ai的图不好看，真的不好看。由文本纯生成图的ai作品真的难看。吹ai的人横竖要反思自己的审美;7;0;7;18388;0.0003806830541657603
67241;哥，发卡怎么加的，为啥我跑不出来呢;2;1;3;18388;0.0001631498803567544
67246;有一种古神的美，你们发现没;4;140;144;18388;0.007831194257124212
67251;这得看着多少人噜啊，眼忙脚乱的doge;3;68;71;18388;0.003861213835109854
67256;0003;2;12;14;18388;0.0007613661083315206
67260;八块腹肌大球雌性的诱惑呲牙吃瓜;2;9;11;18388;0.0005982162279747662
67264;严肃的讲，在可预见的未来，人类画师被彻底全部淘汰后如何更好的让AI设计出人为操作AI的优化作品干掉对手人为操作AI设计出干掉对手人为操作的AI优化作品的优化作品？dogedogedogedoge;21;6;27;18388;0.0014683489232107897
67286;我已经感受到某些人要失业了;6;4;10;18388;0.0005438329345225147
67293;应该不止我一个注意到吧;1;2;3;18388;0.0001631498803567544
67302;Zfoolish来眨眼补帧;1;0;1;18388;5.438329345225147e-05
67312;用这拍个夜勤病栋嗬嗬;4;51;55;18388;0.002991081139873831
67317;我感觉我生病了doge;1;12;13;18388;0.0007069828148792691
67319;238这张特么太像我前女友了，手机差点掉地上。。。。太像了而且刚好是护士辣眼睛;3;11;14;18388;0.0007613661083315206
67325;包呢？吃瓜;3;4;7;18388;0.0003806830541657603
67330;什么模型？;3;2;5;18388;0.00027191646726125733
67335;要是阿里云多好，百度会员过期了大哭;2;2;4;18388;0.00021753317380900588
67341;老规矩，关注，点赞，收藏，没币了，三连了，求图;1;2;3;18388;0.0001631498803567544
67343;继续加油;1;2;3;18388;0.0001631498803567544
67345;UP主加油;1;2;3;18388;0.0001631498803567544
67348;为啥提取码错误;1;1;2;18388;0.00010876658690450294
67353;一位靓仔点赞路过;1;1;2;18388;0.00010876658690450294
67359;阿里盘的提取码多少;1;0;1;18388;5.438329345225147e-05
67366;拒绝女色，从我黑吉辽京津冀新藏蒙陕甘宁晋鲁豫青苏皖沪川贵渝鄂湘赣闽台桂粤港澳琼滇做起;2;0;2;18388;0.00010876658690450294
67378;AI为什么能精准画出大包doge;18;1242;1260;18388;0.06852294974983685
67397;AI的第四张图真的好可爱，这个项圈应该不是AI自学的吧doge;2;462;464;18388;0.02523384816184468
67400;项圈和大包真的很适合你呢喜欢但是细节和画风看得出来和你有很大差别。话说这个AI是在哪弄的？;16;322;338;18388;0.018381553186860997
67417;蓝色深得都成蓝精灵了doge;2;152;154;18388;0.008375027191646726
67421;蓝色有点过于深了。把blue改成lightblue，或者lightskyblue，或者skyblue试试？我自己跑了下，lightblue比较接近你的颜色;1;54;55;18388;0.002991081139873831
67423;能看，但有些细节方面还是有很大的差距的;3;55;58;18388;0.003154231020230585
67428;咱就是说，为什么都有项圈呢？;1;10;11;18388;0.0005982162279747662
67430;那小傻改大大以后是不是就能用AI来摸鱼了Cat2Astromeawt;7;16;23;18388;0.0012508157494017839
67438;突然决定站边ai滑稽;1;9;10;18388;0.0005438329345225147
67440;AI画画的归途终究是作为人类的工具，大家千万不要杞人忧天，自乱阵脚，这么多UP主都说了，我们为什么偏还要担心这些，我们难道不能团结起来自发维护圈中的风气吗？我们中国人就这么脆弱吗？我们就这么不堪一击吗？5000年的历史，一百多年的革命，现代教育难道就只教会了我们逃避吗担心被替代就去让自己无法被替代，去战斗，去练习，面对舶来品，我们却如同和一百多年的人，愚味，胆怯，我们新生代为什么就不来拿出底气和血性让长辈和外人高看我们我们绝不会向AI画画妥协，也绝不会允许人文主义的没落。人在状态最好时是最高贵的动物，但如果违背法律和正义，他会变成最恶劣的动物心存奸险命数变狗驴岂能称至尊;10;30;40;18388;0.0021753317380900587
67461;请问up是怎么喂图的保卫萝卜哇;1;4;5;18388;0.00027191646726125733
67464;AI画的总感觉有点生疏吃瓜;5;2;7;18388;0.0003806830541657603
67470;不如傻老师一根xxx;2;2;4;18388;0.00021753317380900588
67475;AI软件在哪里，我也要整一个脸红;1;1;2;18388;0.00010876658690450294
67477;所以是什么软件？;3;2;5;18388;0.00027191646726125733
67493;为什么b会推给我福瑞消息暹罗猫小豆泥呆滞;1;0;1;18388;5.438329345225147e-05
67510;我记得有个游戏里面就是这首歌，你们都是什么游戏吗，求了;4;0;4;18388;0.00021753317380900588
67519;模仿且超越喜欢问问什么软件;1;3;4;18388;0.00021753317380900588
67525;然后就可以当懒狗了（bushi）;2;1;3;18388;0.0001631498803567544
67529;光影比本人好（自认为，暴论，不代表任何群体，仅代表个人）;2;0;2;18388;0.00010876658690450294
67534;假面雷普Cat2Boom;1;0;1;18388;5.438329345225147e-05
67541;笔触还是模仿不来的脱单doge;1;0;1;18388;5.438329345225147e-05
67543;肯定有脸红和大包的词条脸红;2;0;2;18388;0.00010876658690450294
67555;为什么还是觉得AI的画有点怪呢;1;0;1;18388;5.438329345225147e-05
67558;AI画的也很棒呢，不过相比人画的AI的少了一点毛茸茸的感觉，非常很光滑思考;1;0;1;18388;5.438329345225147e-05
67560;up能分享下网址吗;5;0;5;18388;0.00027191646726125733
67566;大佬深度学习这部分怎么跑的有教程吗我有自己的图片包想加进去;2;0;2;18388;0.00010876658690450294
67572;感觉以后都是ai画画了人类被机器替代了热保卫萝卜哭哭;2;1;3;18388;0.0001631498803567544
67578;果然身体比例、透视和上色AI还是不行;1;1;2;18388;0.00010876658690450294
67580;那个，请问怎么使用这个AI呢，求大大tv难过;2;1;3;18388;0.0001631498803567544
67587;鼓掌提个建议：以后做的图做两个版本的，一种是手机竖屏壁纸类的，另一种是电脑高分辨率大图屏保类的，这样两种类型的用户都能吸引到，以后AI作图区你就是标杆点赞;5;36;41;18388;0.00222971503154231
67593;看多了这种东西以后找对象只能找有趣的灵魂了，毕竟好看的皮囊真的好看不过这些笑哭;2;22;24;18388;0.0013051990428540352
67596;质量越来越好了，谢谢分享打call;1;7;8;18388;0.00043506634761801175
67598;现实中真的有这么美的女人吗？;6;5;11;18388;0.0005982162279747662
67605;分辨率不够，放在电脑上糊藏狐;2;5;7;18388;0.0003806830541657603
67608;有没有进澡堂子感觉的图吃瓜;1;4;5;18388;0.00027191646726125733
67610;以后技术进步了，能不能造一个出来脱单doge;3;3;6;18388;0.0003262997607135088
67615;已赞，送你上首页;3;2;5;18388;0.00027191646726125733
67620;up主，我看这女的样子都一样的，怎么做到的？;1;1;2;18388;0.00010876658690450294
67623;求图包;1;1;2;18388;0.00010876658690450294
67627;支持点赞;1;1;2;18388;0.00010876658690450294
67629;加油阿，up;1;1;2;18388;0.00010876658690450294
67631;喜欢你的视频;1;1;2;18388;0.00010876658690450294
67634;好看;1;1;2;18388;0.00010876658690450294
67636;视频看到的是高清但是下载后用在电脑作为墙纸就变得有点模糊了分辨率是19201080;1;0;1;18388;5.438329345225147e-05
67638;这歌真的是太好听了星星眼星星眼星星眼给心心给心心给心心喜欢喜欢喜欢;1;0;1;18388;5.438329345225147e-05
67640;已三连，求图包;1;0;1;18388;5.438329345225147e-05
67645;老哥有没有提示词？;1;0;1;18388;5.438329345225147e-05
67667;想问下up这个图片有没有高清的;3;10;13;18388;0.0007069828148792691
67671;忘了放地址了补下httpswwwaliyundrivecomsu5RbDFjf8CD提取码qn25;13;4;17;18388;0.000924515988688275
67685;御医把朕的大力丸拿出来泡水吃瓜;1;1;2;18388;0.00010876658690450294
67687;刚看完一份，又要看一份，身体营养都跟不上了藏狐;1;1;2;18388;0.00010876658690450294
67697;提取码错了;1;0;1;18388;5.438329345225147e-05
67701;包的有点多;1;0;1;18388;5.438329345225147e-05
67705;我评论居然被吞了。。。话放这里了，但凡支持AI盈利都不曾真情实感的创作过自己作品的人，你们没有资格发言怪我咯但凡了解一下AI的运行方式，都能知道AI就是通过学习各种各样的图片，通过无数次的试错与重复学习最后变成了现在的样子。可以说，AI是可以做到集所有作品之长的。但是，但是请各位记住，能够支撑起AI的还是人本身。如果人类从来没有创作过画作，那么AI绘图也不会诞生。所以AI画本质上还是人的作品。那些用AI图来谋取利益的人，虽然法律还不能制裁他们，但请各位一定要记住，这就是侵权;84;5145;5229;18388;0.28437024146182294
67790;ai绘画和aicos全是用太太们的图揉捏成的机械怪物，用这些程序盈利的更是狗屎配牛粪微笑;78;6229;6307;18388;0.34299543180335
67869;这就跟你写的作文发在网上，且你还活着版权未公开，然后发现一个人抽了你作文中的一段和其他人的作文拼在一起，再拿去参加了一个作文比赛，赚到了奖金，或者放到网上有一大批流量藏狐;58;5939;5997;18388;0.32613661083315204
67928;ai都能生成h图了还在这龇着个大牙乐呢以后谁看你不顺眼拿两张你的照片生成发布到网站我看你找谁哭;7;573;580;18388;0.03154231020230585
67936;评论区我都看了，ai技术本身是科技的发展，但是ai绘画和aicos就是侵权玩意儿，是应该被否认的程序，而且这俩玩意的存在已经逼走了很多手打太太了本来是为爱发电结果被人用来盈利我骂aicos那条视频明显戳到很多人痛处了，评论区一群人骂我，骂我真无所谓，但是你不抵制我不抵制，迟早有一天会在小网站上看到自己的脸至于有人说这条视频嘲讽了投喂者，我只能说你想多了，我嘲讽他们我就不会叫他们妈咪了，虽然他们也算是变相支持ai，但是他们也是受害者，就像是买到了假药的病人，所以这条视频我只是抵制ai绘画和抵制ai盈利而已;17;2822;2839;18388;0.15439417011094192
67954;支持ai创作的无异于须弥城人民依赖于虚空终端，没有画师的创新，再过十年二十年ai所产生的画也就那样，人体动态、服饰、背景等就丝毫不会产生进步，想想大贤者那些人是怎么跌落的;1;324;325;18388;0.017674570371981727
67957;其实我一直搞不懂营销ai制图时说的：让不会画画的人也能描绘出自己想的世界这种。你不学肯定不会啊这不是废话吗，你不学那你干嘛想着要画啊好好笑，这件事情就像是，你不去进行航空训练指着火箭说我要上太空一样。;6;204;210;18388;0.011420491624972808
67964;还有偷图赚打赏的，人家正主就在老福特还是免费的它们怎么敢的无语;12;2889;2901;18388;0.1577659343049815
67977;这张图热度高很大原因是“ai画图”的tag被老福特推送了。老福特现在就是暗戳戳地支持ai绘画。挺恶心人的无语;10;1578;1588;18388;0.08636067000217533
67988;笑死了，别的地方甚至还有人冷嘲热讽说ai比画师牛逼，画师被抢了蛋糕破防什么的我想说拿ai盈利的嘲讽手工的哪来的脸热;1;162;163;18388;0.008864476832716989
67990;ai绘画在哪都能出现，就是不能在老福特这种为爱发电产粮的地方出现微笑老福特几年前大家一直都是为爱产粮，想打赏就打赏，结果这几年官方想捞钱，各种彩蛋付费功能都出来了，这就算了，现在ai绘画真的是逼死太太们的最后一根稻草说好的保护作品产权，结果官方自己先把大家画的图当ai素材库，你保护了个什么？？？保卫萝卜白眼别人随手用ai生成的图热度比太太们画的高，还一直被官方推送到首页，你让辛辛苦苦画图的人怎么想？更过分的是用ai绘画盈利的，以后大家都别学画画了，直接用ai赚钱就行了，反正技术成熟了又看不出来再见;5;172;177;18388;0.00962584294104851
67996;ai图的作者又没有对图的产生有什么用，凭什么享受和太太们同样的待遇，我对待太太们的作品的是敬佩他们的想象力和对色彩的运用，对你一个ai图，我是敬佩你电脑的算力吗？凭什么给你和太太们同等的待遇;3;400;403;18388;0.02191646726125734
68000;时至今日还在玩AI绘画支持AI绘画的多半是自己没能力创作又眼红真正的创作者的光辉，想把他们戴到自己头上，但是又深知谁都能窃取又拼尽全力想保护偷来的光环的可怜人罢了（在微博上看到一位太太的评论;9;292;301;18388;0.01636937132912769
68010;不反对ai绘画但抵制ai绘画盈利与其给ai送钱不如去投喂认真画图的太太大哭;18;1032;1050;18388;0.057102458124864044
68029;最近刷老福特全特么是ai绘图，真给我整无语了;8;1077;1085;18388;0.05900587339569284
68038;看到下面的评论“啊啊啊啊太太好棒”还赠礼了就觉得又蠢又惨，当然最该死的还得是作者。;3;558;561;18388;0.030509027626713075
68042;有说ai绘画是能让不会画画的人也能创造出自己想要表达的作品你不会画画你去学啊？又不想花时间去学画画又想在网上发绘画作品去获得别人的认可和关注，你怎么不让ai去学高考让所有人都能上985211算了？ai再怎么学它的学习来源不还是别人的画？再怎么学不还是侵权？把侵权问题解决了再说你的ai盈利吧笑我话放这里了，ai绘画，它也配叫画？;1;25;26;18388;0.0014139656297585382
68045;LOFTER不仅AI可以设置存图付费，连转载别人的图都可以捏。垃圾软件一个而已。;3;242;245;18388;0.01332390689580161
68049;我看到榜一那张散宝的胸直接心肺骤停呲牙你要是用ai至少也要画个正常点的;1;723;724;18388;0.03937350445943006
68051;我们现在的AI就是不能解放生产力，却老想着解放脑力。他们把人的脑子当成了什么啊？他把人独有的感性，创造力和想象力都当成了什么啊？;23;291;314;18388;0.01707635414400696
68075;吃点好的吧，原神散已经是很热门的属性了，这么多手打免费粮不吃投给拿ai盈利的人;5;153;158;18388;0.008592560365455732
68081;虽然但是美术生的我看这种图还是一眼ai，只能说大部分人审美emmmm。害但是我现在还是持悲观态度的，实在不行我将来不画画了去摆个小吃摊藏狐;23;188;211;18388;0.01147487491842506
68105;这图ai画的男不男女不女的还真有人会把他当成散兵服了;4;82;86;18388;0.004676963236893626
68111;还有一张散兵满背纹身的一张图，在老福特。也是AI绘画，评论还给限制了微笑;1;66;67;18388;0.0036436806613008486
68113;挂人，作品全是ai绘画，只打了tag（而且放在最后，一般都看不到），我去发了句不是它画的，不到一分钟删评拉黑;10;766;776;18388;0.04220143571894714
68124;老福特就一堆厚脸皮，拿一些外网的图还有一些真人照片啥的他都好意思设置礼物。我自己画图别人来问私印啥的我都没好意思设置收礼，这帮人怎么好意思的辣眼睛;2;52;54;18388;0.0029366978464215794
68129;看一些ai技术的视频，下面的评论全是高兴的，还有很多说什么可以批量产本子涩图的呆;41;97;138;18388;0.007504894496410702
68172;这才哪到哪，p站现在一半都是AI了，有的角色类似归终80都是。骂的人不用，用的人不骂，没法律再骂都是这样。;4;139;143;18388;0.00777681096367196
68178;咱们说，去天桥底下要饭，都比干这缺德事体面辣眼睛;1;34;35;18388;0.0019034152708288013
68180;无语了，评论里为ai开脱的是什么意思？拼接剪切别人的作品收费，你们真的觉得没问题是吗？吐;1;15;16;18388;0.0008701326952360235
68187;ai出的图分享可以，但是用来盈利就有问题了。做个简单的换算，把原神立绘丢给ai十几分钟渲一张精图发到网上送礼给图就算一人一块钱，一百个人就是一百块，卧槽这什么没有成本的赚钱手段;1;13;14;18388;0.0007613661083315206
68193;这俩还算是ai作画里面稍微有点良心的，我要说一个人，老福特搜“aireincarnation”，就是这个b，控评拉黑。他用ai作画，打一堆tag，把ai的tag塞到最后面，许多分不清ai作图的人会把这画当成是他画的，而且画还收费，评论只能夸他画的好，你只要在评论区稍微提一嘴ai，他就立马给你删评，然后拉黑你，我已经被拉黑过一次了，大家不信的话，可以去试试。;3;116;119;18388;0.006471611920817925
68201;这对于画画的我打击很大，真可恨笑哭;20;67;87;18388;0.0047313465303458774
68222;老福特很多AI图都设置了存图送礼，很恶心好恶心啊啊啊啊啊抓狂;8;94;102;18388;0.00554709593212965
68231;本来ai绘画我就看个乐呵，结果现在进步这么大，还逼走了老坟头这么多大大，再不抵制，创作平台上所有作品都变成ai绘画时，就太可怕了灵魂出窍;3;5;8;18388;0.00043506634761801175
68236;我就想问ai吃太太们的作品有没有给版权费微笑;2;9;11;18388;0.0005982162279747662
68239;这些人比多托雷还懂人体实验的，都能造弗兰肯斯坦出来;4;15;19;18388;0.0010332825755927778
68244;还有搬运的图，付费存图捂脸捂脸捂脸;1;26;27;18388;0.0014683489232107897
68248;ai都能画这么像了吗囧;17;75;92;18388;0.005003262997607135
68268;最近看到一个很有名画师的最新作品，肉眼可见的进步，但拿ai炼丹的上限就是画师的上限。我觉得如果画手真的被所谓ai代替了，二次元美术也就走到尽头了，以后都别想进步;2;4;6;18388;0.0003262997607135088
68274;妙啊人气高说明确实有人喜欢这个图。用AI和用画笔也没什么高低贵贱，画的好看被大家喜欢才是最重要的;11;4;15;18388;0.000815749401783772
68290;感觉很多宝子们等论据都是空中楼阁，比如ai是shi块拼接这种确实有隔行如隔山的感觉ai学习我感觉像是，一个人学了三年语文，然后开始写作，如果三年里只读莎士比亚，那么写作风格就像莎士比亚，如果只读鲁迅就会写的像鲁迅妙啊感觉好多拼接论大部分都是个人情感宣泄下的偏向认知，错误的论据对于其他人看到之后觉得“他们又在瞎扯什么啊”这种，最终也只会在认可自己观点的小圈子里产生回想罢了;2;3;5;18388;0.00027191646726125733
68297;我觉得用ai绘图并且要求图图这确实很恶心，骂这个无可厚非，但用这个嘲讽点了赞收了图的散厨大可不必了吧思考毕竟ai的图乍一看确实唬人，有多少没有学习过绘画的普通人只是看着觉得好看就收藏点赞收图了呢？这是什么不可饶恕的错误吗？为什么要在骂这个人的时候连带着嘲讽无意收图的人呢？妙啊“吃点好的”这句话，愿意把吃好吃的的钱花在画手和纸片人身上，我觉得这是散厨和画手的双向奔赴，是幸运的。“吃点好的”这句话对于求了图但本身没有想支持ai的人来说太刺耳了笑哭;2;6;8;18388;0.00043506634761801175
68301;AI绘画这东西刚出我是打算当绘画参考用的，但实际上不经过调试的AI基本画的贼差（人体光影一个都不对），而且既然要调了才能用为啥不直接找大佬画的作品呢，这种说难听点还真是你行你上的东西，喂图，多生成几组挑自己满意的，还开放打赏（打赏就好像是呼吁大家都这么做）美其名曰“帮助不会画画的人”，我知道自己画的难看在不发但在私底下拼命练，画个好看的头像也是自己琢磨了好几版（但能力太差到现在还没修好）辣眼睛可能我太矫情了，这对努力画画进步的人太不公平了。;1;3;4;18388;0.00021753317380900588
68305;ai绘画是有前途的，而ai绘画是ai收集资料作画，也就是杂糅了很多东西，而ai作画盈利，我认为，用ai绘画出的图盈利可以，但我觉得收的费是什么，是别人没办法用ai绘图，或者不会使用，你代替他用ai绘图来画图，收取一些ai代画费，而不是收取“你”画出的图的费用，那些用ai绘图来当做自己的画来盈利的人才最该受到唾弃;5;15;20;18388;0.0010876658690450293
68318;但有没有一种可能，某些人只是想找到一张满意的画，但是找到一张对他们来说较为便宜的呢？总不能因为卖手工所以让人抵制工业品吧。ai绘画盈利本身就是一个愿打一个愿挨;27;12;39;18388;0.002120948444637807
68346;如果各位看到一个人把一堆网上下载下来的图丢进剪辑模板里用切换效果放ppt，再加一个dy背景音乐，请问你们觉得这是高创还是低创。如果你觉得是高创，那咱们的讨论就到此为止，是我太过高傲看不起这种视频我有罪呲牙如果你觉得是低创，AI生成也是这样吃瓜除非你是在搞概念设计图，用AI模拟一下效果，不然这种AI生成二次元涩图的我一律当垃圾吃瓜;4;4;8;18388;0.00043506634761801175
68352;起来一个上古笑话，谷歌翻译的工程师团队说，每当他们的团队里减少一个语言学家，翻译的质量就会提高一些。那年头流行的还是云和大数据大笑;1;4;5;18388;0.00027191646726125733
68358;完全看不出是ai啊，这是丢了多少太太的画进去;10;5;15;18388;0.000815749401783772
68369;天哪，那些给ai送钱的真给散厨丢脸笑哭;1;14;15;18388;0.000815749401783772
68371;难绷，只能说老福特这个平台已经烂完了，想画阿散的二创的太太不如考虑加米游社吧，还有官方扶持笑哭;1;2;3;18388;0.0001631498803567544
68386;我好暴躁，希望无脑支持AI画图和用AI画图恶意盈利的遗照拿去喂AI呲牙;1;2;3;18388;0.0001631498803567544
68393;如果我跟你说有注重版权的AI模型（甚至禁止用户喂图）的话会不会被骂杠精无语;4;2;6;18388;0.0003262997607135088
68398;种花家历史如果说明了一件事，那就是试图用道德对抗科技，那么必定一败涂地对于这种科技，不可能去谈抵制，但是希望能讨论怎么规范化，怎么治理之类;2;2;4;18388;0.00021753317380900588
68402;反正我删图跑路，本来产粮就是为了自己开心，lofter这波操作给我整的太ex了，翻外头去发图了灵魂出窍正好最近三次也忙，先放放二次;1;2;3;18388;0.0001631498803567544
68405;现在刷老福特就一堆AI绘画，我真的感觉老福特活不久了，我暂时是没处可去，被迫呆在这要烂不烂的地方。等什么时候有那种异军突起的APP我再转过去藏狐;1;2;3;18388;0.0001631498803567544
68408;每一项技术被贬值，劳力被取代，都必然伴随着抵制的呼声。从以前的资本建立工厂，到现在的AI使鉴赏大于画技。待到吃不饱饭的受害者另寻出路，后来者越来越少，自然呼声消退，结构转型，未必一个改变对人类绝对好或坏。人群性善使抵制不可避免，且看吧;12;2;14;18388;0.0007613661083315206
68425;并不觉得抵制这种有啥道理。ai是工具，你不用就有别人用，这是没办法的事情。你说ai是融合别人图，那我也看不出来啊？我只知道这玩意好看而已;22;2;24;18388;0.0013051990428540352
68450;不理解你抵制就抵制咯还要拉是别人抵制，他们为什么会付费呢？是因为这是ai的画作？还是因为这是散兵的图？他们是为角色付费不是为了画。你开头那句话偏的离谱;5;1;6;18388;0.0003262997607135088
68456;但是没办法AI是总结规律画的，甚至可以画油画散兵，都没有人类油画散兵，没的拼接;8;2;10;18388;0.0005438329345225147
68465;像这种怎么说原神嗯他声称是自己手绘然后Ai辅助，喂的图全是官方的，自己一遍一遍试也非常辛苦热;2;1;3;18388;0.0001631498803567544
68474;ai绘画已经逼走多少太太了，关注里已经有很多个因为自己的画被拿去喂ai而离开老福特的。散厨们会不会吃啊，吃点好的行不行，这种畸形的东西，细节没一出对的也能上热门。;3;1;4;18388;0.00021753317380900588
68479;AI绘画看起来像什么呢？把别人的基础和作品搅碎，然后拼凑成你们所“热爱”的，拼凑的尸体。;1;1;2;18388;0.00010876658690450294
68485;三个月前ai还很垃圾，只是短短三个月就能生成这样的画，太离谱了;3;1;4;18388;0.00021753317380900588
68489;怎么说;2;0;2;18388;0.00010876658690450294
68495;想知道用ai的话投进去的图会被分尸拼吗大哭我之前被同学投了，她还和我说就是投着玩试一下;1;1;2;18388;0.00010876658690450294
68507;ai挺好的，是个好工具。当年工人也砸过机械吧。;28;1;29;18388;0.0015771155101152925
68545;是真的，散厨们别给那些转载盈利的人送钱了。每天看到热榜上有转载的人盈利时我都被恶心坏了。好多人可能不在意这点钱，但我觉得助长这种风气也太糟糕了，原神成了一些搬运人的盈利工具，太糟心了。捂脸;3;1;4;18388;0.00021753317380900588
68557;没关系，现在又出了什么ai编程什么的，早晚很多职业要轮一遍，不过不包括法学什么的，因为三原则我认为ai永远学不会脱单doge;2;1;3;18388;0.0001631498803567544
68566;ai跟人的区别在于人脑，因为即使再精密的仪器也没办法真正的理解人的感情，就像视频里的两幅画，ai不懂得神之眼和金色羽毛对于散兵的含义，它也不能准确的绘画出属于人偶的关节，同样的它也无法理解散兵服装的来源和一些设定，在我看来这样的图都是一种丑陋的失败品（先不用急着反驳我）。其实相比于抵制ai作画，更准确一点来说，在我看来，应该是抵制用ai作品盈利，即视频中的送礼求图行为，试想，别人花费了几天几夜的精力绘画出来的一张图，却抵不过ai几秒钟合成的机器绘画，这不讽刺吗？当然，ai确实可以给人带来很大的便利，人类的未来发展ai无疑也是不可缺少的一环，但是，ai可以辅助人类，却绝对不能代替人类，今天的ai可以绘画出一张合成图，明天的ai就能够高效地完成你的工作，到时候面临的就是你的失业。当然，ai的出现也并不能作为放弃艺术的全部理由，毕竟人类社会的本质就是不进步就只能被淘汰，在机器大行其道的今天，依旧有人愿意购买纯手工作品，即使电子书再怎么便利，也有人更愿意购买实体书籍，我想这就是人不断追求艺术的意义。地球上几十亿的人，我当然也不能让每个人的想法都同我一样，但我可以肯定的是，ai作品，绝对比不上各位太太辛辛苦苦，倾注了感情所创作出来的作品，以及我一开始的观点，这类作品不应该被拿来盈利;2;1;3;18388;0.0001631498803567544
68572;记得给碗盆喂药妈呀你们散厨;1;1;2;18388;0.00010876658690450294
68576;aicos完全就可以不侵权，凭什么一棍子打死c站也标明了禁止使用真实存在的人物，要骂就去骂那些拿真人照片炼模型的，别开地图炮;2;1;3;18388;0.0001631498803567544
68588;笑死了昨天wb反驳一条说买家卖家都自愿但是你们说不行的评论被这人疯狂开小号追着骂OK挡某些人财路咯;2;2;4;18388;0.00021753317380900588
68596;小画师一副烂画就敢要五六百就正常？;2;4;6;18388;0.0003262997607135088
68599;借用当初原神抄袭风波中的一句话“不服你就去告吃瓜”;1;3;4;18388;0.00021753317380900588
68614;我还是看ai绘画看太少了，第一眼居然看不出来，觉得还挺正常的;3;0;3;18388;0.0001631498803567544
68624;热评第一那个，我暂停看了下图片，总感觉人物表情有点ooc，衣服什么的都是散兵元素，但是人给我的感觉很不像散兵。;1;0;1;18388;5.438329345225147e-05
68627;怎么说呢，ai绘画我不否认，但单纯用ai画单图去盈利我是绝对否认的。ai做动画盈利我不否认，因为其中的剧情，构图，分镜，音乐都是制作人自己做的，我认为只有真正认认真真做，绞尽脑汁后产出的“艺术类”作品才有盈利的需求。因为这种创作是有研发意义在里面的，给画手钱也是希望他能继续画下去，然后开发出新的绘画手法，画风。希望这个行业能够壮大，产出越来越多的不同的奇妙的画风。但我觉得ai画师不会因为收获了钱而对他的“艺术创作”有任何的帮助。相比起说抵制ai我倒觉得这种用ai来赚钱的人才是真正的没脸没皮的社会废人。ai可以做很多事情，但他们只想用它来骗钱。你起码修一修ai图的细节，修改修改光影，让人物和背景更融入些，修改修改材质，以及部分错误结构。我都当你是用了心的。;1;0;1;18388;5.438329345225147e-05
68631;唉，其实我挺喜欢AI技术的，但是现在AI真的太泛滥了，本身就挤占了太多画师、COSER的生存空间了，这些人还拿来收费囧他们到底知不知道AI只是排列组合，不会创作啊。画师学习了十多年，精进画技培养自己的风格美感，一张图几天辛辛苦苦画出来，这些人一分钟就全部偷走了。COSER定制自制服装道具，试妆，练习动作，约摄影后期团队，找场景，这些人偷了图再轻飘飘来一句身材脸没有AI好看，真的太恶心了。;1;0;1;18388;5.438329345225147e-05
68644;要是自己画的投ai只是发出来看会不会被骂;3;0;3;18388;0.0001631498803567544
68655;但是这类同人图，额，ai画的和真人画的差不多吧，官方都开放版权啊;3;0;3;18388;0.0001631498803567544
68660;这种程度的图如果做AI图的人不说自己是AI制图我根本分辨不出来微笑;1;0;1;18388;5.438329345225147e-05
68669;ai如果能自己画我没意见，但现在ai只能做到抄;1;0;1;18388;5.438329345225147e-05
68675;日葵葵子受不了老坟头这样的做法，好多优质的太太都跑路了，老坟头拜拜哈哈哈，抵制AI从我做起;1;0;1;18388;5.438329345225147e-05
68678;有些好看的ai图片是需要人为的后期修改的微笑;1;0;1;18388;5.438329345225147e-05
68683;这咋看出来的笑哭，感觉挺像画的脸红（我是画画盲）;1;0;1;18388;5.438329345225147e-05
68685;那个，我想问一下喂ai自己画的图，应该不会侵权吧因为画的也不是很好看，想去试试ai看看改的怎么样;2;0;2;18388;0.00010876658690450294
68690;“抄不抄袭是厂商（画师）的事，我们只要有的玩（有的看）就好了”dogeai绘画热度前几都是原，有没有一种可能，大伙本来就不在意版权，等ai绘画被资本整合到手机里面翻墙训练都不用，可以人人自己产粮了，相信大部分无所谓版权的人就会反过来感恩吧保佑;1;0;1;18388;5.438329345225147e-05
68701;ai技术没错，取决于人怎么用;1;0;1;18388;5.438329345225147e-05
68704;额，我倒不反对ai绘画吧，我就一臭打游戏的，觉得好看就会想存图，但是我不会给任何太太打赏，也不追求送礼物才能看的画和存的图。;2;0;2;18388;0.00010876658690450294
68721;搞不懂，ai绘画又怎么了，我圈冷的不行，因为ai绘画，又贴人物又量大，我高兴的疯狂右键保存，感谢ai绘画;1;0;1;18388;5.438329345225147e-05
68728;有的人说做ai的也很辛苦不是那么容易的。那么，一个人拿两张试卷抄你会说他抄的辛苦吗？;2;0;2;18388;0.00010876658690450294
68734;纯手工制作和工厂批量生产哪个更有价值相信大家心里都有数脱单doge，这种ai出来的顶多自娱自乐，这在这用ai盈利。。。;2;0;2;18388;0.00010876658690450294
68761;话说，你们是怎么看出来是ai还是人为的？;9;0;9;18388;0.0004894496410702633
68772;画的是挺好看，但散厨也不算冷圈，吃这种没感情的粮有什么意思呢;2;0;2;18388;0.00010876658690450294
68776;ai绘图已经这么牛叉了吗、哪里可以弄啊，想给自己设计一个名片（话说给自己用的话ai绘画行吗？;2;0;2;18388;0.00010876658690450294
68782;请问怎么能看出来这是ai画的啊;3;0;3;18388;0.0001631498803567544
68786;人画的和ai画的应该完完全全的分开，不能出现一个赛道的情况，绘画是包含审美的人类艺术，观赏一个画看的不仅仅是画，还有它背后作者的意图，现在很多人看的好画多，审美好，但是自己画不出好东西就用ai，我认为这是投机取巧的，和画的好看审美也好的人有质的不同，人的发展还远远没有到吃老本总结的时候;1;0;1;18388;5.438329345225147e-05
68799;怎么看出来是ai的？我完全看不出;1;0;1;18388;5.438329345225147e-05
68801;虽然但是有没有一种可能有的人根本不知道这是AI所以送了礼物，我就是那种不看标签的人怪我咯;4;0;4;18388;0.00021753317380900588
68807;老福特好久没下载了，可是我真的不太会分辨哪个是ai啊辣眼睛辣眼睛辣眼睛辣眼睛;1;0;1;18388;5.438329345225147e-05
68813;我觉得不如给大家都科普科普ai绘画怎么搞，都能自己玩了就不会让这些ai画的盈利了;1;0;1;18388;5.438329345225147e-05
68819;怎么认出来的呀太太，我不太会认;1;0;1;18388;5.438329345225147e-05
68834;这位大家知道ta发的画是ai画的吗我开始也没认出来，还收藏了不少ta的画后来看到ta发的魈的性转被创飞了（我不是雷性转，是这个性转完全不对味）我去评论区里问ta的画是不是ai画的结果ta自己把我拉黑了，我估计是给我说中了我让我亲友去看了，她们也觉得是ai画的，但我之前看评论好像大家都以为是ta自己画的;2;0;2;18388;0.00010876658690450294
68838;刚刚刷到一个无偿的画手，但那个怎么看都是ai，但是评论区也没人说我又怀疑是不是自己看错了请眼力好的大大私信我，帮忙看看是不是ai，谢谢;2;0;2;18388;0.00010876658690450294
68862;什么残肢断臂接起来的图;16;0;16;18388;0.0008701326952360235
68883;送礼不太好，但是支持ai绘画捏;5;1;6;18388;0.0003262997607135088
68893;补httpspanquarkcns6e1caba1bd02密码123下其中一个就可以了，不要在线操作解压记得三连吃瓜吃瓜;2;6;8;18388;0.00043506634761801175
68897;看右上角水印，这年头广告连水印都不删了;2;18;20;18388;0.0010876658690450293
68900;不要在线操作httpspanquarkcns909486906d87下载后在本地删除后缀汉字密码就是压缩包名字;4;2;6;18388;0.0003262997607135088
68906;怎么上一个是121这个又是123了，121呢;1;0;1;18388;5.438329345225147e-05
68908;全是上身的多来点全身照dogedoge;1;5;6;18388;0.0003262997607135088
68911;妙啊妙啊大威涩龙威武不屈doge;1;4;5;18388;0.00027191646726125733
68915;来了来了;1;1;2;18388;0.00010876658690450294
68917;先三连，不磨叽doge;4;1;5;18388;0.00027191646726125733
68922;驴哥又来了dogedoge;3;1;4;18388;0.00021753317380900588
68927;看到你发的先把币投上在看;1;1;2;18388;0.00010876658690450294
68929;厚礼蟹打call;1;1;2;18388;0.00010876658690450294
68931;龙哥了不起;1;1;2;18388;0.00010876658690450294
68934;dalao炸了，求补滑稽;1;0;1;18388;5.438329345225147e-05
68950;龙哥，求图包;2;0;2;18388;0.00010876658690450294
68953;为什么链接失效了呢？大哭;1;0;1;18388;5.438329345225147e-05
68955;密码是什么呢;1;0;1;18388;5.438329345225147e-05
68958;这链接不行啊，重新发个链接;2;0;2;18388;0.00010876658690450294
68961;为什么穿了衣服比没穿还瑟瑟;2;2;4;18388;0.00021753317380900588
68964;123期的解压码是什么呀？;1;0;1;18388;5.438329345225147e-05
68966;包里的内容可以星星眼加大力度喜欢;1;2;3;18388;0.0001631498803567544
68969;为什么我下载了是这样的啊;1;1;2;18388;0.00010876658690450294
68971;解压不了;1;0;1;18388;5.438329345225147e-05
68978;有张图片似乎少了什么;1;0;1;18388;5.438329345225147e-05
68980;分享链接已删除酸了;1;0;1;18388;5.438329345225147e-05
68982;upup已三连链接哪去了啊;3;0;3;18388;0.0001631498803567544
68987;解压密码是啥呀大威天龙，已三连奉上;2;0;2;18388;0.00010876658690450294
68991;今天发的好像在哪里对没看到过星星眼星星眼;1;1;2;18388;0.00010876658690450294
68993;老龙啊图包交出来还有我的狐狸呢快吧狐狸交出来滑稽;1;1;2;18388;0.00010876658690450294
68995;画的太好了，支持，有网盘链接吗;2;0;2;18388;0.00010876658690450294
68999;这些妹子都眼袋都好重哦;2;0;2;18388;0.00010876658690450294
69003;为啥我需要解压密码辣眼睛;1;0;1;18388;5.438329345225147e-05
69005;看到某宝上有，也许是错觉;1;0;1;18388;5.438329345225147e-05
69008;笑哭这期分辨率不尽人意;1;0;1;18388;5.438329345225147e-05
69010;抠鼻我想要更大尺度大;1;0;1;18388;5.438329345225147e-05
69015;点进去是空文件夹跪了;2;0;2;18388;0.00010876658690450294
69033;什么软件;1;0;1;18388;5.438329345225147e-05
69039;咳咳咳;1;5;6;18388;0.0003262997607135088
69043;你的手为什么这么完美;2;0;2;18388;0.00010876658690450294
69047;图包有吗吃瓜;1;0;1;18388;5.438329345225147e-05
69049;脱单doge求图;1;0;1;18388;5.438329345225147e-05
69051;求图;1;0;1;18388;5.438329345225147e-05
69053;三连求图求图;1;0;1;18388;5.438329345225147e-05
69055;三连求图;1;0;1;18388;5.438329345225147e-05
69057;吃瓜吃瓜打call打call打call顶你顶你顶你;1;0;1;18388;5.438329345225147e-05
69059;求图包doge;1;0;1;18388;5.438329345225147e-05
69061;AI永远不会取代人类但是以我这个画技足够了跪了;174;16029;16203;18388;0.8811725038068305
69236;这个真的只能算娱乐视频了，ai能帮你直接出图，但是想要调整什么的，还是得老老实实的学基本功;134;6465;6599;18388;0.3588753534914074
69371;人类自己的审美提升不上来，AI再强也没用;107;2134;2241;18388;0.12187296062649554
69479;说实话，现在叫嚣着AI能取代画师的，多半是根本不会画画的。对于画师来说，现在的AI只是一个更加便利的工具而已。只能说AI带来的东西只是让出图的效率变高，但是根本不可能替代人类。除非未来的科技发展到出现强人工智能，但是还差得远。;260;2350;2610;18388;0.14194039591037633
69740;我一直觉得，画画这个事情，最重要的是眼界，没看过就根本没办法画，画家需要翻阅大量的作品，来整合知识，提升画技。但AI这个东西，有太多的“绘画记忆”（资源数据库），这个也就是吊打画师的根本。一个人一辈子能学习多少东西呢？看多少画呢？但是AI一瞬间能搜到无法估计的图片数量，可以整合出中等偏上水平的作品笑哭有人说，高级画师不受影响，但我觉得，只要AI数据库里有高级画师的作品，那就近似可以模仿。像一般普通人专业画画后，就想着思索出自己的路（风格），然后挣点钱，但是AI出现后，你努力好久，有了世界上独一无二的风格，刚想大展宏图，然后AI搜集了你的所有作品，开始创作近似于你风格的作品灵魂出窍这真的是太恶心了。;34;521;555;18388;0.030182727865999563
69775;AI画作就像是一个笨蛋的学生，他只会听你的安排只会听你教给他的他没有思维，没有主动的创造因为他没有道德和思考能力它能创造一幅优美的画是因为我们的安排就像是AI脑补名画倒牛奶的女佣他不知道别人倒牛奶为什么会有那么多人看我认为AI画画系统，只能99的还原画师但不能100举个简单的例子所有人都懂就是11他不知道为什么会等于二，等于二是因为你告诉他等于二;34;236;270;18388;0.014683489232107896
69811;你们说ai代替不了人类的样子真像几年前有人说ai学不会围棋。再这样发展下去各行各业存在的意义只能是服务于计算机行业，起到维护的作用，有人说细节改不了，那加程序不就完了，还有土木什么的，未来画图和设计绝对没有前途，输入各种参数自动成图现在就已经部分实现了，科研创新和产品维护才是各行业的未来，别骗自己了，不过这也许需要很久十年，二十年，或者只需要短短五年，谁知道呢;97;342;439;18388;0.023874265825538393
69909;其实AI就算成熟了，也不会取代萌新。因为大佬都是从萌新过来的，等到最后一批大佬拿不动笔了，那AI的素材库里面就没有其他精美的图片了，到时候那就是几乎千篇一律的风格。绘画界就少了创新，整个绘画界缺了创新，那还能叫绘画吗？所以AI顶多是辅助，而不能直接取代人。;10;113;123;18388;0.006689145094626931
69920;不用害怕ai會取代你ai永遠是工具但掌握ai算法的人永遠是你的威脅因為他用可以想辦法比你做得更好微笑;5;75;80;18388;0.004350663476180117
69926;想象中的ai画画：喂了这么多大佬的画，一定比我强实际中的ai画画：这次比列对了，至少能看了doge;1;57;58;18388;0.003154231020230585
69929;我觉得ai还是不能取代手绘呀，高中联考美术也不跟电脑接触，大学的一些美术专业也不跟电脑绘图接触doge;7;43;50;18388;0.0027191646726125733
69937;大姐，pad边都不直了;11;116;127;18388;0.006906678268435936
69951;ai还是不能取代高质量的风格画，很多画风ai画不来战双帕弥什2保护;2;11;13;18388;0.0007069828148792691
69954;你这个平板什么牌子的啊？还是曲屏的doge;3;13;16;18388;0.0008701326952360235
69960;最傻的是那些ai绘画作品视频下面还有人说大佬好厉害，好厉害什么，显卡厉害吗，还是会打字厉害，还是会上传视频厉害;8;47;55;18388;0.002991081139873831
69969;画技过硬的确实替代不了，模仿都够呛，但是刚学没几年的普通人肯定是随随便便就替代了，估计以后技术成熟了普通的插画都直接ai画了，大部分画手都会失业，只留下顶尖或者人气大的人才;8;28;36;18388;0.001957798564281053
69979;尼玛怎么都在关注ai会不会取代人类，你们没想到ai绘画出来最直观w的问题就是侵权吗？？？？你想想你辛辛苦苦花费20小时画了一张画结果人家用你的画只花半小时就创造出了比你画得还好看的画你气不气？（别杠，我空间神仙太太经历过免费在网络平台发半成品同人图被人拿去喂ai先出稿反过来说她抄袭的破事微笑，现在她都不敢产粮了，我一个破冷圈我上哪吃饭你告诉我微笑）;1;20;21;18388;0.0011420491624972808
69981;AI绘画取代不了艺术家，但能取代90左右的绘画专业的学生;2;16;18;18388;0.0009788992821405265
69985;ai替代不了顶尖画师，无论以前还是以后，对，人的创造力是无穷的，可问题是，没说ai不能替代底层和中层画师啊。没有数量庞大的画师群体，绘画这一项艺术只会逐渐萎缩，到最后剩下的只有绘画而没有了艺术。ai最恐怖的现在并不是智能，因为还没诞生真正机械意识又或是没发现。而是扼杀，扼杀一切创造力一切想象力，固化固化再固化，固化领域固化阶级，机器没有思维，可是掌控机器的人，他真的会把其他没有掌控机器的人当人看吗？热;13;12;25;18388;0.0013595823363062867
69999;这些AI都是要图片的，以后画师没了，等于就是杀鸡取卵;7;6;13;18388;0.0007069828148792691
70008;以前画画课挤颜料，现在画画课数位板，未来怎么就不能敲键盘;1;5;6;18388;0.0003262997607135088
70014;取代人类不至于，能取代我微笑;1;5;6;18388;0.0003262997607135088
70016;把自己学画画认为很辛苦，把用ai作画想的很简单;10;6;16;18388;0.0008701326952360235
70027;AI不能代替人，但能代替大部分人，他不需要有创造力，只要能满足商业需求就可以，除了少部分搞艺术的，大部分图都是用于商业。其实他也具备一定的创造力，你让他乱组合，就可能出现挺有意思的图，而且现在只是刚开始，技术进步是很快的，所以AI不会取代所有人但会抢走很大一部分工作;1;11;12;18388;0.0006525995214270176
70031;如果你输入“唱，跳，rap，篮球，中分，鸡，背带裤”就会生成鸡穿着背带裤拿着篮球或者其他奇奇怪怪的图，看来人工智能也有点不太智能dogedogedoge;1;4;5;18388;0.00027191646726125733
70035;AI画师的出现，只会让人们的作画更加稀有;1;4;5;18388;0.00027191646726125733
70039;ai绘画？不是，是ai生成，纯粹的东拼西凑;1;3;4;18388;0.00021753317380900588
70042;垃圾ai让他拿铅笔画在纸上试试（来自手绘人的不屑）乃琳个性装扮20墨镜;1;3;4;18388;0.00021753317380900588
70045;让ai在同一张图里改动一点点光影，一点点结构一点点饱和度，一点点视角效果，加一点点丰富度的装饰，甲方一句话，让ai无从下手dogedogedogedoge我不信ai能理解甲方说的我要的是那种感觉另外如果是我甲方，知道对方是用ai作画的，肯定不会给那么多钱，既然钱少，谁又会捣鼓ai作画呢脱单doge脱单doge脱单doge;5;9;14;18388;0.0007613661083315206
70053;如果我把人类所有的文学作品喂给AI，不知道他能创造出多么伟大的作品脱单doge;3;7;10;18388;0.0005438329345225147
70057;当一个行业利益威胁到到另一个行业利益的时候，两个利益之间的火花就会摩擦，甚至到达对立。;1;7;8;18388;0.00043506634761801175
70071;别看简单，调参数很费时间;1;2;3;18388;0.0001631498803567544
70074;开美颜把平板都扭曲成啥样了。。;2;2;4;18388;0.00021753317380900588
70077;emmmm怎么说吧，ai也就影响插画行业中接私活的，对于其他任何美术行业都没有影响，因为涉及到商业职业这种东西时候，就已经不单纯是画的好不好的问题了，一个好的画师所拥有的是无数的理论基础和对其专业领域的各种知识，正规中型以上企业的主美都不可能用ai代替人工，那等同于自杀，真正学过画画有一定年份的都不会对此太担心，倒是很多门外汉各种指点论道;12;4;16;18388;0.0008701326952360235
70094;哦，马车夫也曾经反对过汽车;37;7;44;18388;0.0023928649118990647
70144;血压上来了，上次我弟说你画了6年还不如ai让我抽了;2;1;3;18388;0.0001631498803567544
70155;抽象拍艺术;2;1;3;18388;0.0001631498803567544
70158;如果你输入“美少女吃面”，就会生成美少女手捧面条吃或者其他奇奇怪怪的图，看来人工智能也有点不太智能;2;1;3;18388;0.0001631498803567544
70163;你想想html，ai的ml肯定更复杂;1;1;2;18388;0.00010876658690450294
70169;她这个平板电脑怎么弯弯曲曲的？;1;1;2;18388;0.00010876658690450294
70173;ai绘画最多只会取缔庸才。;3;2;5;18388;0.00027191646726125733
70179;有的画师已经在用ai提高效率了，而有的人还在到处叫嚣ai薄纱画师去画师评论里跳脚不如ai;1;2;3;18388;0.0001631498803567544
70184;ai的画是真不行啊，真不如中端画师的画啊笑哭，包括封面插图或者本子涩图之类的，画的身体结构真的不咋的，一部分可能交的钱多画的不错笑哭;1;1;2;18388;0.00010876658690450294
70187;烧鹅真的有点腻一布稻味;31;1;32;18388;0.001740265390472047
70220;以后学画画只要学怎么画手就行了dogedogedoge;4;2;6;18388;0.0003262997607135088
70227;画画以后是不是就要被这个代替了;4;1;5;18388;0.00027191646726125733
70238;画师本来就是落后职业，ps这种上古软件本来就不堪重用了，死守这种绘画方式还不如死守纸绘。;2;1;3;18388;0.0001631498803567544
70253;抛开ai绘画不谈，你为什么会觉得这些学生能学好敲键盘？喜极而泣喜极而泣;1;0;1;18388;5.438329345225147e-05
70264;ai很强，并且以后会更强。但是永远不能取代画师，因为ai没有情感，没有喜恶，它对自己生成的画作没有判断能力。在人类搞清楚“美”是什么之前，人类工程师还无法赋予ai审美能力。;1;0;1;18388;5.438329345225147e-05
70268;所以人类画师还有多久全部灭绝doge;1;0;1;18388;5.438329345225147e-05
70278;ai能取代95以上的人，除非你是顶级画师，不然就等着饿死吧;4;0;4;18388;0.00021753317380900588
70294;大多数人都忘记了ai的特性是会进化阿藏狐;1;0;1;18388;5.438329345225147e-05
70299;等AI能够画出完整的手和脚的时候，再出来说什么代替画师吧。吃瓜吃瓜;2;0;2;18388;0.00010876658690450294
70302;键盘是哪家的呀，脸红脸红脸红有点心动;1;0;1;18388;5.438329345225147e-05
70328;还有人认为ai取代不了画师的也太嘴硬了吧。以前工作室要一群人，但现在有了ai是否一个人就能承担同样的工作。如果不管版权的话，ai它是真的能学。;1;0;1;18388;5.438329345225147e-05
70331;就算是AI能取代人类，大部分画师也还是有饭吃的吧，就像是现在即使可以把画数字化，但还是更多人喜欢纸质的，即使可以流水线，但更多人还是喜欢手工的吧，现在很多行业都能看出来思考;2;0;2;18388;0.00010876658690450294
70345;AI能画中国古典花鸟画吗？现在看到的全是油画风格。;3;0;3;18388;0.0001631498803567544
70350;如果ai真的取代人类那以后的ai就没有人类画的图当狗粮了，自然也没有新的画风了，ai自然也不会帮人类创造新风格，也就不会让审美发展了。;12;0;12;18388;0.0006525995214270176
70365;首先想想ai的方向目的和能力找出自己的位置，不肯进步还胡说八道的那肯定，会让人觉得这行这么好赚钱，画面的搬砖也是搬砖，没必要和自动搬砖机器人争个高下这次就不说ai的生态位了说说ai的三大历程第一大历程是使用人类的数据库，这是一百年前的观点了，这个就是符合小画师的幻想的ai，使用人类的数据库搜索和拼合，比如说网络天才小度读心术微软人立方，缺点是数据库庞杂还需要依靠人类无法超出数据库，只是个搜索引擎而已，如果这玩意儿放在医院，那你用他半天他给你开了个感冒药，然后新冠就爆发了，因为这玩意儿依赖于人类的医疗数据库，离不开人类，太耗算力，结果和成长性感人第二条就是中画师臆想的学习了，这一步的ai是使用人类的超验模型的，也就是说由人类抽象化数据规律模型，然后交给ai，也就是说由人类抽象什么景深什么透视什么颜色搭配，然后交给ai，当然不是小画师臆想的通过语言这种超验模型通过摄像头麦克风教授，这种看起来表面像人，实则不是，原因同上，不过是把数据库换成了模型，这种ai依然无法超脱人类模型，每当需要一个方向就得开设一门课程，不符合人类对智能的万用性的定义，有这么一种ai，他是真的了解了光学和物理学，这种东西呢我们不管他叫ai第三种就是目前的ai了，他自行决定模型，不需要人类给予模型了，人类只需要把数据根据需求告知，然后根据需求自行输出，然后根据人类需求进行自行调节就行了，这种的缺点是需要人类提供初始获得数据的方法，当然也需要人类给予需求，这也是目前的弱人工智能生态位需求方向，这并不是需要自豪的，毕竟很多东西描绘起来很困难，抽象起来很容易，但凡是有简单教程的抽象起来算法模型都不会太难，比如说绘画第一种就是数据库检索，无论是一对一的绑定或者是一对多的检索，我们最熟悉的的就是一对多的，比如说百度，可以说任何软件都离不开数据库了第二种呢我们管他叫物理引擎，你觉得虚幻5是ai吗？这个我们也算是比较熟悉的，各种避免不了人类超验主义的计算都是这玩意儿的成品第三种更不必谈，所以说简单的绘画本就不在话下，之所以麻烦无非是太累，高级火柴人有什么难得呢，尤其是对于计算机，没必要过于鼓吹画火柴人的难度就因为不甘心，这难度不是一眼通，大部分人是脑子不会吗？比如说人体躯干和脑袋也就那几种类型，那几种搭配，抽象这玩意儿的结构输出可比数据库检索容易多了，把新华字典拼凑能拼出小说吗？;3;0;3;18388;0.0001631498803567544
70373;这么跟你们说吧，ai是个很不错的绘画辅助软件脱单doge注意是辅助。;4;0;4;18388;0.00021753317380900588
70391;我不懂所以我问一下哈，懂王就不用来喷我了，我也不会搭理你，就是哈，ai绘图是ai自己画的还是ai从网上一堆图里拼出来的呢;2;0;2;18388;0.00010876658690450294
70394;不吹不黑，等某个平台的ai吃画师吃得差不多了，那也就不需要二三线的画师了。;1;0;1;18388;5.438329345225147e-05
70403;想问一下ai绘画怎么作为辅助工具，它都是直接画完一副完整度非常高的作品，最多也就在上面做一些修改，它怎么作为辅助工具，不太懂这个热;2;0;2;18388;0.00010876658690450294
70411;果然，一切的终点就是编程;2;0;2;18388;0.00010876658690450294
70418;ai的潜力不错，等我有能力了我就拿我的作品喂ai，ai就会作为另一个我，所以说，拜托了，另一个我;1;0;1;18388;5.438329345225147e-05
70423;时间会调整一切，底层的，能力不足的，没有决心的，取代就取代了吧，没什么大不了，是，不能要求萌新直接变大佬，要有成长过程，现在这个过程得不到正面反馈了，就放弃了，那还有什么可说的？你自己选的啊？怎么就有人一边干别的工作，一边养自己画画呢？怎么就有人多苦都要坚持下来搏一搏呢？你说你得活着，那就想办法活着，然后创造机会画画啊？如果放弃了，不坚持了，说白了不就是出局了吗？考虑的不少，没有未来怎么办，不能成功怎么办，没成为剩下来的那一小撮顶尖大师怎么办？我告诉你，不怎么办，这么想的人就该被取代，就该出局自己选的，你怨谁呢？世界和时代就该永远原地踏步，等着你成为大师啊？很喜欢陈丹青的一句话：看来你不是很喜欢画画，喜欢画画卧槽，拦不住的。;1;0;1;18388;5.438329345225147e-05
70425;妙啊AI画福瑞会崩坏，该区画风跨度大所以furry区暂时doge没被波及到，;2;0;2;18388;0.00010876658690450294
70431;评论是不是很多都没了解过画画，光AI说取代不了人类，只会取代“绘圈”的小画师，但凡真去了解一下都不会说出来这种话热纯艺术领域当然取代不了，这不废话吗，但板绘本来就跟商业有很大关系，人和机器怎么比效率啊，真就当几年十几年以后AI不会进步是吧;1;0;1;18388;5.438329345225147e-05
70433;AI不会画手指，不会用筷子吃面条;2;0;2;18388;0.00010876658690450294
70436;我画的画是抽象作品，ai理解不了。他也永远画不出来傲娇;3;0;3;18388;0.0001631498803567544
70452;ai能取代的只有很普通的插画师吧。但凡和创作沾一点边的都取代不了;1;0;1;18388;5.438329345225147e-05
70457;这up好像有什么大病妙啊;1;0;1;18388;5.438329345225147e-05
70463;现在ai作画归计算机视觉管还是归计算机图形学管？;1;0;1;18388;5.438329345225147e-05
70466;ai画的一点艺术系也没有，也没有人画的创作感，这些是我看到站里ai绘画之前坚信的，但是有些真的画的很不错。。并且不费时不费力的;1;0;1;18388;5.438329345225147e-05
70485;我感觉ai挺好的，可以节省很多基础学习的时间，你搞艺术不就是搞创作嘛，你负责创它负责做不更好吗？;6;2;8;18388;0.00043506634761801175
70492;真的能一个下午做一个短暂的galgame;1;0;1;18388;5.438329345225147e-05
70497;原本画画的门槛是很低的，AI出来以后你还得学英语吃瓜;1;0;1;18388;5.438329345225147e-05
70500;天城燐音试图和kkr借钱;1;0;1;18388;5.438329345225147e-05
70502;ai后还得调透视什么的，ai透视差的很，那些很屌的画多少都调过;1;0;1;18388;5.438329345225147e-05
70512;画师沦为修图师，难听点就是类似手机贴膜;2;0;2;18388;0.00010876658690450294
70518;我发布了一篇笔记，快来看看吧;3;62;65;18388;0.0035349140743963455
70522;还是差了丝火候，不如女秘书装，护士姐姐，女校长这类型好看吃瓜doge;2;39;41;18388;0.00222971503154231
70525;像是90年代言情小说封面doge;3;36;39;18388;0.002120948444637807
70529;大头证件照已经看腻了啊能看到腰以上或者全身就好了。;2;21;23;18388;0.0012508157494017839
70532;明人不说暗话，云盘里有没有我想要的？;1;7;8;18388;0.00043506634761801175
70535;大威天龙doge助我修行dogeup能不能多出点竖屏图啊星星眼;3;6;9;18388;0.0004894496410702633
70541;封面：AI到底能画多大doge;1;3;4;18388;0.00021753317380900588
70543;这是哪个模型，我试的Asiaface配汉服lora效果不行笑哭;3;3;6;18388;0.0003262997607135088
70547;我一个朋友说图包gkd;1;3;4;18388;0.00021753317380900588
70552;我朋友说三连了，图包交粗来吃瓜;2;2;4;18388;0.00021753317380900588
70565;这是人画的还是用软件自动化的？（认真脸）;2;1;3;18388;0.0001631498803567544
70571;大佬，三连求个关键词行不行啊？自己调老是不太理想;2;1;3;18388;0.0001631498803567544
70583;放弃了，不画了;1;0;1;18388;5.438329345225147e-05
70590;未来也许人类不会亡于暴力毁灭，而是死于安乐;1;0;1;18388;5.438329345225147e-05
70603;夸克要解压要钱啊好像跟百度网盘一个德行;1;0;1;18388;5.438329345225147e-05
70606;不懂就问能果吗？doge就是问有这个可能性吗;1;0;1;18388;5.438329345225147e-05
70613;我想问下basilmix指的是哪个模型;1;0;1;18388;5.438329345225147e-05
70615;独涩涩不如众涩涩，up不准备出个教程么妙啊;1;0;1;18388;5.438329345225147e-05
70617;可以全身图吗吃瓜;1;0;1;18388;5.438329345225147e-05
70619;找老婆就要按这个标准找;4;9;13;18388;0.0007069828148792691
70624;点赞三连加关注，私信领取额外图包，关键词：大威天龙;2;7;9;18388;0.0004894496410702633
70652;dogedoge;1;1;2;18388;0.00010876658690450294
70654;吃瓜吃瓜吃瓜星星眼星星眼星星眼;4;1;5;18388;0.00027191646726125733
70660;解压密码多少;1;0;1;18388;5.438329345225147e-05
70666;密码是啥啊;1;0;1;18388;5.438329345225147e-05
70670;进步速度真的恐怖，用秋叶启动器里看扩展插件基本每天都在更新;2;115;117;18388;0.006362845333913422
70673;我已经能想到pixiv上面的菩萨ai画师会用这个来做什么了doge;6;40;46;18388;0.0025016314988035677
70680;能够保证单人稳定的产出之后，就会有多人互动的图出现了，那个时候就真的嗯嗯嗯嗯笑哭;4;33;37;18388;0.002012181857733304
70685;还是略麻烦，不过也算是有解决方案了;2;30;32;18388;0.001740265390472047
70688;小白想问一下，如何让SD输出高分辨率图？我看设置最高好像就2K，但是我想生成4k且不失细节的图的话。如何实现啊？求求了;14;12;26;18388;0.0014139656297585382
70703;现在还可以多重控制网络了，可以先用blender摆一个openpose的骨骼，然后弄个手的模型做个depth的渲染或者normal的渲染。最后两到3个控制网络合并;2;18;20;18388;0.0010876658690450293
70706;说的不详细，是在文生图，还是图生图里用单独的手势替换的？跟着操作也没替换下来啊？急死人了。;1;0;1;18388;5.438329345225147e-05
70708;显存要大才行吧。低配置的就别想了，我6g显存直接爆;2;0;2;18388;0.00010876658690450294
70713;人类马上要迎来涩图自由了吗？;3;0;3;18388;0.0001631498803567544
70717;不是可以用安装这个DepthLibrary插件来搞手指形状吗？安装地址：httpsgithubcomjexomsdwebuidepthlibgit;1;1;2;18388;0.00010876658690450294
70729;视频中的手httpswwwdeviantartcomfloruiartMMDHandPosePack341517449;1;1;2;18388;0.00010876658690450294
70731;大佬，我想问下，我现在出图的时候个别图存在紫色圆点，图生图的时候问题会加重，为啥会这样？;2;1;3;18388;0.0001631498803567544
70734;现在controlnet还支持multi模式可以添加多个骨骼模型组合使用;1;0;1;18388;5.438329345225147e-05
70740;妈的，更新了以后，controlnet这个插件启动给指引去找一个不存在的路径了，然后用不了，硬是跟着他的路径创了文件夹把文件放进去才用得了，什么鬼啊;1;1;2;18388;0.00010876658690450294
70747;Controlnet是不是禁止了图生图里用真人图片啊。。做出来的图是黑图或黑重绘;8;1;9;18388;0.0004894496410702633
70759;所以为什么不让AI自己根据正确的手部自动调用controlnet纠正呢？人工导入操作图层有点麻烦，图多了就没法一个个去弄;2;0;2;18388;0.00010876658690450294
70764;请问这个语音是哪个？;2;0;2;18388;0.00010876658690450294
70767;自己用手做动作ps输出深度图就行了;1;2;3;18388;0.0001631498803567544
70769;upup怎么样在0257的时候弄这样弄不同步数的图，我看贴吧还有能测不同的模型生成图;2;0;2;18388;0.00010876658690450294
70774;今天看了一个用深度图的解决方案，和这个类似;1;0;1;18388;5.438329345225147e-05
70779;小白不懂就问，这些ai小姐姐是固定样貌模板，还是可以自己提供脸去生成的？？？如果我想用自己喜欢的脸做基础，然后再调整局部五官美化，这样可以吗？？;6;1;7;18388;0.0003806830541657603
70786;6G显存也没有办法使用Controlnet;1;0;1;18388;5.438329345225147e-05
70789;up，能讲讲怎么安装xformers，折磨我好久了;4;2;6;18388;0.0003262997607135088
70795;脚本里面增加的controlnetm2m怎么用？;1;0;1;18388;5.438329345225147e-05
70800;挺好看的，我自己这辈子画不了这么复杂的画。但不影响我继续把画画当爱好，不影响我继续看黑白漫画。如果画者是网上到处找素材，然后拼接缝合，那ai在这方面应该做到了极致，比不了。但带有个人风格的语言文字、特写镜头、独创事物，这些东西短时间内ai还做不到。;91;2600;2691;18388;0.1463454426800087
70892;学画画的，说说自己的感受，首先这玩意在行业将来绝对就是大趋势了，没得挡，很赞同热评第一的一些想法，一些底层画师再义愤填膺也没用，多去提升自己，别老圈地自萌的发病。我自己看这些画是有挫败感的，构图光影，最基本的一些细节其实都有考究，氛围实打实，能胜一群人。透视和具体细节什么的有待提升，但这玩意发展太快了谁也不好说。但我也不灰心丧志，我多去学多去练，在概念设计想法，塑造都画的比他好就行了，把它看坐一个很好的灵感提供工具，善于利用这些让自己多去向cg界金字塔顶端的那一批人去靠拢，才不会被洪流冲下去。ai到底是ai，人还是人，没必要焦虑，没必要傲慢。;257;9704;9961;18388;0.5417119860778769
71150;这些图的背后都是密密麻麻的词汇和精炼语言。这种图真不是谁都能做出来的，即使给你同款AI，也非常难，不信的可以自己去试试。我觉得AI作图必将成为未来，而现在越早掌握并开始利用的人，就会是下一个“光叔”“杨奇”。这个势头已经挡不住，我们该做的就是去学习，为己所用，而不是去抵制最后被时代抛弃。;131;2710;2841;18388;0.15450293669784643
71282;AI的前景太大了，似乎没什么是做不到的，曾经有人说围棋的变化比宇宙的星星还多，不可能赢人类，不久出现了成熟的学习型AI；星际狗开始打不过中等人机被嘲讽，结果后来开各种操作限制都能靠单一战术爆杀职业比如说作画没有灵魂，且不说这“灵魂”到底谁来评判，我认为“灵魂”的高度也不过是技术暂未到达而已;73;1901;1974;18388;0.1073526212747444
71356;不要神话ta：ta只是人类现有作品的线性排列组合不要小瞧ta：ta能集全世界画家精华于一处要同时保有对局限和优势的观察星星眼微笑;39;1072;1111;18388;0.06041983902545138
71396;一位小哥用AI绘画工具Midjourney生成的作品，在美国科罗拉多州博览会的艺术比赛中获得了第一名。;84;907;991;18388;0.0538938438111812
71481;吵什么啦，反正ai要替代，肯定不止美术，到时候音乐小说这些娱乐的都会被替代，工作很多也会被替代，大家都一样doge所以有啥可吵的，一起等着ai代替所有人，然后大家意识飞升吧意识储存进链接，现实生活ai来做，多完美呀;113;883;996;18388;0.054165760278442464
71595;把画画当作是艺术爱好的算是件好事但是对于靠这个吃饭的底层画师肯定是降维打击，几秒钟就做得比大多人十天半月还好，能节省大量的时间成本，资本是逐利的，他们不会管“情绪”、“思想”、“灵魂”这些虚头巴脑的的概念，只要符合预期效果就行;42;632;674;18388;0.03665433978681749
71638;照相机的出现让画家们在追求真实的道路被封死，画家们开始体现出自拥有自己思想的抽象派画作，AI不过是代替了照相机的作用罢了，会有新一派的画家登场的最典型的就是二次元画作，照相机是绝对弄不出来的，所以看现在干嘛，AI是辅助你的工具，不是代替你的东西;33;522;555;18388;0.030182727865999563
71672;细节太多，一眼看过去抓不住重点，眼睛很累，不过这场景宏大得真的爆杀好多人。。。;18;667;685;18388;0.03725255601479226
71691;目前不成熟的阶段已经十分夸张了。毫不客气的说，我做梦都梦不到这种宏大的场景笑哭AI能不能取代人类画师另说，但是绝对能让业界内卷程度更上一层楼，可以参考围棋界。;18;367;385;18388;0.020937567979116816
71710;比有的画的又烂收费又高屁事还多的接私稿画手画的好，看来以后想约稿又多了些选择。（不是我说，网上有的画手那个收费和水平实在有点大可不必了我记得以前去过圣彼得堡，那里景区有艺术学院的学生摆摊卖画，一副a4纸大小的教堂油画也就一千多卢布画面很精致热）;22;677;699;18388;0.038013922123123774
71733;挺好滴，希望这项技术能快速发展，我不关心画家会不会失业，但以后能有便宜廉价还高速的工具让我一个不会画画的人也能调试出自己喜欢的画面就很好，我也无所谓有没有灵魂，但我知道我想约张视频里这样的图片人工花几千都打不住藏狐;295;3426;3721;18388;0.20236023493582772
72029;了解商业美术原画设计的人，都明白ai带来的变化终归是给画师带来便捷的参考，是取代不了画师的。类似3d行业刚兴起时也一堆人说3d会取代2d，但现在结果也看到了3d只是更好的辅佐了画师进行创作。反而是一些不太了解商业美术的人，一直在咋咋呼呼的大喊ai要取代画师了，就挺搞笑的。真有一天ai能取代画师的时候，那就不是美术行业的事了，那时候人类该先担心ai什么时候造反了;123;846;969;18388;0.05269741135523167
72153;热唉大家都是凡人都是工人画成大师需要时间在这些修习的时间里家里的补贴就很难在这样约稿来了这样下去美术会真正变成贵族的艺术像我这种出身平凡没有家底的人在机器普及之后估计在美术上会更难走了现在被机器追着撵的局面何其眼熟真没想到自己在有生之年还会去体验一把历史书里工人的感受;96;514;610;18388;0.0331738090058734
72250;别忽略根本问题，无论是透视构图还是色彩搭配全都是人几千年积累来的东西，是靠人发现的，ai的底层逻辑从始至终的是人赋予的，让你觉得好看有趣的ai图都是人从成千上万的图中精心挑选出来的，ai无论多么锋利都只是是一把剑，是不能允许成为骑士的，当最锋利的剑成为了国王也就不再需要护卫拱卫或是国民的爱戴了，切忌把工具视为偶像。妙啊;12;283;295;18388;0.016043071568414183
72263;我作为一个美术生来讲的话，看到的第一眼确实能够被色彩丰富所震撼，但不同场景的拼接经不起细看，也许是现在技术还没有成熟到这种地步，但我认为电脑没有办法通过人的思维来去做画，即使色彩符合大众审美，可能整个构图的倾向与及细节度始终是达不到人类的绘画水平的热;110;511;621;18388;0.03377202523384816
72374;目前国外有人用ai作画去参奖拿了一等奖有多少所谓的业内人能拿到？事实证明别说外行人就连很多内行在不知道他是ai作画的情况下也有大概率可能认不出来手绘动画漫画行业很难被取代但那种作画插画行业的普通人确实大概率被取代很多行业为什么ai不好进行因为责任不知道归谁比如ai车但画画行业确实很危险;26;263;289;18388;0.015716771807700675
72401;AI作画兴起了一轮又一轮，但每次讨论之下输出情绪的永远才是大多数，不过如果真有一天AI能够真正取代人类画师，掌握了人类对美的偏好和逻辑，那比起担心画师作家作曲等职业，不如好好担心自己身为人的身份，还有什么是AI不能拿捏的2233娘喝水;34;249;283;18388;0.015390472046987165
72436;轮到ai来提高我的审美了;1;656;657;18388;0.035729823798129216
72438;ai绘画目前最大的问题根本不是是否能取代，而是它参考的这些图的信息绝大多数都是需要版权的非法使用版权才是目前某些画师担忧的问题;22;145;167;18388;0.009082010006525995
72461;难怪说文学再没有意义，ai不断的发展，照这个速度几十年上百年，ai可以做到吸取全世界人类的各种思想文明科技自动完善推演融合，所有的文学作品绘画音乐真的没有意义了，当ai可以一秒钟写出一万首李白水平的诗词，一秒做出一万首肖邦的夜曲，一秒钟绘画出几十万幅大师的作品，这一切真的没有任何意义了;44;173;217;18388;0.01180117467913857
72506;就像当年讨论的机械化是否会取代手工业，答案是肯定的，比人工更低的成本、更高的效率，只能说不是画画这一个行业，各行各业迟早都要面对吃瓜;2;70;72;18388;0.003915597128562106
72509;我破防了，我就一普通美术生，高中当不了学神，未来也当不了无法被替代的画师，目前有点焦虑，尤其是看见一群和美术行业半点关系没有的人，幸灾乐祸的讨论所谓“水平低”“水“的画手会被替代，要知道任何行业最多的也都是中下游的普通人，在这里秀什么优越感呢;110;775;885;18388;0.04812921470524255
72620;当年围棋ai出来的时候也是这样，自诩人类最后的高地，什么都往阴阳五行玄学上靠，变化比宇宙原子还多什么的，真的过于傲慢。反倒是那些九段的围棋大师，处于金字塔顶端的人是最开始接受的一批人。;33;315;348;18388;0.01892538612138351
72654;灵魂？假如不说这是ai，我会说这些画充满了灵魂;29;383;412;18388;0.022405916902327606
72684;画师们现在的情况其实就和二十年前工农阶层还在讨论自动化机械化会不会代替人力劳动一样我只能透露一下企业工厂创办在地方镇府是有最低用人指标的根据注册金额的不同来规定你最低要解决多少就业问题要不然你会看到厂房里都是数控设备每个设备只有两个技术工程师负责高耦合性重复性工作将不会交给人类来做所以真正决定这个行业饭碗的还是镇府的决策;1;71;72;18388;0.003915597128562106
72686;将来游戏行业会产能过剩;52;113;165;18388;0.008973243419621493
72739;没被美院录取的AI画家会发动赛博二战吗？;6;154;160;18388;0.008701326952360235
72746;Ai取代的行业未来可能会很多，但是ai取代后，那么人该做什么？不解决这个问题，会出大问题的，今天是画师，明天就是设计师建筑师，老师甚至医生，在幸灾乐祸啥？;28;81;109;18388;0.00592777898629541
72775;就算ai可以替代人类画画我还是会画画，因为我喜欢仅此而已;9;64;73;18388;0.003969980422014357
72785;所以只有我关心去哪找到这些画吗？;18;113;131;18388;0.007124211442244942
72804;。。。那些说着什么取代中下层画家的人。你们不会以为自己的工作很有意义不会被机器人取代吧？一个个感觉自己多优越一样。。其次这种拼接画肯定会涉及侵权。。虽然我不是搞美术的，真的不觉得这些ai画都是同一个味道吗，要是科技没有什么突破性发展，也不过就是一个依靠素材库的混合体罢了，至少目前不可能达到甲方要求什么就做什么的标准。。说什么取代？真是搞笑;15;99;114;18388;0.006199695453556668
72820;心目中的巨人王庭;7;111;118;18388;0.006417228627365673
72828;画的都不如这个层次的ai的画师担心知识产权是不是有点多余了？;6;93;99;18388;0.0053839460517728956
72835;ai绘画进步的确实很快，但他有个很大的问题就是不能完全按照你的意愿去画出符合设定的图，所以你在视频和绝大多数AI艺术家的作品中看到的基本都是恢宏的场景，也叫所谓的大气图，为什么叫这个名字呢？那是因为这方面的绘画的创作几乎不需要限制，只要你能竭尽全力的表现出一种“大气”的恢宏感就可以了（比如图中那些巨大且若隐若现的哥特建筑和缤纷华丽的呼应光影），正因如此，大气图对于能够高度整合手头资源的AI来说创作非常简单，只要参考并用足够多的大佬作品进行学习调教将很快得到提升，但ai最致命的硬伤是除了大气图画其他的就一般，一旦涉及到你需要具体的规定某种特殊场景，他就画不出来，比如你做出如下要求，几名特种部队队员，全副武装的冲碎一堵木墙，向另一面惊慌失措的敌人发起攻击（就是彩虹六号那张著名原画），ai就画不出来，大气图确实是不需要过于具体的细节描述的，但你怎么让ai理解什么是冲碎一堵木墙？什么是一个人挑起另一个人的下巴？什么是涅槃决起，百鸟朝凤呢？理解这方面的东西可不是单纯找参考那么简单啊笑哭正因如此，AI才不可能在短时间内完全取代艺术家但如果未来的某一天，ai已经能够近乎准确的理解一个人类用口头表达出来的任何脑中画面了，那样的话，比起先担心画家失业，不如让所有人想想，在这么强大的ai面前，还有任何一个其他行业是能够生存的嘛？笑哭笑哭;14;134;148;18388;0.008048727430933217
72850;前几天听机核某期电台聊这个，说起了照相机刚被发明的时候，好些大艺术家当时极其悲愤的说绘画死了。;1;52;53;18388;0.002882314552969328
72852;AI作画现在当然很不完善，但已经比一些浑水摸鱼靠炒作赚米的画手强多了，很多原本要求没那么高的美术作品也可以用AI替代;4;130;134;18388;0.007287361322601697
72857;理论上就没有ai生成的图片。任何ai生成的图片都有人类的劳动，不知道为什么那么多人觉得ai会取代人类绘画;8;54;62;18388;0.003371764194039591
72866;画风一样，看久了会审美疲劳，而且整个画面没有重点，但不得不说色彩真的很好，可以当作背景素材。真正超越人类还是有一段比较大的距离的小电视笑;32;154;186;18388;0.010115292582118773
72899;初一看很美很不错，细看就会发现大部分像是着火了，而且室内外不分，人也画得很模糊，还要继续努力啊。;5;46;51;18388;0.002773547966064825
72905;现在是普通画师，那接下来就是各行各业的普通人，只要是能用机器取代的行业，包括出租车，游戏，网文，还有各种设计类的行业，最后都会滚滚而逝，那时候还在这里嘲讽低端画师的人应该会叫唤的格外难听;67;372;439;18388;0.023874265825538393
72973;不会取代的，我观察过在某些重要领域，AI会暴露它严重的构图缺陷，比如说涩图妙啊;6;45;51;18388;0.002773547966064825
72980;感觉AI绘画真正的意义是让普罗大众，一些对自己画面没有高要求定制内容和没有绘画能力有想要得到自己想要的画面的人使用的，而不是去一味的代替什么群体;6;96;102;18388;0.00554709593212965
72987;这些AI绘图明显全是西式素材拼接的产物，假如让AI代替人的审美，那么人的审美就是收少数人支配的结果。;16;78;94;18388;0.0051120295845116384
73004;最近很多AI画作出现在我的首页，看了许多，我得出了一个与诸位相反的结论，AI的出现不会让所谓的“小”画家这类职业消失，相反，会进一步巩固他们的存在，提高地位，因为会有一个新的职业作为他们的下一层，AI画师，这个职业会提高画作的普及性，提高市场容量，拓展需求。当然这只是一家之言，仅供参考。由于本人从事需要创造性的工作（非画师），就目前而言，机器除了能解决不需要主观意识形态的劳动密集型的工作，其他的行业及工作我看不到任何会被所谓AI取代的可能，顶多是AI辅助，以人的主观性作为驱动力。而且目前看来，这些AI画作顶多作为灵感库的存在，没有丝毫的商业价值，更何况艺术价值（这里涉及到艺术的本质，而不是拿了什么奖就是艺术，那是评委的喜好，少数人的爱好不是艺术，真正的艺术是接地气的有文化内核的）;6;58;64;18388;0.003480530780944094
73012;ai什么时候能画本子脱单doge这样我就不用自己画了脱单doge;10;38;48;18388;0.0026103980857080703
73023;拼接严重，真搞这种大场景都用3D辅助了，就视频里的图最后还得是画师继续修细节，而且还不一定符合项目要求，到最后时间一样没节省，现在就开始喊替代太早了，而且这种图离做成动画游戏或者cg只能算是前期的概念工作而已，最多只能当参考图用;4;38;42;18388;0.0022840983249945617
73028;有汽车了，人为什么还要走路跑步？对于喜欢画画的人来说画是动词，是创造美的过程，不是拥有美的结果。;6;78;84;18388;0.004568196649989123
73035;我做梦都梦不到这样的景象;1;72;73;18388;0.003969980422014357
73037;总觉得好多张画都像火灾场景;3;32;35;18388;0.0019034152708288013
73041;再过几年十几年，AI绘画估计能抢掉一大堆汇圈的工作，在过个二十年，快进到出现知名AI画家马库斯dogedoge;1;29;30;18388;0.001631498803567544
73043;哪里能找到原图做壁纸呢给心心;16;65;81;18388;0.004405046769632369
73060;AI强不强不知道，但画师的嘴是真的硬;2;37;39;18388;0.002120948444637807
73063;所以说图包能给我一份吗，我拿硬币换;18;65;83;18388;0.004513813356536872
73083;能干掉很多新手，但是细节过多了，虽然能做到比人精准的上色，但是不太能做到突显某个重点的能力，构图，疏密。但是可以拿来辅助;72;275;347;18388;0.01887100282793126
73156;现在ai绘画细节上还有问题，但整体构图跟意象能爆杀大多数人了;5;31;36;18388;0.001957798564281053
73162;一口一个灵魂，那请问什么是灵魂？如果一个画师的灵魂是思维，视野，阅历的话，那这些东西不全都可以转化为数据存储到ai当中吗？这样的ai做出来的画为什么叫没有灵魂呢？;1;34;35;18388;0.0019034152708288013
73164;告诉你是人画的：内容丰富有层次感告诉你是AI画的：违和感强没有意境;7;116;123;18388;0.006689145094626931
73172;其实AI绘画我感觉经不起仔细推敲，不知道是不是我的错觉，这些画就像是元素堆积，仔细看画里的“事物”，会发现画的东西很混沌，不知道画的“具体”是什么。;12;34;46;18388;0.0025016314988035677
73185;不知道这么多外行人搁这说什么呢，说什么水平低的自命清高，抱团取暖，说实话约稿本就是一个相互的过程，不喜欢可以不约，没必要叭叭，是，底层画师也许会被ai取代，也不说什么灵魂不灵魂的，画师这一行会被取代，别的行业在ai发展到一定程度的时候不会被取代？到时候看这些人怎么抱团取暖，应该挺有意思的;8;62;70;18388;0.0038068305416576026
73194;我记得上一次有人这么说，还是在照相机被发明出来的时候热;15;33;48;18388;0.0026103980857080703
73210;如果都用ai了，怎么避免同质化呢吃瓜;5;22;27;18388;0.0014683489232107897
73216;别灵不灵魂的了，说是ai就是没灵魂说是人就有灵魂，结果ai和人画的摆一块都看不出来是谁画的，请问是咋辨识的这个灵魂那些灵魂党？;4;25;29;18388;0.0015771155101152925
73221;美术视觉上是可以卷的，但背后的文化知识，是ai无法理解的，也是很多很多画技性画师缺少的;11;21;32;18388;0.001740265390472047
73234;我记得围棋人类不就败给了ai算法，阿尔法狗，ai的发展是靠背后一群科学家改变算法来的，未来可能很多职业的中低下游都会受到它的影响，甚至淘汰，但当ai算法真的发展到可以去掉某些职业的中下游时，要延伸出新的职业与产生新的分工才行，不然失业的人怎么办？会发生大事的;4;19;23;18388;0.0012508157494017839
73240;说真的，这项技术让我感到很欣慰，在经历近几年各种娱乐至死的氛围后，第一次见到相对于大众如此明显的科技进步，可能是人类70亿人口基数太大了吧，看到的大多数是忙碌于生计的人，我之前甚至一度以为科学家和技术开发人员等人要逐步消亡了笑哭笑哭笑哭;4;28;32;18388;0.001740265390472047
73247;某些人可以不用凑热闹，因为绘画界可以承认AI，但绝不会承认靠AI画画的懒汉;1;17;18;18388;0.0009788992821405265
73249;这东西不会取代画师很简单的原因就是画师可以负责ai不会当甲方让你更改某处细节的时候你怎么办不还是人来操作吗这东西只会让画师早点下班;8;17;25;18388;0.0013595823363062867
73258;对我这种普通人来说画好看就够了谁管你是ai还是什么艺术家表达的什么思想这些画已经不能只用好看来形容了有些人不用硬杠给你这些画和其他的画你真能分得清哪张是ai哪张是真人画的？tv白眼;8;93;101;18388;0.005492712638677399
73268;AI推广只会让人意识到人的价值是身为人能够创新与思考，而不是模仿机器去做一些重复性工作就像和镜子里的自己对垒一样，AI会逼迫人类成长，过程很艰辛罢了记住，AI始终都只是工具，工具是人类为了偷懒而创造出来的，而人工智能只是人类为了减少一些重复性思考而创造出来的偷懒工具。AI会将复杂的工作简单化，但并不能阻止人类寻求新的idea。打个比方，马车到汽车的进化，人类跑的更快更远了，但汽车不是飞机，不会飞，不能带人类跨越大洋。不用感到焦虑，人的价值是身为人本身，不是工具可以替代的。有朝一日AI全能化推广后一切传统劳动都没有意义了，那个时候人只需要活着就可以。被取代的焦虑源于将自己的劳动当做商品出售，而AI降维打击使得商品价值迅速缩水。但那个时候这类劳动本身也没有价值了，人会去寻求新赛道。不要把自己当工具人不要去和机器竞争不要物化自己;3;19;22;18388;0.0011964324559495323
73272;只要ai没办法理解甲方要求，那么插画师就不会被取代转自网络;3;19;22;18388;0.0011964324559495323
73276;我也学过几年的美术，虽然不太懂什么设计但是我还是感觉ai画的挺好看的啊，好看不就完了吗，管他那么多干什么脱单doge;1;19;20;18388;0.0010876658690450293
73278;取代人工插画是完全有可能的，但你要AI给出一整套实用性建筑的建造图纸，难;5;15;20;18388;0.0010876658690450293
73284;每次一刷到就觉得自己在失业的路上难过;2;15;17;18388;0.000924515988688275
73287;仔细看的话，有些细节就很违和，包括建筑的堆叠，支柱的分布不符合现实情况。虽然整体画面很有震撼效果，但是真经不起推敲。一个路人的观点;1;15;16;18388;0.0008701326952360235
73289;为什么好几个热评可以这么高高在上、居高临下的说底层画师会被取代，而且还是乐见其成，非常令人火大的嬉笑态度啊。艺术设计类专业在读生有被气到，毕竟我不是什么天才学霸，以后工作可能就是个底层画师。艺术类已经是不容易被机器替代的工作了，不知道这些怀揣着恶意的人自己是什么样子。是因为刀不落到自己身上不知道痛吗，同理心更是完全没有吗。我不理解，为什么有的可以这样轻描淡写的对素未谋面的人肆意批判、幸灾乐祸啊。热评，哈哈，还是热评。;15;36;51;18388;0.002773547966064825
73305;在外行眼里这些作品和真人画的已经没啥区别了，甚至更加精致;1;12;13;18388;0.0007069828148792691
73308;如果告訴他們這是某大佬畫的：臥槽nb大佬yyds得知是ai畫的后：機器莫得靈魂，看多了就審美疲勞了，都是抄人類的，不可能超越人類純純的就是爲了刷存在感，發言前麻煩動動腦子？;1;24;25;18388;0.0013595823363062867
73310;我根本看不出来这是人画的还是ai画的，ai能直接出这样的图的话，很难想象美术行业的从业者后面的生存压力会多大;10;14;24;18388;0.0013051990428540352
73322;有的人别幸灾乐祸，艺术这种极端主观的工作都能被取代的时候，指不定你早下岗了;3;16;19;18388;0.0010332825755927778
73327;想要壁纸。。。怎么那么多懂王没有一个人分享壁纸链接。。tv难过;1;11;12;18388;0.0006525995214270176
73330;艺术的存在意义是能表达作者的思想，一个人画的好，他的作品就会包含他想表达的思想，然而ai画的好，没有人会去说ai想表达的思想，它仅仅是画的好但是没有内在的没有灵魂的，当然ai画的好不好影响不到把绘画当兴趣的人的;7;11;18;18388;0.0009788992821405265
73338;实际上没必要那么悲观，拿游戏行业内的来说吧，动捕出现也没有淘汰动作师3d打印出现也没有淘汰衍生品的学生。退一万步来讲，机器那么发达了，也没淘汰富士康的员工。我不敢说科技永远代替不了人类，但是在艺术这个领域绝对是偏后的。艺术的本质就是人类的感情抒发和传递，这都是ai不具备的。所以幸灾乐祸的或者怨天尤人的都省省吧微笑微笑;4;13;17;18388;0.000924515988688275
73345;真的，我做梦都不敢梦到的场景被ai给画出来了；感觉太震撼了，看的心头一热大哭;1;10;11;18388;0.0005982162279747662
73347;我是计算机专业的，学习过很多AI模型的相关知识，只能说现在神经网络发展太快了。而且在今年年初英国alphabet已经有取代低端程序员的AI，属于是把自己人都干失业了，各行各业都逃不掉微笑只能提高业务能力争取让AI成为辅助工具为我所用灵魂出窍;3;10;13;18388;0.0007069828148792691
73352;这么卷了，以后还是得靠剧情内容质量才能脱颖而出热;9;10;19;18388;0.0010332825755927778
73364;AI到这里就可以了，再过就抢人家饭碗了。作为外行人觉得可以，现在约张大头都要80，半身怎么也得150。我只想给小说男女主有张脸，花钱嫌贵不买心痒痒，如果AI粗糙给张图还像现在这样免费，真的可以星星眼;6;12;18;18388;0.0009788992821405265
73373;作为一个曾经的行业内来说如果是曾经的我那我确实会紧张，因为未来几年ai绘画还会飞速发展，我可以打包票除了最顶尖的那批人，90的美术从业者都画不出ai这种水平特别是ai的效率，本来需要制作10个精细场景图，可能5个人需要画一个月，有了ai，一个人几天就能完成，只要在ai的基础上进行一些修改就好了，本质和贴图画法差不多，说不能取代的还是太小看ai绘画了，但是画二次元的还真没有这个烦恼，目前ai绘画只能画抽象，写实，或者设计类的;13;9;22;18388;0.0011964324559495323
73388;嗯。。AI其实还是在拿大数据玩拼图。还是缺少真正的创作。;5;9;14;18388;0.0007613661083315206
73394;感觉低级的画师是一定会被取代的，会很快，十年吧。;9;9;18;18388;0.0009788992821405265
73405;一些人在这里吵架，ai依旧在学习成长，一天24小时不间断学习，成长的速度太快了无语无语无语无语无语无语;3;8;11;18388;0.0005982162279747662
73413;对于我这种爱好写小说却没钱约稿约角色形象的人来说，，，AI绘画真的是福音了，，，;3;7;10;18388;0.0005438329345225147
73417;这个就和刚出生的婴儿一样，随着时间流逝，等它长大了，一切争议都将烟消云散。;1;7;8;18388;0.00043506634761801175
73419;说ai没有灵魂的，如果把大量的人类作品和ai放一起，能分辨出来吗？比如每天给他看一幅画问有没有灵魂，那他能百分百正确把ai的判断成没灵魂吗。人类作品能看出灵魂感的也是少数吧，我对于ai有灵魂的作品比例和人类比例高低存疑;1;7;8;18388;0.00043506634761801175
73421;碳基可以运行的程序硅基也一定可以，说ai永远无法取代人类的，只是在麻痹自己罢了;3;7;10;18388;0.0005438329345225147
73425;可能会冲击插画从业者，但漫画和动画还是要人来，毕竟AI不能自己想个故事吧。所以我觉得画画的人也不至于焦虑，而且有时候会画画本身就很快乐，就像听别人拉小提琴不如自己会拉更爽，AI再怎么完善，就是真的人人都能用AI画画了，还是和听别人拉琴一个效果，永远不如自己用笔画来的痛快。;1;7;8;18388;0.00043506634761801175
73427;我来谈一下我对目前AI能力以及AI画作的理解（作为目前在AI行业中的奋砺人士）。先说说被很多人提起的AI发力的两个例子，围棋和星际。围棋是有最优解的，只是解空间太大，计算机算力跟不上。现在的做法是用AI来给很多状态一个估计值，这个值估计的越准确，下棋越好，但围棋仍没有得出最优解（只是比人类强）。星际是非完全信息下的博弈问题，解空间更大。由于算力不足，现在AI采用的学习人类战术，加上独有的操作优势（AI可以使用引擎内部信息，从而操控精度远胜用鼠标的人类）。这两个领域主要属于算力问题，算力提升上去很多问题可以解决。绘画这个领域跟算力的关系并不是很大。现在的AI绘画更多是学习了很多画作后形成的一种风格模仿加元素堆积，更擅长联想能力（这就是为什么它擅长画科幻和奇幻），但是它独立创造的能力不足（不擅长画从来没有的东西）。而且AI画作内部逻辑是缺失的，画的可解释性不强。这就是我们为什么说它没有灵魂的原因。现在的AI的能力集中在归纳能力上，你要想拥有灵魂，你至少还得是有推理能力的吧。从现在这个角度上说，AI画画要想取代人类还是太早了。;3;10;13;18388;0.0007069828148792691
73432;笑看圈外人一个劲的笑ai作画取代人力的;68;34;102;18388;0.00554709593212965
73501;这项技术还有很大的提升空间，有些构图看得出来还比较乱。;1;7;8;18388;0.00043506634761801175
73503;如果我偷偷用ai画出来，然后说这是我自己画的，你们是不是会觉得很有灵魂蛆音娘卖萌;1;9;10;18388;0.0005438329345225147
73505;一群酸别人会画画的纯外行在职画师在公司里是干嘛的都不清楚ai底层算法也不知道就在哪儿说画师要被替代了;6;9;15;18388;0.000815749401783772
73516;作为一幅画，它好看，它就有意义。;1;6;7;18388;0.0003806830541657603
73519;板绘会不会我不知道，毕竟输入几个关键词，ai再从网上的那些画学习计算就可以创造出新的画，但本质上还是得从其他画师身上抄袭才能通过关键词创作，关键词没有相关作品，ai创作就啥也不是，有了关键词创作，那么ai的商业能力该怎么付费给被“借鉴”的成千上万的画师。之前有一个日本的ai绘画平台，将自己作品上传后可以生成与自己画风一样的画，提供创作思维，但由于谁都可以使用，平台也没有鉴别出作品是谁的能力，很多人将其他画师的图片上传为自己的作品，然后生成出其他画师的图片说自己画的使用在多个方面，侵犯了集体画师的利益，这个日本的ai平台直接关闭了，说白了还是看利益;4;6;10;18388;0.0005438329345225147
73526;效果确实惊艳，但是局限性也是有的，什么时候ai能真正理解需求了才真能完全取代人力，但真到了那种程度人类也不需要工作了;1;6;7;18388;0.0003806830541657603
73529;科技或者技术的进步如果挤压了人的生存，那么这样的技术不能大量推广，你让失业的人怎么办？人没了，拿这些东西有什么用？留给外星人吗;3;6;9;18388;0.0004894496410702633
73533;快进到ai画家画出虚拟形象，后被某知名美术院校录取;1;6;7;18388;0.0003806830541657603
73537;这个世界最后一项被取代的是内容文学。如果这也被取代了，人类在所有领域失去优越性，那么将开始被淘汰。;1;8;9;18388;0.0004894496410702633
73543;真的好看啊，实话说灵魂说这东西就好像是阅读理解，只能说作者确实带着心血和感情去创作，但解读和感悟只能靠后面的人自己去体悟，你把ai的画和其他人的放一起，实际上和做阅读一样还是会有不少人自我解读出来思想和情感的捂眼;2;5;7;18388;0.0003806830541657603
73550;Ai会取代一部分画师，但不能取代画家;9;5;14;18388;0.0007613661083315206
73560;这几副画的AI画的建筑什么的，不都是人类造出来的吗;1;5;6;18388;0.0003262997607135088
73562;相信自己，机器人早就能准确的弹奏出钢琴，但到现在弹奏者一点也没受影响;1;5;6;18388;0.0003262997607135088
73564;好看，但是只会用ai的人能被称为画师吗;8;5;13;18388;0.0007069828148792691
73573;应该还是有修过的，人家说拿AI做辅助，谁也不知道最初产生的AI背景图是怎么一个混沌的景象。如果AI真可以画出这样50完成度我感觉都很有用了，至少场景和氛围上能帮很多人画出更好的图;8;5;13;18388;0.0007069828148792691
73583;人类太自大了，任何东西都可以被解构然后量产，艺术中所谓的感情完全可以大数据破解，目前只是技术不够。;4;8;12;18388;0.0006525995214270176
73588;和历史潮流作对的一般都死的渣都不剩。;2;22;24;18388;0.0013051990428540352
73593;感觉上吧，比较平铺直叙，缺少注重点和表达的意志2233娘疑问用来配一些小时插画可行，当画作来讲救是没得灵魂。;1;6;7;18388;0.0003806830541657603
73595;你不说这是ai画的，估计弹幕就全是“壁纸get”或者“膜拜大佬”之类的，不会像现在这样，还什么缺乏感情，好家伙这都能看出来缺乏感情，那您可真是吴道子再世啊哦呼;2;51;53;18388;0.002882314552969328
73598;本身学过一些画画，很喜欢。今年开始接触的AI，给弹幕里的人科普一下，首先这几幅画的生成条件应该就那么几条，也就是说作者用同一组词缀跑了很多风格类似的图。只要作者换个模型画风，换个VAE色彩，再改一点词缀，跑出来的图会完全不同。另外就AI绘画发展的这个速度下去，手，构图，透视，都会被插件解决，而且很快。;1;4;5;18388;0.00027191646726125733
73600;嗯，人脑的运转是存在一个机制的，意识因为这个机制而诞生的，人类的情感和文化等等也都从这个机制当中出现。事实上，当AI能模拟出人脑的机制，能理解人的感情和痛苦，能感受到快乐，有欲望和渴求，有了遗憾和满足的时候，它就是人了。只不过拥有着和我们不一样的躯壳罢了。关于AI会不会诞生自我意识这个事嗯，不说AI，我们又有什么能力证明除自己之外的人，有没有自我意识的存在呢？;1;4;5;18388;0.00027191646726125733
73609;写代码的AI也在路上了，研究这些AI的都是技术狂，革自己都不亦乐乎，会在乎画师？你骂资本我也骂，骂完继续研究怎么取代自己，技术的洪流挡不住的。;2;4;6;18388;0.0003262997607135088
73613;但凡这些是人类画的就不会有这么多“只是意识流罢了”“感觉空荡没灵魂”ai绘画起步在这几年才开始他给画师带来的是更卷的社会，处境，但是不得不说他就是素材融合，但是机器的筛选，他能知道人类更爱的风格;1;4;5;18388;0.00027191646726125733
73618;我焦虑什么，我画画是给自己看的，是自己开心的，为什么我非要出去约稿，AI肯定会越来越好，但是风格嘛，还不是从那些画师的作品那里学来的（我看了好多个都差不多的画风）所以我会自己努力加油的，我想要创作出属于自己的画;1;4;5;18388;0.00027191646726125733
73620;AI作画，实际上创意还是来源于人类的吧;2;4;6;18388;0.0003262997607135088
73623;虽然说很多结构不清晰但是有些改改拿来做概念设计完全够啊，更别说氛围了;1;4;5;18388;0.00027191646726125733
73626;取代不了是因为ai目前为止做得都是抄袭现成的，如果人类真的放弃了艺术创作把它一股脑交给ai做，那么艺术永远不可能发展出新画派和新风格;2;4;6;18388;0.0003262997607135088
73629;我觉得，ai确实是大势所趋的了，但最后的点睛之笔肯定要人类来完成，不妨ai绘制大体轮廓，然后人类做小幅度修改，感觉会很完美？;1;4;5;18388;0.00027191646726125733
73632;应该配小说来看最好;3;4;7;18388;0.0003806830541657603
73637;一个学画画的表示，ai绘画取代画师就跟自动驾驶取代自己一样理所当然，只能无奈，ai绘画在我的理解中就像是一款高科技的画笔，我们普通的炭笔，笔刷就是最原始的画笔要一笔一笔的画，而ai就是把想的东西输入，它就会自动帮助人类画出好看的画面，画画不是简单的技法，好的画可以反映一个人甚至一个文明或者种族的观察这个世界的方式，像国画和西方油画就反应了两个文明之间看待世界的异同，有时候毁灭画家的都是画家本身，当初的摄影，现在的ai，哪个都说要取代绘画，哪个都是绘画行业的人发明的;1;4;5;18388;0.00027191646726125733
73640;你要是不说这是ai算法画的，给普通人看，而不是专业的画师看，那普通人就两字，震撼，非常震撼，我约的画师估计没有一个能达到这图的水平，虽然她们也很在进步，但是拿出来和这视频中的图一对比，真的对比太强烈了，而且我当时约的也是大图;1;4;5;18388;0.00027191646726125733
73642;说句题外话，我是真受不了某些ai战士张口闭口取代替代的，就算哪天ai有自主意识能产子了，人类也会第一时间毁灭或者限制它，创造一个比人类强太多的机器对人类有什么好处？还取代中下层画师，巴不得一堆人转行失业然后画画变成只有上层人民才能玩的起的高档艺术是吧？;4;6;10;18388;0.0005438329345225147
73648;艹，Ai画的真特么流弊，感觉这么多年白画画了，Ai老师教我画画呜呜呜呜保卫萝卜哭哭保卫萝卜哭哭保卫萝卜哭哭;1;4;5;18388;0.00027191646726125733
73650;把边缘无用的细节交给ai，核心表达思想的给人类不是更好？叔本华说哲学家应当有不愁吃穿的生活来思考哲学问题，艺术家也应该有将无关痛痒的背景交给AI，以此将更多精力投入真正关键的艺术核心思想的自由;3;4;7;18388;0.0003806830541657603
73657;如果不说这是AI画的，是某某大师的作品，小画手们应该会争相吹捧吧哈哈哈，但是一说是AI画的，小画师们就说没有灵魂，只是冰冷的数字产品吧啦吧啦;2;8;10;18388;0.0005438329345225147
73661;人的思维活动是电信号，人家电脑也是，怎么人画的就有灵魂了呢tv调侃;3;5;8;18388;0.00043506634761801175
73665;某些人真和那些十九世纪养马的认为汽车不会取代马车一样急了;2;5;7;18388;0.0003806830541657603
73672;不知道AI什么时候能一键生成3D区的视频妙啊如果未来真的做到了我将跪拜在AI大人的脚下成为它最忠实的信徒dogedoge;1;3;4;18388;0.00021753317380900588
73677;要夸也应该夸给AI提供养分的那些杰出的画师们，我相信如果把AI在生成这些图片时参考的（画师画的）原图展示出来，肯定不会比AI“画”的这些差;1;3;4;18388;0.00021753317380900588
73682;咱没啥美术造诣，也不懂啥叫有灵魂，但就是觉得AI画的耐看，尤其是色彩看起来很高级。;1;3;4;18388;0.00021753317380900588
73691;有《诗云》，就会有《画云》，人类所谓的情感在暴力运算面前只是个笑话罢了。;1;3;4;18388;0.00021753317380900588
73693;看看十年后ai的学习能力会提升到什么水平;1;3;4;18388;0.00021753317380900588
73696;谁能告诉我什么是灵魂，唯物主义者也会相信有灵魂么;2;3;5;18388;0.00027191646726125733
73703;我顿时想到了黑魂，血缘;1;3;4;18388;0.00021753317380900588
73707;还好我是学计算机的呲牙;4;3;7;18388;0.0003806830541657603
73717;我的妈这也太好看了鸡皮疙瘩掉一地;1;3;4;18388;0.00021753317380900588
73719;打不过ai就加入ai，不画了，去研究ai滑稽;1;3;4;18388;0.00021753317380900588
73722;你们说以后会不会有ai半自动3d建模呢？;4;3;7;18388;0.0003806830541657603
73728;画师的心中有无限的奇思妙想与奇迹，想象无限，而机器，在作画前，这副画就已经失去活力了;1;3;4;18388;0.00021753317380900588
73731;战锤40k里面建筑差不多就这种风格吧;1;3;4;18388;0.00021753317380900588
73733;请问最开始那一小段bgm叫啥啊？;2;3;5;18388;0.00027191646726125733
73737;我觉得弹幕风气挺邪门的。AI作画确实有瑕疵，但也不至于被键盘侠指指点点。作品的初衷不是被欣赏的吗，不说细节什么的，就光这个视觉冲击和想象就被吊打了。觉得不行的可以在评论区展示下自己的作品。;1;8;9;18388;0.0004894496410702633
73744;没可比性，感觉AI作画能取代的只是一些固有的设计，画作多为风景画，是在大数据上的再加工。普通的画师可能会感觉有压力，但是真正有艺术细胞的画家重在表达一些更深层次的东西，创新的火花不是所谓的“智能”能取代的。不过我感觉这个取代不取代的问题，讲真，就像问AI未来能不能取代人类的地位一样。;1;4;5;18388;0.00027191646726125733
73749;机器人只要是没有产生意识，都只是人类人脑意识的高级辅助表达工具，意识才是人类特有的，机器人只能模范大致的表象，永远不可能取代人类;6;4;10;18388;0.0005438329345225147
73759;只要是科技进步我就支持脱单doge无脑支持;1;2;3;18388;0.0001631498803567544
73761;技法一流但，艺术的创造性和唯一性被AI打破了，好看但无收藏价值OK是个商业作品不是艺术品;1;2;3;18388;0.0001631498803567544
73769;有没有详细的关键词参考一下？;1;2;3;18388;0.0001631498803567544
73773;还真有人以为ai就是把要素组合？它是真的有创造性的;4;2;6;18388;0.0003262997607135088
73786;bgm配的真好;1;2;3;18388;0.0001631498803567544
73796;我总觉得这些画特别有种生命的活力感，很梦幻，有种现代社会很缺少的一种创造力，一种生命原始的想象力，那种无法形容的感觉，很震撼，我特别喜欢这种尽情的无拘无束的那种创作感，感觉特别美，无法形容的那种美。;1;2;3;18388;0.0001631498803567544
73798;怎么说呢，作为一个不会画画的普通人，感觉ai画出来的画已经完全能满足我的审美需求笑哭，甚至感觉比一部分人工画师还精美惊讶;1;2;3;18388;0.0001631498803567544
73801;然而不论再怎么说，现在的Al水平就是不行。整体的氛围有了，但要么细节细看不行，要么主次不分明。自己用着图一乐可以，但想当商稿用，还差的挺远的。;1;2;3;18388;0.0001631498803567544
73813;ai这个东西比你们想的还厉害得多，ai学习能力完爆人类，现在看起来很多方面还和人类有很大差距，但要不了多久就会发现ai已经训练到人类的盲区了。;1;2;3;18388;0.0001631498803567544
73820;别说灵魂不灵魂这画你不是Ai谁看得出来;2;2;4;18388;0.00021753317380900588
73825;只要是涉及创意的工种人类是有绝对优势的。别看现在AI作画写作大行其道，但这些AI的作品只是用素材库里的素材按照代码逻辑生成，缺少中心思想、精神内核和人文关怀。换句话说，就是你说不出来这些作品到底想表达什么。比如说这副作品，你只知道它画的是“天堂之门”，是怎样的天堂之门？天堂之门的来龙去脉？神话传说？发生了怎样的故事？承载了怎样的思想？拥有怎样的内涵？一概不知道。即使你能根据这些作品描述，那也是凭空飞来之词，没有画面里的元素做支撑，因为难说AI本身是不是有这样的想法。总而言之，就是空有华丽的躯壳，而躯壳背后却轻浮之极个人观点，欢迎友善讨论，不喜勿喷;5;2;7;18388;0.0003806830541657603
73835;这说不定是件好事，不必这么焦虑;4;2;6;18388;0.0003262997607135088
73849;自己玩玩就得了，这种被动式标签式随机生成的低完成度色块稿根本上不了商业，还有我觉得没有人与人之间的沟通，根本没法把甲方的要求具象化，这东西发展再厉害也是给辅助绘画的工具;2;2;4;18388;0.00021753317380900588
73857;为什么总有些人会对刚出生的婴儿感到害怕doge;2;4;6;18388;0.0003262997607135088
73863;虽然但是，AI只能画它们能画的，毫无想象力可言（不是引战嘴下留情）;1;2;3;18388;0.0001631498803567544
73865;最近看了好多ai作画，都是一个特点，极度绚丽，各种杂糅，生怕不知道它学习了几万个画，想一股脑展示出来，看的眼花缭乱但是不知道你想表达什么;5;2;7;18388;0.0003806830541657603
73872;人类的想象是无止境的，只要AI还没有发展出灵智，不理解何为艺术，人类就可以完胜;2;2;4;18388;0.00021753317380900588
73877;这些图在哪可以提取到啊，想拿来做壁纸脱单doge;1;2;3;18388;0.0001631498803567544
73880;从机械狗再到绘画，al确实要比人nb，等以后要是给al程序编辑出类似人脑的逻辑思维，作为一个机械生命体正式诞生，那会发生啥真不敢想象热;1;2;3;18388;0.0001631498803567544
73885;可是ai不能透过现象看本质;1;2;3;18388;0.0001631498803567544
73887;这是什么软件？;1;2;3;18388;0.0001631498803567544
73889;ai作画的存在就是为了筛掉中底层画师，其实ai没啥强，也就是网上搜图怼一块，简单的堆叠学习而已，但是你架不住人类画师也是这么搞的，有自己风格的画师不担心，但是没本事那些人就完犊子了也别酸溜溜的说ai作画没灵魂了，就视频里这光影构图不薄纱你那二两灵魂？AI几秒一张图，给你几秒钟怕是连笔都没拿起来吧;1;6;7;18388;0.0003806830541657603
73892;真高兴不起来，已经达到可以商用的水平了，藏狐一个画师画这种图估计得一个星期甚至一个月，这其中还不包括几年甚至十几年的基础，一想到十几分钟就生成出来了就很窒息无语;3;3;6;18388;0.0003262997607135088
73896;有人说未来AI会取代人类，你都活不到那个时候，你关心那玩意干什么？自己现在都搞不好，还有心情关心未来热;1;3;4;18388;0.00021753317380900588
73900;Al在形意的表达上已经到了登峰造极的地步，甚至成为给艺术家提供灵感的工具，而在具体事物上反而会受到这种艺术性的阻碍，与原像产生违和，但是这也是艺术的发展趋势，学习的呐喊太多就画不出创造亚当，未来当算法优化到一定地步，并对样品取的足够恰当，这种违和也是可以消灭的，才会连“灵魂”都输给机器;1;6;7;18388;0.0003806830541657603
73903;画师和ai画师的关系绝不等同于棋手和ai棋手的关系二者有明显分别;2;2;4;18388;0.00021753317380900588
73915;他们是成功不了的，或者说，如果他们成功的话，他们会更惨。如果有“画风”之类的版权的话，大公司会第一时间把所有的版权弄到手。;2;1;3;18388;0.0001631498803567544
73921;up这个是什么ai软件画的啊，我只尝试过novelal;1;1;2;18388;0.00010876658690450294
73941;真的好看，做梦都想象不出来这么震撼的画面（绘画爱好者，感叹一下热词系列知识增加）;1;1;2;18388;0.00010876658690450294
73959;如果，我是说如果，有心人为了让自己赚钱而设计一套可以破坏这种ai的编码，那是不是最后ai作画也会出现bug，最后能被允许使用ai作画的就只能是大公司，而不是平民了呢。（虽然有点阴谋论，但是我觉得人类个体很多是自私的，这种事不可能没概率发生。）;1;1;2;18388;0.00010876658690450294
73966;“没有灵魂”可能是真的，但这也确实证明很多画师已经没有办法从别的地方反驳了而且AI的进化速度是远远超过人类的，就像阿尔法狗从出世到世界冠军再到完全脱离人类的层次才过了几年？你现在可以说构图、结构、阴影啥的有问题，但难道未来不可以直接给AI投喂基础的绘画理论，让它在绘画理论上出图吗？而且当其吃的图足够多，算法足够优化的情况下，就像阿尔法狗现在已经是自己左右手互博，你能肯定未来AI不会脱离画师，自己创造自己的风格出来吗？;5;1;6;18388;0.0003262997607135088
73983;都好好看。一眼看上去美的很惊艳。不过细看不太行;1;1;2;18388;0.00010876658690450294
73988;没有自我，想象力不会被约束。;1;1;2;18388;0.00010876658690450294
73996;一种说不上来的感觉，人类精心制作的艺术却只需要AI的一键生成就能轻松超越;3;1;4;18388;0.00021753317380900588
74001;ai啥时候在医疗行业卷卷啊，给我把癌症各种疑难杂症搞定喽，这才是实实在在的造福人类，到时候我第一个膜拜ai技术;3;1;4;18388;0.00021753317380900588
74009;我学手绘的，我已经有点怕了;2;1;3;18388;0.0001631498803567544
74013;这些图真的好漂亮，有一些光是看都能脑补出许多，我真的超爱这种宏大感的图画;1;1;2;18388;0.00010876658690450294
74020;浅浅的问一下，各位大佬有知道这是用的哪款ai绘画软件吗？;1;1;2;18388;0.00010876658690450294
74024;最后发展AI可能都会超乎人类想象了，不过不必杞人忧天吧;1;1;2;18388;0.00010876658690450294
74026;其实到最后AI一定是超越人类的，毕竟你说灵魂什么的它能把你的力道，角度，甚至用的什么笔都还原，但现在还是以画师为主要。;1;1;2;18388;0.00010876658690450294
74028;也是挺倒霉的，刚入行就接收一波行业冲击，看看怎么把握好这个新工具;1;1;2;18388;0.00010876658690450294
74031;我只知道我去一个ai绘画软件看别人画的画，有个好兄弟给搞了个打篮球的鸡笑哭不过ai代替这个个人感觉还算遥远;1;1;2;18388;0.00010876658690450294
74036;这些也只是电子画，现实中你让他拿画笔弄墙画呀？;2;1;3;18388;0.0001631498803567544
74042;把它当做一个绘画风格，AI绘画，不就能接受了吗，怎么到处挑刺，这个说细节不行，这个说没有创造力;1;1;2;18388;0.00010876658690450294
74044;ai画其实本质上就是一种作弊，抄袭，抄的是人类文明留下的所有影像资料和理论。但在现在的人类画师也正是在前人的影响下一步一步的形成自己的知识体系，并创作出受到人类群体意识后的作品，（这个说法有点否认个人意志，不过在艺术这种无法定量分析的领域，个人意志在创造中产生到的影响往往更难以区分，所以可以说艺术到底还是集体的）这样就隐约得出了一个很残酷的答案，由人类一手创作的视觉艺术的时代可能要结束。“开创新的流派，大师”这些事也已经好久都没有发生过了。只能说：人类的本质是复读机，不巧，AI更擅长。;1;1;2;18388;0.00010876658690450294
74051;画的太抽象了，好多细节都没有;2;1;3;18388;0.0001631498803567544
74060;ai不能创新不能发明不存在的东西相当于一个学习特别恐怖的人学习了人类文明所以画作代表目前人类理论最高水准这就是它的顶点除非我们画出一种新的东西哦ai学习了ai突破了;1;1;2;18388;0.00010876658690450294
74064;我觉得AI现在是我的老师，感觉好多可以学习的配色和画面逻辑;2;1;3;18388;0.0001631498803567544
74089;说到底画画就是对光影、空间和结构的理解，将这些理解数字化后ai就能在此基础上进行再创新和超越。当人类能够将自身的思维能力数字化并赋予ai时，或许就可以看到人类的极限了。;1;1;2;18388;0.00010876658690450294
74100;幸好我选择转行了抠鼻;1;1;2;18388;0.00010876658690450294
74107;所谓的板绘本来就是电子搬运工，不排除一定程度上可能会被ai替代，但传统绘画就不存在这种问题;1;1;2;18388;0.00010876658690450294
74127;虽然但是，我要泼一盆冷水了，这些ai绘画是人工辅助生成的，需要有专业知识的人才能用的好，不是随便一个小白能自己搞出来的。换句话说，这些东西要给画师用才顺手。一个不懂画画和编程的纯粹想要图的小白可能用不好。;1;1;2;18388;0.00010876658690450294
74130;卧槽，这些恢宏的场景精美的画面只要几秒就能出图，还24小时全天候为你服务，简直酷毙了好吧;1;1;2;18388;0.00010876658690450294
74137;第一二张哪里有原图？太好看了。直击心灵的感觉。话说人类画家能把光影处理成这样吗？不可思议。;1;1;2;18388;0.00010876658690450294
74152;建议约法三章：1：AI绘画只可学习使用者自身作品，若学习他人作品必须征得其同意。2：任何绘画比赛需明确说明是否可以使用AI参与绘画，参与的程度，或分为AI组和手绘组。3：发布有AI参与的作品需标明作品由AI完成或由AI辅助完成，并且此作品作者不具有版权。;4;1;5;18388;0.00027191646726125733
74168;照相机没有让画家失业，我认为ai绘画也不会;2;1;3;18388;0.0001631498803567544
74173;我只想问有没有那种画本子的功能脱单doge高低得开发一下滑稽;1;1;2;18388;0.00010876658690450294
74182;我这个问题可能有点弱质，AI能画出五彩斑斓的黑吗;1;1;2;18388;0.00010876658690450294
74190;ai画法其实就是靠的不断的喂图，从画师的作品和照片里扣出你需要的部分，它画的来的东西都是世间上已经有了的，它不能凭空画出一幅画来就像是画师能在看到一朵花，一颗树，一缕光时能用他获得的灵感画出和你心灵相通的画来ai能取代不了画师，但真的会对中下层画师带来很大的打击，自己辛辛苦苦练了好多年的技术，被一个没有思维的程序碾压了，那程序还是偷的别人的画（照片）很难让人不伤心（打字不易，点个赞吧）热;1;1;2;18388;0.00010876658690450294
74193;有图包不，做电脑壁纸应该会贼棒;1;1;2;18388;0.00010876658690450294
74206;去看看有多少所谓的“画师”结构和透视都完全不对的，还有人在这里纠结灵魂和细节？不管怎么说，如果ai可以花1块钱生成一张图，然后交给一个画师花300块钱细化，成本就是301块钱，但是交给一个能画出这个水平的画师，可能就是3000块钱了。说白了插画这个东西就是商业品，插画的运用场景就是商用，你可以去问问无论是小插画师还是大插画师，想靠这门技术活着，都要和哪些甲方对接，腾讯网易买你的画也不是回来供着，你的东西基本上也没有升值和保值的价值。在电脑上涂的东西上画廊，成为“艺术”，你可以自己看这个比例是多少。洗衣机一定会一定程度替代洗衣工，也许某些牌子的洗衣机洗不了太干净，也许某些衣物没办法用洗衣机，但是你看现在国内外不还是家家洗衣机？也就个别衣物手洗，这个个别的市场还真就没有洗衣机的市场大辣眼睛;1;1;2;18388;0.00010876658690450294
74210;人类以后可能只有两个工种，机器（程序）设计师和维修师。妙啊;2;1;3;18388;0.0001631498803567544
74215;这能替代啥ai只是把画画的底线拉高了，随便一个人都能用ai画出能看的图，但是如果想更进一步呢想要更高的精度，更个性化的需求，不是还要找画师吗，到时候有钱的人还是会去约画师调整画面，但凡口袋里有点钱，有点个性追求的人，都不会希望属于自己的图是烂大街人人都能拥有的吧，反正作为画师来找我约稿的人都是对我的风格比较偏好，题材上也有详细要求的人，我个人没感觉ai会对我有什么冲击就算最基本的简单绘画工作可以被代替，我的审美也还在，我也明白怎么让ai生成的图变得更美，效果更好我可以做到让烂大街的ai图变得与众不同，这就是甲方会花钱找我的理由，有什么好担心的;3;1;4;18388;0.00021753317380900588
74233;根源上还是需要人的灵感和对于艺术类型的创造，AI无法作出超出人类认知的画，最多也就是不可名状，而这些依旧还是根据吸取艺术家的风格，画技，构图之后才创造出来的，AI是可以绘出更美妙的，人类无法达到的场景，但没有人类大脑的创造，AI是无法自我进化出对于美的认知，对于情的感悟，对于场景的思考。;1;1;2;18388;0.00010876658690450294
74236;ai绝对取代不了律师，公务员这种doge即使事实上能取代，也不会让其取代的;1;1;2;18388;0.00010876658690450294
74238;技法是远超普通画家的，但思想与情感无法超越。也许AI绘图出现对画家是一个好事，促使我们向本质的情感考量，而不是在技法上无效内卷。;1;1;2;18388;0.00010876658690450294
74248;所以我想知道比的过这些ai作画的画师又有多少，这些画除了细节没太处理，还有什么比不上人工的，那些说顶尖画师不会被取代的，能说一下原因吗真的好慌;5;1;6;18388;0.0003262997607135088
74256;我就想问在哪下图;1;1;2;18388;0.00010876658690450294
74259;我就想知道，这种作品出来，版权是谁的？是软件的还是你的？;2;1;3;18388;0.0001631498803567544
74272;ai画的画只剩下巅峰级别的壮阔恢宏了，我看不到其中来自于人类充满感情的笔法;1;1;2;18388;0.00010876658690450294
74274;你顶级画师用15个小时画一张90分稿子它人工智能用1分钟画1500张95分稿子懂了吗;2;1;3;18388;0.0001631498803567544
74282;好耶太棒了，希望可以开发二次元画风;1;1;2;18388;0.00010876658690450294
74289;ai无法取代绘画，就像历史上摄影无法取代绘画一样，当真正到达临界点时，很大可能会诞生新的艺术，比如曾经的抽象派，ai说到底只能是工具，我们渴求的是创作的感觉，我们需要ai去推动这个领域继续向前。（个人愚见，不喜勿喷）;1;1;2;18388;0.00010876658690450294
74296;布鲁RC弟弟;2;1;3;18388;0.0001631498803567544
74301;这是什么软件画的？;1;1;2;18388;0.00010876658690450294
74330;取代还是不太可能，但也许会是一个很好的工具吧;1;1;2;18388;0.00010876658690450294
74333;但拼接感确实重了点没有灵性;1;1;2;18388;0.00010876658690450294
74359;在我看来ai更像是一种工具，而画家可以很好的使用这种工具来进行绘画创作，不存在什么取代不取代，缺少的是善用工具的人;1;1;2;18388;0.00010876658690450294
74361;为什么AI的画复杂度都那么高？;2;1;3;18388;0.0001631498803567544
74369;吃瓜吃瓜吃瓜传统画家又不会，家里面挂打印画始终不如挂手绘画高级，墙上的墙绘也是手工大于印刷。cg画家会慌，传统画家完全不慌。;3;1;4;18388;0.00021753317380900588
74374;我在尝试写一些程序来替代我自己的做点事喜极而泣比如修改文章等。我虽然站在ai会替换画手的那一边，因为我觉得技术的进步绝对会超越人类去完成这种精细的工作。但是我也承认，人与机器有完全不一样的地方，我甚至觉得这边更重要。举一个很露骨的例子，娃娃可以替代真人吗？答案模棱两可，但是，你和你的另一半在做这件事情的时候是有感情的，简单点说，双方都是有爱的。有情感和没有情感的东西表现出来的东西就是不一样。画手也一样，每一幅画是倾注了心血的产物，他自然就会表现出画手在作画时的情感，当时的时代背景，或者画手的人生经历。我也是人，有时我能感同身受，我才会感受到这副画背后的东西，我觉得这才是重要的地方。但机器不行，他可能颜色和填涂什么的确实比人类要精细，但作品你只能感受到精细和完美却感受不到情感。;2;1;3;18388;0.0001631498803567544
74378;看来抽象派目前变成最难取代的了笑哭;2;1;3;18388;0.0001631498803567544
74393;值钱的画之所以值钱并不是由画的多好决定的吃瓜;2;1;3;18388;0.0001631498803567544
74403;Al永远不可能超过人类，因为它有上限;3;1;4;18388;0.00021753317380900588
74407;很多画画的要失业的感觉，以后再发展这个不得了微笑;7;1;8;18388;0.00043506634761801175
74426;哇已经开始出ai绘画了;3;1;4;18388;0.00021753317380900588
74431;在后互联网时代，起初ai取代了美工，我没有说话因为我不是美术工作者；接著ai取代了文字工作者，我没有说话因为我不写小说不做自媒体；后来ai砸了生物学的饭碗，说是能计算所有蛋白质的三维结构，我听不懂也没有说话因为我不是科学家；此后ai取代了产业工人，我没有说话因为我工程师；最后ai奔我而来，却再也没有人站起来为我说话了。;8;2;10;18388;0.0005438329345225147
74443;人工智能。人，工，智能。懂？没了人他有个屁的智能。;1;2;3;18388;0.0001631498803567544
74448;这幅画的创作理念是什么，想要传达的是什么？只是为了画而画，就失去了艺术作品本来的意义了，艺术作品是人类思想的载体，是人类灵魂之间的对话，不是你没有意识的AI堆堆素材就能做的。;5;3;8;18388;0.00043506634761801175
74455;咋这么多人破防了捏;1;3;4;18388;0.00021753317380900588
74460;就喜欢看自信小画家自命清高恰黑心钱不成只能破防的样子;1;2;3;18388;0.0001631498803567544
74469;看到弹幕有说“ai好伟大这是ai眼中的世界”一类的字眼真让我觉得恶心，我寻思这些不都是人类画师的作品被ai拼接出来的产品吗？怎么到你们嘴里感觉就变成是ai的作品了？ai是人类的工具，不是你们所期望的新智慧。;10;3;13;18388;0.0007069828148792691
74480;评论里一口一个中下层画师，敢问您在您的领域又是什么水平啊？呲牙说真的，如果艺术创作都被AI取代的话，我们生活中的99的工作也会被AI取代，针总有一天会扎到你身上。;1;5;6;18388;0.0003262997607135088
74482;如果AI有一天能取代人类，对整个地球文明来说是一件幸事，人类这种只会一遍一遍重蹈覆辙，重复无意义的争执浪费无数资源只为了“压榨”同类的在基因层面又一团乱麻的脆弱生物属实已经无药可救了，让吸取“教训”的AI冲出地球代表人类也不失为一种贡献;2;2;4;18388;0.00021753317380900588
74485;小画家来咯是在校学生，平时靠接一些私稿赚取生活费。绘画这件事本身就给我带来了无数的快乐将来也想将其做为一生的职业去发展。ai绘画的出现确实有让我感到心灰意冷，如评论所说ai绘画不会伤害到顶尖的画手们而我目前只能被分为中下之流，也没用足够的信心说将来我一定会干到顶尖。有一种还没有踏上赛道就被一脚踢出去的感觉emmmm我还记得ai绘画几年前刚出来时根本没有人太过在意，区区几年的发展它却拥有了足以爆杀大部分小画家的技术（我落泪）那如今看来所谓的不足之处被ai攻克还需要多久呢？版权也是同样，yysy用版权抵制ai绘画可以说是几乎不可能了。现在国内版权意识薄弱抄袭借鉴层出不穷，所有人都在抵制但成功的又有几个？如果有人使用ai绘出一张图自己再加以修改算不算侵权？一位画师的画几百人几千人在用画师又将如何维权？总之就是，学画画死路一条。终于开始理解机械运作大批工人下岗的苦楚了;2;2;4;18388;0.00021753317380900588
74489;当年织布机的发明淘汰了一大批女工，她们失去生计，开始聚集砸机器，但时代碾过她们，别无所长的她们及家人后来的人生没人知道，但是机器普及造就了各种服装的现在，只有顶端品牌搞手工缝制。毫无疑问，AI绘图会淘汰掉98的从业者，他们的未来如何无人知晓，但是世界的未来会变得更美好。归罪于技术是没用的，你这算既得利益者，百万漕工衣食所系，阻碍进步。你该归罪于灯挂件。;9;1;10;18388;0.0005438329345225147
74499;它在学习在学习那也是从活人提供的数据库中去学习的，它自己能生成数据库？这些的来源只可能是人类的实践;10;1;11;18388;0.0005982162279747662
74511;快进到画家禁止商用ai用自己的作品训练，ai能直接废了;1;1;2;18388;0.00010876658690450294
74513;如果没有说明是ai，说这是一位画家画的，不能说百分百吧，99是被各种夸的。;1;1;2;18388;0.00010876658690450294
74517;说那么多，你们永远忽略了一个问题：时间成本，这样的图AI一分钟能出几百上千张，但一张这样的图一个大师要画多少天？未来用这种手段辅助画家，AI的图作为概念基础，画家润色注入灵魂，这才是AI绘画的价值;1;1;2;18388;0.00010876658690450294
74519;一群人搁这臆想，要是就这样AI就真能取代画师。那机器人不早就统治服务业了辣眼睛;1;2;3;18388;0.0001631498803567544
74523;其实很多时候人类画的画，很多时候被思想局限，（生活知识等等）而AI就没有被逻辑这些框住，以及效率高，如果算法在完善一些，可以在一定程度上采用AI构思，人类二次创作这种方法，代替人类还是不可能的，不过有很多能够利用的点，也可以说合作;2;1;3;18388;0.0001631498803567544
74541;大家没必要慌也没必要跟人吵，因为你永远不知道跟你吵得人到底是多大，自从有一次我发现在跟一个10后争论后我就决定再也不在B站跟人争辩了。真到了艺术都能被ai取代后，那还有什么不会被取代？99的工作都会被取代，那还怕什么，我个人是挺期待这一天的到来。;1;2;3;18388;0.0001631498803567544
74553;为什么大家会这么赞同ai绘画呢因为人类的本质是白嫖党呀可以不用学习不用苦练不用天赋比认真学习绘画的节省了大把岁月可以画出好看的图画何乐而不为呢星星眼谁管你们画画人是死是活的我又不在乎什么人类什么艺术我这一辈子快乐就行滑稽;2;2;4;18388;0.00021753317380900588
74556;评论给我看笑了，这玩意出的就是个草稿，还淘汰底层画师，底层画师表示也就拿来看看草稿的效果，然后还得继续细化。本质上和ps拿素材直接贴那次冲击差不多，和3d比起来便利性低很多;1;1;2;18388;0.00010876658690450294
74559;可以看得出有些部分是拿画师的图一部分拼接的，无非是加点效果换点颜色，我只想知道视频里这几张图ai是从哪些画里面截取的，想知道原画师;8;1;9;18388;0.0004894496410702633
74568;这不比艾尔登法环美多了。。;1;1;2;18388;0.00010876658690450294
74570;画家都可以退休了;13;1;14;18388;0.0007613661083315206
74588;机器工具人听歌识曲;1;0;1;18388;5.438329345225147e-05
74620;这发展下去是真能把一些水平不高的画师饭碗给砸了的;3;0;3;18388;0.0001631498803567544
74646;ai怎么会代替绘画，加油继续卷绘画，期待5年后的大家;1;0;1;18388;5.438329345225147e-05
74661;可以取代行业大部分人，整个行业被取代只能等到强人工智能时代。尤其是现在还只是感知智能，认知智能发展还很初期的阶段。;1;0;1;18388;5.438329345225147e-05
74669;这些人能画出来？;2;0;2;18388;0.00010876658690450294
74698;为什么我的都是动漫的，怎么改成这种写实的画风给心心;1;0;1;18388;5.438329345225147e-05
74705;Up主，方便把这些照片分享给我吗，我用作电脑壁纸，真的好喜欢。;1;0;1;18388;5.438329345225147e-05
74727;给岁月以AI而不是给AI以岁月;1;0;1;18388;5.438329345225147e-05
74729;评论里嘲讽新人画手的大可不必，AI也是吸取的各种画师的画作才能画出来这些作品;5;0;5;18388;0.00027191646726125733
74735;永存的星;1;0;1;18388;5.438329345225147e-05
74741;viceversavv;1;0;1;18388;5.438329345225147e-05
74744;怎么找图啊想当壁纸;1;0;1;18388;5.438329345225147e-05
74762;疑惑怎么还有这种逻辑，让ai有自己的意识，当机器有了自己意思，你不是玩完了？你肉体凡胎干的过机器？;1;0;1;18388;5.438329345225147e-05
74764;所以呢，按照部分人的逻辑不久未来机器代替人类，哦都被代替了，请问人该干什么返祖？把这个世界留给机器？都被机器代替了，人什么都不用干，一个人变得懒惰会变得怎么样？不要给我扯你不会去当设计和创造机器的顶尖人类吗，所以呢这个世界是天才多于普通人，还是普通人多于天才，难道之后的每个人都是完美无瑕的吗，没有天生缺陷了？你可以说机器可以让人更便捷，机器代替人类是什么逻辑，你被代替了，不需要你了，你还沾沾自喜，机器的作用是有助于更快的发展和便捷，不是让一个人变得没有想法和变得懒惰的理由;2;0;2;18388;0.00010876658690450294
74771;到时候原画师的钱都被ai公司赚走了，大家知道该选什么专业了吧嗑瓜子;1;0;1;18388;5.438329345225147e-05
74777;相比之梦幻高雅，我更想看点俗的。可以画吗？;1;0;1;18388;5.438329345225147e-05
74781;100个画师中只有5个能超越AI，其他都得完蛋，而且这还是建立在数据库还没彻底完善的情况下，数年后估计只有百分之2的画师能超越;1;0;1;18388;5.438329345225147e-05
74783;恐怖如斯，为什么像素这么高啊;1;0;1;18388;5.438329345225147e-05
74803;没灵魂抓狂;1;0;1;18388;5.438329345225147e-05
74814;这么说吧你敢把ai画的画拿出来到处给人炫吗，可能一些小商演小活动能接受，但是漫展这种讲究设定的呢;1;0;1;18388;5.438329345225147e-05
74832;AI作画都是由很多画师的作品特点缝合到一起的，本质上依然离不开画师画;5;0;5;18388;0.00027191646726125733
74840;好美啊想知道这种画一张要多少钱脸红;3;0;3;18388;0.0001631498803567544
74853;有图吗，求求了;1;0;1;18388;5.438329345225147e-05
74855;可以作为灵感;1;0;1;18388;5.438329345225147e-05
74859;跟ai翻译一样，ai翻译最后也没取代人类翻译，一些事情ai还是做不到;3;0;3;18388;0.0001631498803567544
74870;请问bgm是什么？;1;0;1;18388;5.438329345225147e-05
74872;不过还是有个问题，色彩太过于艳丽了，看了几十分钟就视觉疲劳了;1;0;1;18388;5.438329345225147e-05
74875;看多了就有些腻了;1;0;1;18388;5.438329345225147e-05
74881;有图吗，建议光速上传小红车;2;0;2;18388;0.00010876658690450294
74892;ai怎么说呢，上限低，但仅限于顶级的，下限高，配合优秀的设计者可以无限接近上限;1;0;1;18388;5.438329345225147e-05
74900;人怎么都卷不过AI;2;0;2;18388;0.00010876658690450294
74911;好强，我都可以向ai学习了;3;0;3;18388;0.0001631498803567544
74927;机智的妖妖凌好喜欢这种画风，宏伟而不失浪漫;1;0;1;18388;5.438329345225147e-05
74936;破防小画家都在说AI取代其他行业看你们怎么办doge取代又怎么样呢？我倒希望AI快点取代，快进到AI帮我值夜班脱单doge生产力极度提高，全人类从繁琐劳动中解放不好吗？;1;0;1;18388;5.438329345225147e-05
74943;现在AI绘画的出现就如同当年第一部摄像机被发明出来，大量画家失业;2;0;2;18388;0.00010876658690450294
74948;ai是要收集大量现有画家的绘画数据，能画出来是因为庞大的数据库，要是没人生产画了，ai也不可能画出来;2;0;2;18388;0.00010876658690450294
74974;能直接画出本同人本子吗不人工修改，能的话我就觉得应该能代替画师了脱单doge;1;0;1;18388;5.438329345225147e-05
74981;我其实想问一下，就，ai能做到（如果继续发展的话）像作家，漫画家那样，创造一个有鲜明特色的自己的作品吗？如果可以，那真的太强了;1;0;1;18388;5.438329345225147e-05
74988;画应该是“繁星”才对，但这些里都没有看到精神，灵魂，和情感;8;0;8;18388;0.00043506634761801175
75006;AI没普及之前，不用担心，没有几个人能掏得起服务器机组的一天电费;2;0;2;18388;0.00010876658690450294
75020;都是毁灭的画。。。。有多阴暗啊。。。;1;0;1;18388;5.438329345225147e-05
75040;有原图吗？想做壁纸;1;0;1;18388;5.438329345225147e-05
75049;目前的ai只能做到无限分解加拼接，繁杂的堆砌和精准的解析的确适合参考和绘制宏达的艺术画面，但是无法替代画师的灵感，至少目前许多优秀的二次元画作是ai模仿不来的，当然，说不定以后ai就能模仿人类的思维进行自我创作了呢藏狐;1;0;1;18388;5.438329345225147e-05
75055;想要几张做壁纸，up可以分享不？;1;0;1;18388;5.438329345225147e-05
75109;千泷baby;2;0;2;18388;0.00010876658690450294
75120;目前看到的都是AI场景概念图，有没有角色类的？;1;0;1;18388;5.438329345225147e-05
75131;AI的色彩和构图比大部分画师画的都好。;4;0;4;18388;0.00021753317380900588
75136;我担心的是未来不会有新风格出现了，画家十几年研究出的个人风格，ai一瞬间就能学会，然后廉价快速复刻，资本会选谁？不言而喻;1;0;1;18388;5.438329345225147e-05
75148;救命吧这也太漂亮了每一张都超级震撼;1;0;1;18388;5.438329345225147e-05
75151;AI绘画AI合成给从业者的忠告，对于新兴技术我们要积极了解，不然就会落后于时代然后被抛弃。。。不管是国家历史还是企业商业历史都有深刻的教训;1;0;1;18388;5.438329345225147e-05
75159;溟煌弥月这个真的无法形容的美;1;0;1;18388;5.438329345225147e-05
75184;确实就算ai水平再高也不可能取代人，不会有人觉得ai画的能比人画的更有感觉吧？;1;0;1;18388;5.438329345225147e-05
75187;真的好好看，我不太懂绘画圈，但这种人工画的肯定很贵吧;1;0;1;18388;5.438329345225147e-05
75197;点炮的鼠了我好喜欢这种;1;0;1;18388;5.438329345225147e-05
75204;我不由得开始思考，ai应该不会替代医学人吧，大多数人应该都不敢让机器给自己扎针吧（除非是未来半机械化的改造人来古震撼;1;0;1;18388;5.438329345225147e-05
75206;不想被ai取代，那就考警校嗑瓜子我不信有人敢让ai当警察;1;0;1;18388;5.438329345225147e-05
75209;这些都是电子稿，你要它画出手稿，每个笔触，肌理。;5;0;5;18388;0.00027191646726125733
75218;我觉得ai画得可以但是这也只是一直画风有些东西是机器画不出来了;1;0;1;18388;5.438329345225147e-05
75220;这些东西靠喂图喂出来的，这玩意并不会有任何革新，因为它不是人类;2;0;2;18388;0.00010876658690450294
75225;目前ai还不太适合具有连贯性的组图，单图水平已经很高了（科幻世界杂志封面2k我觉得被ai完爆了），如果想以某个固定地点固定角色多角度做出一系列图就完全做不到了。比如说写一本网络小说，缺个封面拿这个做一张就很好看成本也很低，但是里面插图就配不了。;1;0;1;18388;5.438329345225147e-05
75229;感觉画风过于一致，没有个体差异性;1;0;1;18388;5.438329345225147e-05
75245;大鹅会喷火;1;0;1;18388;5.438329345225147e-05
75254;看了3天后来评论，惊艳吗？确实惊艳。能超过人类吗？未必。我觉得从商业角度讲，这种水平确实能替代很多画师。但从艺术角度讲，还是遵循着人类的风格，并没有挑出框架。更不可能谈自立门户自成一派。没有贬低的意思，只是期待更高水平的作品。脸红;1;0;1;18388;5.438329345225147e-05
75276;画师不会失业。也许未来会有一种职业，叫概念设计师。而且光有图画本身是不够的。且ai绘画的精度对于一些绘画应用也不够。;3;0;3;18388;0.0001631498803567544
75281;它怎么满脑子都是西方建筑和画里的歪果仁，这是歪果AI;1;0;1;18388;5.438329345225147e-05
75289;辣眼睛我就想知道这些图在哪整的。我想当桌面;1;0;1;18388;5.438329345225147e-05
75329;只能说人类是比不过ai的;1;0;1;18388;5.438329345225147e-05
75354;什么时候上wallpaper脱单doge;1;0;1;18388;5.438329345225147e-05
75369;还替代，没有基本数据输入ai有屁用，ai只有可能起辅助作用;1;0;1;18388;5.438329345225147e-05
75379;现在连坦然接受别人的优秀都是一种奢望，跟何况接受ai呢。我也学过美术，但我不懂什么灵魂，我能接受一个普通人从零慢慢学习绘画，慢慢变好，我也能接受ai慢慢学习，慢慢进步，慢慢变好，就算将来他能代替画师，我也是祝福的心态居多。至于能不能，我们慢慢等待就好，何必争的面红耳赤呢？;2;0;2;18388;0.00010876658690450294
75384;除非AI会自学，不然老是需要喂图就不能取代;1;0;1;18388;5.438329345225147e-05
75387;頾鼏;1;0;1;18388;5.438329345225147e-05
75390;诸位具有高尚人格无与伦比审美能力的大艺术家们，咱就是俗人，俗人就喜欢看你们口中的俗画，不仅我这种俗人喜欢，资本更喜欢偷笑而且我觉得你们的论据有失偏颇，所谓创造力或灵魂不都是由人为的一行行代码实现的吗人的创造力不可被取代和ai十秒一张的顶级作画能力有半毛钱关系？不可取代之物只是由捏着画笔的艺术家们变成机器背后赋予这些ai画作生命力的人罢了。相机的出现都没有杀死艺术，放下画笔这个动作很难吗;8;0;8;18388;0.00043506634761801175
75411;虽然但是，可如果未来的哪一天，AI真的取缔了我们这些人类的作曲师或者画师，那么我们又该何去何从呢？我们花费了小半个人生学习的专业技术，又该怎么去施展呢我不理解;2;0;2;18388;0.00010876658690450294
75421;全是哥特式？ai画人物目前来说是真不行;1;0;1;18388;5.438329345225147e-05
75438;私以为趋势应该是画师的工作内容大量减少，只需要在ai基础上修图，由于用短时间就可以创作出更精细的画，制作成本变低使得人们对画作的要求变高，市场上画作的质量和细节会大幅提高，数量也会上升（因为工业化产出了）。画师岗位会减少一些，但不会像想象中那样急剧缩水，也不会只剩顶尖画师，影响最大的应该还是画作的平均质量;1;0;1;18388;5.438329345225147e-05
75489;乐与饵live有没有可以下载的原画链接？OK;1;0;1;18388;5.438329345225147e-05
75499;机器得出图永远只有商业性目的。。就像肯德基快餐。。;1;0;1;18388;5.438329345225147e-05
75507;工厂里面的工人越来越少，因为都大部分都被机器取代，生产力也越来越高，但是问题来了，这些被取代的人都去了哪里？;1;0;1;18388;5.438329345225147e-05
75526;这是什么原理？完全无法理解机器人能作出这样的画;2;0;2;18388;0.00010876658690450294
75556;第一眼看上去很好看，很绚丽，豪华。可是就算是门外汉，我也会去看看细节，它画的不是很具体，就是只有第一眼看可以猜出它画的是什么，细看会觉得头疼，并且就是一些朦胧的形体，看的很懵。;1;0;1;18388;5.438329345225147e-05
75568;虽然不认为ai能取代人类作画但不得不说这画面美轮美奂流光溢彩完全能开辟一个新的美术领域另外恩雅的音乐和这个真是绝配;1;0;1;18388;5.438329345225147e-05
75595;是会和围棋一样吗？;5;0;5;18388;0.00027191646726125733
75602;话说低端画师真的不焦虑吗;5;0;5;18388;0.00027191646726125733
75612;ai能画本子吗doge;2;0;2;18388;0.00010876658690450294
75619;额所以热评里说的这些画到底能用在什么地方当壁纸？？;28;0;28;18388;0.0015227322166630412
75660;但是艺术的本质不是表现内心吗工具的差异又不会改变人对美好的向往那有什么取代之说啊;1;0;1;18388;5.438329345225147e-05
75691;AI绘画的版权算谁的？;1;0;1;18388;5.438329345225147e-05
75696;人类的情感也会被ai学习吗？;1;0;1;18388;5.438329345225147e-05
75706;Ai作画的原理是什么，是把顶尖画师的画打碎重组吗（？？）会不会牵扯到利益纠纷（我不太懂，只不过是猜测一下）我未来主业就是建模原画游戏制作动漫制作之类的，今年也在努力内卷练习，然后闲暇时间打开b站看了看，就看到了这个视频，总觉得有一种被人砸了饭碗的感觉;3;0;3;18388;0.0001631498803567544
75717;我好喜欢这种，大气震撼像梦中的场景一样，比啥啥啥艺术家画的好看多了，始终不理解艺术是个啥玩意？几个鬼画符幼儿园小孩都能照着描出来的都能叫艺术;1;0;1;18388;5.438329345225147e-05
75721;能不能代替人类不好说，一开始也说ai不可能攻破围棋。到现在人类已经彻底败给了AI，绘画这种艺术性的东西现在也说不可能能被取代，但未来的事情谁知道呢？;1;0;1;18388;5.438329345225147e-05
75792;真是美轮美奂啊，但说到底也只是美轮美奂的图片生成器，可以给动漫做一些背景图。人物什么的不还是要人来画。机器辅助修图这个角度可能会更好一点，输入草图或半成品让机器去补全精化;2;0;2;18388;0.00010876658690450294
75795;就我一个想问问图源，出处引擎，和prompt嘛笑哭保卫萝卜哭哭;1;0;1;18388;5.438329345225147e-05
75815;乍一看，整体非常震撼，仔细一看，细节好像什么都没画，ai作画只能适合油画了，细腻细节的部分难以绘画，只有人的手细心描绘才能呈现出来，以及那种立体感与空间感。;1;0;1;18388;5.438329345225147e-05
75839;这种是不能细看的，都是一个个画块拼接起来的;1;0;1;18388;5.438329345225147e-05
75878;哥特建筑喂得太多了，画到后面都快成蒸汽朋克了，来点东正教风格的doge;1;0;1;18388;5.438329345225147e-05
75885;目前人最大的优势就是创意，这个目前ai还做不到;1;0;1;18388;5.438329345225147e-05
75887;中低层画画人不一定会死，但是求变时必须的辣眼睛;1;0;1;18388;5.438329345225147e-05
75895;我第一反应是那些构建自己喜欢的世界观的文手和作者可以借用ai绘画把自己想象的世界具现化出来诶;1;0;1;18388;5.438329345225147e-05
75920;别担心，自动化流水线都说了十几年了，现在早就能应用了，也没见得影响电子厂拧螺丝;1;0;1;18388;5.438329345225147e-05
75958;美啊;1;0;1;18388;5.438329345225147e-05
75969;都说Ai画景无敌，画人不行，这是真的吗;1;0;1;18388;5.438329345225147e-05
75977;确实好看;1;0;1;18388;5.438329345225147e-05
75981;想想柯洁为什么输阿尔法狗后会哭呲牙;1;0;1;18388;5.438329345225147e-05
75987;这是生成后画师又自己修改的吧，修改也要花很长时间的，只是生成出来的话会很模糊，像克苏鲁那样，细节看不清是什么;1;0;1;18388;5.438329345225147e-05
76024;快点让ai做音乐呀;1;0;1;18388;5.438329345225147e-05
76036;要担心的不仅是一两个职业，ai的发展，未来很多职业都会发生变化的。。。。。太可怕了;1;0;1;18388;5.438329345225147e-05
76043;大家都在讨论AI取代画师啊热词系列知识增加可是我想的是米哈游miHoYo保卫萝卜哇保卫萝卜哇保卫萝卜哇有没有机会以后玩到这样的地图呀;1;0;1;18388;5.438329345225147e-05
76045;能取代自然最好，人类发展科技的动力就是提高生产力，降低自身的劳力。科技的发展必然会让旧有的一些职业消亡，但是同时也会创造新的职业。;2;0;2;18388;0.00010876658690450294
76053;ai不能取代的是绘画中的哲学升华;1;0;1;18388;5.438329345225147e-05
76057;Cyukii卧槽;1;0;1;18388;5.438329345225147e-05
76077;很简单的事情，和音乐同样，如果合成器能完全取代乐器演奏，那人类音乐的历史会如何;2;0;2;18388;0.00010876658690450294
76089;红屋顶与散步的猫来看来看;1;0;1;18388;5.438329345225147e-05
76092;有点想要其中的几张做壁纸，从哪里可以找到吗;1;0;1;18388;5.438329345225147e-05
76107;倒也不是因为饭碗问题而感觉不适，本人纯理科生，职业跟美术毫无关系，就是觉得这些图最大的硬伤就是没有感情，有感情的画面和没的完全不是一回事，相同的技术技巧，前者可以震撼你，后者只能惊艳你一瞬;5;0;5;18388;0.00027191646726125733
76117;“在终极吟诗开始时，我就着手编制诗词识别软件，这时，技术在艺术中再次遇到了那道不可逾越的障碍，到现在，具备古诗鉴赏力的软件也没能编出来。”他在半空中指指诗云，“不错，借助伟大的技术，我写出了诗词的颠峰之作，却不可能把它们从诗云中检索出来，唉”;1;0;1;18388;5.438329345225147e-05
76122;把网上的图片随机组合就算绘画了？先不提高端的思想表达了，等它能根据甲方需要，准确汇出有价值作品的时候再说吧这种看起来宏伟壮丽但实际上没有任何表达的作品，也就能当个屏幕壁纸;2;0;2;18388;0.00010876658690450294
76130;有一说一，ai画人不行，希望有一天能再上一层楼吧;1;0;1;18388;5.438329345225147e-05
76136;哪里可以下载到这些图呢？想做背景;2;0;2;18388;0.00010876658690450294
76162;汽车替代马车的时候，要做的不是抵制，而是学会如何开汽车星瞳敬礼;1;0;1;18388;5.438329345225147e-05
76176;这些画真的好好看呀，现在有什么渠道能约稿吗？想要几张当壁纸头像;1;0;1;18388;5.438329345225147e-05
76188;比起问ai会不会取代画家，我更好奇ai会不会取代原画师;1;0;1;18388;5.438329345225147e-05
76192;哪有原图，想做壁纸;3;0;3;18388;0.0001631498803567544
76218;嗯，目前来看生成一张大气的单个艺术图是可以的，但是存在很多情况需要画师画不同角度的同一个场景展现故事，这点随机生成的ai还差点啦。AI随机生成的很美丽，但是细节还需要画师进行逻辑修补，但是用的好可以省去画师起型的时间，而且AI生成的很多时候很神奇的超出想象边界，也是非常奇妙的灵感开发;8;0;8;18388;0.00043506634761801175
76231;照相机的产生也让写实派画师死掉一大片，现在不照样还是有冷军这样的人。被淘汰的永远是中下层可以被取代的罢了。;1;0;1;18388;5.438329345225147e-05
76243;有ai画的写实风格的画作吗？这些作品虽然乍一看很不错，但是细节经不起考验。我是外行人，说一些外行人的看法。有没有内行人仔细说说？;1;0;1;18388;5.438329345225147e-05
76264;嗯看上去是很宏伟，但是不耐看，我不认为AI的绘画能有人性;2;0;2;18388;0.00010876658690450294
76268;要是出个写诗机器人疑惑问题意义在哪呢;4;0;4;18388;0.00021753317380900588
76279;谁能想到人工智能除了下棋以外最成功的领域居然是艺术;5;0;5;18388;0.00027191646726125733
76293;可以用来做概念构图，放在电影电视剧创作阶段应该非常有效率，但是说能不能代替手绘的要清楚创作的目的在于什么，自我创作重心在于情感表达，Al作画主题是计算机，那请问ta的创作的意义在于什么呢脸红;5;0;5;18388;0.00027191646726125733
76301;确实具有别样的风格;1;0;1;18388;5.438329345225147e-05
76303;人类最厉害的就是学习，不断学习超越自己，既然ai的能画成这样那我便临摹它，直到超越他。;1;0;1;18388;5.438329345225147e-05
76308;AI早晚是必然会超越人类的，它的进化速度人类不可能追的上;5;0;5;18388;0.00027191646726125733
76321;说实话这种作品商业化，性价比是直接拉满的，找个画师画同水平作品可能要千百倍的成本，改多了还要加钱;9;0;9;18388;0.0004894496410702633
76335;好美，up动态能发图吗？保卫萝卜哇如果有不方便就当我没说捂眼;2;0;2;18388;0.00010876658690450294
76344;粗看很惊艳，细节经不起推敲;13;0;13;18388;0.0007069828148792691
76399;完全不可能替代，它根本无法回应甲方的修改要求笑哭;4;0;4;18388;0.00021753317380900588
76424;这是哪个AI画的呀星星眼;1;0;1;18388;5.438329345225147e-05
76427;什么时候ai可以作曲;1;0;1;18388;5.438329345225147e-05
76433;不是dd、是刚内测就结束的那个ai吗;2;0;2;18388;0.00010876658690450294
76443;感觉现在的插件更新很快，但是模型没有跟上，chilloutmix好多动作生成不正确（趴着躺着基本全废），有没有其他好用的模型呀打call;28;72;100;18388;0.005438329345225147
76472;这个是真的好用，openpose的编辑器太难用了捂脸;9;35;44;18388;0.0023928649118990647
76482;为何我点开posex没有像up你一样有骨骼模型出来，点了没啥反应;17;13;30;18388;0.001631498803567544
76500;我写了个类似的，没想到up已经集成插件了，httpszhuyu1997githubioopenposeeditor;3;19;22;18388;0.0011964324559495323
76504;现在有个问题，Ai的透视有点差，虽然骨架图是3d的，摆出一些姿势后，ai作图会变成矮挫胖，效果还不如找张动作图pose预处理再绘图;9;32;41;18388;0.00222971503154231
76514;up跑到这么快是什么显卡啊;3;9;12;18388;0.0006525995214270176
76518;好好好，本来还说去学一下blender，这下省了星星眼;5;15;20;18388;0.0010876658690450293
76528;日新月异;1;10;11;18388;0.0005982162279747662
76530;看似自由度更高，但是很多特殊动作AI都理解不了，我觉得可以再用3D模型做一份深度图，开启第二个controlnet用以辅助，现在更新速度很快，我暂时观望吃瓜;1;9;10;18388;0.0005438329345225147
76533;有没有能导入mmd动作软件，来让ai生成视频的插件呢;2;5;7;18388;0.0003806830541657603
76536;SendthisimagetoControlNet我的posex只有这一个选项，而且打了勾之后没有出现火柴人和其他选项，一点反应都没有，我的controlnet也是最新的;6;5;11;18388;0.0005982162279747662
76543;装了之后巨占用显存，原本可以生成的大小现在完全直接爆显存，我还是老老实实用之前的吧;1;4;5;18388;0.00027191646726125733
76547;GitCommandNotFoundCmdgitnotfoundduetoFileNotFoundErrorWinError2系统找不到指定的文件。cmdlinegitclonevhttpsgithubcomhnmr293posexgitCUsers12578Desktopstablediffusionwebuitmpposex这是咋回事;1;2;3;18388;0.0001631498803567544
76549;点击发送到controlnet没效果，也许是版本问题;8;3;11;18388;0.0005982162279747662
76558;请问，没有出现可以操作的火柴人怎么办;3;4;7;18388;0.0003806830541657603
76562;一直觉得。。未来可能版权加强，然后大佬自己调自己图，出图更快，年轻的新手的全被g掉doge;3;4;7;18388;0.0003806830541657603
76568;AttributeErrorNoneTypeobjecthasnoattributeshape;3;3;6;18388;0.0003262997607135088
76572;加载安装显示错误求教下哪位大佬有本机安装的办法;1;1;2;18388;0.00010876658690450294
76574;我把CONTAINET重新卸载，试过好几次你的方法都不成功，显示不出来那个骨骼;5;1;6;18388;0.0003262997607135088
76580;步骤一模一样，没有targetcontroinetnumber这栏怎么办，就是sendthisimagetocontroinet这个选项右边的回车框，问遍了群都没人理俺，有人救救我吗;5;2;7;18388;0.0003806830541657603
76588;想请问下现在有解决肢体交叉情况下分不清前后的办法吗？例如我想左脚在右脚前面但ai老是画反辣眼睛;1;1;2;18388;0.00010876658690450294
76596;阿？难道不是用blender更好用吗;1;1;2;18388;0.00010876658690450294
76600;这个本地安装复制到哪个文件地址呢;1;0;1;18388;5.438329345225147e-05
76602;controlnet在哪里下载啊;1;0;1;18388;5.438329345225147e-05
76604;up我的操作和你一样，为什么posex没有把骨架自动导入到controlnet中啊;5;2;7;18388;0.0003806830541657603
76610;这个也有个网页版httpsavatarposemakerdeezeincom;1;1;2;18388;0.00010876658690450294
76613;已投币，up可以研究一下这个po什么的，能带花手功能的，前些天看见有人拿这个画过手;1;1;2;18388;0.00010876658690450294
76615;还是需要8G以上显存吗;1;0;1;18388;5.438329345225147e-05
76617;所以骨骼图头上那两根须到底是什么？;2;0;2;18388;0.00010876658690450294
76620;这个骨架可以多个操作吗？;1;0;1;18388;5.438329345225147e-05
76622;有没有ai画的本子doge;2;0;2;18388;0.00010876658690450294
76625;为什么我用了这个插件跑图好慢好慢，平时2分钟能出图的，这个起码20分钟，是哪里设置错了吗？;2;0;2;18388;0.00010876658690450294
76628;为什么你们的webui界面都是中文的啊？大哭;4;0;4;18388;0.00021753317380900588
76633;有个问题，AI为了保证手指数量准确，把一边被视觉遮挡的手指移到另外一边的手上，这怎样解决？;1;0;1;18388;5.438329345225147e-05
76635;canvassize到底和生成图的分辨率和长宽比有没有关系？我让它待在默认似乎对出图没影响啊;1;0;1;18388;5.438329345225147e-05
76637;posex能导入已摆好的骨骼吗？我只想微调。根据预处理出来的骨骼图不太精准，AI还不是看不懂大范围交叉的肢体。;1;0;1;18388;5.438329345225147e-05
76641;我的posex界面那里没targetcontrolnetnumber这个框框，选了发送到controlnet也没反应;7;1;8;18388;0.00043506634761801175
76649;确实比openpose编辑器好用，摆造型简单也准确很多，就是对速度影响有点大，我只有p106正常速度15sit左右，用这个直接105sit笑哭;2;1;3;18388;0.0001631498803567544
76652;没有界面怎么处理;2;0;2;18388;0.00010876658690450294
76656;这个插件那能在云端上安装吗？;1;0;1;18388;5.438329345225147e-05
76658;为什么你的webui是深色的我的是白的？;1;0;1;18388;5.438329345225147e-05
76660;不知道为啥我没选择预处理器生成的图也不按姿势来;2;0;2;18388;0.00010876658690450294
76664;刚研究玩blender的模型，好了这玩意就上了;1;0;1;18388;5.438329345225147e-05
76697;请问一下up，安装的时候一直installing怎么办，开了魔法了，看下行流量几乎为零tv大哭;4;0;4;18388;0.00021753317380900588
76707;Controlnet里预处理选无，模型没有选择只有无，和你的不一样，一运行后台就报错，提示model没发现，然后生成的图没有姿势变化;3;0;3;18388;0.0001631498803567544
76715;安装不上，一直installing，是我网的问题吗大哭;1;0;1;18388;5.438329345225147e-05
76719;Up这个插件对多个人物骨架存在前后关系或者其他交叠情况的识别能力很差，有办法解决吗;2;0;2;18388;0.00010876658690450294
76726;为什么我找不到openpose的模型;6;0;6;18388;0.0003262997607135088
76734;装了这个插件之后，无论使不使用这个插件，controlnet的所有模式都无法捕捉任何图像，一律以黑屏显示，控制台均提示：controlnetisenabledbutnoinputimageisgiven;2;0;2;18388;0.00010876658690450294
76741;我啥开了这个POSEXCPU能到85度以上笑哭;1;0;1;18388;5.438329345225147e-05
76743;大佬，请问可以围绕一个姿势批量生成360度图吗，脸型会不会不稳定;1;0;1;18388;5.438329345225147e-05
76748;一直不知道，头部的五个点，分别表示什么喜极而泣;7;0;7;18388;0.0003806830541657603
76756;装上插件不显示那个界面是因为啥我SD版本低？;1;0;1;18388;5.438329345225147e-05
76761;posex界面跟up主不一样，没有那个框框的朋友们不要紧，应该是版本不同的问题，只要勾选了sendthisimagetocontrolnet就直接能读取到了;4;0;4;18388;0.00021753317380900588
76775;要是你有近视，摘下眼镜，或者把手机拿远，孙悟空那张的大致颜色布局是真的像;69;2901;2970;18388;0.16151838155318687
76845;这个画很离谱，我一个男生传了四张照片画出来全是女生;57;1408;1465;18388;0.0796715249075484
76903;经典火星文doge;10;761;771;18388;0.04192951925168588
76914;看到了吗？这就是我迷恋二次元的原因脱单doge;5;796;801;18388;0.04356101805525343
76920;二师兄不好了，师傅和大师兄被妖怪抢走了doge;1;294;295;18388;0.016043071568414183
76922;我用了一张合照，结果AI画的是后面的铜像，还把铜像画成了霸总，全班成了一群小弟藏狐;3;191;194;18388;0.010550358929736785
76926;我同学玩这个用了我俩的合照，她是公主我TM是狼狗，后来我自己单人终于是个人了但是TM给我带对狼耳朵，我就不能是个人了吗捂脸;30;1805;1835;18388;0.09979334348488145
76958;upup，求孙悟空的ai少女图片大哭脱单doge脱单doge脱单doge;6;140;146;18388;0.007939960844028714
76965;铁子们，什么软件的ai画得好看啊，我找了一个，画得太tm奇怪了;14;101;115;18388;0.006254078747008919
76980;doge这唐僧就他妈离谱;2;124;126;18388;0.006852294974983685
76985;我一个人，试了好几次全是狗辣眼睛;3;20;23;18388;0.0012508157494017839
76992;玩这个的时候注意一下，不知道为啥就分享到QQ的那个小世界了，我TM社死，八百年不看小世界，幸好我今天脑抽点开了一下，;1;1;2;18388;0.00010876658690450294
76998;我玩这我一男的变成了群友说的大姐姐无语;1;6;7;18388;0.0003806830541657603
77001;有一说一，这是哪个APP呀？我也想下一个。;1;1;2;18388;0.00010876658690450294
77004;我把自己的照片搞上去，画出来的图就像是梵高的《呐喊》一样抽象笑哭;1;4;5;18388;0.00027191646726125733
77009;孙悟空哪个一模一样啊;2;1;3;18388;0.0001631498803567544
77023;啥软件？;1;3;4;18388;0.00021753317380900588
77026;我觉得AI抓型特别准，本来觉得有出入的地方摘下眼镜隔远看阴影啥的都对上了;3;1;4;18388;0.00021753317380900588
77072;孙悟空老孙我可就;2;0;2;18388;0.00010876658690450294
77124;为什么都是蓝色眼睛啊？;1;0;1;18388;5.438329345225147e-05
77151;除了刑铺头，都没有本人好看;1;0;1;18388;5.438329345225147e-05
77163;我一个男的照了10张八张女图笑哭，这怎么回事笑哭;1;0;1;18388;5.438329345225147e-05
77171;什么APP笑哭;1;0;1;18388;5.438329345225147e-05
77173;画风太单调了;3;0;3;18388;0.0001631498803567544
77182;其实吧，只要是张脸，ai都能给你画成帅哥美女;25;4162;4187;18388;0.2277028496845769
77208;这是QQ小程序里的;4;164;168;18388;0.009136393299978247
77213;我的理性告诉我这种视频不能再看下去了因为再多看一眼就会爆炸doge;14;1608;1622;18388;0.08820970197955189
77228;我就说吧，坤坤很帅doge;4;977;981;18388;0.05335001087665869
77233;坤坤要是长成这样，我立刻粉他笑哭;5;775;780;18388;0.04241896889275615
77240;卧槽这AI画的鸡哥也太有味道了脱单doge脱单doge;1;102;103;18388;0.005601479225581902
77242;你们真是无可救药笑连最只因本的尊重都做不到生气我绝不会受你们影响爱哥哥每一天，拒绝黑子，从我做起脱单doge;2;93;95;18388;0.0051664128779638895
77246;这些ai改照片的up都是用什么网站跑的吗;2;10;12;18388;0.0006525995214270176
77251;这只鸡怎么像斯大林;1;14;15;18388;0.000815749401783772
77255;今天玩ai弄了个好扭曲的图我已经被AI吓得睡不着了;1;10;11;18388;0.0005982162279747662
77262;青提味橡皮糖巧克力我裂开了;1;11;12;18388;0.0006525995214270176
77264;匿名0007;1;4;5;18388;0.00027191646726125733
77267;坤坤下面的胡子都白了（悲）doge;2;9;11;18388;0.0005982162279747662
77270;这是哪个软件上的功能啊，蹲一个好心人;5;3;8;18388;0.00043506634761801175
77299;Al特有的埃及文喜;1;1;2;18388;0.00010876658690450294
77311;这是什么软件制作的？求回复;1;2;3;18388;0.0001631498803567544
77348;喜极而泣;1;0;1;18388;5.438329345225147e-05
77353;看看这个妙啊;1;0;1;18388;5.438329345225147e-05
77368;机器还会画画？到底是人画的还是机器画的？;2;0;2;18388;0.00010876658690450294
77386;这画的，一看你就是从抖音上;2;0;2;18388;0.00010876658690450294
77391;我想知道是什么AI软件;1;0;1;18388;5.438329345225147e-05
77395;啥软件啊，我也想试试;1;0;1;18388;5.438329345225147e-05
77402;嘶，第一张不我图吗？嗯，白墨;1;0;1;18388;5.438329345225147e-05
77412;问一下用的什么软件弄得？;1;0;1;18388;5.438329345225147e-05
77429;UP主加油看好你噢;1;0;1;18388;5.438329345225147e-05
77442;所以去掉衣服的指令是什么呢;28;123;151;18388;0.008211877311289972
77471;我先收藏了一个星期不玩这个了腰疼这比找片方便多了哎呦;11;93;104;18388;0.005655862519034153
77483;该笔记混合了另一个作者的。写一起了在提示中使用会增加模型对提示词的关注，使用则会减少它。您可以组合多个修饰符aword提高wo;2;49;51;18388;0.002773547966064825
77486;写实照片，最高画质，精美的cg，参考周淑怡的脸，女仆装，低胸裙，肩膀露出，上半身特写，趴，迷人动作，真实的光影;13;375;388;18388;0.02110071785947357
77500;比三次元p图好看多了，看多了三次元p图感觉有些真的辣眼睛doge;3;143;146;18388;0.007939960844028714
77505;httptagsnovelaidev;5;100;105;18388;0.005710245812486404
77511;弄得图全是不穿衣服的，气死我了，我就想要穿衣服的大哭;8;71;79;18388;0.004296280182727866
77520;高清图自取：httpscivitaicomgallery135351reviewId19135infinitefalsereturnUrl2Fmodels2F64243Fmodal3DreviewThread26reviewId3D19135;2;7;9;18388;0.0004894496410702633
77523;现在还不够，硬件有门槛不说，实际上玩了AI合图才发现，连使用都是有门槛，并不是随心所欲的程度，更多时候只是“这张还行吧”的情况呆也许再调整一年，明年2024年的时候，那才是真正炸天了思考;1;1;2;18388;0.00010876658690450294
77525;如何让脸部样子不变呢？比如随机10张里面有一张脸部我认为是好看的，如何让接下来生成的照片都采用这个脸部样貌呢？;6;17;23;18388;0.0012508157494017839
77532;AI生成的人物角色会涉及到版权纠纷吗？想用生成的人物做宣传图人物;11;5;16;18388;0.0008701326952360235
77544;doge教程那个视频被干掉了，有其他地方地址看吗;1;4;5;18388;0.00027191646726125733
77546;一样的tag，一样的模型，一样的lora，一样的参数，一样的seed，出来的图就是不咋的大哭大哭大哭;9;7;16;18388;0.0008701326952360235
77556;有这技术就给b友看这个？良心不会痛吗doge;7;11;18;18388;0.0009788992821405265
77564;我的诉求刚好相反，想要一张真实的照片，生成ai的脸，行不行呢dogedogedoge;11;17;28;18388;0.0015227322166630412
77576;实测3060ti30轮大概10秒出图，我加了ersgan超分，感觉出来直接搞成4k就可以直接出图了笑哭;6;8;14;18388;0.0007613661083315206
77583;有这个技术是不是可以搞点副业doge;5;24;29;18388;0.0015771155101152925
77592;生图模型和lora模型傻傻分不清，都是一个格式，都扔lora里都能引用的说奸笑;6;3;9;18388;0.0004894496410702633
77599;你们不要老是玩我妻子了辣眼睛;4;1;5;18388;0.00027191646726125733
77607;男变女，是用文生图，还是图生图，我两个都试了。感觉都转换不了。有能出一期专门讲xyz的课程吗。哦呼;1;0;1;18388;5.438329345225147e-05
77613;（（（（（（（（（giganticbreast））））））））））;2;2;4;18388;0.00021753317380900588
77620;背景音乐叫啥名来着？？？;2;0;2;18388;0.00010876658690450294
77627;xyz图标的脚本里面，提示词搜索替换，没有这个选项啊？？？？？？？？？？？？？？？？？？;2;0;2;18388;0.00010876658690450294
77631;为啥我生成的有些会分裂成两张甚至三张图，就左上角或者右上角还有个小图这种;4;0;4;18388;0.00021753317380900588
77636;CouldntfindLorawithnameyaeMikoRealisticyaemikoMixed；CouldntfindLorawithnameiuv20；敢问这种提示是什么意思，我生成的图像不管怎么切换模型，都是一样的脸和服装辣眼睛;2;0;2;18388;0.00010876658690450294
77641;好烦啊真不知道哪里出问题了出来的图根人体蜈蚣似的要不从脖子上要不从腰上再长出个上半身要不就天灵盖上再长个脑袋捂脸没一个tag涉及这方面的全是正常tag负面tag也有全部的多手多脚不合理构造根本没用奸笑;2;0;2;18388;0.00010876658690450294
77644;为什么我的图片都出现好多人;1;0;1;18388;5.438329345225147e-05
77648;giganticbreasts15nipples15doge;1;1;2;18388;0.00010876658690450294
77651;上什么网站可以看他们发的图？;1;0;1;18388;5.438329345225147e-05
77657;画大图老是出好几个人是怎么办？明明tag写着1girl;2;0;2;18388;0.00010876658690450294
77660;是不是a卡不行，我上次用的是CPU，画出来的效果挺一般的;1;0;1;18388;5.438329345225147e-05
77663;请问113这种能看到生成过程，是什么插件或者哪里的设置调的呀;2;0;2;18388;0.00010876658690450294
77668;这。。这软件要什么配置啊笑哭我怕我的跑不动;4;0;4;18388;0.00021753317380900588
77673;我想用自己的脸作为模型可以吗，自己训练AI;1;0;1;18388;5.438329345225147e-05
77677;封面图是用什么模型啊大佬脱单doge脱单doge脱单doge;2;0;2;18388;0.00010876658690450294
77681;看来就是一个叠词缀游戏，所谓AI绘画不过是自定义底层逻辑的生成工具罢了。;1;0;1;18388;5.438329345225147e-05
77687;话说有没有老哥跟我一样，图生图的五官老是错位;6;1;7;18388;0.0003806830541657603
77695;有保持同一张脸出几张图的方法吗？微笑;2;0;2;18388;0.00010876658690450294
77699;A卡能玩吗？;5;0;5;18388;0.00027191646726125733
77709;有没有标签会画手笑哭;1;0;1;18388;5.438329345225147e-05
77714;这么好的技术不用于瑟瑟浪费了;1;1;2;18388;0.00010876658690450294
77716;up主，之前的sd教学视频咋不见了，刚看一半，刷新就没了;1;1;2;18388;0.00010876658690450294
77718;有教程吗什么软件;1;0;1;18388;5.438329345225147e-05
77723;27号stablediffusion的教学视频噶了，看到一半还没尝试完，up主或者哪位好兄弟保存了可以给一下云盘链接嘛大哭;2;1;3;18388;0.0001631498803567544
77726;up主，我的集成显卡跑不出图，有什么办法解决吗？吃瓜;11;1;12;18388;0.0006525995214270176
77738;像素画可以吗？;1;0;1;18388;5.438329345225147e-05
77741;有没有多人时能够分别描述的tag符号呢（一个人短发T恤生另一个人长发外套开心这种）;1;0;1;18388;5.438329345225147e-05
77743;封面那个model包怎么civi网站上找不到了doge;3;0;3;18388;0.0001631498803567544
77748;有没有核显能玩的;4;1;5;18388;0.00027191646726125733
77754;即将有大批量的小黄油来袭笑哭;1;0;1;18388;5.438329345225147e-05
77756;什么软件啊？;1;1;2;18388;0.00010876658690450294
77758;不同的模型是不是对tag的识别也不一样？;1;0;1;18388;5.438329345225147e-05
77760;1660能不能做到？;6;1;7;18388;0.0003806830541657603
77772;那括号是干嘛用的，我在tag网站点经常是这个括号，我还以为这个是加权重;1;1;2;18388;0.00010876658690450294
77775;这个ai的cos质量，只能说是大势所趋;2;1;3;18388;0.0001631498803567544
77778;这是炼了抹茶太太的画吧捂脸;1;58;59;18388;0.0032086143136828365
77780;这个模型混橘子，比例就05，非常好用，谁用谁知道;13;26;39;18388;0.002120948444637807
77795;技术干掉梦想的证明呐捂脸;2;13;15;18388;0.000815749401783772
77798;求问这个safetensors格式的模型怎么使用;10;5;15;18388;0.000815749401783772
77809;为啥我的颜色很暗淡和奇怪？是VAE不对吗？我按照网站要求下载VAE了呀;2;8;10;18388;0.0005438329345225147
77827;这些模型都是从哪找的啊，还是up自己练的;1;0;1;18388;5.438329345225147e-05
77831;为什么我用这个蜡笔模型画出来是模糊的图大哭;3;0;3;18388;0.0001631498803567544
77839;求图包doge;2;0;2;18388;0.00010876658690450294
77842;聪明的小军后悔的中军孤独的老军doge;14;642;656;18388;0.03567544050467696
77857;0006;1;144;145;18388;0.007885577550576462
77859;记得樱桃要多洗洗黑了腐败了别吃笑哭;2;115;117;18388;0.006362845333913422
77865;doge;1;6;7;18388;0.0003806830541657603
77869;我挺好奇美图秀秀这个ai是怎么来的，用得原代码？虽说代码泄露novelAI都在用但是这样商用没问题吗？;1;5;6;18388;0.0003262997607135088
77901;ai绘画用的是什么软件问一下吃瓜;1;0;1;18388;5.438329345225147e-05
77909;甚么软件doge;2;0;2;18388;0.00010876658690450294
77916;什么李阿姨这不就是miku嘛;1;0;1;18388;5.438329345225147e-05
77919;与其说ai画的像真人，不如说现在真人p的像ai。;18;1062;1080;18388;0.058733956928431585
77938;被玩坏了，数据库里全是涩图;18;378;396;18388;0.021535784207091582
77957;C站上有她的Lora模型，别说还真相，和照片没区别吃瓜;9;126;135;18388;0.007341744616053948
77967;私信炸啦，主页动态进主页动态;4;94;98;18388;0.005329562758320644
77972;骗子，说好的苦茶子都没呢doge;1;36;37;18388;0.002012181857733304
77974;你们私信戳我吧，留言太难找了一个一个回复脸红脸红脸红;3;34;37;18388;0.002012181857733304
77979;链接老被吞，留言的会一一回复给心心给心心;11;13;24;18388;0.0013051990428540352
77991;关键词宝多六花雷火剑阿里嘎多墨镜;1;10;11;18388;0.0005982162279747662
77994;大可不必遮成这样，看看其他的ai画画up主，刺激多了doge;1;7;8;18388;0.00043506634761801175
77996;先是画师，然后是coser;2;4;6;18388;0.0003262997607135088
77999;裤衩子在哪呢;1;2;3;18388;0.0001631498803567544
78008;三连求网盘;1;1;2;18388;0.00010876658690450294
78019;已三连，求图包，谢谢;3;0;3;18388;0.0001631498803567544
78024;老规矩，求图包。。;1;0;1;18388;5.438329345225147e-05
78026;我想学技术;1;0;1;18388;5.438329345225147e-05
78035;三连了，求链接doge;1;0;1;18388;5.438329345225147e-05
78045;投币换链接脱单doge;1;0;1;18388;5.438329345225147e-05
78053;三连啦，求链接脱单doge;1;0;1;18388;5.438329345225147e-05
78111;有没有不穿的那种脱单doge;1;0;1;18388;5.438329345225147e-05
78119;我来啦dogedoge;1;0;1;18388;5.438329345225147e-05
78170;求链接打call;1;0;1;18388;5.438329345225147e-05
78183;三连求图;1;0;1;18388;5.438329345225147e-05
78185;已三连doge;1;0;1;18388;5.438329345225147e-05
78187;求一个;1;0;1;18388;5.438329345225147e-05
78189;星星眼;1;0;1;18388;5.438329345225147e-05
78191;已三连求图;1;0;1;18388;5.438329345225147e-05
78193;三，图doge;1;0;1;18388;5.438329345225147e-05
78196;已赞已币，求点放不出来的dogedoge;1;0;1;18388;5.438329345225147e-05
78202;已三连求图;1;0;1;18388;5.438329345225147e-05
78204;给币了，链接图片打call;1;0;1;18388;5.438329345225147e-05
78210;已三连求图喜欢;1;0;1;18388;5.438329345225147e-05
78228;投币关注啦，求图;1;0;1;18388;5.438329345225147e-05
78230;脱单doge;1;0;1;18388;5.438329345225147e-05
78232;3连，来个大图包;2;0;2;18388;0.00010876658690450294
78235;这AI画的也太细致了吧，连那里都看得很清楚;1;10;11;18388;0.0005982162279747662
78239;请问up能分享tag吗大哭原图分析不出来谢谢啦東雪蓮对不起;5;1;6;18388;0.0003262997607135088
78245;第一脱单doge熟系的画风，熟系的硬币妙啊;2;1;3;18388;0.0001631498803567544
78249;笑死，我也是，喜欢那种脑子里想画但因为自己的水平画不出的感觉吃瓜;3;43;46;18388;0.0025016314988035677
78253;AI不会取代画师但会取代大部分画师说这类画的人脑子有问题没有小画手哪来的大画师？找你这么说天生就得牛行业断层了跟你这类人也没什么关系就会拿什么纺织工人做比喻从别人哪里学来的词儿现学现用的复读机还什么AI不算抄人类也是先临摹别人的和AI一样这种人就没画过画你自己画画的时候即使临摹别人你脑子里想的也是结构沟通光影透视掌握了这些只是才能生成自己的理解去创造表达自己想要的东西AI直接拿图片和图片比对生成噪点最后用剪影合成与关键字相符的图像懂配色？懂表情？你会说提高了生产效率不用那么多画师了那我也没见现在创意行业有多么景气啊中国的游戏一刀999中国的动漫熊出没中国的漫画全是日本色漫现在这个AI生生被某些人用来p黄图去了挺好多玩吧玩坏了就好了说白了真正美术人的眼里AI是生产力而且是没有上线的生产力前提是AI足够强的时候但是现在不行我用过不好用能控制的部分很少及其不稳定在普通人手里也就是照着关键字一模一样的模板输入之后得到个和模型差不多的玩意儿天天拿失业蹭热度的祝你们一路前刑;6;39;45;18388;0.002447248205351316
78260;影响最大的：底层画师，在淘宝3500块钱一张的，本来画画就是半废物级别，和ai相比毫无竞争力；大厂的中间美术，大厂因为版权顾虑，质量问题自己不差钱，不太会允许成品用ai，但游戏开发中风格预览，配色方案等过程，用ai能节省大量工期确定方向；自媒体创作者，独立游戏开发者，本身依赖快速产出变现，根本不在乎版权和稳定性，ai绘画是相当高效廉价的素材，只要你有剧本和想法就能产出;9;45;54;18388;0.0029366978464215794
78270;感觉这已经不是AI绘画的失业了，连拍摄都要失业了。网上已经有人用网红图训练模型，然后去生成照片，效果虽然差些，但AI已经进步到这种地步，未来还远么？这出图效率已经不是拍照和PS能比的了。以后什么婚庆、广告照、明星照都不是事。拍几套样张，然后训练模型，直接出片。我一个完全不懂的小白20分钟都能上手，以后AI真是未来可期。;10;17;27;18388;0.0014683489232107897
78282;我挺支持取代头像画师的吃瓜，啥也不会画点照片，骗骗小白。;2;11;13;18388;0.0007069828148792691
78288;笑死，up笑容满面的冷静态度真的值得学习哈哈哈哈哈;1;3;4;18388;0.00021753317380900588
78291;我们还就这个话题打了辩论赛结果打输了;3;4;7;18388;0.0003806830541657603
78295;像我用多了电脑。以前学的架上绘画根本都提不起劲。画几笔就想着ctrlZ，想着有个选区多好。等AI功能加入PS里面。整个绘画流程又要变了。其实工具改变的仅仅就是绘画习惯罢了。。;2;4;6;18388;0.0003262997607135088
78301;省流：“他可以无限生成色图”妙啊;1;1;2;18388;0.00010876658690450294
78307;请问UP这个软件有网址吗？我也想试着用用看看能不能当辅助工具使，毕竟未来发展趋势。脱单doge;1;0;1;18388;5.438329345225147e-05
78321;可以让画师效率提高30倍。;1;0;1;18388;5.438329345225147e-05
78325;为什么B友都觉得焦虑，我说一下接触AI这段时间以来对我的好处1帮我完全戒了冲吃瓜这个很重要的，以前真的很难戒，想起来，还是因为没怎么接触过美女，现在每当我看到赛博Coser妹子一对比我才觉得以前网上看的那些女的是多么的丑啊，内心彻底崩溃后悔了，就直接醒悟了。2缓解了我的精神内耗，AI绘画让我认识到这个世界人外有人，天外有天，即便一个人再优秀也有比他更牛逼的，最牛逼的人也可能会被AI替代，就算努力了很多年，在AI看来也不过是低效率的重复性工作，那我还焦虑什么呢？3更自信了，心态更好了，每天多看看AI绘画，看看AI新闻，会觉得自己离尖端科学这么近，会觉得世间很多事物不过是二进制组成的庞大数据而已4工作效率，学习效率更快了，每天完全充满了干劲，不会的问AI，心理不痛快问AI，有什么想法让AI给我出图，让AI给我唱歌。现在我在思考AI能不能帮我打工，让我变得有钱，总之，现在每天精神状态都一级棒，感觉整个人年轻了10岁AI绘画，绝对值得拥有;1;1;2;18388;0.00010876658690450294
78327;Up好可爱的吃瓜吃瓜;2;0;2;18388;0.00010876658690450294
78331;其实觉得不会代替的想想，这玩意才出来多久，这才是最可怕的，你完全不能想像它以后是什么形态;1;0;1;18388;5.438329345225147e-05
78333;可以取代中低端画师doge;1;0;1;18388;5.438329345225147e-05
78337;他就是个工具，因为这个失业的，多半都是能力不行的。;3;0;3;18388;0.0001631498803567544
78343;这么说吧，这种生产力下放会抹平中层画师和小白的之间的技术和经验差距，然后依靠涌进来的小白和资本关注而解放出来的创意，会把顶流画师给干趴下的。之后AI成熟彻底颠覆行业，让其成为“通用”行业，只有会讲故事的才能得到“高附加值”。就像画师摄像PSAI这个过程一样。看似画师更有效率了，实际社会地位变低了。;1;0;1;18388;5.438329345225147e-05
78345;能者先阅;1;0;1;18388;5.438329345225147e-05
78347;现在工作流程是用mid出设计稿主管修一下然后就可以出模型啦然后用模型渲染基础图SD精修上个月开始我们公司已经不发原画设计插图立绘图标外包了你猜因为啥？doge;2;0;2;18388;0.00010876658690450294
78356;对职业画师肯定是有影响的，对于把画画当兴趣的人真的无所谓。。AI绘画没有带给我绘画的乐趣。。用自己的图喂给AI倒是可以，但是成品图我自己肯定要修改的。。。;1;0;1;18388;5.438329345225147e-05
78358;本来画画就是为了取悦自己，Ai只是工作。这个就跟生孩子一样的，你生个孩子不是为了养儿防老，单纯是因为自己想要个孩子。;2;0;2;18388;0.00010876658690450294
78363;不管是AI画师还是人类画师，谁成本高谁淘汰，谁速度慢谁淘汰，就这么简单;1;1;2;18388;0.00010876658690450294
78366;你玩碧蓝的这大小你能忍？;10;156;166;18388;0.009027626713073745
78377;顺便问一下，模型mmc是指momoko吗？;1;33;34;18388;0.00184903197737655
78379;1874年，世界上第一台摄像机被法国的朱让卡尔发明于是，有些画家歇斯底里，说摄像机要除掉他们的饭碗、说摄像机要革了绘画界的命有的画家则把摄像机贬低得一无是处：“你看它的照片连最基础的颜色都没有，简直是糟糕透了”而现在呢？摄像机既没有抢了画家的饭碗，也不是向以前那些人说的那样一无是处。而绘画界和摄影界更是以一种奇妙的关系互相影响着现在，ai绘画技术仍不成熟，我们不妨沏上一杯茶，静静的等待这场“第二次绘画大战”的落幕复制粘贴看到你这评论，真忍不住想复制发下这段话doge唉希望对画师影响不大吧笑哭;4;29;33;18388;0.0017946486839242985
78387;为什么前几张下面都是西夏文，这AI到底被喂食了多少个游戏icondoge;1;11;12;18388;0.0006525995214270176
78390;up问一下秋叶大佬的id搜了下太多了笑哭;2;9;11;18388;0.0005982162279747662
78395;求图包;10;2;12;18388;0.0006525995214270176
78408;这么好的作品怎么没人看;3;1;4;18388;0.00021753317380900588
78412;手指有点怪（有些图片里面手指打结，有些图片里有6只手），是AI的问题吗;2;1;3;18388;0.0001631498803567544
78427;有没有女孩准妈妈;1;0;1;18388;5.438329345225147e-05
78429;BGM是什么;1;0;1;18388;5.438329345225147e-05
78431;一眼望去都是不懂AI又不懂艺术的人在大肆欢呼谁谁谁又要被取代了;54;132;186;18388;0.010115292582118773
78486;你晚了，现在AI观众已经开始看满江红了;1;35;36;18388;0.001957798564281053
78488;发梦笑哭，ai能拍电影那人就差不多不用创作了;57;26;83;18388;0.004513813356536872
78546;这标题太极端了还贩卖焦虑呀，取代行业什么的不现实，毕竟现在的ai就是纯纯的中文房间啊，没有心智的玩意想做出电影这种体系复杂的工业产品就是天方夜谭。当然我觉得在未来多个特化ai相互合作，通过模仿学习来制作出一部完整的电影也不是不可能。我支持为了解放创造力和提高工作效率而发展运用ai，但永远不应该让没有心智的ai掌控人类的文化艺术娱乐发展，工具就是工具，本末倒置的话那就是全人类的悲哀小电视笑;12;21;33;18388;0.0017946486839242985
78559;这玩意的更新迭代确实快，我上次看ai绘图还非常的毛病，我听我一画画的哥们说ai动漫可以自己编程骨架完成动作然后巴拉巴拉的弄成动画，未来的某一天确实有可能看到画面异常精致帧数极高更新贼快的ai动漫吧，而且我感觉只是作为插画的话，ai目前的水准已经合格了，至少对我一个外人来说很精美，如果有画画很厉害的再去在此基础上修改或者增加细节，效率应该会很高吧;2;15;17;18388;0.000924515988688275
78562;ai绘画首先就不可能取代艺术绘画，可以参考刘慈欣的《诗云》，因为对艺术的定义是人在特定时代和人文环境下作品才有了含义，艺术的价值是来自于多方面的，而ai创作的大多数作品只是对人定义的好作品进行模仿。为什么文艺复兴的画作和艺术被世人封为伟大的艺术画作主要是因为那个时候艺术开始有了人文精神代表了人类的精神内核，这点ai是永远达不到的。更何况电影这种更能表达人类情感的动态艺术，就算ai创作出来也大概率是没有观赏价值的;2;14;16;18388;0.0008701326952360235
78565;内行人来告诉你们，目前AI已经挤掉了很多中端以下的岗位，我也因此而失业，一些嘲笑我技术不够的人，他们后面也会被取代，只是时间早晚的问题而已，能取代初级和中级原画师，那日后一定能取代高级原画师的;4;12;16;18388;0.0008701326952360235
78570;小说市场将成为文化娱乐产业改编的龙头和核心。;8;9;17;18388;0.000924515988688275
78579;太恐怖了吧，前些天还是静态图呢现在就会动了，再下去不是会做cg电影了笑哭，一大推失业警告;4;8;12;18388;0.0006525995214270176
78586;那意思就将来，演员也会失业了微笑;3;3;6;18388;0.0003262997607135088
78590;连电影制作是什么都不懂就取代了，笑死。;5;3;8;18388;0.00043506634761801175
78605;算了吧，先把手画画好再说doge;3;1;4;18388;0.00021753317380900588
78609;不出5年，就会有第一步纯AI生成的电影。;1;1;2;18388;0.00010876658690450294
78626;可能会审美疲劳，木得灵魂;3;0;3;18388;0.0001631498803567544
78636;以前以为的ai：人用鞭子鞭打AI，AI干活。真实的ai：有钱人拿着AI鞭子抽打干活的底层人;33;2614;2647;18388;0.14395257776810963
78670;当年相机消灭了以写实绘画为生的大部分画师，但绘画并没有消亡。工具的发展不应当引起恐慌，效率往高处走是必然的。现阶段我觉得侵权问题是更需要考虑的;82;2030;2112;18388;0.1148575157711551
78753;任由AI挤压中低画师的生存空间是没有好结果的，大神也是从底端一点一点练的，如果没有中低画师的话，新一代的大神从哪里来？这是直接把绘画根都刨了，学习绘画尤其是前期投入巨大，是想让中低画师都喝西北风吗;116;1429;1545;18388;0.08402218838372852
78870;只能说当有一天ai影响到你的工作时，你就能理解很多画师的焦虑了;62;924;986;18388;0.05362192734391995
78933;“不管AI发展的怎么样，都不影响我们喜欢画画”，这才画画人该有的态度，如果你一开始选择画画抱着一种功利心态，就是为了未来去接稿赚钱，那就没必要再继续学了，因为你很有可能会饿死，这东西不是一天两天一年两年能学成的，暂且不谈对硬件设备的要求有多高，有多少人能自律到一天拿出48小时去练习的。初中高中卷的厉害，录取率50，没啥时间全在学习了，大学就更别说了，课程死板难懂，而且挂一门课你就别想毕业了，高数英语马原那是多少人的痛。已经辍学的，大多都是996，996我也干过，一天能挤出4个小时练画就已经很不容易了，每天睡八小时都睡不醒的，累的要死。这东西对于一些非专业的人（比如视觉传达、动画师等专业）来说，包括我在内，它只能当兴趣爱好，如果啊，如果有人愿意花钱买那是最好不过的情况了，但也只是这个兴趣爱好给你带来的除精神需求外的附加产物，技术没达到像wlop那样的水平如果觉得自己可以做全职自由画师那无疑是守株待兔，强如wlop都不敢辞去原有的程序员工作，可见这行的不稳定性，当然也可能跟他个人有关，他是真喜欢画画，不愿意被束缚。如今AI的诞生，无疑会是对绘画商业价值的严重打击，就如同摄影艺术打击写实艺术一样，电脑数字绘画在AI发展强盛的未来将会脱离商业，完全融入传统美术形式，AI虽然会导致很多人失业，但电脑美术画师的精神自由性将得到最大化的扩展，这何尝不是一个更好的倾向？所以，对于任何事物，我们都要抱着客观积极的心态去看待和评判，而非只站在自己的角度，我们无法阻止新事物的诞生和发展，那我们就得顺应新事物带来的影响。;216;2397;2613;18388;0.1421035457907331
79150;先把图源素材问题考虑清楚吧大部分使用画师作品投喂ai都是侵权的行为，首先在使用图源的时候你就得给原创画师一定的使用报酬更别说ai即使能给你几百张细节不同的类似图像，在某些无法理解的逻辑偏差上也不是ai能取代的;38;761;799;18388;0.043452251468348926
79189;这质量说真的中端画师基本上没活了，有那人也别嘴硬，这AI的画的质量不是真的对美术要求很高的地方外完全可用。大多数人对图的理解就和正常人喝红酒一样，低端中端根本分不清楚基本上就靠价格硬撑。;19;365;384;18388;0.020883184685664562
79209;积极影响：很多低要求的人不用花钱找画师了，对于普通人是很大的福音。消极影响：对于画师极大的挑战，中低端画师可能会因此丢掉饭碗。;27;308;335;18388;0.018218403306504243
79237;你才低端画师不要拿着这种软件来嘲讽辛苦努力的人。很讨人嫌;106;1711;1817;18388;0.09881444420274092
79344;那些公司和甲方为了钱啥做不出来，当Ai效果达到他们要的水准后，谁还管你是多少年画师，你能给他们创造多大的收益呢？效率和速度，是你快还是ai快？工厂都会全自动，Ai发展下去，不说人工画师死绝，就像有些人说的xp问题，但是绝大多数通用场景或者一些不是特殊的内容或者定制不再需要人去做了，这就是成千上万的画师眼巴巴看着那么几个单子，可笑;29;455;484;18388;0.02632151403088971
79374;说真的，看了很多ai的话，一眼就能知道是那个画师的，原画师看到这个会有多伤心自己的画风，自己的创意，自己的元素，都被ai转换成一堆数据然后到处缝合大哭我痛啊;30;482;512;18388;0.027844246247552752
79405;1Dreambywombohttpsappwomboart2Nightcafehttpscreatornightcafestudio3Starryaihttpscreatestarryaicomcreate4DiscodiffusionhttpscolabresearchgooglecomgithubalembicsdiscodiffusionblobmainDiscoDiffusionipynbscrollToInstallDeps5DALLE2httpsopenaicomdalle26滴墨社区大画家Domo7imagenhttpsimagenresearchgoogle;8;594;602;18388;0.03273874265825538
79414;ai也就画画风景和建筑了，对于人物，ai根本不能理解人类的xp，也就不能画出你满意的图，而且ai的图不是ai原创的，也不是你原创的，是网络上搜集的素材缝合到一起，有很大的侵权风险，看看就好;71;323;394;18388;0.02142701762018708
79486;所有说为爱发电的都是说风凉话，一个行业衰弱的起点就是其利润空间不断被压缩。;2;86;88;18388;0.004785729823798129
79489;今天已经看到有人拿画师直播画稿的截图去喂ai出图，完了还倒打一耙说画师参考他的ai出图了，倘若这就是未来的话，还是算了吧;14;464;478;18388;0.025995214270176203
79504;看乐子的人不会真觉得波及不到你们吧，先不说远的下一个ai拿什么动刀，就近的，大量失业中低端画师将涌入别的行业，你们猜有没有你们的行业呢doge卷起来吼吼吼;43;180;223;18388;0.012127474439852078
79548;怎么那么幽默呀？up。我看你的这个标题明显是那种不爱画画的才会想要看的视频，你在这里卖网课，我真的难绷;3;294;297;18388;0.016151838155318687
79552;你们真的不觉得。。。ai绘画很恐怖吗，我学人工智能的，我已经感觉到了ai的恐怖了，现在是绘画。。。那以后呢，音乐，设计，甚至更智能的ai可以开始通过打字和人进行交流了，ai是可以发展，但是发展趋势应该是帮助生活，而不是取代生活不是吗。。。;65;445;510;18388;0.02773547966064825
79618;我就不一样了，身为一个网文作者，我思考的是什么时候我们这群靠脑洞吃饭的会被ai挤死。热;34;287;321;18388;0.017457037198172723
79653;由于ai绘画的兴起未来可能会有大量美术生涌入啤酒馆doge;5;144;149;18388;0.008103110724385468
79659;学绘画的小可爱看这里自学绘画不容易，把我大学到进大厂收藏一系列资源绘画入门资料笔记超多笔刷线稿各类素材包经典书籍教学指导视频都打包放着了：httpsb23tvFaDinC1打call需要的自提哇哈哈打call打call;10;177;187;18388;0.010169675875571025
79671;我看了一些ai绘图，我甚至能想起原图是什么。同一个姿势构图特别明显，只是在脸材质画法上有些微区别，如果追求独一无二ai绘画达不到，因为它是拼起来的。模板约稿或许真的可以用ai，但是其他的另说。;13;174;187;18388;0.010169675875571025
79685;AI绘画导致大部分普通画师失去了土壤，就像书法，骑马等等，最终成为少数有资产有爱好的人，才会去学习的技能。对于社会来说没啥影响，对于喜爱画画的人来说，想要进一步提升就会变得困难重重;3;45;48;18388;0.0026103980857080703
79689;看到标题我就火大了;12;127;139;18388;0.007559277789862954
79703;自学绘画的小可爱们看这里，我把绘画书籍PDF笔刷绘画AI插件安装包一系列资料都放在这了：httpsb23tvFaDinC1打call需要的小伙伴点链接自取噢;5;177;182;18388;0.009897759408309767
79709;Ai是触碰了绘圈的蛋糕了么思考;48;87;135;18388;0.007341744616053948
79758;ai图源素材侵权，素材本身就由画师提供，如果ai绘画的技术让大众认为画师这个存在没有意义时，画师又应该怎么办？大佬都是从新手开始的，如果这一行业的开始底层画师都做不下去了，哪来新的图喂给a？ai的绘画哪来新的创意？a由多位画师的图画成画，版权又属于谁？;3;39;42;18388;0.0022840983249945617
79762;看到这些东西我只有沉默，我画了好几年最后直接被ai碾压，真的挺伤心的。;29;131;160;18388;0.008701326952360235
79792;为什么某些工程师职位不能被ai替代。因为ai不能坐牢藏狐;2;30;32;18388;0.001740265390472047
79795;霍金在世时对人类发出的4个警告：1人类应该想办法离开地球2不要尝试与外星人联系3人工智能将取代人类4全球变暖会变成巨大威胁个人感觉后两个已经差不多要有预兆了。呆;19;128;147;18388;0.007994344137480966
79815;让绘画回归艺术。挣钱的事就交给ai了。;2;45;47;18388;0.0025560147922558192
79819;绘画跟写代码不同，不是只需要技术就可以的。绘画、设计是艺术的一种，需要审美和感知，需要情感和想象力，而这些都是人类独有的。ai无非就是拼凑人类的已有创作，它无法思考无法感知，它没有灵魂，所以取代不太可能，只是提高了技术的下限。感觉大概率以后会变成创作工具的一种，像3d软件一样。但前提是素材全是商用免费素材，本身未经授权二传画师的图就是侵权行为。;19;86;105;18388;0.005710245812486404
79839;关键是单纯出于兴趣绘画，但是谁又有那么多时间金钱来学习呢？学几年会了后没办法赚钱生活，那个时候你又不会其他东西怎么办，绘画未来一片灰暗阿;1;21;22;18388;0.0011964324559495323
79841;画师是人类，可以理解你的XP，和你非常细致的沟通来对画作进行调整，而目前的AI还没有发展到足够的智能当然也没办法理解你的XP和太过复杂的要求，再者为什么要找低端画师约稿？除非是高端的没时间不然又不差那几个钱干嘛不去约个高端的？而且高端画师有经验你的XP和要求基本上一点就通了还省去很多麻烦藏狐;27;101;128;18388;0.006961061561888188
79872;咋说呢，要完全取代人工，也不太可能，因为没有人画新图，ai拼来拼去会越来越雷同，没什么价值像设计类的更无法取代，就算画师们设计也是各种参考借鉴，也是经过自己审美再创作的，ai没有审美;28;72;100;18388;0.005438329345225147
79901;画师存在的理由：AI会遇到停电脱单doge;4;17;21;18388;0.0011420491624972808
79906;AI绘图再怎么发展，淘汰的只是部分画师，我是认为AI绘画会成为未来美工画师的辅助工具，正向科学技术进步带来的改革只可能有快慢的差别，最终前进的结果都是不可阻挡的。当然，其实对未来画师也有一个问题，那就是AI绘画虽然大大帮助画师提高了效率，但是行业单价明显也会降低，虽然因为效率提高固定时间产出提高了，但是市场能吃得下多出来的产出吗（虽然价格便宜了）到时候可能会出现更多差异化走高端竞争的画师;13;79;92;18388;0.005003262997607135
79920;毁灭吧，让程序员做出更多ai取代人的工作，我想看看未来在这里道貌岸然的人有多急doge;8;20;28;18388;0.0015227322166630412
79929;1Dreambywombo2Nightcafe3Starryai4Discodiccusion5DallE26大画家Domo7imagen;2;58;60;18388;0.003262997607135088
79933;人工智能这东西它存在的意义本应该是推动生产力的发展或者是便捷日常生活，而不是去挤压别人的空间，它的本意不应该是解放人而不是取代人吗？;117;115;232;18388;0.01261692408092234
80051;你这标题;1;18;19;18388;0.0010332825755927778
80053;Ai决定下限，人工决定上限。Ai源自于大数据学习上限已经没了，只有下限。但是不同的画师总能有后起之秀带来不同的超模画技。;5;44;49;18388;0.002664781379160322
80059;自学绘画不容易，我把自己零基础到现在的资源都整理出来了包含全套笔刷库、学习书籍、各类线稿素材、绘画插件软件、教学指导等分享给大家httpsb23tvFaDinC1我们顶峰相见打call;3;25;28;18388;0.0015227322166630412
80063;落榜美术生表示AI尽情发展;2;27;29;18388;0.0015771155101152925
80066;非得说经验不足的画师是低端画师？就这么喜欢贬低新手？逊色一点的原创图怎么就不如高速P图了;4;65;69;18388;0.003752447248205351
80071;杀鸡取卵了属于是;2;17;19;18388;0.0010332825755927778
80074;AI画画确实厉害，但自己那份热爱、兴趣和发自内心的喜欢让你依旧热爱画画这才是最重要的，每次画得不好虽然确实心里难受比不过别人，但怀念起以前儿时画画的时候没有太在意人体结构还是火柴人，而是表达自己真正想要表达的内容，真的。。。。蛮惭愧的;5;42;47;18388;0.0025560147922558192
80080;Ai绘画本质上不是工具吗画师们为什么一定要站在对立面呢学过美术用ai绘画和没学过美术用ai绘画能一样吗;13;21;34;18388;0.00184903197737655
80094;我现在庆幸的就是，绘画始终是我的爱好，我没有在关键卡点上选择让它变成我的专业我的饭碗;4;34;38;18388;0.0020665651511855556
80099;“汽车是不可能取代马车的。”;26;30;56;18388;0.0030454644333260824
80126;现在看来我觉得过分乐观了，画师总要有一个学习的过程，那么在这个过程中k他们拿什么坚持下去呢，理想吗？人总是以生存下去为前提的，商稿未来很长一段时间都不会被取代，但画师的价值可能会一步步走低，我们用如此多的时间，金钱，去学一门短时间内难以生存的职业，值得吗？未来画师肯定是要考虑这个问题的，况且就像围棋一样，ai必然影响学习的积极性;9;39;48;18388;0.0026103980857080703
80137;很好奇的问，都推荐AI绘画了，怎么还送绘画书籍啊喜极而泣;1;13;14;18388;0.0007613661083315206
80140;我无所谓，别用ai来搞同人就行了（我看不得那些耗费了几天几夜来产粮的太太到最后热度没一个ai画的热度高然后被群嘲没ai画的好的场景，有人说要等ai发达了来画自己冷圈bz，害怕）捂脸捂脸捂脸捂脸捂脸热热热;4;14;18;18388;0.0009788992821405265
80145;那就去努力提升自己啊，难不成去抵制ai？;8;16;24;18388;0.0013051990428540352
80154;励志走过所有ai绘画视频祝大家学会使用ai绘画之后都能将自己心中的想法通过画面表达出来打call，但记住不要拿着ai绘画去嘲讽或否定那些真正付出过时间、金钱、精力和热爱，努力追逐梦想的画师们欧OK（如对本视频有不好的影响将立刻删除）;1;11;12;18388;0.0006525995214270176
80157;有些小画师天天臆想自己是艺术家趾高气昂有次我点进一个小画师空间披头就是一句骂，一切东西不得转载，滚开。这下有他急的了;3;22;25;18388;0.0013595823363062867
80162;这对与许多靠绘画维持生计的人来说是巨大的打击，很难想象下一个受到冲击的又是什么职业;2;12;14;18388;0.0007613661083315206
80169;恐怖24小时无休、零工资、零失误AI智能主播哔哩哔哩httpsb23tvIFxd3Kd;1;8;9;18388;0.0004894496410702633
80171;这结尾笑死我了呲牙;1;8;9;18388;0.0004894496410702633
80173;用什么软件，真男人就该自己写深度学习doge;1;7;8;18388;0.00043506634761801175
80175;开始了是吧;1;9;10;18388;0.0005438329345225147
80177;有的甲方都讲不清自己的需求，或者讲了一大堆，指望ai理解怎么可能呢;2;9;11;18388;0.0005982162279747662
80180;为什么我很少能看见有画师这类话，就算AI绘画未来能完全取代人类，大不了就不画画赚钱了，从事相关或其他行业，并且维持着画画的爱好。本人目前还是觉得这种话是比较中肯的，画画本来不就是兴趣爱好自我取悦吗从某种程度上说，你画画就是为了赚钱的话，艺术和兴趣爱好可能就不是很适合从你嘴里说出来了，这一段有点像暴论但我还是想发出来;3;10;13;18388;0.0007069828148792691
80184;看到ai绘画就想到ai替代人类，中国人的想象唯在这一层能够如此跃进;6;21;27;18388;0.0014683489232107897
80193;目测手绘，油画会火;2;6;8;18388;0.00043506634761801175
80196;也就是说画不了人物原创，画不了细节;2;6;8;18388;0.00043506634761801175
80200;卢德先生，你准备干呢？哦不快快砸了台蒸汽机，他抢了我的工作;3;12;15;18388;0.000815749401783772
80204;我只能说长期来看，永远不要试图对抗时代的浪潮。唯一可能值得欣慰的是，每一项生产力的新技术变革后都会创造出新的职业;49;7;56;18388;0.0030454644333260824
80254;这种生产力提高的事关我屁事，我还想这种好事赶紧点卷到土木来。;2;7;9;18388;0.0004894496410702633
80257;ai画作很多都能明显看出缝合的违和感;4;7;11;18388;0.0005982162279747662
80262;ai模仿不了人类的艺术。真正的艺术家不会受影响。那么，谁急了？;1;5;6;18388;0.0003262997607135088
80264;本质上就是工具，人总要向前看的，ai缺乏想象力，但有无限精力，人有机器无法比拟的感情和想象力，为啥不结合起来，这样不是省去了很多重复劳动的过程，提供草稿思路配色也不错啊，就算现在ai版权问题过不了，但只要有趋势出现，它以后完全可以缝合无数无版权的图片，也会有很多人愿意给ai喂图，它还是能超过大部分人，再说了，画风没有版权，如果画风有版权，那绝大部分人都是侵权的，原画师图不能用，那同画风的画师就少了吗？总有人愿意喂图，到时候又能说是谁抄谁了吗，没有用的啊。我自己也画画，当然能懂这种失落感，但是这种趋势已经不能磨灭了，与其怨天怨地，不如提高自己研究研究新画风新设计，也许未来ai是个不错的工具;2;5;7;18388;0.0003806830541657603
80267;搁这抱怨有啥用啊呢，AI绘画的趋势又不会因为你的抱怨而停止，有这时间不如多练习成为不会被取代的顶级画手或者直接转行，不明白光这个叫能解决啥问题;1;5;6;18388;0.0003262997607135088
80269;很多插画师的风格所带来的温度，机器是不会有的，人做出来的画是会带上感情的，比如东隆咚的画，真的是机器创作不出来的;5;8;13;18388;0.0007069828148792691
80275;差不多不用考虑那玩意儿，就是素材库按照算法拼成，算法不够先进的话就跟克苏鲁古神一样，运气不好也一样画画跟抽卡一个味儿笑哭;2;8;10;18388;0.0005438329345225147
80278;ai本来就是一个发展趋势，我看到很多人特别反对这个，真的没想到，不跟上时代就要被淘汰，承认技术发展很难吗，我不懂热;5;12;17;18388;0.000924515988688275
80285;画师们来这里报道安排进厂包吃包住脱单doge脱单doge脱单doge;1;6;7;18388;0.0003806830541657603
80287;帮大家避个雷，有个软件叫绘画精灵我下了然后也买了会员，但是我每次让ai生成它都是图片审核未通过，我试了好多次都这样，我去投诉过，商家也没回我，也不给我解决办法，我是昨天刚买的会员，也不退钱，真的很生气保卫萝卜哭哭我不知道有没有人和我有种情况，反正就是没了98块保卫萝卜哭哭没买的看看我的评论别买保卫萝卜哭哭保卫萝卜哭哭保卫萝卜哭哭保卫萝卜哭哭保卫萝卜哭哭;1;4;5;18388;0.00027191646726125733
80290;真的火大啊标题现在我们这种小画师就完全没有存在的意义了吗我们艺设系的人将来可不是被ai代替的物品啊;6;4;10;18388;0.0005438329345225147
80299;谁便宜好用就用谁，画师的死活我才懒得管。;106;18;124;18388;0.006743528388079182
80406;我自己的一个插画原画板绘爱好者部落422632516。里面都是B站小伙伴们一起学习交流，一起来玩呀还有我自己整理的笔刷线稿板绘原画书籍戳这里httpstbilibilicom693341252140138533;1;10;11;18388;0.0005982162279747662
80408;强烈建议评论区的某些孩子尝试自己整点什么本地ai（比如deepfacelab，无需N卡，用A卡也能跑）玩玩之后再讨论ai相关的畅想和论断。有些发言太瞎子摸象了笑哭;2;7;9;18388;0.0004894496410702633
80411;真的，我感觉很可笑，假设ai和画师一样都一样的收费，你还会出这个视频吗低端画师是高端画师的雏形，没有收入没有人来指导他们作画，以后还会有np的人类画师吗吃了画师的画来学习，没有任何回应，甚至过河拆桥，有什么好宣扬的呢，合着低端画师不配拥有生产力？;5;3;8;18388;0.00043506634761801175
80422;AI永远取代不了人工;2;3;5;18388;0.00027191646726125733
80425;ai最大的局限就是ai读不懂人话，详细的设定几个关键词是绝对无法概括的，不断进步的只是ai的审美和算法，或许ai作品质量不断提高，但ai的局限让它注定无法代替人类画师，最多就是画个壁纸和头像，完全无法满足对复杂设定的需要;1;3;4;18388;0.00021753317380900588
80427;投币了哈哈哈哈哈哈;1;3;4;18388;0.00021753317380900588
80429;https6penart推荐一个中文Ai生成的，电脑手机都能用，各种的脱单doge;3;3;6;18388;0.0003262997607135088
80435;Discodiffusion这个AI绘画软件B站有教程哦，大家可以看看;1;7;8;18388;0.00043506634761801175
80439;我有一个问题，当年etc普及的时候，绘圈的各位有没有为售票员申冤呢？;2;2;4;18388;0.00021753317380900588
80443;怎么这么多人担心ai替代人工画画辣眼睛这么比喻吧，ai就像是食品调料包，当调料包被发明出来时一堆人说：“完了调料包要代替厨师了”，就像这样的事就不可能发生;2;2;4;18388;0.00021753317380900588
80448;请问什么叫低端画师呢给心心;2;2;4;18388;0.00021753317380900588
80451;好剑啊，不知道为什么;1;2;3;18388;0.0001631498803567544
80455;我觉得AI作画的话，他是在已经创作出来的基础上进行缝合AI创作不一样的人物，但是如果这些原创作品都没有了的话，那他不能自己创作新的东西，也会慢慢淘汰掉的;1;2;3;18388;0.0001631498803567544
80457;众所周知，ai的画不过是人类画出来的画集堆积出来的，如果真的把苦练技术的画师踢出去，那ai的画根本就没有意义可言了，而且人类的灵感是ai不能比的;1;2;3;18388;0.0001631498803567544
80461;纺织工人当初也觉得自己不该喝西北风。跑得快的人觉得每小时不到5公里的汽车威胁不到自己;1;2;3;18388;0.0001631498803567544
80463;感觉未来十年的发展ai真的能顶半边天了脱单doge;1;2;3;18388;0.0001631498803567544
80465;AI替代不了人工绘画的。。。;2;2;4;18388;0.00021753317380900588
80468;要是有能精准定位到我喜欢的角色的AI就好了;1;2;3;18388;0.0001631498803567544
80471;扯下约稿的遮羞布几k上万的不如ai免费画的;6;3;9;18388;0.0004894496410702633
80478;纺织机出世的时候纺织工的反应也差不多吧，AI绘画带来最大的影响可能是画师门槛降低;4;3;7;18388;0.0003806830541657603
80483;就喜欢看小画师破防，都快急死了呲牙;28;6;34;18388;0.00184903197737655
80514;我想起英国当年的红旗法了，车的出现影响了当时的马车行业，所以出台这个法律，车的前面必须有几名红旗手走在前面，用来拖慢车的速度，也就没人坐了。我的建议是，车夫趁早改行跑出租，让乘客快点到达目的地。;1;1;2;18388;0.00010876658690450294
80518;这题目，，，你是在贬低画师吗？？ai绘画好是好，但不能做到十全十美。真人可以倾听并且理解你的所有需求，给例图也不会完全参考，，，;5;1;6;18388;0.0003262997607135088
80534;虽然但是我找自己喜欢的画师约稿是因为喜欢他们的人和画风，喜欢他们特别的设计感，有些特别的东西ai模仿不来，至少现在ai的作画风格就是普通日系大众画风，但我喜欢的几位老师他们的画风都很特殊。。。这就像是虽然现在有机械制作的工艺品但还是会有人追求手作一样，，努力攒钱去约喜欢的太太喽;2;1;3;18388;0.0001631498803567544
80540;以前老觉得，艺术这玩意儿是永远没法被ai取代的，ai怎么能理解美理解呢，其实人家不用理解啊，人只要把美的东西给他学习就行，，ai写文，ai画图，ai写诗刚开始还觉得挺好玩来着，觉着是和捏脸差不离的玩意儿，毕竟生成的东西很多也挺离谱的，就当笑话看看罢了，结果，好家伙，这未来再完善完善，还需要什么画家歌手作家啊，你吭哧好久的心血搞的玩意儿还不如ai两分钟生成，都去给ai当素材库供ai学习吧;4;1;5;18388;0.00027191646726125733
80546;ai绘画我感觉挺不错的，不用花钱请人画画了微笑;1;1;2;18388;0.00010876658690450294
80549;Al连艺术都可以替代了，那么社会上的一切还有什么不可以替代的吗？;3;1;4;18388;0.00021753317380900588
80558;努力十几年被ai取代了热;2;1;3;18388;0.0001631498803567544
80562;AI可能会取代大部分中低档画师，但绝不会超越大师级画师，就好比机器可以取代大部分工人，但绝不会取代科研人员，要么逆流而上成为大佬，要么就索性放弃。;1;1;2;18388;0.00010876658690450294
80571;我用ai画图，人脸都是各种歪歪扭扭的，也就风景画还能用;2;1;3;18388;0.0001631498803567544
80574;影视文学绘画音乐，艺术永远不会被电子技术所替代的，创新还得看人。不过这个对于那种非商业，就是想画着玩玩的圈外人还是挺有意思的;1;2;3;18388;0.0001631498803567544
80577;你说AI绘画毁了中低端画师，不该出现。但是创造AI绘画的无数程序员的努力不配被尊重吗？他们哪里比不过那些画画的？;7;2;9;18388;0.0004894496410702633
80586;光速去下载了滴墨社区试试;1;2;3;18388;0.0001631498803567544
80588;你没事吧;1;5;6;18388;0.0003262997607135088
80602;以后找ai设计ai吧;3;1;4;18388;0.00021753317380900588
80607;我觉得未来可期啊，ai如果训练的牛批。以后漫画就可以随便看了，把小说扔进去，几分钟，几千集的漫画就出来了，。。脱单doge;2;1;3;18388;0.0001631498803567544
80614;就像外卖打掉了方便面一半以上的销量一样，未来程序员会打掉画师一半的需求，有时候自己职业的挑战不一定来自本行业。微笑;1;1;2;18388;0.00010876658690450294
80616;实际上没人侵害小画家，要喂图也是喂顶端大神的，人家大神都没发话，小画家先急了;3;1;4;18388;0.00021753317380900588
80622;当ai绘画成熟后，大多数画师会饿死，当ai代替画师的时候，就代表着绘画再无突破，不要说不喜欢ai绘画的都是画师，我并不是画师，现在的人一味的认为画师收费贵，但是当画师行业不存在后，ai绘画收的钱绝对不比画师低，就像一些商家最喜欢的，用低价免费的东西，吸引人的注意力，打败竞争者后原地起价。一个是没有有极限的ai，一个是有无限可能的有可能突破极限的画师，我宁愿选择画师，ai绘画的突破是人类不断的投喂训练，失去了画师，ai绘画就只能保持现在的完美。最令人不齿的是，投喂ai绘画的原画来源可能并没有经过原画师允许。当然也有可能是时代的局限性吧，不是还有人说当年汽车出现时，拉黄包车的人也担心自己会失业嘛。说到底我只是害怕ai全面代替一样行业的时候，特别是文化艺术方面，人类这方面就不会有进步了，现实点，都说画师不喜欢ai绘画是因为ai绘画抢到自己赚钱，但是无利可图的事谁愿意做，用爱发电嘛可能只有正在财富自由的人才有有时间去培养爱好的同时顺便创创新吧说到底对真心爱画画的人，和把画画当饭碗的人是极其不公的，不要再说什么不喜欢ai绘画的画师都是图利的，退万步讲，无利可图的事情，你回去做嘛，不可能人人都是富二代。当然ai绘画的确也有很多好处，要不b站那个up主就这些事情开个辩论赛。我觉得应该很有搞头doge;1;1;2;18388;0.00010876658690450294
80646;还好我学的是室内设计热;1;0;1;18388;5.438329345225147e-05
80648;有点跑题了但是我想问一下背景音乐是啥？;3;0;3;18388;0.0001631498803567544
80659;Dreambywombo;1;0;1;18388;5.438329345225147e-05
80662;话说，ai绘画能画手抄报吗？doge;1;0;1;18388;5.438329345225147e-05
80665;学了四年素描之后开始学漫画的时候，有了AI绘画这个东西，努力似乎付诸东流了。。。;1;0;1;18388;5.438329345225147e-05
80682;我不理解那些说自己画了好几年被ai代替的人笑哭现在ai也没代替画师啊？咱也不是未来的人，也不知道未来会发生什么事，走一步是一步就好了，有这担心的时间还不如多画点画呢热词系列好家伙;1;0;1;18388;5.438329345225147e-05
80696;这个稀烂的没有版权意识的世界感觉毁灭吧;1;0;1;18388;5.438329345225147e-05
80706;我现在真的挺好奇ai作画到底能不能构成侵权，如果算是侵权，那一些画手学别人的话算不算侵权？一些人用什么ps软件改自己的画，要不要叫软件费？;3;0;3;18388;0.0001631498803567544
80711;手机应用商店一个都搜不到;4;0;4;18388;0.00021753317380900588
80717;我觉得失业的是那些画师，而不是联考（校考）考完选设计专业的美术高考生失业。因为美术不只有画画;3;0;3;18388;0.0001631498803567544
80732;我很好奇这个ai能生成水粉静物吗脱单doge;1;0;1;18388;5.438329345225147e-05
80741;模板更难，ai其实很难在一个风格下画出有不同视觉特点的画的;1;0;1;18388;5.438329345225147e-05
80744;怎么下载dream呀，ipad装哪个有用？;1;0;1;18388;5.438329345225147e-05
80749;机器淘汰的从来不是工人，而是小生产;2;0;2;18388;0.00010876658690450294
80767;转行本子画师咯;1;0;1;18388;5.438329345225147e-05
80772;UP我想问一下，如果有那个角色原型有没有直接给角色人设图让ai直接取脸的？只能利用词条吗;1;0;1;18388;5.438329345225147e-05
80776;051是特别福利？脱单doge;2;25;27;18388;0.0014683489232107897
80779;一定要坚持创作哦;2;9;11;18388;0.0005982162279747662
80785;什么时候会进化成动图呢;3;1;4;18388;0.00021753317380900588
80790;一键三连加充电，这Tm太棒了呲牙;1;1;2;18388;0.00010876658690450294
80800;喜欢喜欢啊，电脑配置咋样啊？也想整一些;1;0;1;18388;5.438329345225147e-05
80810;怕不是四叶草玩家;1;0;1;18388;5.438329345225147e-05
80813;三连支持;1;0;1;18388;5.438329345225147e-05
80815;衣服少点就好了;1;0;1;18388;5.438329345225147e-05
80817;好奇和这个的配套使用效果热词系列知识增加BV1PD4y177PM;7;126;133;18388;0.007232978029149445
80825;三视图是用于做3d模型的，ai的图还是要有设计师或者模型师改成适合做3d的结构，不过确实能省时间和人员；现在ai迭代的太快，现在把ai整合进设计流程还太早没有性价比，很多设计师包括我都在观望，等差不多成熟了专业设计师就都会下场用了;15;547;562;18388;0.030563410920165325
80841;今天在推特看到好多画师因为ai缝合了他们的画都被气的不行捂脸;314;401;715;18388;0.0388840548183598
81156;由此可见画师的伟大，ai拿了这么多画师作品训练，质量能差就有鬼了。;7;522;529;18388;0.028768762236241027
81164;恐怖如斯，大部分的质量都能直接做人设图当v出道了粉红兔子出神粉红兔子出神;4;231;235;18388;0.012780073961279096
81169;说实话这质量真的就比某些新出道皮套连普通都算不上的v强太多;5;148;153;18388;0.008320643898194474
81175;这玩意绝对吃了pinterest的数据库，pinterest尊重版权到不不保留原图，点开直接跳到采集地址。这玩意的模型里全是版权作品，甚至商业作品。真恬不知耻;9;213;222;18388;0.012073091146399826
81185;AI出来后再也没有人会吐槽描图和设计细节撞车等了，图片都只是熔炉而已;10;116;126;18388;0.006852294974983685
81196;人类若是选择放弃了最应该人类去做的东西，那么就随他去吧。即使肉体凐灭，霍金依然可以在思考中形成宇宙简史，而放弃思考的人类，不过是行尸走肉的连机械都不如的乐色罢了;19;132;151;18388;0.008211877311289972
81218;第一眼看上去还行，看完发现还是太同质化了笑哭;4;45;49;18388;0.002664781379160322
81223;哇居然可以画三视图了，但结构还是有很大问题啊，一些地方对不上，没办法用在建模上，和其他ai一样，可以用来作参考，没办法真正意义上的取代设计师;2;31;33;18388;0.0017946486839242985
81226;越想越难受，好不容易画出来的孩子被融到ai里变成了别人“画”的;4;53;57;18388;0.003099847726778334
81231;用来学习参考还是很不错的，不过现在的ai都这么牛了吗笑哭;1;25;26;18388;0.0014139656297585382
81233;连签名都抄下来，ai真是太牛辣;8;28;36;18388;0.001957798564281053
81242;现在的人，都想着ai走捷径，都不老老实实提升水平了吗？;36;27;63;18388;0.0034261474874918425
81279;思考一下，为什么所有大厂的ai画都用辣鸡AI冲着整活去做？还不是因为淘金热里真正挣钱的是卖工具的。一个自动驾驶里的边角料技术漏出来的东西，还真把他当风口了。niji的质量说实话真不低了，你猜为什么没人用它来投入生产？ai总不能比人工贵吧还不是因为这玩意和元宇宙一样，狂欢一阵之后就什么都不剩了。;4;25;29;18388;0.0015771155101152925
81285;觉着抢设计师饭碗的，真有那天全体设计师AI起手，业余还是业余一样抢不过妙啊现在也就看个乐吧，商业价值太低大部分时候用不上;10;19;29;18388;0.0015771155101152925
81296;签名一大堆好抄阿;4;21;25;18388;0.0013595823363062867
81301;再来个AI建模，输入三视图自动建模，一条龙服务。热词系列知识增加;5;23;28;18388;0.0015227322166630412
81307;niji三视图怪异文字签名，鉴定为笑话，估计是把盗来的商插或者别的老师家的oc图生图劣化丢给你，还以为是画的呢，没素材库他能画个啥;1;30;31;18388;0.0016858820970197955
81309;说到底还是钱的问题，该抵制的是白嫖画师作品训练并盈利的行为，而不是抵制AI本身。StableDiffusion是开源的，网上也有很多公开的模型，别拿去赚钱就行。不干人事的就只有Spellbrush和Midjourney以及AI图卖家。;2;15;17;18388;0.000924515988688275
81313;一致性这么强用了什么tag;1;3;4;18388;0.00021753317380900588
81315;天哪我要失业了;2;3;5;18388;0.00027191646726125733
81318;跪求一个tag，好想用这个当参考喜欢;4;19;23;18388;0.0012508157494017839
81323;什么这不是拼图这是学习我们这个ai啊他遇水变大变高，原图喂进去之后呢，就会变成答辩什么哪里玩niji25美元，一个月几百张;34;42;76;18388;0.004133130302371111
81360;这些图缝的太明显了;4;4;8;18388;0.00043506634761801175
81367;再来个ai写程序彻底解放双手;2;8;10;18388;0.0005438329345225147
81370;做为3D建模来说，完全可以够用来建模的了。很多时候，公司里给的图都没这些清晰，直接就给一张立绘或者45度透视的，就让用于建模了，只要大感觉对，造型上保持90相似度，不合理的结构再设计，改成合理化，就差不多了。微笑;2;2;4;18388;0.00021753317380900588
81373;说实话，设计得不好，比例疏密都没考虑过，东西堆得太满了，ai只能重复缝合过去的东西，而人脑能创造无限的新风格新形式脱单doge脱单doge;4;2;6;18388;0.0003262997607135088
81378;看签名，过拟合了吧。而且三视图最大的作用还是给其他对接岗位做示意，拿ai干这种事，出来一堆似是而非实际完全没有意义的东西，就跟太平洋岛上的土著模仿美军召唤空投补给一样。;4;6;10;18388;0.0005438329345225147
81388;設計比我強好厲害大多數都很漂亮;1;2;3;18388;0.0001631498803567544
81393;感觉风格都是日式奇幻的那种偏原神的像美卡那种风格独特的能弄出来吗？;10;6;16;18388;0.0008701326952360235
81405;把别人辛苦的作画当做乐趣拿来随便合成，别人付出几个小时你只需要几分钟，做出来以后还拿来播视频企图让ai代替手工，我只能说无语，我还能说什么呢，护ai的太多了，都想省事，不用努力学就会成功吐都不愿意付出时间去练习，企图一步登天，真的笑死，又不是给别人学的。;3;4;7;18388;0.0003806830541657603
81415;上层画师也是要从底层慢慢训练，走出来的吧。ai在以远远超越人类学习能力的速度进步，有没有可能扼杀那些本来能成为上层画师的下一代希望之星呢。本来还能画画图勤工俭学的，本来有点兴趣要成为画手的，会不会在被ai逐渐垄断底层甚至中层的绝望中，再也到不了上层？;2;4;6;18388;0.0003262997607135088
81418;平时拿来做参考蛮好的只是要建模这种还远远不行修改还是需要补充蛮多细节的还有因为融合东西问题后续被玩家投诉的危机和风险太大，参考一下还是不错的日常做的三视图根据每个公司要求不同会有各自侧重点细节要求的程度不是大家平时以为的那种还是蛮鼓励AI做想法参考的工作用还是拉倒吧;2;4;6;18388;0.0003262997607135088
81428;都是日韩风，大都是做服设的感觉，所以比较好奇穿插结构复杂一点设计的ai还能生出来吗;3;6;9;18388;0.0004894496410702633
81438;厉害，居然能稳定生成原创角色，而且还是三视图，up有兴趣出教程讲讲嘛？;1;1;2;18388;0.00010876658690450294
81452;这几个三视图给3d，3d要骂娘了;1;0;1;18388;5.438329345225147e-05
81476;含铅汽油，R22氟利昂，镭荧光技术那种技术不是存在，然后被抵制到消失，你自己没有能力独立完成设计，因此使用洗稿机进行大规模抄袭而已，没有什么好说的;1;0;1;18388;5.438329345225147e-05
81499;问一下三视图纯色的背景关键词用什么？;1;0;1;18388;5.438329345225147e-05
81518;可以求求是什麼ai嗎星星眼星星眼;1;0;1;18388;5.438329345225147e-05
81520;发图不留种;1;0;1;18388;5.438329345225147e-05
81523;最后一张地图是啥呀给心心;1;0;1;18388;5.438329345225147e-05
81536;完了，感觉我要失业了笑哭;9;101;110;18388;0.005982162279747662
81546;正常人多久才能画出一张，AI随随便便就生成出来了，囧;26;857;883;18388;0.04802044811833805
81573;So，why，蛇显得那么没有特性，不仔细看身上的纹路压根看不出是蛇呀。大哭;10;175;185;18388;0.010060909288666521
81584;DE你看看它;4;30;34;18388;0.00184903197737655
81590;其实让他们当正派的话，也有一种强度的美思考思考;1;8;9;18388;0.0004894496410702633
81593;要是赤皇有这十二神将，早统一星团了吃瓜;7;6;13;18388;0.0007069828148792691
81601;正派没感觉，但是变邪恶之后气质和颜值都上升了dogedoge;1;46;47;18388;0.0025560147922558192
81640;用的什么软件;1;0;1;18388;5.438329345225147e-05
81643;牛是不是可以魁梧一些，除了角其实还有很多性状可以模拟，小建议，up画的真棒;1;0;1;18388;5.438329345225147e-05
81655;圣歌抱歉走错片场了doge;1;0;1;18388;5.438329345225147e-05
81657;这是哪个软件？;1;0;1;18388;5.438329345225147e-05
81667;哏哏查你学厉;1;0;1;18388;5.438329345225147e-05
81669;区分方法，每个生肖各四张，烦兄弟顶我。;1;1;2;18388;0.00010876658690450294
81671;猪太刻板了，为什么非得胖胖的，肉嘟嘟的;4;1;5;18388;0.00027191646726125733
81689;用的哪个ai什么算法训练的我那个跟幼儿园水准一样;1;0;1;18388;5.438329345225147e-05
81694;这是哪个软件或者网站呢脱单doge;1;0;1;18388;5.438329345225147e-05
81712;都是人的头骨，没有做到概括动物的骨骼形状变成机甲，看一俩个感觉很帅，看多了就没有每种动物自己的特色了;2;0;2;18388;0.00010876658690450294
81742;求AI名称;1;0;1;18388;5.438329345225147e-05
81748;什么软件弄的，好厉害;1;0;1;18388;5.438329345225147e-05
81762;up用的是什么软件;2;0;2;18388;0.00010876658690450294
81772;niji出的图;1;0;1;18388;5.438329345225147e-05
81778;图包云盘打call打call打call链接：httpscaiyun139commi0l5CLQVV66u51提取码：XsmO复制本段信息并打开中国移动云盘APP，免输提取码哦;89;62;151;18388;0.008211877311289972
81868;图包云盘打call打call打call链接：httpscaiyun139commi0l5CLQLmfcV2w提取码：EWa2复制本段信息并打开中国移动云盘APP，免输提取码哦;62;51;113;18388;0.006145312160104416
81931;AI：人类就喜欢这样的玩意？懂了每秒画1000000000张让人类沉迷于此然后灭;4;86;90;18388;0.004894496410702632
81936;已经下载完毕脱单doge;6;56;62;18388;0.003371764194039591
81943;图包云盘给心心给心心给心心链接：httpscaiyun139commi0l5CMOH8sL0jr提取码：O1M3复制本段信息并打开中国移动云盘APP，免输提取码哦;13;24;37;18388;0.002012181857733304
81957;这是什么模型啊，画风都不一样了捏打call;1;18;19;18388;0.0010332825755927778
81959;AI居然已经能画这么精美的图了吗，这也太厉害了;3;50;53;18388;0.002882314552969328
81963;我觉得这些人工智能做出来的形象已经比很多国漫的美女都要漂亮了，人工智能的绘画能力一定会用在动画的生产上的，毫无疑问;4;20;24;18388;0.0013051990428540352
81969;啊，海外用户领不了，没有中国手机号笑哭;6;10;16;18388;0.0008701326952360235
81976;可以看出up对猫耳娘非常喜欢;1;5;6;18388;0.0003262997607135088
81979;0041这手怎么感觉怪怪的;5;7;12;18388;0.0006525995214270176
81985;up有发小红车吗星星眼;6;6;12;18388;0.0006525995214270176
81992;有没有百度网盘的？;36;7;43;18388;0.002338481618446813
82029;图包给心心给心心给心心链接：httpscaiyun139commi0l5CLQLmfcV2w提取码：EWa2复制本段信息并打开中国移动云盘APP，免输提取码哦;4;3;7;18388;0.0003806830541657603
82037;没有移动号码啊笑哭;2;1;3;18388;0.0001631498803567544
82047;顾笙诉璃歌乐乐乐乐;2;3;5;18388;0.00027191646726125733
82050;綾華丶已关注，求私发;1;1;2;18388;0.00010876658690450294
82057;有没有百度网盘。;1;1;2;18388;0.00010876658690450294
82059;收藏比赞多一人之下养生;1;1;2;18388;0.00010876658690450294
82067;百度云私发一下啊呜米刀口舔血;1;1;2;18388;0.00010876658690450294
82075;还有画了三条腿的，反正啥奇形怪状的都有;1;2;3;18388;0.0001631498803567544
82078;用的什么软件啊，看看我;2;3;5;18388;0.00027191646726125733
82099;已经三年有没有百度网盘的，up主发我一下，谢谢;1;1;2;18388;0.00010876658690450294
82104;星星眼打call喜欢;1;2;3;18388;0.0001631498803567544
82107;三连，求tag星星眼;8;1;9;18388;0.0004894496410702633
82117;兄弟们，我来当好人了。我把图片从和彩云下下来有上传到百度云了。链接发在置顶的评论区里了;2;1;3;18388;0.0001631498803567544
82120;细看极恐，不愧是随机组合吃瓜;3;1;4;18388;0.00021753317380900588
82124;阿婆主，你看我这两个硬币能换个度盘链接么;1;1;2;18388;0.00010876658690450294
82159;百度网盘弄一个，秒传也行;1;0;1;18388;5.438329345225147e-05
82168;下了模型，才明白为什么大都只有个头。;1;0;1;18388;5.438329345225147e-05
82170;大佬问一下你搞这个多长时间了已经怎么搞2D和3D风格？刚下载完的萌新笑哭笑哭;1;0;1;18388;5.438329345225147e-05
82184;第一次听说移动网盘，而且登陆发的验证码一直错误也是离谱最后直接锁号了看来此图与我无缘;4;0;4;18388;0.00021753317380900588
82190;过期了？怪我咯;3;0;3;18388;0.0001631498803567544
82201;已三连求度盘。;2;0;2;18388;0.00010876658690450294
82205;第一感觉，青花瓷兔年;1;0;1;18388;5.438329345225147e-05
82212;綾華丶三连了up，求私发个百度云的。;1;0;1;18388;5.438329345225147e-05
82220;求私啊，百度云脱单doge;2;0;2;18388;0.00010876658690450294
82231;脖子好长嘿嘿;1;0;1;18388;5.438329345225147e-05
82351;白起和蒙恬简直上了几个档次;18;477;495;18388;0.026919730258864478
82370;讲真乍一看很好看，但是大多数细节还是没法比的（毕竟人家王者画师一张稿子好多钱呢）;3;207;210;18388;0.011420491624972808
82374;东皇盾山白起蒙恬赢麻了，吕布恐成最大输家doge;5;180;185;18388;0.010060909288666521
82380;怎么没有女化白起doge;3;78;81;18388;0.004405046769632369
82385;大佬ai绘画是哪个网站星星眼星星眼星星眼;2;25;27;18388;0.0014683489232107897
82389;啊B呀啊B，你们在干嘛，之前的把我的稿件从网络游戏区转移到综合区，手机游戏区，说是不符合规定。那我投手机游戏区得了吧，结果又给我挪到电子竞技区，这到底是哪一个区啊笑哭;3;11;14;18388;0.0007613661083315206
82393;怎么感觉还上了档次笑哭;10;6;16;18388;0.0008701326952360235
82406;全部看完，表示挺拉的，很多报网课初学板绘的人都能画出来，和原画对比不管是人物造型还是上色水平差的距离还是很大很大的，有的人物合成的甚至很奇怪头身拼接很尬评论里叫好的廉颇白起对比都差很多很多笑哭廉颇白起的动做ai好像连透视都没画明白;1;4;5;18388;0.00027191646726125733
82408;嘤哩个嘤哩个嘤哩个嘤好帅的夏侯;1;3;4;18388;0.00021753317380900588
82412;这不是崩不崩，就是画风从25变2了，逼格没了;1;2;3;18388;0.0001631498803567544
82415;脱单doge;1;2;3;18388;0.0001631498803567544
82417;大佬关键词是啥啊都，给个教程可以吗;2;1;3;18388;0.0001631498803567544
82420;拂袖挽风这个蒙恬我去;2;1;3;18388;0.0001631498803567544
82423;天美好好看，好好学doge;1;1;2;18388;0.00010876658690450294
82430;这咏唱一看就没有达到超位级别呀doge（bs）;1;1;2;18388;0.00010876658690450294
82475;好看个鬼画风感觉就是那种小孩子喜欢的又白又萌弱的感觉;1;0;1;18388;5.438329345225147e-05
82479;我看评论都在说蒙恬帅，而且越看我心越痒，我耐着性子等等看tv微笑;1;0;1;18388;5.438329345225147e-05
82482;蒙恬第二个重画的帅0525;1;0;1;18388;5.438329345225147e-05
82486;怎么没有法师克星doge;1;0;1;18388;5.438329345225147e-05
82494;AI你还我白起崽大哭;2;0;2;18388;0.00010876658690450294
82498;那个，，我想问下你是哪找的英雄横版图的妙啊;2;0;2;18388;0.00010876658690450294
82502;感觉ai现在画二次元炉火纯青，古风不太行;2;8;10;18388;0.0005438329345225147
82521;求包谢谢星星眼星星眼;1;0;1;18388;5.438329345225147e-05
82523;想要图包;1;0;1;18388;5.438329345225147e-05
82526;三连安排能给个图包吗;1;0;1;18388;5.438329345225147e-05
82529;三连送上，不要骄傲;1;0;1;18388;5.438329345225147e-05
82531;Pixiv上一大堆这种不穿衣服的图。见的太多了;2;31;33;18388;0.0017946486839242985
82534;所以究竟是画没画出来，还是画出来了，让你给裁剪了doge;1;7;8;18388;0.00043506634761801175
82540;现在用basilmix还是chilloutmix;1;1;2;18388;0.00010876658690450294
82584;建议还是别搞这些花里胡哨的切图特效，直来直去，比啥都好DOTA2dodo省略号;1;9;10;18388;0.0005438329345225147
82586;第1张太棒了，以后如果发展到仿真机器人可以当老婆了，请务必给我这张图的参数;3;6;9;18388;0.0004894496410702633
82599;高质量已三连;1;0;1;18388;5.438329345225147e-05
82611;是novelai吗，我昨晚弄了一晚上，各种问题搞不懂。。。;1;0;1;18388;5.438329345225147e-05
82624;涩涩是人类技术进步极大的推动力;2;8;10;18388;0.0005438329345225147
82627;这up主，为啥揣着明白装糊涂呢？我们大众肥宅要的是啥？（答：我们要欲，不要纯）;2;7;9;18388;0.0004894496410702633
82630;第一张的体态我想到了芙蓉JJ笑哭笑哭笑哭;4;3;7;18388;0.0003806830541657603
82639;请问模型是哪个;1;1;2;18388;0.00010876658690450294
82649;那个模型doge;1;0;1;18388;5.438329345225147e-05
82655;这个之前已经看别人上传过了，原理是利用谷歌虚拟云盘colab跑笔记，下载模型。注意，需要科学上网。由于原理是调用谷歌运算，其速度可能会比电脑跑的更快。注意，目前有连续使用时长过长导致被拉黑的情况占用过多资源会被网站拉黑;25;1439;1464;18388;0.07961714161409615
82681;感谢大家支持，UP没开激励计划，不用投币呀，关注就好啦，因为只有1000粉丝才能设置私信自动回复，up一个一个手动回复大家，别着急喜极而泣喜极而泣;69;253;322;18388;0.017511420491624973
82751;谢谢，因为害怕饿死，已经转行去画漫画了，累就累些吧，总比饿死强笑哭;19;197;216;18388;0.011746791385686317
82771;東雪蓮喂喂喂up我问一下这个图片自己捏我怎么保存，是没法保存吗東雪蓮嗯？東雪蓮嗯？;5;21;26;18388;0.0014139656297585382
82777;这个有没有使用次数限制热词系列知识增加;5;40;45;18388;0.002447248205351316
82783;励志走过所有ai绘画视频祝大家学会使用ai绘画之后都能将自己心中的想法通过画面表达出来打call，但记住不要拿着ai绘画去嘲讽或否定那些真正付出过时间、金钱、精力和热爱，努力追逐梦想的画师们欧OK（如对本视频有不好的影响将立刻删除）;7;148;155;18388;0.008429410485098978
82791;如果Colab限额的话可以换没用过或者没用多久的账号继续用，我就这样玩的脱单doge;3;20;23;18388;0.0012508157494017839
82795;大乘AI绘画吗;2;11;13;18388;0.0007069828148792691
82798;现在用不了了大佬，今天全都用不了了;5;6;11;18388;0.0005982162279747662
82804;up我的第三步最后出来error怎么办（;1;5;6;18388;0.0003262997607135088
82806;已经出现许多涉及ai作画的恶劣事件，每一次新技术的出现都会刷新某些人类的道德底线;1;17;18;18388;0.0009788992821405265
82808;wwwDraftart不香吗？？不比这个好？我直接把我的原画搬上去，它能给你整出一张半成稿啊啊啊啊;2;5;7;18388;0.0003806830541657603
82811;求网站;7;4;11;18388;0.0005982162279747662
82819;大佬，现在这个4chan版的我一直卡在启动模型这，colab还有额度，但就是加载不完怎么办啊？;3;3;6;18388;0.0003262997607135088
82823;请问一下大佬网址是什么大哥这个网址是什么葫芦娃tc;1;1;2;18388;0.00010876658690450294
82825;谢谢up不过这第二次打开还要不要跑代码呀？每次打开都要这样一遍吗？;1;1;2;18388;0.00010876658690450294
82827;已热词系列三连，求网址;2;1;3;18388;0.0001631498803567544
82830;已热词系列三连求私信;2;1;3;18388;0.0001631498803567544
82833;可以给张图片，up帮忙改成二次元的吗;1;2;3;18388;0.0001631498803567544
82835;网站是什么喜欢;2;1;3;18388;0.0001631498803567544
82838;兄弟，每次后台colab断了，都得重新跑吗;3;2;5;18388;0.00027191646726125733
82842;在第三步的时候停住了怎么回事？;3;1;4;18388;0.00021753317380900588
82846;苹果也行吗;2;2;4;18388;0.00021753317380900588
82849;只能说千万不要搞手，特别是两个人以上的手藏狐;2;1;3;18388;0.0001631498803567544
82852;网络没问题，为啥用着用着就用不了了，要退出去再安装一遍才行;5;1;6;18388;0.0003262997607135088
82858;有些预感，先缓存了藏狐;1;2;3;18388;0.0001631498803567544
82864;每次进网站是要重新下载安装一遍吗;3;1;4;18388;0.00021753317380900588
82873;求私热词系列三连;1;2;3;18388;0.0001631498803567544
82875;以前用过，忘记叫啥了，以前不懂二次元;1;1;2;18388;0.00010876658690450294
82877;求视频里的咒语doge;1;1;2;18388;0.00010876658690450294
82879;已热词系列三连，求网址，大佬;1;1;2;18388;0.00010876658690450294
82881;我有一个朋友剩下的你知道的脱单doge;1;5;6;18388;0.0003262997607135088
82883;求网址星星眼星星眼星星眼;1;5;6;18388;0.0003262997607135088
82886;已热词系列三连，求网址脱单doge;3;2;5;18388;0.00027191646726125733
82891;已三，求私;2;2;4;18388;0.00021753317380900588
82896;所以什么是魔法;1;1;2;18388;0.00010876658690450294
82902;恐怖的收藏量doge;2;1;3;18388;0.0001631498803567544
82905;up我也要个热词系列三连;1;1;2;18388;0.00010876658690450294
82908;我要我要;1;1;2;18388;0.00010876658690450294
82911;说是无法连接到gpu，达到了colab的使用限额怎么解决啊;3;1;4;18388;0.00021753317380900588
82915;要一下链接;1;1;2;18388;0.00010876658690450294
82917;这个能发送底图吗;4;1;5;18388;0.00027191646726125733
82929;三联加关注一气呵成，Up主能发个链接吗？;1;1;2;18388;0.00010876658690450294
82931;视频里用的什么浏览器？;9;1;10;18388;0.0005438329345225147
82950;求;1;1;2;18388;0.00010876658690450294
82966;求网址热词系列三连;1;1;2;18388;0.00010876658690450294
82969;已热词系列三连求;1;1;2;18388;0.00010876658690450294
82980;求网址，已三连doge;2;1;3;18388;0.0001631498803567544
82984;求网址脱单doge;1;1;2;18388;0.00010876658690450294
82986;看简介耶，关注我我们就是朋友了doge;1;1;2;18388;0.00010876658690450294
82991;求网址;3;1;4;18388;0.00021753317380900588
82996;主播你搜索的网址能私发给我吗？;1;0;1;18388;5.438329345225147e-05
82999;这是什么浏览器;1;0;1;18388;5.438329345225147e-05
83002;吾有一友脱单doge;3;0;3;18388;0.0001631498803567544
83007;但是没有3d写真;1;0;1;18388;5.438329345225147e-05
83017;up，这个好像生成不了图了;2;0;2;18388;0.00010876658690450294
83021;upup，iOS手机怎么用分屏模式呀？我搜都搜不到;3;0;3;18388;0.0001631498803567544
83027;为啥我下载的很慢;3;0;3;18388;0.0001631498803567544
83031;up我也要热词系列三连;1;0;1;18388;5.438329345225147e-05
83033;可以生成涩涩图吗;1;0;1;18388;5.438329345225147e-05
83042;up主，这个4chan版本的colab能换上别的模型吗，例如anyting，可以的话能不能出个教程;4;0;4;18388;0.00021753317380900588
83048;真不错;1;0;1;18388;5.438329345225147e-05
83057;请问一下，哪个魔法好用;1;0;1;18388;5.438329345225147e-05
83059;链接打不开是怎么回事辣眼睛;1;0;1;18388;5.438329345225147e-05
83062;UPUP，我用uc海外版魔法进那个链接，就显示一个载入中，等了将近十分钟也没进去，怎么办呢？（已热词系列三连）给心心;3;0;3;18388;0.0001631498803567544
83072;网站打不开是怎么回事;1;0;1;18388;5.438329345225147e-05
83075;想要求网址UP主大大给心心给心心脱单doge打call;2;0;2;18388;0.00010876658690450294
83080;求网站星星眼星星眼星星眼;1;0;1;18388;5.438329345225147e-05
83089;求私信脱单doge脱单doge脱单doge;1;0;1;18388;5.438329345225147e-05
83096;三连了求私信;1;0;1;18388;5.438329345225147e-05
83098;求私信;1;0;1;18388;5.438329345225147e-05
83100;跪求网站脱单doge;2;0;2;18388;0.00010876658690450294
83103;说起来谷歌这个怎么把后台彻底关上呢很多时候限额用的很快;2;0;2;18388;0.00010876658690450294
83107;求私;2;0;2;18388;0.00010876658690450294
83111;三连求私;1;0;1;18388;5.438329345225147e-05
83113;up，连接忙碌怎么回事？;1;0;1;18388;5.438329345225147e-05
83116;up俺也要，已投币;1;0;1;18388;5.438329345225147e-05
83121;三连求私;1;0;1;18388;5.438329345225147e-05
83124;求;1;0;1;18388;5.438329345225147e-05
83129;使用量限额了怎么办无语;1;0;1;18388;5.438329345225147e-05
83134;已热词系列三连求网址;1;0;1;18388;5.438329345225147e-05
83137;好人求求了脸红;1;0;1;18388;5.438329345225147e-05
83143;求网址，已热词系列三连脱单doge;1;0;1;18388;5.438329345225147e-05
83145;三连了，求求私信;1;0;1;18388;5.438329345225147e-05
83150;三连求私保卫萝卜哇;1;0;1;18388;5.438329345225147e-05
83152;能不能求个网站;1;0;1;18388;5.438329345225147e-05
83155;求网站;1;0;1;18388;5.438329345225147e-05
83158;是每次都要这样弄吗;2;0;2;18388;0.00010876658690450294
83161;你这用的啥浏览器，我用的是via和火狐，火狐不能切成小窗口;1;0;1;18388;5.438329345225147e-05
83163;naifu有没有那种根据一张图来画的那种功能？这个功能在哪找？比如给你一张cod普莱斯的图，生成个娘化的普莱斯;9;0;9;18388;0.0004894496410702633
83175;第四个怎么使用;6;0;6;18388;0.0003262997607135088
83183;up求私发;1;0;1;18388;5.438329345225147e-05
83187;热词系列三连求求;1;0;1;18388;5.438329345225147e-05
83191;热词系列三连求脱单doge;1;0;1;18388;5.438329345225147e-05
83194;这个好像不能用了;3;0;3;18388;0.0001631498803567544
83201;想要，谢谢;2;0;2;18388;0.00010876658690450294
83204;up为什么我弄好了之后我ai画了俩次就不能画了;6;0;6;18388;0.0003262997607135088
83213;怎么启动模型那加载半天没有反应了;3;0;3;18388;0.0001631498803567544
83217;求网站脱单doge;1;0;1;18388;5.438329345225147e-05
83219;求;1;0;1;18388;5.438329345225147e-05
83221;求;1;0;1;18388;5.438329345225147e-05
83223;求热词系列三连;1;0;1;18388;5.438329345225147e-05
83225;求码;1;0;1;18388;5.438329345225147e-05
83227;哥，私一下;1;0;1;18388;5.438329345225147e-05
83229;热词系列三连求;1;0;1;18388;5.438329345225147e-05
83235;求脱单doge;1;0;1;18388;5.438329345225147e-05
83238;求一下;1;0;1;18388;5.438329345225147e-05
83240;三连滴捏，请给我一个网址八;1;0;1;18388;5.438329345225147e-05
83242;求求了;1;0;1;18388;5.438329345225147e-05
83244;已热词系列三连求网址;1;0;1;18388;5.438329345225147e-05
83246;求网站害羞;1;0;1;18388;5.438329345225147e-05
83248;为什么生成不出来啊;3;0;3;18388;0.0001631498803567544
83252;三连，求;1;0;1;18388;5.438329345225147e-05
83264;up我也要个热词系列你币有了;1;0;1;18388;5.438329345225147e-05
83266;up已三连，跪求网站;1;0;1;18388;5.438329345225147e-05
83268;三连求链接;1;0;1;18388;5.438329345225147e-05
83270;大佬，我第一步连接就失败了，连接云盘，点允许后就转一会后就红了大哭;1;0;1;18388;5.438329345225147e-05
83273;已三连了;1;0;1;18388;5.438329345225147e-05
83275;up已三连，跪求网站;1;0;1;18388;5.438329345225147e-05
83278;关掉浏览器后再进每次都要重新下吗;1;0;1;18388;5.438329345225147e-05
83280;大佬求网址;1;0;1;18388;5.438329345225147e-05
83284;已三热词系列三连求私;1;0;1;18388;5.438329345225147e-05
83287;网址打不开;3;0;3;18388;0.0001631498803567544
83291;关注了，求私脱单doge;1;0;1;18388;5.438329345225147e-05
83294;求;1;0;1;18388;5.438329345225147e-05
83296;还要谷歌账号无语;1;0;1;18388;5.438329345225147e-05
83298;这么好的东西？给我来个doge;1;0;1;18388;5.438329345225147e-05
83302;可以给下嘛up主，挺需要的;2;0;2;18388;0.00010876658690450294
83305;求私;1;0;1;18388;5.438329345225147e-05
83311;求网址;1;0;1;18388;5.438329345225147e-05
83315;第三步要多久啊？我一个午觉一小时过去了还没好;2;0;2;18388;0.00010876658690450294
83318;为啥我的这个生成图片的分辨率不能自定义，虽然有一个自定义的选项，但是改好以后图片生成不了;2;0;2;18388;0.00010876658690450294
83321;封面怎么这么像空和荧脱单doge笑哭;1;0;1;18388;5.438329345225147e-05
83326;Applicationstartupcomplete一直出不来怎么办？;1;0;1;18388;5.438329345225147e-05
83335;能生成出来但是没办法保存图片是什么情况啊保卫萝卜哭哭;1;0;1;18388;5.438329345225147e-05
83342;开了魔法也进不去网站怎么回事;1;0;1;18388;5.438329345225147e-05
83344;我那个连接显示忙碌这么搞？;1;0;1;18388;5.438329345225147e-05
83346;RuntimeErrorPytorchStreamReaderfailedreadingziparchivefailedfindingcentraldirectory，唉，很烦;1;0;1;18388;5.438329345225147e-05
83350;没办法保存图片唔，说是没有权限;1;0;1;18388;5.438329345225147e-05
83361;这个怎么下载啊？;1;0;1;18388;5.438329345225147e-05
83371;求网站;1;0;1;18388;5.438329345225147e-05
83374;那个7G的怎么用啊;1;0;1;18388;5.438329345225147e-05
83381;诶，为啥我发一样的视频，但是都没播放量;1;0;1;18388;5.438329345225147e-05
83384;手机上可以用什么软件？;1;0;1;18388;5.438329345225147e-05
83387;问一下手机有没有喂图片给ai加工的那种网站啊脱单doge;2;0;2;18388;0.00010876658690450294
83391;每次退出都要花十几分钟部署吗doge;1;0;1;18388;5.438329345225147e-05
83394;up，代码完成之后的链接打不开怎么办怪我咯;2;0;2;18388;0.00010876658690450294
83400;求网站;1;0;1;18388;5.438329345225147e-05
83412;大佬这个图片怎么保存;1;0;1;18388;5.438329345225147e-05
83425;我的一直都在显示忙碌;1;0;1;18388;5.438329345225147e-05
83447;谷歌阻止了我的道路;1;0;1;18388;5.438329345225147e-05
83452;有没有那种tag嗯对;1;0;1;18388;5.438329345225147e-05
83456;玩了三天，突然想约稿了热词系列知识增加;1;0;1;18388;5.438329345225147e-05
83459;加油吧，我记得上一个可以用的已经寄了，希望你能活的比他久，我就不去玩那个东西了;1;0;1;18388;5.438329345225147e-05
83466;右上角显示忙碌怎么办呀up大哭大哭;1;0;1;18388;5.438329345225147e-05
83479;感觉r18画出来的和我想的有点差距阿，是它的图库小了吗微笑;4;0;4;18388;0.00021753317380900588
83486;三连求私发;1;0;1;18388;5.438329345225147e-05
83490;upup这个图片为什么保存不了;2;0;2;18388;0.00010876658690450294
83494;以后分享本子就不是种子了。;1;0;1;18388;5.438329345225147e-05
83503;？他那个启动模型要好久吗;1;0;1;18388;5.438329345225147e-05
83507;为什么画着画着就画不了了委屈委屈;1;0;1;18388;5.438329345225147e-05
83513;求链接热词系列三连;1;0;1;18388;5.438329345225147e-05
83526;都没有推荐手机用webui的吗热词系列知识增加;1;0;1;18388;5.438329345225147e-05
83530;求私;1;0;1;18388;5.438329345225147e-05
83533;谢谢up之前还在想有没有手机能用的现在找到了，谢谢up;1;0;1;18388;5.438329345225147e-05
83535;连一开始的网站都打不开冰糖IO蜕变闪耀呃呃金牛座担忧;4;0;4;18388;0.00021753317380900588
83541;用的是谷歌云;1;0;1;18388;5.438329345225147e-05
83552;b部署代码在哪啊;1;0;1;18388;5.438329345225147e-05
83554;termux可以用吗？;1;0;1;18388;5.438329345225147e-05
83561;求网站;1;0;1;18388;5.438329345225147e-05
83570;秋月爱莉是吧？;1;0;1;18388;5.438329345225147e-05
83575;up，求一手嘟嘟;1;0;1;18388;5.438329345225147e-05
83578;己三连求链接;1;0;1;18388;5.438329345225147e-05
83581;之前那个寄了，好想再玩啊啊啊啊啊啊大哭;1;0;1;18388;5.438329345225147e-05
83590;一键三连了;1;0;1;18388;5.438329345225147e-05
83598;我也想要;1;0;1;18388;5.438329345225147e-05
83600;大佬谷歌账号登陆过程中报格式错误该怎么解决啊脱单doge;2;0;2;18388;0.00010876658690450294
83606;已热词系列三连求;1;0;1;18388;5.438329345225147e-05
83612;三连已给，跪求网址脱单doge;1;0;1;18388;5.438329345225147e-05
83614;求私;1;0;1;18388;5.438329345225147e-05
83633;这种ai参数都是怎么获取的，怎么知道这个参数是我需要的，好奇;1;0;1;18388;5.438329345225147e-05
83669;求关键词网站;1;0;1;18388;5.438329345225147e-05
83677;已三连，求链接;1;0;1;18388;5.438329345225147e-05
83679;存不了图咋办只能截图？;1;0;1;18388;5.438329345225147e-05
83694;已热词系列三连，求私;1;0;1;18388;5.438329345225147e-05
83698;如果我跑一个图下来临摹到底算ai画的还是我画的啊;1;0;1;18388;5.438329345225147e-05
83700;doge;1;0;1;18388;5.438329345225147e-05
83703;已三求私;1;0;1;18388;5.438329345225147e-05
83711;已热词系列三连，求私;1;0;1;18388;5.438329345225147e-05
83715;求;1;0;1;18388;5.438329345225147e-05
83717;已三连，求链接星星眼;1;0;1;18388;5.438329345225147e-05
83720;已三，求私;1;0;1;18388;5.438329345225147e-05
83722;up好强热词系列三连;1;0;1;18388;5.438329345225147e-05
83726;浏览器给我说不存在笑哭;6;0;6;18388;0.0003262997607135088
83733;已三连，求私;1;0;1;18388;5.438329345225147e-05
83736;我真傻麻烦你，请您再发一遍。我手欠，把那个删了，谢谢。;1;0;1;18388;5.438329345225147e-05
83739;一直收藏从未动手脱单doge;1;0;1;18388;5.438329345225147e-05
83741;我也需要谢谢。;2;0;2;18388;0.00010876658690450294
83744;这个是每一次关闭都要重新下载吗？;1;0;1;18388;5.438329345225147e-05
83750;为什么显示网站不能提供安全链接？;7;0;7;18388;0.0003806830541657603
83766;已三连，蹲一下链接;1;0;1;18388;5.438329345225147e-05
83770;金发双马尾过膝嗑瓜子;1;0;1;18388;5.438329345225147e-05
83782;有个webui版本的代码可以把模型下到自己的云盘，其实就是cd切换下目录，就不用每次下载了;1;0;1;18388;5.438329345225147e-05
83785;有人会那种分屏吗？;9;0;9;18388;0.0004894496410702633
83795;求;1;0;1;18388;5.438329345225147e-05
83798;已三连求私脱单doge;1;0;1;18388;5.438329345225147e-05
83802;求网址热词系列三连;1;0;1;18388;5.438329345225147e-05
83812;大佬球球啦;1;0;1;18388;5.438329345225147e-05
83824;我要，已三连;1;0;1;18388;5.438329345225147e-05
83826;所以他下载的是源文件50的包咯笑哭;2;0;2;18388;0.00010876658690450294
83839;哥求;1;0;1;18388;5.438329345225147e-05
83851;求网址;1;0;1;18388;5.438329345225147e-05
83870;脱单doge求;1;0;1;18388;5.438329345225147e-05
83878;求网址;2;0;2;18388;0.00010876658690450294
83883;大佬来个网站，谢谢，顺便问一下图片保存到了哪里;1;0;1;18388;5.438329345225147e-05
83887;已热词系列三连，求网址，大佬;1;0;1;18388;5.438329345225147e-05
83889;111需要1;1;0;1;18388;5.438329345225147e-05
83896;求网址脱单doge;1;0;1;18388;5.438329345225147e-05
83908;求网，热词系列三连;1;0;1;18388;5.438329345225147e-05
83941;求私;1;0;1;18388;5.438329345225147e-05
83975;三连求网址;1;0;1;18388;5.438329345225147e-05
83983;三连了求私;1;0;1;18388;5.438329345225147e-05
83990;upup，求个链接;1;0;1;18388;5.438329345225147e-05
83996;求网址;1;0;1;18388;5.438329345225147e-05
83998;崩坏3路过;1;0;1;18388;5.438329345225147e-05
84003;求网址;1;0;1;18388;5.438329345225147e-05
84005;不知道我的平板能不能这种分屏;4;0;4;18388;0.00021753317380900588
84010;求;1;0;1;18388;5.438329345225147e-05
84013;求网址;1;0;1;18388;5.438329345225147e-05
84017;三连求链接;1;0;1;18388;5.438329345225147e-05
84027;求网址热词系列三连;1;0;1;18388;5.438329345225147e-05
84032;已关已三连;1;0;1;18388;5.438329345225147e-05
84042;已3连求私;1;0;1;18388;5.438329345225147e-05
84049;啊，这个还是有一点点小麻烦的，嗯，虚拟机有时候运存直接爆了。有时候网络一不稳定，代码就自动停止了运行。毕竟这个代码如果运行不起来，那整个网站都没法用。;2;0;2;18388;0.00010876658690450294
84054;三连了求脱单doge;1;0;1;18388;5.438329345225147e-05
84081;好耶;1;0;1;18388;5.438329345225147e-05
84084;求私;1;0;1;18388;5.438329345225147e-05
84086;求脱单doge;1;0;1;18388;5.438329345225147e-05
84096;求脱单doge;1;0;1;18388;5.438329345225147e-05
84100;我有一个朋友（）;1;0;1;18388;5.438329345225147e-05
84104;求网址;1;0;1;18388;5.438329345225147e-05
84118;谢谢大佬，我成了doge;1;0;1;18388;5.438329345225147e-05
84120;假的，试了一整天一直在转圈圈;1;0;1;18388;5.438329345225147e-05
84122;求网址，已热词系列三连;1;0;1;18388;5.438329345225147e-05
84124;三连关注求网址;1;0;1;18388;5.438329345225147e-05
84126;已三连;1;0;1;18388;5.438329345225147e-05
84128;三懂？滑稽;1;0;1;18388;5.438329345225147e-05
84130;三连了，求网址;1;0;1;18388;5.438329345225147e-05
84132;gkdgkdtv斜眼笑;1;0;1;18388;5.438329345225147e-05
84134;已三连球网址吃瓜;1;0;1;18388;5.438329345225147e-05
84136;求网址;1;0;1;18388;5.438329345225147e-05
84138;大佬地址来一个;1;0;1;18388;5.438329345225147e-05
84140;已热词系列三连;1;0;1;18388;5.438329345225147e-05
84142;已热词系列三连求网址;1;0;1;18388;5.438329345225147e-05
84144;求网址;1;0;1;18388;5.438329345225147e-05
84146;已三连，求;1;0;1;18388;5.438329345225147e-05
84148;已三连求网址;1;0;1;18388;5.438329345225147e-05
84150;求网址脱单doge;2;0;2;18388;0.00010876658690450294
84153;三连了，求网站;1;0;1;18388;5.438329345225147e-05
84155;求网址;1;0;1;18388;5.438329345225147e-05
84157;脱单doge脱单doge脱单doge可以拥有;1;0;1;18388;5.438329345225147e-05
84159;求;1;0;1;18388;5.438329345225147e-05
84161;以三连求网址喜欢;1;0;1;18388;5.438329345225147e-05
84163;求网址呀我有一个朋友需要;2;0;2;18388;0.00010876658690450294
84166;已三连求网址脱单doge;1;0;1;18388;5.438329345225147e-05
84168;呜呜想要;1;0;1;18388;5.438329345225147e-05
84170;求;1;0;1;18388;5.438329345225147e-05
84172;已投币求网址脱单doge;1;0;1;18388;5.438329345225147e-05
84174;来一份;1;0;1;18388;5.438329345225147e-05
84176;我有一个朋友;1;0;1;18388;5.438329345225147e-05
84178;已热词系列三连求网址脱单doge;1;0;1;18388;5.438329345225147e-05
84180;求网址;1;0;1;18388;5.438329345225147e-05
84182;求网址脱单doge;2;0;2;18388;0.00010876658690450294
84185;求网址星星眼星星眼星星眼已三连;1;0;1;18388;5.438329345225147e-05
84187;已三连嗑瓜子;1;0;1;18388;5.438329345225147e-05
84202;求网址;1;0;1;18388;5.438329345225147e-05
84213;求网址呀我有一个朋友需要;2;0;2;18388;0.00010876658690450294
84221;求网址脱单doge;1;0;1;18388;5.438329345225147e-05
84223;求网址;1;0;1;18388;5.438329345225147e-05
84225;求网址啊星星眼;1;0;1;18388;5.438329345225147e-05
84227;求网址;1;0;1;18388;5.438329345225147e-05
84229;求网址;1;0;1;18388;5.438329345225147e-05
84231;已三连，求个网址脱单doge;1;0;1;18388;5.438329345225147e-05
84233;求网址;1;0;1;18388;5.438329345225147e-05
84235;三连关注了脱单doge;1;0;1;18388;5.438329345225147e-05
84237;求网址;1;0;1;18388;5.438329345225147e-05
84239;求网址脱单doge;1;0;1;18388;5.438329345225147e-05
84241;我们已经是朋友了所以脱单doge;2;0;2;18388;0.00010876658690450294
84244;求网址;1;0;1;18388;5.438329345225147e-05
84246;这不那个up发群里的网址？;1;0;1;18388;5.438329345225147e-05
84248;求网址;1;0;1;18388;5.438329345225147e-05
84250;求网址热词系列三连;1;0;1;18388;5.438329345225147e-05
84252;这是个人部署云端的吧吃瓜;1;0;1;18388;5.438329345225147e-05
84254;求网址;1;0;1;18388;5.438329345225147e-05
84256;已三连，求私星星眼;1;0;1;18388;5.438329345225147e-05
84258;求网址;1;0;1;18388;5.438329345225147e-05
84260;求网址;1;0;1;18388;5.438329345225147e-05
84262;求网址打calldoge;1;0;1;18388;5.438329345225147e-05
84264;求网址doge;1;0;1;18388;5.438329345225147e-05
84266;一键三连换个网址不过分吧脱单doge;1;0;1;18388;5.438329345225147e-05
84268;求神秘字母保卫萝卜哇;1;0;1;18388;5.438329345225147e-05
84270;已三连关注，求网站脱单doge;1;0;1;18388;5.438329345225147e-05
84272;求网址脱单doge;1;0;1;18388;5.438329345225147e-05
84274;求;1;0;1;18388;5.438329345225147e-05
84276;求网站;1;0;1;18388;5.438329345225147e-05
84278;求网址脱单doge;2;0;2;18388;0.00010876658690450294
84281;已三连，求网址;1;0;1;18388;5.438329345225147e-05
84283;求网址;1;0;1;18388;5.438329345225147e-05
84285;求网址呲牙;1;0;1;18388;5.438329345225147e-05
84287;求;1;0;1;18388;5.438329345225147e-05
84289;三连关注了，求求星星眼;1;0;1;18388;5.438329345225147e-05
84291;求网址保佑;1;0;1;18388;5.438329345225147e-05
84293;求;1;0;1;18388;5.438329345225147e-05
84295;求网址脱单doge;1;0;1;18388;5.438329345225147e-05
84297;试过，每次开都要运行一次代码，模型啥的不如电脑那种魔导师的效果，可以用吃瓜;1;0;1;18388;5.438329345225147e-05
84299;求网址;1;0;1;18388;5.438329345225147e-05
84301;求网址;1;0;1;18388;5.438329345225147e-05
84303;求网址;2;0;2;18388;0.00010876658690450294
84306;关注了;1;0;1;18388;5.438329345225147e-05
84308;求网址脱单doge;1;0;1;18388;5.438329345225147e-05
84310;求网址www，已三连了;1;0;1;18388;5.438329345225147e-05
84312;求网址;1;0;1;18388;5.438329345225147e-05
84314;求网址;1;0;1;18388;5.438329345225147e-05
84316;求网址;1;0;1;18388;5.438329345225147e-05
84318;求网址脱单doge;1;0;1;18388;5.438329345225147e-05
84320;求网址脱单doge;2;0;2;18388;0.00010876658690450294
84323;求网址;1;0;1;18388;5.438329345225147e-05
84325;求个网址脱单doge脱单doge脱单doge;1;0;1;18388;5.438329345225147e-05
84327;截了几张图;2;30;32;18388;0.001740265390472047
84330;我搜了一下，竟然没看到一个AI画的绫热词系列知识增加;4;13;17;18388;0.000924515988688275
84335;感觉大部分是喂的t爹的图？（指眼睛有那感觉）真好看啊;2;13;15;18388;0.000815749401783772
84338;都挺不错的，可惜都是脚和手的问题笑哭;1;10;11;18388;0.0005982162279747662
84342;AI画的是真的离谱，在水中应该看不到水才对，而且这个手真的是一言难尽洛天依9th资词;1;5;6;18388;0.0003262997607135088
84345;不知道为什么看多了会腻;5;5;10;18388;0.0005438329345225147
84365;怎么做到全部都是同一张脸的;1;2;3;18388;0.0001631498803567544
84405;我感觉al画的和课本内涵不太相符思考;6;1552;1558;18388;0.08472917119860779
84412;看来要在我的课本上面多写点字了doge;11;842;853;18388;0.0463889493147705
84424;励志走过所有ai绘画视频祝大家学会使用ai绘画之后都能将自己心中的想法通过画面表达出来打call，但记住不要拿着ai绘画去嘲讽或否定那些真正付出过时间、金钱、精力和热爱，努力追逐梦想的画师们欧OK（如对本视频有不好的影响将立刻删除）;2;246;248;18388;0.013487056776158364
84430;历史课代表狂喜（话说我们学校美女老师真滴多，我历史老师就是其中之一，所以我文科不得不好脱单doge）;2;75;77;18388;0.004187513595823363
84434;姑姨早茶;1;2;3;18388;0.0001631498803567544
84437;离谱;3;54;57;18388;0.003099847726778334
84441;啊楶永遠燃燒的雪哦谢;1;1;2;18388;0.00010876658690450294
84451;求历史原图捏星星眼;4;6;10;18388;0.0005438329345225147
84457;幻书启世录，又让我想起了这款书籍拟人游戏保卫萝卜哭哭保卫萝卜哭哭保卫萝卜哭哭;1;9;10;18388;0.0005438329345225147
84479;唉，终究还是换课本了呀（来自老高考最后一届的叹息）热;1;6;7;18388;0.0003806830541657603
84484;是不是发评论就会被up赞啊？;1;4;5;18388;0.00027191646726125733
84488;证盟今日守心人，今日守心何所真，不失凡身得道身喜极而泣感觉图片和原本毫无关系;1;2;3;18388;0.0001631498803567544
84493;请问这个是什么软件呀;1;2;3;18388;0.0001631498803567544
84500;只有两三张的透视是正常的;1;2;3;18388;0.0001631498803567544
84511;up求新链接doge;2;1;3;18388;0.0001631498803567544
84592;为什么我们的地理书是中国地图出版社的思考;1;1;2;18388;0.00010876658690450294
84605;在？历史的图私发一下？doge;1;1;2;18388;0.00010876658690450294
84615;这一看就是没加约束咒术的嗑瓜子;2;1;3;18388;0.0001631498803567544
84640;。。。。。。。有点浪费这12小时。。。应该先跑个简单的，再用12小时跑更高分辨率;1;90;91;18388;0.0049488797041548835
84644;和up的XP相同星星眼;1;16;17;18388;0.000924515988688275
84647;这是内存，不是显存。不是一个东西。;3;49;52;18388;0.0028279312595170763
84651;神tm显存这不内存么;11;21;32;18388;0.001740265390472047
84668;租cpu是不是有点蠢了，那么多租gpu的那么便宜;1;0;1;18388;5.438329345225147e-05
84675;3060的12g显存跑1080p的图都会直接黑掉笑哭;1;6;7;18388;0.0003806830541657603
84677;好奇多卡显存能不能叠加，能的话我弄个矿板跑ai;1;1;2;18388;0.00010876658690450294
84683;第一次见拿CPU单跑AI的辣眼睛;2;0;2;18388;0.00010876658690450294
84690;说实话没那么行。我还期望着可以弄出细节非常复杂的图;5;4;9;18388;0.0004894496410702633
84700;太强了，电脑哪里去领酸了;1;6;7;18388;0.0003806830541657603
84702;你用核显跑？;3;9;12;18388;0.0006525995214270176
84707;太强了，所以图哪里领打call;6;4;10;18388;0.0005438329345225147
84715;12个小时跑出来这种质量的图，搁这搁这？？？;3;1;4;18388;0.00021753317380900588
84721;首先要会跑，再是设备;1;0;1;18388;5.438329345225147e-05
84724;本地部署表示跑个20481280一分钟多点;3;0;3;18388;0.0001631498803567544
84728;已三连，想问下up用的是那个模型啊;2;0;2;18388;0.00010876658690450294
84732;这就是现在ai应用的问题，算力只是快慢的问题，但显存大小就是能不能跑的问题，买不起大显存的计算卡就用cpu堆时间也是一种思路;2;0;2;18388;0.00010876658690450294
84736;少看这些，不然找不到老婆的;1;15;16;18388;0.0008701326952360235
84746;没图包只能给个赞;1;0;1;18388;5.438329345225147e-05
84751;图包呢;2;0;2;18388;0.00010876658690450294
84754;图包呢;1;0;1;18388;5.438329345225147e-05
84759;有图包吗，求星星眼;1;0;1;18388;5.438329345225147e-05
84764;好视频，下次换个配音模型吧，这个小帅实在受不了灵魂出窍;2;21;23;18388;0.0012508157494017839
84767;都重装过了，yaml路径也是对的，color预处理预览正常，产图完全无关。求助;7;2;9;18388;0.0004894496410702633
84776;总感觉这个AI配音在念controlnet的时候突然激动;2;14;16;18388;0.0008701326952360235
84780;前两天安装controlnet结果安出一堆bug的记忆又开始攻击我了无语;6;7;13;18388;0.0007069828148792691
84787;使用styleadapter做风格的时候，自动下载了一个clipvision，171G的文件想问下是我哪里搞的不对，忘记下载重要参数了吗;2;2;4;18388;0.00021753317380900588
84791;style按着你的设置图没有变化啊没有应用上啊。。。。color是正常的;7;2;9;18388;0.0004894496410702633
84799;不知道为啥，用adapter，图片输出尺寸必须是8的倍数，否则就报错;3;3;6;18388;0.0003262997607135088
84805;按照教程试了，我的color试了完全无效果呀，没有该有的效果。。。图片尺寸是512512，请问怎么回事哎;1;1;2;18388;0.00010876658690450294
84807;处理器里没有color选项啊;6;1;7;18388;0.0003806830541657603
84828;style一用就报错，麻了。;4;0;4;18388;0.00021753317380900588
84840;不能gitpull更新吗？;1;0;1;18388;5.438329345225147e-05
84849;up介绍的这些功能都太实用星星眼有个小问题想问您，使用一些控制面部特征的lora，在特写和近景表现很好，但在中景别经常失控，请问是我lora训练的问题吗？想问up应该怎么解决啊脱单doge;2;0;2;18388;0.00010876658690450294
84855;Tag里面的斜杠是什么意思啊星星眼;1;0;1;18388;5.438329345225147e-05
84857;风格算法提示我：StyleAdapterandcfgguessmodemaynotworksduetononbatchcondinference该怎么解决？;2;0;2;18388;0.00010876658690450294
84863;042确实让我惊讶了一会;1;10;11;18388;0.0005982162279747662
84865;我今天看到一个另Up用Ai话怪物娘，挺不错的，求求Up出一期，求求了星星眼;3;6;9;18388;0.0004894496410702633
84869;这要什么显卡;1;0;1;18388;5.438329345225147e-05
84872;网盘里不能下载全图是咋回事;2;0;2;18388;0.00010876658690450294
84877;第一张惊艳到我了;1;0;1;18388;5.438329345225147e-05
84879;换显卡了吗？;1;0;1;18388;5.438329345225147e-05
84881;我就想知道如何让她走出屏幕吃瓜;1;0;1;18388;5.438329345225147e-05
84883;很棒诶;1;0;1;18388;5.438329345225147e-05
84885;继续加油;1;0;1;18388;5.438329345225147e-05
84887;三连奉上，可以分享一下这类华美室内装潢的tag吗？星星眼;2;0;2;18388;0.00010876658690450294
84890;三连送上，不要骄傲;1;1;2;18388;0.00010876658690450294
84895;聪明人，知道手是弱点，干脆不画手;4;34;38;18388;0.0020665651511855556
84900;祝大家都生这么漂亮的女儿啊doge;5;28;33;18388;0.0017946486839242985
84906;拒绝幼态审美，从你他做起doge;3;25;28;18388;0.0015227322166630412
84910;图包来咯链接：httpspanbaiducoms14PGIFzd3PAnopcI82Q5vagpwddz91提取码：dz91点赞三连支持一下给心心给心心给心心;13;24;37;18388;0.002012181857733304
84924;我国有一套完整的doge;10;16;26;18388;0.0014139656297585382
84935;tv馋;8;15;23;18388;0.0012508157494017839
84944;拒绝不了幼态审美;3;11;14;18388;0.0007613661083315206
84948;头身比列可以调整吗;2;8;10;18388;0.0005438329345225147
84951;三年起步重则无期吃瓜;2;9;11;18388;0.0005982162279747662
84954;很刑doge;4;8;12;18388;0.0006525995214270176
84959;有模型就好了，我直接打印出来;1;1;2;18388;0.00010876658690450294
84961;httpsb23tvvLClbvc为什么我的差那么远笑哭笑哭笑哭;1;2;3;18388;0.0001631498803567544
84963;你也太厉害了吧，多出点图喜欢喜欢喜欢喜欢;1;2;3;18388;0.0001631498803567544
84965;现在的Al这么厉害？;1;1;2;18388;0.00010876658690450294
84967;妙啊多推荐推荐写实风ai;1;2;3;18388;0.0001631498803567544
84969;这几太可爱了吧;1;1;2;18388;0.00010876658690450294
84971;都是双马尾;1;2;3;18388;0.0001631498803567544
84973;拒绝幼态审美doge;1;5;6;18388;0.0003262997607135088
84975;感觉就像真人加了个头;2;4;6;18388;0.0003262997607135088
84978;今天开始我就是老粉了脱单doge;1;3;4;18388;0.00021753317380900588
84980;UP主好人;1;2;3;18388;0.0001631498803567544
84982;好耶星星眼;1;2;3;18388;0.0001631498803567544
84984;求御姐;1;1;2;18388;0.00010876658690450294
84986;看吧，只要我点赞，首页就给我推送嘘声;1;1;2;18388;0.00010876658690450294
84988;抱走全都抱走;1;2;3;18388;0.0001631498803567544
84990;萝莉什么的最棒了;1;5;6;18388;0.0003262997607135088
84992;这用的啥模型啊喜欢喜欢;10;4;14;18388;0.0007613661083315206
85003;蹲个链接打call;1;2;3;18388;0.0001631498803567544
85005;拒绝幼态审美，从我四川做起doge;1;2;3;18388;0.0001631498803567544
85016;怎么没大人？;1;1;2;18388;0.00010876658690450294
85024;如果三次元没化妆这样的天使全国会有几个笑哭;1;1;2;18388;0.00010876658690450294
85027;评论区的基本都可以抓起来了doge;1;2;3;18388;0.0001631498803567544
85029;很明显，我更喜欢成熟的;1;1;2;18388;0.00010876658690450294
85031;大家随便说，扣的分我们山西全包了脱单doge;1;1;2;18388;0.00010876658690450294
85033;女鹅，我女鹅星星眼星星眼星星眼;1;1;2;18388;0.00010876658690450294
85035;哪个模型还有tag交出来星星眼;1;1;2;18388;0.00010876658690450294
85037;什么软件呀，我也想玩这个星星眼求教;4;1;5;18388;0.00027191646726125733
85042;打call;1;1;2;18388;0.00010876658690450294
85045;好;1;1;2;18388;0.00010876658690450294
85047;给个老婆，我想再生一个;1;1;2;18388;0.00010876658690450294
85049;真的是basilmix吗，你怎么用什么方法解决画面糊的问题？;3;1;4;18388;0.00021753317380900588
85057;模型哪来的doge;3;0;3;18388;0.0001631498803567544
85062;软件是什么;1;0;1;18388;5.438329345225147e-05
85066;这个都是免费的ai做的吗？;3;0;3;18388;0.0001631498803567544
85075;好可爱保卫萝卜哇保卫萝卜哇可以问一下这种麻花辫双马尾的tag吗;3;0;3;18388;0.0001631498803567544
85081;这东西一出来多了世界又开始不安定了;1;0;1;18388;5.438329345225147e-05
85083;好可爱啊，有没有那种侧颜的;1;0;1;18388;5.438329345225147e-05
85085;求upup的模型，授人以鱼不如授人以渔;1;0;1;18388;5.438329345225147e-05
85087;所以你怎么不继续出这种了？？惊讶惊讶;1;0;1;18388;5.438329345225147e-05
85092;三条丸子;2;0;2;18388;0.00010876658690450294
85096;你小子指定有点副业吃瓜;1;0;1;18388;5.438329345225147e-05
85098;这头大得吓人;1;0;1;18388;5.438329345225147e-05
85100;阿婆主模型呢，有牢一起坐呀拥抱;1;0;1;18388;5.438329345225147e-05
85102;用什么软件画的;1;0;1;18388;5.438329345225147e-05
85104;把头发去掉，眼睛再大一点，下巴再尖一点，越来越相信外星人就是未来人的说法了;1;0;1;18388;5.438329345225147e-05
85108;可不可以穿凉快点打call;1;0;1;18388;5.438329345225147e-05
85111;融合还是？;2;0;2;18388;0.00010876658690450294
85114;这小萝莉竟然都有A了;1;0;1;18388;5.438329345225147e-05
85118;看多有点吓人;1;0;1;18388;5.438329345225147e-05
85120;软糯香甜，小孩很爱吃，敏感肌也能用，下次一定回购doge;1;104;105;18388;0.005710245812486404
85122;图包在这里链接：httpspanbaiducoms1SnOgovwqZMRZkQq9doJrQpwd7gif提取码：7gif点赞三连支持一下吧脱单doge;4;87;91;18388;0.0049488797041548835
85128;我最后再救你一次：别让欲望击穿你的意志;2;25;27;18388;0.0014683489232107897
85133;三连求图脱单doge;4;10;14;18388;0.0007613661083315206
85145;哪个AI能画得这么好看？;3;1;4;18388;0.00021753317380900588
85150;薄纱那些酸不拉几的三流画师吃瓜;1;1;2;18388;0.00010876658690450294
85152;吃瓜;1;1;2;18388;0.00010876658690450294
85166;可以分享一下tag吗;6;0;6;18388;0.0003262997607135088
85178;求图doge;1;0;1;18388;5.438329345225147e-05
85180;三连求图脱单doge;1;0;1;18388;5.438329345225147e-05
85182;喜欢doge;4;256;260;18388;0.014139656297585382
85187;女朋友很多变啊doge;1;163;164;18388;0.00891886012616924
85189;用的那个ai啊这么好用，我总是生成奇怪漩涡和多手;4;54;58;18388;0.003154231020230585
85197;这些是同一个人吗;2;6;8;18388;0.00043506634761801175
85200;漂亮漂亮，很漂亮;3;6;9;18388;0.0004894496410702633
85204;骗骗兄弟们也就行了，别把自己骗了;1;5;6;18388;0.0003262997607135088
85207;眾所周知，吾有一友一般都是指自己doge;1;5;6;18388;0.0003262997607135088
85216;怎么弄的我也想知道;3;1;4;18388;0.00021753317380900588
85222;怎么弄的呀我也想试试脱单doge脱单doge脱单doge脱单doge;1;1;2;18388;0.00010876658690450294
85241;BGM是什么？;2;0;2;18388;0.00010876658690450294
85246;我还是想当画师，也许我应该更努力了;19;727;746;18388;0.04056993691537959
85266;这次限流更严重了;5;125;130;18388;0.007069828148792691
85272;补充一点视频没有说到，目前评论区也还无人提及的事实：2022年7月，来自美国哥伦比亚大学的工程师团队创造出全球首台无需人类帮助就能从头开始学习自己身体形态的机器人，并根据此构建自身的运动模型，规划运动。我们可以简单理解为，全球首个知己机器人已经问世。科学家认为该研究是机器人塑造自我意识的第一步。相关研究已经发布在近期的《科学机器人》杂志上（对于机器人是否“知己”，由于部分报道拥有selfaware，仍然存在相当争议）。我非常欣赏目前评论区大家各抒己见的气氛，但是如果是一看到我没有骂AI绘画就咒骂我、让我去亖的真的大可不必，就像我在视频简介写的，我不像其他视频一样对AI绘画骂骂咧咧或者轻视，是希望帮大家找到一个更为客观的认知角度，为接下来的职业发展寻求更理性的规划所以我选择沉下心来探寻它十年的发展史、讲述背后的技术原理、甚至对比19世纪的历史经验。为了确保这个视频内容的事实性，我不仅查阅了视频末参考文献的中英论文，也和阿文，也就是国内比较有影响力的AI艺术创作普及推广者（WB：Simon阿文）确认了文案无误。无论是开头AI画作拿一等奖惹怒人类艺术家只是被营销号过度包装的农产品博览会上的一个小比赛，还是结尾AI绘画的版权争议，以及A站艺术家们的联合抵制信我都呈现在视频中了，没有回避。希望各位能看清楚视频再来攻击我，不要随便发动键盘绝招。成为AI绘画一时的反对讥笑者或者支持者或许能给我博得一些流量，但这只会加深观众对它的片面认知，让憎恨AI绘画的人更加憎恨，让想以AI绘画为工具的看不清它的未来。这应该是一期数据很差的视频，但就像一些评论说的，它是有意义有价值的，那就足够了。希望这期视频能对各位有所帮助，我们下期再见。;5;81;86;18388;0.004676963236893626
85278;我觉得艺术绘画和商业绘画应该区分开讨论。艺术绘画更注重于思想甚至是人的表达，而画面只是媒介。而不是像商业绘画一样注重画面的内容。所以AI可以加入艺术，但确实不可能取代艺术。;7;204;211;18388;0.01147487491842506
85286;作为一个画画人想到自己可能被ai取代真的很难受委屈而且感觉现在网上一堆人就是：哎呀你画的这么烂还不如ai呢要你何用真的会谢无语;11;168;179;18388;0.009734609527953013
85298;艺术在于个人化表达，现在的AI绘画是语言和图片模态的融合。很多人所指出的AI画的怪、没有灵魂，内在原因依旧是没有类似PSNRSSIM的量化方式去评估“美”，这样就不容易拟合出美的分布，模型只能建立起词汇的语义与图像之间的关系。;15;126;141;18388;0.007668044376767457
85314;本期没有“就像爱情”doge;3;96;99;18388;0.0053839460517728956
85318;我就一句话，各位担心自己职业的人。如果你的行业能够被AI轻易取代粉碎，那么你这个行业本来就没必要存在。;60;261;321;18388;0.017457037198172723
85379;感觉ai绘画跟v家有点像啊，如果技术够好的话虚拟歌姬也能唱得跟很好甚至跟真人一样，但是仍然有很多人喜欢真正的人声;7;72;79;18388;0.004296280182727866
85387;很多从业者对于AI绘画唱衰，我个人作为外行人不懂其中辛酸，聊一些不成熟的看法。首先，AI绘画很难像摄影那样冲击绘画，这是取决于它的学习特性。它需要不断学习更好的作品来提升自己，而现阶段玩过AI的应该都能发现，AI在细节处理上还是存在部分瑕疵，画面主体精细程度相当不错，背景却谈不上细致，而这些瑕疵往往只能靠人来弥补，所以至少现阶段是没办法取代人类的。最重要的是，它的学习特性决定了它需要时间去处理和学习新的内容，比如今天新出了一个爆款番剧，画师可以用已有的经验直接画出二创，或者完成一手角色创建，但是AI现阶段几乎没办法达到这个水平。其次是AI调教，看起来好像人人都能够做出自己想要的图，但对于主体内容相似的图，更熟练运用关键词的人能够使其更具合理性和美感，而对于关键词的把握是需要一定学习和练习成本的。绘画从业者显然会比无绘画经验的普通人关键词学习成本更低。因此绘画从业者可以用AI绘画作为工具，进行初步图形绘制，之后根据AI出图进行下一步精细化或者重构，能够提升绘画从业者的出图速度。不过肯定也会导致普通人过于依赖AI绘画，基本功都不扎实就扎进绘画行业，这就需要市场进行优胜劣汰了。不过总体来说我个人是持乐观态度看待的。;15;54;69;18388;0.003752447248205351
85403;在人类发挥创造力之前，AI是不知道鸡和篮球结合起来应该是怎样的在AI深度学习了上千万表情包之后，AI创作出来鸡和篮球主题的作品，不知为何总是伴随着背带裤和中分头或许在商业应用中，AI能代替一部分的功能，但是和“创作、创意”一点都不沾边，只是把大多数人思考的结果结合起来而已就像输入“黑子”一词，AI给你输出的是某明星表情包，还是棋盘上的黑子，取决于谁给她看的东西比较多。人类在绝大部分认知内都没达成共识的前提下，AI连很多思维方式都没成型，何谈“创作”如果非要担忧AI取代人类工作，那起码也得是在L5级别自动驾驶之后再说吧，反正都是在混沌中寻找过规律;4;56;60;18388;0.003262997607135088
85408;它无法比肩神明，但它可以取代我十年的努力;2;27;29;18388;0.0015771155101152925
85411;我发现了什么？七个蛋大佬也关注了up;6;41;47;18388;0.0025560147922558192
85418;我感觉ai能不能替代传统绘画要看什么领域，如果是商业插画类，甲方要的不只是一张好看的图，还有背后的服务，源文件或者三视图之类的，这些都是现阶段ai做不了的doge;5;61;66;18388;0.003589297367848597
85424;这期限流好严重;2;21;23;18388;0.0012508157494017839
85427;无所谓，我会一直画;6;66;72;18388;0.003915597128562106
85434;我绘画不用ai用psdoge;1;52;53;18388;0.002882314552969328
85436;我见到的都是害怕ai，撒泼打滚的居多，这里的评论居然出奇的理性？这很互联网。笑哭;6;16;22;18388;0.0011964324559495323
85443;都不告知直接拿别人的东西进行学习拼凑，出来的东西再打上自己的版权，不知道是哪门子的尊重法律微笑微笑微笑微笑微笑再加上最近又有个ai测试准备拿网络上的画师图训练，直接放话说出类似“您要是不想被测试可以在期限前到我们这里告知取消”这类强盗话语，更是对ai绘画没好感（ps：知道工具无罪，杀人不能怪刀，但你这地方要是没有法律制裁拿刀杀人的人，那我觉得这个地方就不该有刀存在）;1;8;9;18388;0.0004894496410702633
85445;我的想法是：人类的绘画技巧、风格会迭代，审美会改变，如果不持续投喂ai，他总会落伍。;14;40;54;18388;0.0029366978464215794
85461;AI绘画本质上不是画而是数字拼接;3;33;36;18388;0.001957798564281053
85465;我觉得其实可以类比相机的发明。相机发明前，西方有写实主义的油画或宗教绘画；相机发明后，画画并没有消亡，而是衍生出了如超现实主义等艺术类型。我觉得ai也很类似，画师的一部分工作被ai取代后，艺术会逐渐演化出新的形式，产生新的艺术类型。;2;8;10;18388;0.0005438329345225147
85469;人类在毁掉属于人类的艺术;8;32;40;18388;0.0021753317380900587
85478;摄像机的出现画家不得不发展抽象派，印象派，还要辅以过度解读和精神控制。现在印象派和抽象派也要被电脑攻陷了。画家为一个出路就是灵魂派了，他们会宣传ai画作没灵魂，画家会赋予画作灵魂;31;37;68;18388;0.0036980639547531
85510;视觉艺术有一项非常珍贵，也是人能实现而ai难以实现的核心价值叙事的戏剧性。如果说视觉上外形的东西都让ai卷完了，那内核就是人值得发掘的价值。;1;6;7;18388;0.0003806830541657603
85512;我觉得AI只会取代低端中端市场，高端与奢侈品市场永远是最贵的人工。现在服装包包家具都走机械批量生产了，但是最贵的高定都是人工手工打磨的。说机械生产的预制菜之后会出现在中低端餐饮业，你去喝早茶，应该很难找到全是现做的没有批发熟冻点心加热给你的酒楼。但是五星级酒店、几千上万一餐的高端餐厅就应该是厨师给你现做的。以前因为颜料贵，画家是贵族出生或者倾家荡产才能培养出来的，平民很难做画家。以后ai来替代中低端了，可能以后人类画家、厨师变回为富豪贵族奢侈品服务的小众行业了吧。就像之前马术之类的在运动领域不是小众的贵族运动吗？;1;25;26;18388;0.0014139656297585382
85517;顶层的艺术是不会被撼动的，ai的表达是无意识的冰冷的，但是大部分普通的画画人大概会逐渐被取代吧;8;6;14;18388;0.0007613661083315206
85526;AI只能模仿，不能创新，如果有一天AI能够创新的话，危机的不但是这个职业，而是整个人类。;2;21;23;18388;0.0012508157494017839
85532;我最不理解的是AI产生的图，发行商居然说归使用者所有，完全就没尊重原画师。。。;1;16;17;18388;0.000924515988688275
85535;AI的技术还无法取代人类吧首先如果说AI画一幅画作，它必须要别人给他一段文字，它没有办法自己思考，没有办法去想象，画画不是只靠技术，画画是要动脑子的而且最近不是很多老师们表示：AI的画作有自己画作的影子，并且这件事情已经被证实了所以AI只是一个服务人类的拼凑怪，至少按照现在的技术，根本不可能取代人类而且机器骨子里本来就是有奴性的，他们为人类服务，需要人类的编程代码和指令才能工作，所以人类是不会被AI取代的，如果有一天真的被取代了，那么这个东西绝对不是AI;2;4;6;18388;0.0003262997607135088
85541;生来什么都不学，就能把画画出来的人屈指可数。绝大部分人画画都有一个模仿别人的过程。其实仔细想想，AI学习绘画的过程也跟人学习绘画的过程差不多，先参考合成别人的，再画自己的。只是说现在AI的水平只能达到合成罢了，至于AI什么时候能达到创新的水平，我暂时还想象不到。;2;17;19;18388;0.0010332825755927778
85547;人类的艺术方式一直都在更新迭代，摄像，电影，游戏等等都是近代才出现。同样的，人类的审美也是在不断得变化，现代不同文明之间的人都有相差很大的审美，就更别说不同时代的人的审美，穿越回古代，你觉得古代人是“乞丐”，他们觉得你是奇行种doge而AI绘画，AI视频如果取代了人，那对于艺术绝对是毁灭性的打击，因为AI一直是在学习参考过去以及现代的艺术家的作品，它可以达到他们的水平，但也框在了他们审美观里面，审美不会得到发展。我这个观点比较绝对笑哭，也许人类会找到新的表达方式也不一定，还是有很多的可能性;1;4;5;18388;0.00027191646726125733
85553;就是一句话，AI是由其他画师的作品喂出来的，这点上我不是很认可;1;5;6;18388;0.0003262997607135088
85555;明显ai不会取代传统，ai只会创造出新的职业，明显给从事艺术工作的人提供了新的发展方向，但继续坚持传统的并不会消失反而会有新的突破。在历史必然的发展面前ai的进步肯定是个好事啊。;1;8;9;18388;0.0004894496410702633
85557;AI编曲已经出现有段时间了，2010年前后就接触过AI编曲出来的作品，但是身边统计学来讲，我从来没有听过任何音乐行业从业者抱怨AI编曲抢了他们的饭碗。;37;5;42;18388;0.0022840983249945617
85598;摄影无法与绘画作比较，AI绘画与绘画是同源，目前喂图涉及到了版权，那么用AI生成的图去喂给AI呢，由人类主观判断进行迭代。最后必然会无限趋近于人类接受范围，最终达到与手绘别无二致，然后再回头看一眼绘画，最需求画的地方是哪里？游戏，动漫，漫画。这些都需要大量的绘画。所以很显然意见，人仍在画画，绘画的巅峰仍然是人类，但需要的人类不用那么多了。以前是100人淘汰10人，现在是100人淘汰90人。很简单，就是的单纯的机器代替人类了，人再吃饭睡觉摸鱼的时候，AI还在学习，与其害怕AI替代人类，不如想着怎么成为那百分之10的人，如果没有自信，建议及时止损。另外，做个比较扎心的假设，如果你觉得手绘很值钱，AI的绘画一文不值，那么请试着通过肉眼分辨这是AI画，还是手绘，还是AI画过人手绘修补，如果无法分辨，那么AI画手绘。（有人千元买瓷，有人千元买玉，有人，千元买图，谁买到真的，谁买到假的了呢？）;4;3;7;18388;0.0003806830541657603
85604;Ai挤压底层生存空间，对于大佬而言没什么影响，反而还能利用Ai作辅助。我群里的大佬在Ai大火之前，早已经联合多名大佬研究学习了;2;3;5;18388;0.00027191646726125733
85608;从al的用户服务协议来说，AI绘画就是，把其他作家的画，拆开再重合。就是一个AI绘画。，个人理解，欢迎补充doge;2;3;5;18388;0.00027191646726125733
85613;Stablediffusion模型的作品，精细程度与二十一世纪的写实艺术家们相当；Novelai的二次元，在绘圈能卖到一百五十元，与绘圈小画家的平均水平差不多；但这些仍不过是传统的数据驱动型ai而已，不可能与人类画师抗衡。基础理论决定一切，开源社区清楚地看到了这一点。而你们，却被回光返照的低级技术蒙住了眼睛。你们躺在营销号的温床中安于享乐，对即将到来的真正威胁人类的技术完全没有精神上的准备。;2;3;5;18388;0.00027191646726125733
85618;AI可能能取胜，但AI无法取代；行业顶尖高手听不懂的甲方刁钻需求，AI同样也不行。;5;8;13;18388;0.0007069828148792691
85624;大家可以下载一个软件：滴墨社区，AI作画，非常精美，我只能说，AI的专业程度，大部分人都是达不到的。在围棋这个智商高地人类都胜不过AI，其他领域又凭什么赢过AI？AI有大数据支撑，能学到人类可能一辈子也学不到的知识储备量，更专业才是常理吧;5;5;10;18388;0.0005438329345225147
85631;自然界一块石头，它本身是死物，没有思想，没有灵魂，不算艺术。不过，一旦有具备高审美水平的人从万千石头里把它们挑出来，放在桌上充当装饰的时候，它们就被赋予了灵魂，瞬间具备了表达思想的艺术性。AI的画也是这样，AI生成的无数张画，本身没有思想，没有表达，只是死物，不算艺术。但具备高审美能力的人把其中一张从万千生成的画作中挑选出来，它就被赋予了灵魂，具备了表达人类思想的艺术性。这就是我对AI绘画艺术性的看法。;3;2;5;18388;0.00027191646726125733
85637;今天刚做过关于这个的阅读，主要是说Al绘画只能依靠现有的数据建模，没资格取代人类，毕竟人是有创新能力的，而Al没有，只是一味地拆分融合罢了。不过Al与人是能互助的，比如大多数人觉得被抢了饭碗，反而能激发创作潜能。创新成果就成了Al的新数据，从而能激发新灵感，就如此反复下去。所以AI绘画不见得是坏的，个人认为利大于弊。;4;2;6;18388;0.0003262997607135088
85645;画家在画作上注入的情感是ai无法取代的;2;2;4;18388;0.00021753317380900588
85649;在一切都可以量化可以计算的未来会不会出现一个由掌握了人类历史上所有人类商业精英的经验和策略，并且不断自我博弈优化的Ai经营的超级公司，将所有人力和资源的效率都发挥到极致。会不会最终成为一个全球最强大的超级企业不过，在技术和社会不断发展的今天，人与人，人与世界的关系也一直在变化。也许在未来公司的概念也会与现在相比发生巨大的变化。科技的进步对人类的影响往往是全方面的。当被取代的不只是工作，人类将会处于什么样的位置呢tv思考;1;2;3;18388;0.0001631498803567544
85651;我认为一万可以取代我的心害羞;1;2;3;18388;0.0001631498803567544
85655;这期，是不是发过了辣眼睛;1;1;2;18388;0.00010876658690450294
85657;ai本来就是在模仿人类作画，人类画风不进步，ai也就只能停留在原地（个人见解）藏狐;2;3;5;18388;0.00027191646726125733
85661;那些说AI不具备感情的，有没有一种可能，AI创造也是人先给他提供情绪方向才能进行创造的，本质上还人为先。;2;1;3;18388;0.0001631498803567544
85665;作为一个画画新人，虽然ai画画铺天盖地，但是前几天我买的数位板刚到货tv目瞪口呆;1;1;2;18388;0.00010876658690450294
85667;ai不仅会取代人工绘画，还会取代很多人的工作岗位，我觉得人类如果想要不被取代，就要把科技发展往人类本身去研究，利用科技使人类本身获得突破，尽管会付出很大的代价;2;1;3;18388;0.0001631498803567544
85671;emmm如果艺术从业者都被取代了，那AI还有什么不能取代的呢，总不可能人类到最后连生活的权利都没有了吧。AI永远是工具，AI绘画就像把调味料直接当饭吃了，正确用法应该是用来辅助画师进行修正与提高效率而不是让艺术变为资本与效率的奴隶。只要不干侵权非法谋利这种恶心事，我认为AI与画师能成为很好的朋友并不断发展下去造福人类;4;1;5;18388;0.00027191646726125733
85678;如果ai可以完美生成视频、图片、声音，那罪证还有可信度吗？;2;1;3;18388;0.0001631498803567544
85683;如果ai能取代画家，那其他各行各业也将被取代，因为ai已经具备了人的基本情感，能以人的思想思考问题，到那时候取代人类也是时间问题;3;1;4;18388;0.00021753317380900588
85704;笑哭笑哭难受的不是ai裁缝那群太太的作品侵犯版权么，还有的人拿ai图去打太太的脸，尤其点名上回雷神同人图事件;1;1;2;18388;0.00010876658690450294
85708;你自己看看AI画的些什么玩意，你再想想这个问题。;3;1;4;18388;0.00021753317380900588
85713;摄影的出现并没有打垮艺术家，却极大的挤压了艺术工作者的生存空间；ai绘画同理;1;1;2;18388;0.00010876658690450294
85719;AI绘画和人类绘画的区别，就是AI绘画和很多人类底层画师的画一样，看不到人的东西在里面;3;1;4;18388;0.00021753317380900588
85730;很多人在说AI只不过是制造，伟大的艺术家是将自己的情感融入进去，叫创造。可实际上反观很多人画画也只不过是制造，甚至没有同期的AI制造的好，而且还要收费，不收费的AI绘画当然就会脱颖而出，在我们这群评论者中又有几个人画画真的叫做创造呢？;3;3;6;18388;0.0003262997607135088
85746;AI创作不就是用无数个素材进行训练的结果吗？其本质上还是模仿，然后进行各种拼接以及加工。他是没有感情的，创作不出具有内核，能够直击人心的作品。;1;0;1;18388;5.438329345225147e-05
85749;每天都在焦虑哪天会不会失业，AI发展太快，要不要考虑转行;1;0;1;18388;5.438329345225147e-05
85753;如同照相机没有消灭写实绘画一般。;3;0;3;18388;0.0001631498803567544
85760;AI取代的是画工而不是画师，画工连拾人牙慧的实力都比不上ai一根，还谈什么艺术啊;2;0;2;18388;0.00010876658690450294
85768;当AI有自我意识，就是硅基生命和碳基生命的PK;1;0;1;18388;5.438329345225147e-05
85772;这将是人脑和电脑之间的一次斗争吗？中间只有一字之隔，便是人与电的问题，人脑在爱因斯坦那里被开发的也只有一部分，那么在接下来的发展当中，人脑会被迫的继续发展，高度发展，也许这是一件值得庆幸的事？;1;0;1;18388;5.438329345225147e-05
85774;窝一个游戏美术从业者真的在年底狠狠的焦虑了几个月，但是后来被旁友骂醒了“依赖工具的人，作品上限就是工具的上限“对于这些AI创作者来说，这些工具只是玩具。况且每次想到美术与策划，程序，各个部门之间的死亡拉扯，我觉得单单一个生成图片的工具并不会取代我的工作;3;0;3;18388;0.0001631498803567544
85784;AI绘画就是文明的进步，让人类的想法和输出更贴近。那些抵制AI的就是文明进步的绊脚石doge;1;0;1;18388;5.438329345225147e-05
85791;唉从翻译会被替代，现在到画画了辣眼睛;2;0;2;18388;0.00010876658690450294
85797;其实AI感觉真的不如人画的，人画的能创造出很多深层含义，就算你AI绘画手会画枪又怎么样，也只是空有其躯壳罢了OK;5;0;5;18388;0.00027191646726125733
85803;ai取代小画师是必然的，并且这才发明不到一年就画的那么好了，而且学的快啊你们临摹一幅图得多久？人家一秒学会，最后只剩有思想的大画师不被影响了肯定;1;0;1;18388;5.438329345225147e-05
85805;ai的一系列智能创作让我联想到了诗云，或许未来它真的能绘画出无与伦比的画作，惊艳世人的文章，ai是被人创造出来的工具，并且确实有能力影响我们，随着时间越来越完善，它进步飞快，模仿在看不出模仿时，是不是可以等同于创造？人工可以被机器取代，人的创作会不会被人工智能取代？我的理解是会取代一部分，但不能完全取代。残酷的说，我们的寿命是有尽头的，但机器之类的是没有的，与其担心未来被替代，不如多开发身为人的独创性，它毕竟是工具，有的是人会用，和无限期限的工具斗迟早是要输的藏狐;1;0;1;18388;5.438329345225147e-05
85815;ai就算了吧脱单doge;1;0;1;18388;5.438329345225147e-05
85820;想问一下，目前我知道的AI绘画是需要用各种词条调教出画的，那那种无法用语言描述的美是不是AI永远画不出？这是否代表AI不能取代人工绘画？（希望如此。）;2;0;2;18388;0.00010876658690450294
85842;很有意义，有价值的一期，可惜限流严重。;1;0;1;18388;5.438329345225147e-05
85851;我觉得ai作画与画师的关系可以参照虚拟歌手和真实的歌手吧;1;0;1;18388;5.438329345225147e-05
85863;结果还是被限流了？;1;0;1;18388;5.438329345225147e-05
85868;视频质量相当高充电了;1;0;1;18388;5.438329345225147e-05
85870;宝子换了头像差点认不出来保卫萝卜哭哭;1;0;1;18388;5.438329345225147e-05
85875;摄影推动了绘画发展，那ai绘画能推动绘画发展吗;5;0;5;18388;0.00027191646726125733
85895;暹罗猫小豆泥遇见泥请你AI首先取代的就是创意工作，最难取代的其实是拧螺丝;1;0;1;18388;5.438329345225147e-05
85909;我超，为啥不能撅啊doge;10;845;855;18388;0.04649771590167501
85920;成功的man：机甲风暴doge;4;479;483;18388;0.026267130737437458
85925;无法确定只因甲里面的是男是女或者他本来就是机器人？所以不确定坤有没有保住？所以现在的状况属于：薛定谔的坤坤;1;46;47;18388;0.0025560147922558192
85928;只因没保住，也不能撅不问天感叹号;1;31;32;18388;0.001740265390472047
85931;可以撅啊，就是有点风险，你怎么知道机甲里面藏着的是男是女呢doge;3;16;19;18388;0.0010332825755927778
85936;依旧没有保住男人的象征;1;7;8;18388;0.00043506634761801175
85938;所以说，还是雌了吗doge;2;7;9;18388;0.0004894496410702633
85942;它至少抱住了它的坤吧doge;1;4;5;18388;0.00027191646726125733
85944;看到标题：又是娘化，不太对我xp看完视频：手当其冲doge;1;3;4;18388;0.00021753317380900588
85946;第一个投币到时候用大号再投一次;1;3;4;18388;0.00021753317380900588
85953;居然没变性;1;2;3;18388;0.0001631498803567544
85960;居然没有变萌妹;1;1;2;18388;0.00010876658690450294
85969;我拿美图画，右手变大腿了，姿势非常的（难视）脱单dogedoge自己想吧;1;0;1;18388;5.438329345225147e-05
85985;失败的man越来越失败了doge;1;0;1;18388;5.438329345225147e-05
86004;httpsb23tvBV1744y1X7AX本人自己开发的永久免费;2;34;36;18388;0.001957798564281053
86007;密码更新啦，群主不定期更新笑哭笑哭;2;23;25;18388;0.0013595823363062867
86010;简单来说，第一个要加群1005104201第二个直接就能进第三个我没看;1;23;24;18388;0.0013051990428540352
86012;第2个网站：无过滤，懂得都懂。;8;21;29;18388;0.0015771155101152925
86021;所以没人问up想打金发巨什么吗doge;2;8;10;18388;0.0005438329345225147
86025;贡献一个httpflagstudiobaaiaccn风格多样，风格选项选择动漫，完全免费;2;6;8;18388;0.00043506634761801175
86030;生成器怎么用dogedoge;5;0;5;18388;0.00027191646726125733
86036;在线等密码，已经三连啦;2;0;2;18388;0.00010876658690450294
86039;密码是啥啊;1;0;1;18388;5.438329345225147e-05
86041;已三连脱单doge，在线等第二个网站密码脱单doge;1;0;1;18388;5.438329345225147e-05
86043;急，有人知道第二个网站怎么改用户名吗，或者注销账号，把名字弄成电话了大哭;4;5;9;18388;0.0004894496410702633
86049;1161187112;4;0;4;18388;0.00021753317380900588
86054;httpsaitagsfun加载的时候有少女祈祷中欸;1;3;4;18388;0.00021753317380900588
86056;怎么涩图都行doge;1;0;1;18388;5.438329345225147e-05
86058;网站我输入了恐怖和一点恐怖一下子吓我一跳（根本不是有点恐怖太吓人了千万别输入）大哭;1;0;1;18388;5.438329345225147e-05
86060;不懂就问，这种是ai根据条件词组完全随机生成的，还是通过关键词进行的素材拼接？如果是后者的话，拿来使用的话会有侵权风险不;2;3;5;18388;0.00027191646726125733
86063;点击按钮无反应是怎么回事啊笑哭;2;0;2;18388;0.00010876658690450294
86066;好家伙，生成的东西给我吓了一跳，惊叹这是什么鬼，连鬼都不是，果然还是不太熟练哪灵魂出窍;2;1;3;18388;0.0001631498803567544
86069;收藏点赞不成正比doge;1;3;4;18388;0.00021753317380900588
86072;保卫萝卜哇保卫萝卜哇保卫萝卜哇;1;1;2;18388;0.00010876658690450294
86074;upup，第一个密码是什么a洛天依;4;1;5;18388;0.00027191646726125733
86079;httpsb23tvBV1Mg41167K6自荐一个国内做stablediffusion在线工具最早的。（从sd放出第二天就开始陆续机器人、小程序的开发了）滑稽;2;4;6;18388;0.0003262997607135088
86082;有无图生图;2;1;3;18388;0.0001631498803567544
86085;居然真的是好东西诶打call打call投币了;1;1;2;18388;0.00010876658690450294
86087;这个网站的AI竟然会画手星星眼星星眼星星眼;1;5;6;18388;0.0003262997607135088
86089;第二个怎么注册啊;3;0;3;18388;0.0001631498803567544
86093;补充一个：httpsdraftartdrawing，当我没说;2;0;2;18388;0.00010876658690450294
86097;密码是什么啊啊啊啊;2;0;2;18388;0.00010876658690450294
86102;佬，求网站;1;0;1;18388;5.438329345225147e-05
86108;在线等密码;4;0;4;18388;0.00021753317380900588
86113;aifun挺好看，nsfw你们知道的脱单doge;1;0;1;18388;5.438329345225147e-05
86116;我手机系统是iPhone，可以弄吗;2;0;2;18388;0.00010876658690450294
86119;跟个怪兽似的，吃的越多越强大;2;26;28;18388;0.0015227322166630412
86122;科技不愧是第一生产力;1;7;8;18388;0.00043506634761801175
86129;这装扮变来变去能不能固定？动作可以不一样;1;0;1;18388;5.438329345225147e-05
86132;这。。比原作更狠啊。。这种艺术还是太超前了;11;6981;6992;18388;0.3802479878181423
86144;硬生生把低分卷变成高分卷小电视笑;27;1797;1824;18388;0.09919512725690668
86172;这是对抽象派画家的降维打击妙啊;4;537;541;18388;0.029421361757668043
86177;这充分说明了一点ai能够化神奇为神奇但不能化腐朽为神奇（当然如果你负面样本喂得够多还可以化腐朽为腐朽）;18;2744;2762;18388;0.15020665651511855
86196;其实我一直很想知道，他们是怎么做到在画室待了快一年还能画成这样的笑哭当时在画室我也确实见过同学画出这样抽象的素描画，我一直没有能理解得过来笑哭我觉得照着原图怎么着也该大差不差的，怎么会画得连人形都没有笑哭可是这话听起来有点怪怪的，我一直都没敢说;111;2405;2516;18388;0.1368283663258647
86308;原版只是生草，ai改完后直接恐怖谷了喜极而泣;7;2004;2011;18388;0.1093648031324777
86316;只要你画的够抽象，你就是ai不能替代的艺术嗑瓜子;15;1253;1268;18388;0.06895801609745486
86332;谁把半圆的刃牙倒进素材库了，直接自由艺术家笑哭;2;509;511;18388;0.027789862954100502
86335;我感觉。ai真的可以拓宽人的创作思路，你看这些恐怖的画，如果用在巨人等黑深残漫画里作为原型，肯定效果很不错，毕竟从0创作是最难的，不然人人都是伊藤润二了。。;5;457;462;18388;0.02512508157494018
86341;感觉可以，改一改可以当恐怖游戏的boss了;3;298;301;18388;0.01636937132912769
86345;第一卷的立眉小对眼儿，没有一个AI表现明白了。有些画虽然愚蠢，但真的有灵魂。;1;215;216;18388;0.011746791385686317
86347;可以很明显的看出ai画的失去了灵魂;12;166;178;18388;0.009680226234500761
86360;我是老实人建议重练ai或者tag里加个铅笔画啊写生啊什么的;1;66;67;18388;0.0036436806613008486
86363;中庸必被代替，唯有极端无法取代，艺术一直都是如此dogedogedoge;1;49;50;18388;0.0027191646726125733
86365;看着精美的ai绘画，多少有点感叹，英国画家约翰康斯布特尔穷其一生所做名作，人工智能几小时几分钟就可以绘出，我不相信这是一种美，或将来的美将来人的看法会变做如此。我觉得ai绘画不应该代替人工绘画，失真;15;66;81;18388;0.004405046769632369
86382;这就像是写生电棍，画成栗子头。用AI修复成说的道理一样。;1;19;20;18388;0.0010876658690450293
86384;我本以为ai动画就是让世界上一切东西都变得能冲起来的神奇事物，原来我错了囧;5;36;41;18388;0.00222971503154231
86391;勇次郎看了都说纯度很高脱单doge;1;5;6;18388;0.0003262997607135088
86394;题目在这，观众老爷们可以自行比较一下dogehttpsb23tvBV1aU4y1T7ws;8;453;461;18388;0.025070698281487926
86403;有的还挺有风格的挺酷;1;6;7;18388;0.0003806830541657603
86405;新视频发布了，观众老爷们可以来看看dogehttpsb23tvBV1RK411Q7tj后面才是高能部分脱单doge;3;124;127;18388;0.006906678268435936
86411;这个ai绘画是不是可以修复老照片思考;2;2;4;18388;0.00021753317380900588
86414;好家伙，属于是给恐怖游戏积累素材了，谢谢你doge;1;2;3;18388;0.0001631498803567544
86416;梵高看了后高呼：既生梵何生AI;1;47;48;18388;0.0026103980857080703
86420;我去刃牙;1;3;4;18388;0.00021753317380900588
86423;这就是硅基生命的艺术吗doge;2;3;5;18388;0.00027191646726125733
86427;AI拯救不了笑死了哈哈哈哈哈哈;1;3;4;18388;0.00021753317380900588
86434;大哭大哭大哭大哭大哭;2;1;3;18388;0.0001631498803567544
86447;一个成熟的ai应该知道直接把分数改成150;1;5;6;18388;0.0003262997607135088
86458;背景视频不是灯泡好几年前做的误解系mad吗？up有没有获得过授权？;2;1;3;18388;0.0001631498803567544
86462;ai就是当代毕加索;1;1;2;18388;0.00010876658690450294
86487;虽然但是有的居然还挺好看辣眼睛完蛋哈哈哈;1;1;2;18388;0.00010876658690450294
86503;随着AI绘画技术的发展，有时候我真的很迷茫。作为一个很喜欢打基础的人，喜欢踏踏实实去画去学的人，自己那么辛苦，那么努力，最后AI就可以一键实现。挚友曾经告诉我，不要在意这些，要学会利用技术，并且不断提高自己。但是我真的很迷茫;1;1;2;18388;0.00010876658690450294
86517;巨人原来是这样画出来的tv冷漠;1;1;2;18388;0.00010876658690450294
86522;我有点感觉害怕，ai绘画似乎开始代替人类作画了，但是ai的进步是需要不断喂图的，但是代替人类作画后就没人创造出新的作品了，岂不是塞源而欲流长也？根不固而求木之长？;2;1;3;18388;0.0001631498803567544
86528;开头那个各种动漫人物在一起是P的嘛？;2;1;3;18388;0.0001631498803567544
86542;只有我觉得左边这是满分作品吗？微笑;1;2;3;18388;0.0001631498803567544
86609;好可爱;1;0;1;18388;5.438329345225147e-05
86617;novelai喂的大部分是二次元，应付不来联考素描脱单doge试了试stablediffusion，效果不怎么样，但是起码不克苏鲁，发动态了;1;0;1;18388;5.438329345225147e-05
86624;好想知道用的是什么软件;1;0;1;18388;5.438329345225147e-05
86632;虽然但是我好喜欢这种啊捂眼捂眼捂眼;1;0;1;18388;5.438329345225147e-05
86643;AI绘图到底是什么啊？有没有人给我这种小白科普下？想跟上时代的步伐。;1;0;1;18388;5.438329345225147e-05
86655;请问BGM是？;1;0;1;18388;5.438329345225147e-05
86692;感觉实力都好强;1;0;1;18388;5.438329345225147e-05
86699;现在学美术的从学生到老师直接学怎么调参喂图吧doge;1;0;1;18388;5.438329345225147e-05
86711;降低自由度加的是什么tag啊;2;0;2;18388;0.00010876658690450294
86789;要是拿这些图去喂AI会发生什么doge;1;1;2;18388;0.00010876658690450294
86792;螺母在拧紧;1;0;1;18388;5.438329345225147e-05
86798;不要再去看一眼会做噩梦;1;0;1;18388;5.438329345225147e-05
86813;其实有那么几张AI作品也还挺好看的，风格不一;1;0;1;18388;5.438329345225147e-05
86817;生物老师真希波艺术啊;1;0;1;18388;5.438329345225147e-05
86852;doge改的很好，能冲，已经在动手了;1;0;1;18388;5.438329345225147e-05
86905;这个ai作画的渠道在哪呢;1;0;1;18388;5.438329345225147e-05
86917;用的是什么tag呀;1;0;1;18388;5.438329345225147e-05
86960;还能打60？30吧？;4;0;4;18388;0.00021753317380900588
86980;捡尸是犯法的吧保卫萝卜哭哭;12;557;569;18388;0.030944093974331087
86993;这是第几个痛失只因的人了？doge;3;194;197;18388;0.01071350881009354
86997;恋尸癖？;2;127;129;18388;0.007015444855340439
87000;虽然很好看，但是做不到对尸体发情热词系列“狼火”;3;96;99;18388;0.0053839460517728956
87004;连尸体的不放过的AI是屑，狠狠地撅五楼原神交给我吧原神交给我吧原神哼哼;3;89;92;18388;0.005003262997607135
87008;原来ai是入俭师doge;1;22;23;18388;0.0012508157494017839
87019;这个梗只是听说过，没见过具体的，谁能告诉我;1;1;2;18388;0.00010876658690450294
87021;强见尸体示犯法的生气;1;9;10;18388;0.0005438329345225147
87025;软件是什么;3;1;4;18388;0.00021753317380900588
87030;都凉了，不能用了;1;11;12;18388;0.0006525995214270176
87042;这是什么软件;3;0;3;18388;0.0001631498803567544
87050;doge;1;0;1;18388;5.438329345225147e-05
87056;wallpaper为什么没有ai绘画图;4;18;22;18388;0.0011964324559495323
87061;软件是什么，能不能也私信我一个doge;23;17;40;18388;0.0021753317380900587
87085;这手指数量怎么有点吓人;3;5;8;18388;0.00043506634761801175
87090;Xstijl我喜欢这种的脱单doge脱单doge脱单doge;1;1;2;18388;0.00010876658690450294
87094;软件是啥啊，求发;1;1;2;18388;0.00010876658690450294
87115;手指太怪了;1;0;1;18388;5.438329345225147e-05
87117;好哦;4;0;4;18388;0.00021753317380900588
87143;这是什么软件画的？;1;0;1;18388;5.438329345225147e-05
87149;嘿嘿嘿;1;0;1;18388;5.438329345225147e-05
87156;用什么软件画的;1;0;1;18388;5.438329345225147e-05
87159;以前迅雷下载特别慢，早就卸载太久了;1;0;1;18388;5.438329345225147e-05
87161;bgm是什么？;1;0;1;18388;5.438329345225147e-05
87164;倒数第二张，是要吓屎人吗？那么多个手指;3;0;3;18388;0.0001631498803567544
87173;一位靓仔点赞路过;1;0;1;18388;5.438329345225147e-05
87176;总结一句，只要是人形生物，AI最后都会给你画成美少女;10;307;317;18388;0.017239504024363715
87187;有几幅图像莫娜，后面有张像胡桃doge;105;405;510;18388;0.02773547966064825
87293;什么，这不是史蒂夫，这是爸爸我生产的压缩x染色体，不用打开，一看就能看见，他不用遇水也可以变答辩糕，不用扯也扯不坏，不用使用也没问题，出差旅行非常方便，什么，这么好哪里买？点击下方大拇指，买五包送五包，还包邮;1;32;33;18388;0.0017946486839242985
87295;总有些喷子到处找事，理论不过还被喷了就直接删动态换身份当个没事的人一样一个月就能碰见五六个;1;30;31;18388;0.0016858820970197955
87297;我想知道AI绘画20次纯黑图片能不能画成人;3;25;28;18388;0.0015227322166630412
87319;史蒂夫痛失坤巴;1;7;8;18388;0.00043506634761801175
87322;感觉还没有原来好看，感觉现在AI只会二次元女生;1;2;3;18388;0.0001631498803567544
87324;方块人的勾勾也是方的吗;2;8;10;18388;0.0005438329345225147
87328;这关键词是不是选了什么不该选的东西doge;1;1;2;18388;0.00010876658690450294
87335;史蒂夫只因小时候发育不良和名字的关系，同学们都以为她是男的。一直到她到了15岁时开始变成美少女了，20岁时越来越美，就这样，她走上了人生巅峰。doge;2;24;26;18388;0.0014139656297585382
87340;这算娘化吗？tv鬼脸;2;7;9;18388;0.0004894496410702633
87344;越来越大了（指身高）;3;1;4;18388;0.00021753317380900588
87352;从一个徒手撸木头的真男人变成了一个妹子doge热词系列知识增加;1;24;25;18388;0.0013595823363062867
87355;AI是懂娘化的doge;2;22;24;18388;0.0013051990428540352
87358;越看越眼熟doge这怎么这么像胡桃堂主，且还有一点点像一个女的拿着把狙击枪打个兔耳朵天线，反正满满科技感;4;5;9;18388;0.0004894496410702633
87366;ai绘画是什么软件，谢谢doge;1;0;1;18388;5.438329345225147e-05
87378;0028这一张有点quan老师的感觉;1;0;1;18388;5.438329345225147e-05
87388;up主用的什么ai绘画软件;1;0;1;18388;5.438329345225147e-05
87397;什么软件啊;2;0;2;18388;0.00010876658690450294
87427;他是男的，为什么AI给他变成她了，这还是事三年前的事，;2;0;2;18388;0.00010876658690450294
87430;开撅;1;0;1;18388;5.438329345225147e-05
87446;ai崛起，画师们面临失业dogedoge如果在德国街头看见激情演讲的艺术生，请立即将其逮捕;16;1790;1806;18388;0.09821622797476615
87463;“陛下，我等恳请此次营救交给我等”doge“不可，此程危机四伏，我亲自去”脱单doge;11;800;811;18388;0.04410485098977594
87475;双手不吊起来或者反绑我不认可，虽然这样很可能过不了审doge;15;803;818;18388;0.0444855340439417
87491;能不露手尽量不露，up是懂ai的doge;1;362;363;18388;0.019741135523167284
87493;这是恶魔天使都是很吓人的。dogedogedogedoge;20;428;448;18388;0.02436371546660866
87514;奶香浓郁，口感细腻，入口即化，回味无穷，隔壁小孩都馋哭了滑稽;4;228;232;18388;0.01261692408092234
87519;她的身边永远有着光，那是驱除了一切黑暗和不安的光辉。只要用眼睛看到她的样子心灵就会得到平静，只要用耳朵听到她脚步的声音身体就会得到安谧，只要触碰到她的光芒灵魂就会得到安息。她不需要翅膀也可以展示出自己的温柔和智慧，因为她就是光，她就是希望，具备一切神性的光辉天使。她双脚所踏之处，便是她的国度，她是天生的皇者，天命加身的主宰。那洁白如玉，纤巧秀美的双足，踩在湖泊上的瞬间，整个湖泊都发出清脆的声音。那洁白的肌肤，有如温润的美玉，没有一点瑕疵，又象清澈的泉水，清新而不沾半点凡尘。她的一举手、一投足，一抬眼、一回眸，已无一处不是美，无一处不动人心魄。;3;63;66;18388;0.003589297367848597
87523;来个天使恶魔贴贴星星眼星星眼;4;100;104;18388;0.005655862519034153
87528;别让欲望击穿你的意志星星眼;6;134;140;18388;0.007613661083315205
87536;没有那种痛苦的表情，和被禁锢了以后饱受折磨的那种姿势。我不认可ai的品味傲娇;1;65;66;18388;0.003589297367848597
87538;天使被困住了动不了，快来帮帮她罢;6;70;76;18388;0.004133130302371111
87545;如果你控制不了你的老二，那它就是老大;1;39;40;18388;0.0021753317380900587
87547;完全没感觉到禁锢，锁链更像是一种装饰;1;34;35;18388;0.0019034152708288013
87549;没感觉，被囚禁的话应该狼狈一点，整点凄美的感觉就好了;2;38;40;18388;0.0021753317380900587
87552;ai锁链算是锁了个寂寞笑哭;4;31;35;18388;0.0019034152708288013
87560;这才是天使;1;9;10;18388;0.0005438329345225147
87562;谁让你偷拍我家地下室的阴险;1;16;17;18388;0.000924515988688275
87567;好家伙，这是拿刀架在审核脖子上了吧审核，如果你被威胁了，你就呼吸;1;13;14;18388;0.0007613661083315206
87570;AI已经能达到这种程度了？;8;13;21;18388;0.0011420491624972808
87579;你这个天使正经吗？哦呼;1;13;14;18388;0.0007613661083315206
87582;我一直觉得，那个地方太大或者大的离谱的话反而有点影响美观;1;5;6;18388;0.0003262997607135088
87584;为什么这个天使的翅膀长在腰上doge;2;2;4;18388;0.00021753317380900588
87587;这才是真正的天使。;3;4;7;18388;0.0003806830541657603
87594;如果是圣经里描述的天使就好了tv色;2;2;4;18388;0.00021753317380900588
87597;大家畅所欲言，分扣我们山西的，，，好吧，其实我是湖北的，又被发现了，，唉，只能告诉你们了，我是河北的。;2;7;9;18388;0.0004894496410702633
87602;等一下天使为什么会被囚禁;2;7;9;18388;0.0004894496410702633
87607;唉，今天又下了一堆画师原图，太赞了，AI小伙儿还是比不了哟跪了;4;2;6;18388;0.0003262997607135088
87612;求bgm，给您点赞投币收藏了歪嘴;1;2;3;18388;0.0001631498803567544
87614;看手就知道是ai还是手绘了笑哭;1;7;8;18388;0.00043506634761801175
87616;为什么我的Ai给她文生图，打几个字，她乱出图doge是不是我没有训练她的原因？doge;1;2;3;18388;0.0001631498803567544
87620;看着有温泉瓜老师的风格;1;6;7;18388;0.0003806830541657603
87629;三连了，求BGM;1;2;3;18388;0.0001631498803567544
87631;Bgm的名字叫什么;3;1;4;18388;0.00021753317380900588
87635;唐三：干得好，下次这样对千仞雪滑稽;1;5;6;18388;0.0003262997607135088
87648;看来大家都喜欢熊大啊dogedoge;1;1;2;18388;0.00010876658690450294
87658;呦西，花姑娘支持;1;1;2;18388;0.00010876658690450294
87667;没有手，只有一只腿，你们ai绘画也就这样吧嗑瓜子没有喂进去的图，不去盗取别人的心血，你们啥也不是哦大笑;6;1;7;18388;0.0003806830541657603
87675;up能不能给一下bgm;2;0;2;18388;0.00010876658690450294
87678;机器工具人识别音乐;1;0;1;18388;5.438329345225147e-05
87754;想被锁起来保卫萝卜哭哭;1;0;1;18388;5.438329345225147e-05
87765;喂的什么图输的什么关键词都给我拿出来（恼）;1;0;1;18388;5.438329345225147e-05
87769;天使掉毛严重doge;1;0;1;18388;5.438329345225147e-05
87771;画个笼子吧doge;1;0;1;18388;5.438329345225147e-05
87774;哈哈哈，我要让她杀了我，然后愧疚一辈子。;1;0;1;18388;5.438329345225147e-05
87789;我想看那些逼真的图片，求图;3;4;7;18388;0.0003806830541657603
87794;up，跑出来的图感觉不是很清晰，但是宽度和高度已经拉很高了，请问还有什么方法能提升画质吗;3;3;6;18388;0.0003262997607135088
87799;up视频里用的模型跟插件哪里可以下啊？好久之前玩的了，当时玩的还是anything30模型tv委屈;1;2;3;18388;0.0001631498803567544
87803;脸咋改，感觉没视频里怎么精致笑哭;1;1;2;18388;0.00010876658690450294
87809;想问问大伙，打开页面以后为什么没有up那种八重神子的lora;1;0;1;18388;5.438329345225147e-05
87811;所以说目前的赛博coser还是以图生图为基础的吗？;1;0;1;18388;5.438329345225147e-05
87816;colab代码httpscolabresearchgooglecomdrive1Ya0NkkjscxlOTlnJeln92GwUh9ggKQt你好呀，是直接点开这个链接依次点击开始就可以了吗？;2;0;2;18388;0.00010876658690450294
87823;950显卡能玩吗？？如果单纯为了玩这个换显卡，是不是闲鱼二手P1048G这种显卡性价比最高？？;1;0;1;18388;5.438329345225147e-05
87826;请问用colab的话是把环境布置在本地还是云端呢？;1;0;1;18388;5.438329345225147e-05
87828;求一个chilloutmixni的模型下载地址;1;0;1;18388;5.438329345225147e-05
87830;我是用colab跑的AI画图，也可以用插件吗？;2;0;2;18388;0.00010876658690450294
87833;那么有没有三次元转二次元的方法;1;0;1;18388;5.438329345225147e-05
87836;A卡用不了吗;1;0;1;18388;5.438329345225147e-05
87838;Up主，请问为什么每次AI出的图都很灰;1;0;1;18388;5.438329345225147e-05
87840;我记得有个网站可以生成“不存在”的人的图像，那是否可以用生成出来的图像做模型，来对二次元进行升维思考思考思考;1;0;1;18388;5.438329345225147e-05
87842;各位大大請問這怎模解ModuleNotFoundErrorNomodulenamedfontroboto但我有放anythingv40prunedfp16ckpt在裡面大哭;1;0;1;18388;5.438329345225147e-05
87844;为什么按照up的tag输入然后再加上lora还是会生成奇奇怪怪的而不是像up的转换前后长得差不多;2;0;2;18388;0.00010876658690450294
87847;终于看到男人啦;2;30;32;18388;0.001740265390472047
87850;lora模型下载：访问civitai搜索GachasplashLORA图包已分享到网盘，部分图片发在了动态：链接：httpspanbaiducoms1LuYVZolLUgmUqejYcVRsApwdgxdz提取码：gxdz正面tag：1boywhitecoat，lightbluecurls，Short，masterpiecebestqualitycleardetailswhitebackground155bottlebottom09midshotfullbodywaterbackground125fullbody13dynamicposeBeautifuldetailedeyescoatraytracingperfectlightingcleardetailsopenclothesDamagedclotheschestmuscles，wet，Richindetailmasterpieceicedecorationicepatternmagicatmospheretyndaleffectbalanceandharmonybetweenallthingsabsurditywaterdropletsplasmaparticleeffectcrystalcleartexturestarskyspacestarryskyblueeyesgalaxysoloshorthaircleavageearthplanetlightinglightdynamicangledepthoffieldlightandshadowreallightandshadowdiffuse;2;21;23;18388;0.0012508157494017839
87854;哈哈哈，我要失业啦;7;6;13;18388;0.0007069828148792691
87862;请问VAE用的哪个呢？;1;0;1;18388;5.438329345225147e-05
87864;我只想看UP分享美丽的图片。;1;5;6;18388;0.0003262997607135088
87866;为什么我生成的图比较灰蒙蒙呢;4;0;4;18388;0.00021753317380900588
87871;这个需要什么电脑软件或是网页直接生成吗？;1;0;1;18388;5.438329345225147e-05
87873;大佬，可以分享一下模型吗TT我的模型不知道为什么全是女孩子，和你一样的TAG，难受;1;0;1;18388;5.438329345225147e-05
87875;求一个angthing45的下载链接，C站没找到;1;0;1;18388;5.438329345225147e-05
87877;请问下up说的光钻lora是哪个呀？去网站上搜不到;2;0;2;18388;0.00010876658690450294
87882;大大请问一下我这个为什么生成不了男人呀，而且负面tag添加女人好家伙直接没有人了，而且色彩异常暗淡;2;0;2;18388;0.00010876658690450294
87885;作者大大，为什么我生成的都是正太呢？;1;0;1;18388;5.438329345225147e-05
87889;已赞，送你上首页;1;1;2;18388;0.00010876658690450294
87892;upup，那个一分四十七秒的帅哥喜欢结合的模型是c站的吗，我搜视频列出来的名字没有找到委屈;2;1;3;18388;0.0001631498803567544
87895;哇，谢谢大大分享星星眼;1;1;2;18388;0.00010876658690450294
87901;开了高解析修复后，出来的图除了脸其他部位都变糊了，up主有遇到过这种情况么酸了，求解脱单doge，是因为我没设好vae还是因为单纯配置不够呢;7;1;8;18388;0.00043506634761801175
87912;大大我始终搞不懂loar和触发词之间的关系。按理来说，我输入tag，然后点击loar加入权重，不就可以让出图向着loar靠近了吗？为什么还要额外加入触发词？;2;1;3;18388;0.0001631498803567544
87915;笑哭up能把模型也发个网盘吗翻不了墙;3;0;3;18388;0.0001631498803567544
87919;大佬光钻是哪个lora呀，c站上搜什么才能找到啊;2;0;2;18388;0.00010876658690450294
87922;大大负面tag有哪些啊，这个能在navelai用嘛;8;0;8;18388;0.00043506634761801175
87931;Up你好，0118的那个选择lora，有权重条且能显示在主界面的插件叫什么呢;2;0;2;18388;0.00010876658690450294
87936;细节刻画真挺六的，用的啥AI工具;4;22;26;18388;0.0014139656297585382
87942;up你相似度调了多少tv笑哭tv笑哭我跑出的基本不能看;1;2;3;18388;0.0001631498803567544
87945;用的是哪个工具啊？;1;1;2;18388;0.00010876658690450294
87950;up你能分享一下，这视频播放率会更高哦。;1;0;1;18388;5.438329345225147e-05
87954;卧槽这是ai画的？牛批;1;0;1;18388;5.438329345225147e-05
87958;UP主加油;1;0;1;18388;5.438329345225147e-05
87960;为什么投不了币啊？;1;1;2;18388;0.00010876658690450294
87964;已赞，送你上首页;1;0;1;18388;5.438329345225147e-05
87968;一位靓仔点赞路过;1;0;1;18388;5.438329345225147e-05
87970;其实AI就是帮助你更简单更快速的找参考素材。。。;124;2303;2427;18388;0.13198825320861432
88095;网上刷了一个帖子一位网友找画手一百块定制了一张自画像结果发现对方是ai合成的压根就没有动笔;41;562;603;18388;0.032793125951707636
88137;把入门的画家掐死了，就没画家升级到大师级的了。当然是掐死了初级艺术家靠卖作品过度到高级的传统渠道了。以后更多的是借鉴ai的作品的作家了。;94;827;921;18388;0.050087013269523604
88232;如果ai创造出的艺术也能和人产生共鸣，那为什么要去担心它呢思考，毕竟连大象的画都有人买，ai作画，我觉得差别不大;31;509;540;18388;0.029366978464215793
88264;都开始争论灵魂了，肯定能替代啊;38;494;532;18388;0.02893191211659778
88303;ai绘画是替代不了传统绘画的，就像照相机没有取代美术一样，ai是帮助人类绘画的工具;99;875;974;18388;0.05296932782249293
88403;现在99的人分辨不出是否是ai作画，一些人还嘴硬，后面ai算法越来越成熟，甲方自己就能搞了，画师没饭吃，以后画画的人基本只有自己兴趣带着了;41;354;395;18388;0.02148140091363933
88445;摄影没有取代绘画，是把绘画挤向了一个更纯粹但更小的空间。可是AI也是在这个空间里，AI将把绘画挤向一个超小的空间，虽然还会有画家能够生存，但是很多很多艺术家将丢掉工作，或许绘画将变得更加纯粹，但是这个进程或许并不是好的;32;212;244;18388;0.013269523602349358
88478;摄影技术对绘画造成的最大伤害，也许就是消灭了画家最好的“白天工作”。历史上，大多数伟大画家靠画肖像谋生。摄影术发明不久，画肖像的工作机会就大大减少，从事摄影的黑客抢走了这些机会。（对于被画的人来说，坐在镜头前也更轻松一些。）肖像画家这种要求高度技巧的工作就这样慢慢消失了。画家为了得到收入，就将肖像技巧用在为商业公司画品牌商品的广告图片上。（可是，这样的工作也是极大地依赖于摄影术，或者更准确地说，极大地依赖于复制在书籍和杂志上的照片。摘自《黑客与画家》我个人是不喜欢ai技术的。我觉得是这样的，画画最早出现是想表达现实的事物，摄影是第一把屠刀，对准了画家；幸好画家们发现了绘画的世界不但有写实，还有想象力的表现，因祸得福，画家们开始在新的世界里开辟天地蓬勃发展。现在ai技术又把屠刀对准了这个世界的画家们。摄影剥夺了画家们的写实工作，ai技术剥夺想象力工作，这样不断剥夺画家的生存空间是几个意思。难道每次都可以柳暗花明找到新的天地吗。;14;168;182;18388;0.009897759408309767
88493;根本不用担心能力，该担心为谁所用，ai可以是资本压榨画师的工具，也可以是画师提升创造作的伙伴，不过现在的ai多是喂图喂出来的，那被喂图者的权益，别吃别人的图超过别人后再把别人踢走，这才是最该担心的热;36;153;189;18388;0.010278442462475527
88530;同一张画的标题：画师作画：哇绘画大佬ai作画：缺乏灵魂把ai作画那几张拿回半年前给不知道ai作画的人看，真的有人分辨的出来吗（别拿失败品杠）;9;82;91;18388;0.0049488797041548835
88540;我觉得与其说普通人用ai表述自己想像的画面，到不如说是普通人看到ai的画然后找一幅贴近自己想像的画，然后说这就是我想像中的画面。但是实际上ai画的内容，与表达跟他想像其实没有什么关系。并且有的人跟风，看到ai画觉得其很美，但美在哪里也说不上来，久而久之影响的其想像中的美也变得和ai画一样，变得没有什么实际意义;15;55;70;18388;0.0038068305416576026
88556;喜欢我抄袭之王版权摧毁者吗歪嘴，小说现在抄袭还能做调色盘，以后就和绘画一样抄都看不出来，快餐吃到饱喜欢;9;52;61;18388;0.0033173809005873395
88566;我拼两张图可以构成抄袭，我拼十张图可能构成抄袭，但我要是拼一百张图那我就不叫抄袭了，这是借鉴，因为人类在作画的过程中也并非完全原创，而是参考了各式各色的元素然后将他们统筹一起变成一副新的作品，老是有人说ai作画侵犯了版权，实际上并没有这种说法。;20;68;88;18388;0.004785729823798129
88587;ai是能不断进步的，不存在什么只淘汰低端画师的说法，毕竟设计本身就是元素重组，而且ai绘画出来之后又会有多少人继续进入绘画领域呢？自己学了一辈子的成果，不如输出的几条指令，这种打击，不是一般人能承受的。彻底淘汰估计还得有段时间，但目前来看也只是时间问题而已，已经看不到前景了。OK;3;41;44;18388;0.0023928649118990647
88591;ai作品无版权。这一点很重要需要强调。平台手册都有写脱单doge欢迎恼羞成怒的同学来抬杠;27;32;59;18388;0.0032086143136828365
88619;其实要想知道AI艺术会不会取代人类艺术家，这个问题并不难，触类旁通地设想。人类进入工业时代后，用于劳动生产的新技术新设备层出不穷，工人被取代了吗？尽管造成过失业，出现过人工生产与机械生产之间的冲突矛盾，但纵观历史，这种冲突只是短期的，工人终归会以另一种形式参与到劳动生产的环节中。从另一方面看，在制造业，比如手表、皮具，奢侈品、甚至是汽车制造，都存在手工制造的价格远比流水线生产的高，这也是人力参与生产的另一个出路。总的来说AI就是个工具，跟铁锹、镰刀本质是一样的，它的出现代表生产力的提升，对于艺术创作也是一样的，手工绘画作品永远会比AI创作的价值高，而一部分艺术家也可以像工地上用铁锹搅拌混凝土的工人升级为拌合楼操作手一样，转为创作电子艺术品。所以技术在革新，人类在进步，一切矛盾都是暂时的。;20;45;65;18388;0.0035349140743963455
88640;希望杜绝模仿的属性，相反，希望人工智能可以给创作带来相应的灵感;14;82;96;18388;0.005220796171416141
88655;说实在，现在才是刚出来，不难想象以后绘画就会变成纯粹的个人爱好，就算你是大师级别的画家，也只可能是给网上加点绘画风格，或者调整ai绘画的方向，我反正无所谓，没有人会真正关心人的死活。不难说未来人的必要性就越来越低，我只希望人能有尊严的活下去。;1;22;23;18388;0.0012508157494017839
88657;以生成对抗网络为基础的模型，其模式崩溃一般的创作所带来的画面是超出想象的。缺乏想象力？缺乏灵魂？只是训练太少，样本有问题，或者模型太简单罢了。但是另一方面，这种程度的AI根本不值得焦虑，就是纯粹的，复杂化的数学计算罢了。;26;65;91;18388;0.0049488797041548835
88684;工具是人类进化的产物，用来替代操作AI也是人类进化的产物，用来替代人类;14;11;25;18388;0.0013595823363062867
88699;al只会取代没有思想的画手和工具人，不会取代真正的画家;21;14;35;18388;0.0019034152708288013
88722;ai绘画看似实际上把绘画门槛降低了。实际上却是把绘画门槛提高了一大截，而且不是一般的高。用我一个长辈曾经讽刺我的话来讲：现在用相机拍的，都比你画的好。;6;43;49;18388;0.002664781379160322
88729;如果不提前告诉你这是ai画的，我敢说那些张嘴说“内核”、“灵魂”的人没有一个能分辨出来;4;46;50;18388;0.0027191646726125733
88734;知道网文工作室吗，这种东西就是开发给这些人用的，经典劣币破坏市场驱除良币;1;8;9;18388;0.0004894496410702633
88736;如果AI可以创作艺术，那么AI就是人类所做的装置艺术;1;8;9;18388;0.0004894496410702633
88738;打游戏，我可不喜欢遇到开脚本的。同样，如果创作不是自己思考的灵感。那我是创作了一幅画，还是帮AI画完了一幅画。;9;57;66;18388;0.003589297367848597
88748;其实很多人只是缺少画画的技能，他们脑中的画面比这些要离奇多了;3;8;11;18388;0.0005982162279747662
88752;如果真想要AI有能够原创艺术作品的能力，那么你得先让ta有自我意识，有自我思想，先让ta成为人，（这波就直接仿生人变人了藏狐）到后面有自我意识和思维的AI，就会慢慢明白，他们可以自我优化，自我进化，各项机能都比人类要强，为什么还要听从人类的命令？然后就是铁人叛乱藏狐阴险;23;74;97;18388;0.0052751794648683925
88776;首先，我们到底在担心什么？你学画画的目的难道是为了表现别人的想法吗？如果是这样，那只能说画画本身就不适合作为“赚钱”的工作，ai画画是很厉害，但你能控制ai表达你所想的每一处细节吗，每个人的经历都是不同的，ai确是一样的，ai永远画不出与你一样的画（哪怕ai的画很好看），只要你融入自己的思考，ai就无法取代你。;15;11;26;18388;0.0014139656297585382
88792;说不好。不过我觉得人类有点高估自己的创造力了。所谓的设计也不过是缝合罢了。我觉得大概率AI会提高缝合效率，快速实现一些大脑洞的效果图，再人为调整。ai替代不现实，但ai辅助可行。;35;38;73;18388;0.003969980422014357
88828;杀鸡取卵，竭泽而渔。这不光会打击创作者的创作激情，甚至缩减新事物的诞生，世界上将不会出现第二个梵高。;1;7;8;18388;0.00043506634761801175
88830;不会取代，就是一个工具，帮助更人们便捷的工作脱单doge;1;7;8;18388;0.00043506634761801175
88832;没有必要担忧吧，感觉图像生成跟绘画还是不太一样的，与其称之为ai绘画感觉ai图像生成技术更贴切。艺术来源于生活，如同文学一样，并不是简单技术上的东西。也许未来会有一种风格叫ai风，但人类并不会因为一种风格的出现而不需要其他风格，艺术之美也在于有千千万万种美于风格。至少现在的ai还远远不能具备指向目的性强的商业绘画所需要的能力，只能是为从业者提供一些创意概念的参考。当然等有一天出现西部世界那样能完全丝毫不差的复制人类时，ai具有自我意识的时候确实值得担忧，但相信有生之年应该不太可能;6;28;34;18388;0.00184903197737655
88839;说到底，人不进行适合的字词输入ai也画不出相对有逻辑的画面，你让ai自己乱组合，百分之九十九点九九效果差，只有剩下那一点可能比较惊艳;16;28;44;18388;0.0023928649118990647
88856;以前的画师：你已经是一台成熟的电脑了，应该学会自己画画现在的画师：人类的艺术已经快要被AI超越了人类要完蛋了AI：春b人类真难伺候热;2;17;19;18388;0.0010332825755927778
88859;说穿了就是断人财路杀人父母;7;22;29;18388;0.0015771155101152925
88867;其实悲哀的一点就是，以目前大部分国人的审美来说，AI出的东西质量上来说已经够了，所以老板资也不回去追求那些其他细节，总监和主美也不个个都是伯乐，更多时候都是为了效率和进度来推动项目，所以评论区也不用太过二极管，想好如何利用和提升很好;1;15;16;18388;0.0008701326952360235
88869;总之，如果我喜欢一幅画，我不会在乎它是人画的，还是电脑画的;3;21;24;18388;0.0013051990428540352
88873;解释一下什么是灵魂？人本质不就是一团化学结构复杂的物质吗。ai与人的区别只不过是组成元素不同罢了。灵魂只不过是人类天生的傲慢热;5;37;42;18388;0.0022840983249945617
88880;当AI替代掉大部分人的工作的时候，可能只有动刀子的医生，需要人情的职业，资本家和科学家的存在了。;7;6;13;18388;0.0007069828148792691
88889;无所谓，反正艺术本该不值钱原神喝茶;1;12;13;18388;0.0007069828148792691
88892;不要灵魂了，好看吗？好看就行了;1;7;8;18388;0.00043506634761801175
88894;虽然会有一些不安，但是又不能改变什么。与其关注这些，我还是先关注我眼前要处理的速写作业吧。大哭;11;12;23;18388;0.0012508157494017839
88906;人类和AI本质上都是算法，一个是生物算法，一个是电子算法。前者在大草原上历经几百万年进化成现在这样，而AI的诞生，仅仅只有数十年。AI的神经网络在日夜不息的数据输入中不断进化，终将超过人类在过去几千年主宰世界的算法这是根据AI在过去进化的表现得出来的必然结果。自然，AI会替代人类的大部分工作，但未必会成为世界的主宰。AI是人类强大的工具，我们不应该在即将到来的“智能世界”中丧失我们人类的意志与能力，而是要寻找一种新型的生活方式来适应。至于抵制AI唾弃AI，则大可不必。因为这是历史的潮流，就如同工业革命中旧匠人对革命的抵制，最终也无法阻止新时代的到来。而历史表明，工业革命并没有摧毁世界，而是带来了更好的世界。所以，我们现在应该担忧的，不是AI是否会替代我们，而是，我们以后应当如何适应新世界。;2;11;13;18388;0.0007069828148792691
88909;以前：你是一个成熟的数位板了，应该学会自己画画jpg现在：你砸我饭碗是吧？;2;11;13;18388;0.0007069828148792691
88912;拿着别人的画重新ai生成，绝了;2;14;16;18388;0.0008701326952360235
88917;就像手工劳作的工人升级成操纵机器的工人，无非是省去艺术绘画的学习过程，把想要的题材画面内容描述给ai创作出自己想要表达的东西，乐观地说是画笔的工具升级，悲观地说从零开始学绘画显得低效率;2;5;7;18388;0.0003806830541657603
88920;有没有一种可能AI用于合成的素材还是需要人来画呢doge;8;11;19;18388;0.0010332825755927778
88929;ai要是能取代绘画中的设计类职业到那时候世界上最少百分之五十的岗位都会被机器替换掉吃瓜;2;5;7;18388;0.0003806830541657603
88932;爆莎小画家了;6;14;20;18388;0.0010876658690450293
88939;人类已经没位置了的感觉（草;3;5;8;18388;0.00043506634761801175
88943;义务论和唯结果论的对战又要开始了;3;5;8;18388;0.00043506634761801175
88947;大部分人画画也就是学了个技术，和ai拼素材没有本质区别，被学习效率远胜自己的ai秒杀是必然的。;1;9;10;18388;0.0005438329345225147
88949;而且AI作画会有很多版权问题。。。毕竟都是照抄叠图缝合上去的，你今天创作一个新作品，明天AI就那你的作品跟别人的作品进行缝合叠图“创作”出“新作品”来;20;8;28;18388;0.0015227322166630412
88971;这个东西最好永远是工具，而不是代替;1;4;5;18388;0.00027191646726125733
88975;它不是把画师消灭了，它是逼着画画的人进化，这就是社会的“进步”;10;5;15;18388;0.000815749401783772
88986;很简单。艺术是一种精神生产，精神属于意识。而AI没有意识，无法进行创作，所以无法称为艺术。;3;4;7;18388;0.0003806830541657603
88991;这玩意不就是网上搜图拼一块么辣眼睛;24;4;28;18388;0.0015227322166630412
89016;艺术家都能被代替，普通人是不是就没存在的必要了？可以被人道毁灭了？;5;4;9;18388;0.0004894496410702633
89024;AI短时间到达不了意识博弈范畴，这些东西只不过眼前一亮，无深究的价值，真正的艺术，是对创作者意识的揣摩，如诗词歌赋的抒情、围棋的意识博弈、画师眼中的世界，是一个近乎绝对主观的东西，而现阶段这些只是对人类拙劣的模仿，没有任何深层次意义。;2;2;4;18388;0.00021753317380900588
89030;我不是反对科技的进步，而是觉得这种东西失去了画作这种东西的灵魂，我并不认为AI会取缔人类，我没有这种杞人忧天的情感，我只是觉得AI作画相比于人的来说没有内核。;1;2;3;18388;0.0001631498803567544
89032;Ai可以用于油画水墨画浮世绘等因为现在大部分年轻人因为日本二次元文化入侵，艺术作品画的人越来越少。Ai不会打败人类的艺术，人类自己堕落。;2;2;4;18388;0.00021753317380900588
89039;我看这些画也就这样吧，毫无感觉。;2;2;4;18388;0.00021753317380900588
89045;ai创作小说，剧本，ai绘画生成漫画，生成虚拟演员，生成影视作品热词系列知识增加;10;2;12;18388;0.0006525995214270176
89056;不觉得ai画有多神奇，这都是拿现有的画拼起来的。;4;2;6;18388;0.0003262997607135088
89061;ai离谱在别人分不出是ai;5;2;7;18388;0.0003806830541657603
89068;我觉得自动挡永远取代不了手动挡，自动挡真的一点灵魂都没有，人类都会想要开手动挡;6;3;9;18388;0.0004894496410702633
89090;会吗？？？至少人类目前为止没有办法创造出能取代人类艺术家的AI;2;1;3;18388;0.0001631498803567544
89093;就好比现代特效漫画被旧时代手绘漫画吊打，AI想取代现在艺术家那还得个几百年，何为艺术？艺术表达情感的一种方式，艺术是一种味道，艺术是灵魂，着是机器人做不到的，机器人只能模仿着种味道，着种情感，着种灵魂，你告诉AI你要一幅画他永远只会出现人类早已创造过的无论是风格，还是色彩，而人类却对艺术的理解有无数种表达的方式，着是AI没办法做到的，当AI能做到那一天怕是都有自我意识了;1;1;2;18388;0.00010876658690450294
89095;等你看多了你会发现ai也只擅长这些抽象的画，根本无法实用，短期对美术没有什么冲击;1;1;2;18388;0.00010876658690450294
89100;抄袭嫌疑，什么时候搞个ai写论文啊doge;1;1;2;18388;0.00010876658690450294
89103;发展的实质是事物的前进和上升是新事物的产生和旧事物的灭亡是新事物取代旧事物的过程。;1;1;2;18388;0.00010876658690450294
89108;ai绘图如果真的成熟普及可能会致使数十年的市场美术风格停滞，当需要创作者的时候，时代会做出选择的，社会和人一样，总是要不停的吃瘪才能意识到事情的后果。一个美术的风格是由画师的观察独特的归纳总结出的个人风格，如果ai绘图喂了鸟山明梵高的图片大家是一眼就看得出来的，而今市面上普及的ai二次元或油画厚涂类的作品风格区分的并不明显，喂图而养的程序，终究是有尽头的，因为他的饲料，是人类目前有限的风格库。终有一天，世界会再次需要创作者，在人们对这些风格感到厌烦时。;13;1;14;18388;0.0007613661083315206
89125;技术的发展从来不会取代艺术本身，但会取代极大部分用艺术去牟利的画手，所以以后的艺术会更纯粹，只是为了艺术而艺术，和利润无关;3;2;5;18388;0.00027191646726125733
89130;这样的话那画师就都不要再创作了吧，首先被他吃掉变成数据的画没有得到任何画师的授权，其次它挤压了画师的努力和生存空间你可能不知道画师得多努力才能到现在这样。最后这点最糟糕，画师无论多努力画出来的画都会未经允许注意了是未经允许的被AI瞬间学过去，然后就被商用，这就是妥妥的抄袭。;2;1;3;18388;0.0001631498803567544
89134;书法人应该就懂，人类艺术是很细致的东西，像书法大家，一笔一划里都蕴含故事与历史，这是AI做不到的。;3;1;4;18388;0.00021753317380900588
89140;绘画是为了记录还是为了表达自我？ai绘画表达的也是人的“自我”啊，只不过绘画的工具不是画笔而已。;1;1;2;18388;0.00010876658690450294
89149;现在的ai还不是很成熟，它可以淘汰大部分低端画师，以后ai会越来越发达，至于会不会影响到高端局，只能说有可能，毕竟ai收集足够的数据可能会模仿的以假乱真的地步，但不用但心会影响到传统绘画，因为艺术是有感情有温度的，机器永远是机器。;2;1;3;18388;0.0001631498803567544
89155;aips;1;1;2;18388;0.00010876658690450294
89161;ai没有经历过人生，不会去表达人生百味脱单doge所谓ai艺术家，只是一种玩具罢了;3;2;5;18388;0.00027191646726125733
89165;ai作画是真的带劲，我要是个插图师我都乐疯了;1;2;3;18388;0.0001631498803567544
89174;高级画师是卷不死的，毕竟一个人物从设定到三视图再到和甲方一直扯皮修改，AI倒是在起步方案阶段可以生成大量图片加速灵感获得和甲方沟通成本。倒是一些“小画师”会被卷死，高水平定制画师也是受益者，就像电子翻译卷不死翻译家，扫描模型卷不死建模师一样，反而降低了建模师搭建场景的时间。辣眼睛说资本利用AI的一看就是不了解甲方一般是什么样子，具体可以参考一下半佛老师最新视频，一语中的。;1;1;2;18388;0.00010876658690450294
89176;插画师会像现在的油画家一样贵族化，脱离人民群化;3;1;4;18388;0.00021753317380900588
89180;普通绘画爱好者肯定比不上，但真正的艺术家还是没法取代的;5;1;6;18388;0.0003262997607135088
89188;主要是这玩意，他学习那些图交版权费吗？还是白嫖拿人家的图，后者那就有问题了。这玩意儿超越人类，我觉得暂时不行，毕竟还得有人给他提供素材不是？你要说他精细度是可以，创造力呢？我觉得这玩意儿做不到，看了一部分，我觉得更多的还是需要人对画面和意境进行一些加工。反正我觉得在更长时间内，这个应该被用作找灵感来源。;1;1;2;18388;0.00010876658690450294
89194;ai终将是ai，不会自主学习，不会自主创新，还是由人为跟它灌入各种数据;1;0;1;18388;5.438329345225147e-05
89205;ai会画画，但不懂艺术;3;0;3;18388;0.0001631498803567544
89213;AI都出多少年了？該理解不了的還是理解不了。除非ai有思想，那真到呢時候可不只是畫師失業吧？所以絲毫不慌;2;0;2;18388;0.00010876658690450294
89223;一个有趣的问题，当ai掌控了人们的普遍审美之后，艺术家们要怎样才能体现出自己的个性呢？人们的审美会为了彰显自身的灵魂与个性变得越来越扭曲吗;1;0;1;18388;5.438329345225147e-05
89226;市场的战争就是用更高的性价比去占领更多的市场。被踢出市场的企业和个人数不胜数。既然过不下去又打不过，那失败者就只能转行或者破产。这次无非就是ai进入了一个被认为是开创性行业的市场，然后被大肆宣扬吸引了关注。我的建议就是，转行。和ai卷是绝路。市场被ai大幅缩水的话（需求方自己用），争抢单子只会每个人都吃不饱。当然，用ai的吃了不少。除非联合抵制。不允许使用这个产品。也就是否认这个ai获利的合法性。但是这样一来得到ai的画师，非画师私自使用再手绘改改绝对赚翻了，至少比之前轻松很多。现阶段就是对这个工具进行公开化。拿到手偷偷用相对有利于画师开题，针对设定微调目前还得人类的创造性工作。不过市场缩水没得跑了毕竟需求方可以自己用。结论就是市场缩水，维持收入更难了。每单时间成本，价格都下降。单少，钱也少，花的时间更少。是转行的时间了。;1;0;1;18388;5.438329345225147e-05
89230;一定会取代，而且不光是艺术，所有的都会取代。人的大脑没有那么高大上，就是一堆细胞，当技术发展到一定程度后，造出更强的机器智能是必然的。;1;0;1;18388;5.438329345225147e-05
89234;利大于弊？我不好说;1;0;1;18388;5.438329345225147e-05
89250;很多人绘画的目的，是把自己所见或者所想象的世界画出来，而AI是结合当下过去的想法和信息，但其实真正的画师，画的不是过去，也不是当下，而是未来，我们可以发现AI都是拿已经有的作为参考进行结合，但只要只要是画师都知道自己脑子里有很多的想法，就是画不出来是因为经验不够，真正的成熟画师想什么都能画出来，这个阶段画的就是未来，曾经有一句话说的很好，一味的模仿，永远超越不了，AI智能模仿，如果AI没有自己的想法和套路，永远无法超越，如果说AI我自己的想法，那么AI就是一个设计师，而到那个时候，他也无法跟其他的设计师争抢，因为每一个设计师都有自己的想法。;1;0;1;18388;5.438329345225147e-05
89258;个人认为不会被取代，ai更多的是可以让人去参考，不会被赋予意义。有些画的历史性，已经存在的人物个性，点睛之笔等，甚至是传承，ai都做不到。;1;0;1;18388;5.438329345225147e-05
89267;先把绘画想象中无数的伟大的艺术家合力做了一个作品。;1;0;1;18388;5.438329345225147e-05
89271;上次一个失业的画师发起了二战;1;1;2;18388;0.00010876658690450294
89273;在纸上绘画的质感，比如水彩国画等，ai怎么也模仿不来吧，感觉对板绘冲击更大一些妙啊;1;0;1;18388;5.438329345225147e-05
89277;ai作画的出现让一大堆不会画画但拥有有趣的灵魂的人有了展现的机会滑稽;3;0;3;18388;0.0001631498803567544
89292;頾鼏;1;0;1;18388;5.438329345225147e-05
89295;在支持AI之前，请先完善关于AI的法律，已经有人把画师在直播间里先画的草稿，然后拿去喂AI生产了成品画，然后将此画说成自己的。这就是个恶性事件呀。;3;0;3;18388;0.0001631498803567544
89302;ai绘画最大的进步就是突破了底线，白嫖素材，并理直气壮。单个技术，例如大数据，图形处理，渲染是之前就有的;2;0;2;18388;0.00010876658690450294
89305;好多人在自己没被取代前，都以为自己是不可以被取代的。职场，爱情，现在还来了个ai。;1;0;1;18388;5.438329345225147e-05
89322;tm的ai只是作画工具，不会真的在艺术上压过人类的，关键词都是人输入的，人的想象力才是艺术的关键打call打call打call;2;0;2;18388;0.00010876658690450294
89325;ai会绘画了，那ai离写论文还远吗？绘画是根据别人的样张东拼西凑再根据算法进行画面整合，大学生写论文不也是类似吗脱单doge;2;0;2;18388;0.00010876658690450294
89329;ai作画是创作，还是对原有作品的拆分胶合疑惑;2;0;2;18388;0.00010876658690450294
89339;ai毁灭人类，超棒给心心;2;0;2;18388;0.00010876658690450294
89347;当有一天AI有真正的自我意识时候，才算是艺术创作，不以你发出的需求来作画，而是AI自己有创作的欲望。不过估计他们会先想“我特么画一幅你能给我多少报酬”;1;0;1;18388;5.438329345225147e-05
89369;所以在哪搞呢;1;0;1;18388;5.438329345225147e-05
89376;有些人可能还没清楚现在的ai究竟是个什么水平，现在的ai根本就不存在创造的能力，只是在把数据库里的画作排列组合罢了。也就是说如果没有人类画家给数据库里增添新的作品元素，那ai永远也画不出更多带有新元素的作品。比如你只给ai中国画的数据库，那现在ai的水平就永远画不出西洋画。;1;0;1;18388;5.438329345225147e-05
89385;一句话总结，AI会成为辅助人进行创作的工具，不会取代人;1;0;1;18388;5.438329345225147e-05
89389;好看的还是人从许多张里挑选出来的，easy？并不;3;0;3;18388;0.0001631498803567544
89405;画是画者灵魂的表现，ai绘画是对画者的一种侮辱;2;0;2;18388;0.00010876658690450294
89419;中二大帝鲁鲁修我超，我最喜欢超现实主义的创意了，令人耳目一新;1;0;1;18388;5.438329345225147e-05
89423;上亿年演化出的高级生物怎么可能轻易被自己的附庸取代;2;0;2;18388;0.00010876658690450294
89435;现代人已经不会钻木取火了囧;2;0;2;18388;0.00010876658690450294
89439;很正常，智能化运转工作已经取代了好多人的工作了，只不过这次涉及到绘画是要人类花费大量金钱、时间、精力才能达到的，所以觉得内心不平衡罢了;1;0;1;18388;5.438329345225147e-05
89441;猫咪骑士求原图;1;0;1;18388;5.438329345225147e-05
89451;和百年前纺织工人抵制纺织机一摸一样;2;0;2;18388;0.00010876658690450294
89454;我只感觉人类追求艺术的方向已经错了，就像冷军画的一幅画和照片一样，功力登峰造极，可有什么意义呢？因为高清照片已经可以替代了，工具完全可以做到，这样的努力是把人努力成工具？再显本来就有的东西，这应是科学还原，不像是艺术表达，艺术是应该有性格在里面的，勾得起人的情绪和思绪，通过艺术表达画画也好，舞蹈也好，歌唱也好，传递情绪和思绪，这才是艺术的意义所在。;1;0;1;18388;5.438329345225147e-05
89458;就算代替作画，也需要经过人类的审美选择，因此更好的美学素养的人还是比普通人更有优势，这种根本的美学才是艺术性的根源，并不是一种消亡了;1;0;1;18388;5.438329345225147e-05
89470;但它的素材来源不都是人类吗？说到根本，还是人类艺术家厉害;4;0;4;18388;0.00021753317380900588
89487;把AI两字改成“大佬”，评论区会变成什么样思考;1;0;1;18388;5.438329345225147e-05
89494;艺术是艺术，绘画是绘画，怎么老有人喜欢混为一谈呢跪了;1;0;1;18388;5.438329345225147e-05
89501;那个，AI画的本子。。。如何？doge;1;0;1;18388;5.438329345225147e-05
89503;你怎么等肯定AI创作的就是你想要的呢？;2;0;2;18388;0.00010876658690450294
89513;根源上的创新还是靠人;2;0;2;18388;0.00010876658690450294
89519;有谁还记得许多年前吵着闹着要取代笔译和口译员;1;0;1;18388;5.438329345225147e-05
89524;个人觉得ai能做到作画技术上的极致，但因为没有意识，不能发挥主观能动性，因此目前不可能取代人类绘画doge，等ai有自我意识的时候人类可能也灭绝了;1;0;1;18388;5.438329345225147e-05
89532;ai就是素材拼接，只有资本家才天天吹ai多好多好;1;0;1;18388;5.438329345225147e-05
89536;用的是哪个网站啊;1;0;1;18388;5.438329345225147e-05
89546;坐等AI编剧AI绘图AI建模AI配音AI编曲AI后期做出点大制作给AI看了写AI剧评了doge而且我想催催什么时候出更简单的AI编程，降低一下编程门槛，最好是只用提需求那种脱单doge;1;0;1;18388;5.438329345225147e-05
89563;人创造的艺术是要在ai的帮助下更上一层楼的;1;0;1;18388;5.438329345225147e-05
89592;ai它解释不了它画这个有什么寓意啊，细节方面怎么解读;2;0;2;18388;0.00010876658690450294
89598;什么模型;2;0;2;18388;0.00010876658690450294
89602;三连求图;1;0;1;18388;5.438329345225147e-05
89627;三求;1;0;1;18388;5.438329345225147e-05
89638;三连求图;1;0;1;18388;5.438329345225147e-05
89640;三连求图;1;0;1;18388;5.438329345225147e-05
89642;三连求图;1;0;1;18388;5.438329345225147e-05
89644;三连求图;1;0;1;18388;5.438329345225147e-05
89646;求图;1;0;1;18388;5.438329345225147e-05
89648;留口饭吃吧呜呜呜，从小学画画十几年辛苦终于能自己赚钱糊口了，突然就被ai创了，最后一口虚拟主播的立绘饭也不让吃了么，ai不会饿死，人会的大哭，走过路过。。。传统纯手工虚拟主播立绘看一看啦。。半身700起，全身15k起，要游戏立绘级别的也能约鸭大哭;147;1318;1465;18388;0.0796715249075484
89796;都挺好，留着自己玩玩行，但ai的好像不能商用吃瓜直播应该算商用吧脱单doge;21;215;236;18388;0.012834457254731346
89818;最开始v的概念就是ai吧，返璞归真了属于是;21;1086;1107;18388;0.06020230585164237
89840;你觉得ai画不好是因为你的咒语不对doge;14;461;475;18388;0.025832064389819446
89855;能用，但跟免费皮没区别doge，图变lv2d面捕的软件早就有了，就是不能45度角转脸还有东西很少，不过y1s1，录视频套皮还是能用的，但up这种局限性问题很严重，配置要求压住了百分之八十的人;14;267;281;18388;0.015281705460082663
89870;什么时候ai能帮我一键吧pcb画了doge;17;172;189;18388;0.010278442462475527
89888;原作者冒个泡，有疑问可以去我的教程下面回复暹罗猫小豆泥抱大腿httpsb23tvBV1gS4y1x75w;3;123;126;18388;0.006852294974983685
89892;铁匠，农民和画匠凑在一起喝酒，酒过三巡，有哭有笑。铁匠道，我自十岁学徒打铁三十几年，现见得我们有万吨水压机来锻钢，能造武器以御外侮，吾心甚慰。农民道，我七岁就下地帮忙干活，现在有收割机和化肥，不会有人挨饿了。画匠道，舞无午，我学了好几年画画，原本坐屋里随便画一张就能吃个把月，现在有ai了，要和你们溴打铁的种地的平起平坐了，我不甘心。委屈给心心;125;302;427;18388;0.023221666304111377
90018;数位板会成为时代的眼泪吗？三星堆三星堆三星堆;15;110;125;18388;0.006797911681531434
90035;学习一下脱单doge那天也顶个皮，出个道捂眼;5;38;43;18388;0.002338481618446813
90041;别太焦虑，ai功能有限版权处灰色地带还未定性，真正靠画图吃饭的行业都未受影响，该怎么干活还怎么干，业绩没减少。网上传的沸沸扬扬的ai灭世论拱火居多doge就连隔壁搞设圈的单子也没少，谁的蛋糕少了我不说;6;62;68;18388;0.0036980639547531
90048;有没有一种可能，ai绘图的版权不能商用呢？;21;61;82;18388;0.00445943006308462
90070;明天出道，后天毕业实现人人有v当的美好愿景阿梓从小就很可爱新装扮打call;1;53;54;18388;0.0029366978464215794
90072;这个我倒不是很担心被AI取代，小工作室每月两千块招个刚毕业的大学生来实习，比AI便宜还比AI听话妙啊;22;35;57;18388;0.003099847726778334
90095;人人有v当，好时代要来力;1;38;39;18388;0.002120948444637807
90097;如果有图片一键拆分成模型的软件，配上AI画的画岂不是绝鲨doge;3;21;24;18388;0.0013051990428540352
90104;免费图库，免费皮套，免费模板库都没把我创死，套上个AI的皮就想创死我？tv目瞪口呆;1;18;19;18388;0.0010332825755927778
90106;ai拆不出图层，这是很致命的问题;13;10;23;18388;0.0012508157494017839
90121;正儿八经吃绘画这个饭的现在不会被AI影响到，毕竟AI没法完全展现人脑所形成的的图像反应你的意识，在至少5年内不可能有一点波及到关键领域如原画，机械设计，动画领域的就业，焦虑自嘲理解，不用担心，但是。至于急的，只有底边在莫鱼恰头像烂钱出一些廉价私设的“高端”画师了。;3;57;60;18388;0.003262997607135088
90127;唉，画画没用了，我们学校还天天教画画，走平面设计。总觉得平面设计到最后要被ai取代保卫萝卜哭哭保卫萝卜哭哭;14;12;26;18388;0.0014139656297585382
90146;错了，画师对于画的理解会高于普通人，ai生成反而可以帮助画师快速出粗图，画师只需要在上面加工即可高速出图，ai不可能完全替代，只能说是辅助;1;7;8;18388;0.00043506634761801175
90148;目前效果一般，但未来可期，然后我就要饿死了，xixi热;8;6;14;18388;0.0007613661083315206
90158;ai绘画最根本的问题是无授权用网图来喂ai学习，如果是画师把自己的图自己喂给ai来降低画图劳动强度应该没人回会说什么;4;6;10;18388;0.0005438329345225147
90163;724那里模型没有出来是黑屏咋办;3;3;6;18388;0.0003262997607135088
90173;FileNotFoundErrorThepathdoesnotexist这个怎么解决啊，我都重新下好几次了;1;3;4;18388;0.00021753317380900588
90180;还以为出了什么拆分魔法，还是老一套嘛，就是图自己不用画了;1;4;5;18388;0.00027191646726125733
90182;我在想著作权什么的怎么算呢，如果以后有人用你用AI生成出来的虚拟主播形象去做盈利活动，维权时还会顺利吗？;2;1;3;18388;0.0001631498803567544
90186;调试程序可以跑出来但是加载不出图片是为啥呢;1;2;3;18388;0.0001631498803567544
90188;我去，我记得前几年就有这个AI建模了吧？;1;2;3;18388;0.0001631498803567544
90200;真的希望以后这种虚拟的人物软件能简化一下笑哭因为我的梦想也是虚拟主播脱单doge但是不知道怎么让她动起来笑哭大哭大哭梦想破灭大哭;1;1;2;18388;0.00010876658690450294
90203;我的评价是无授权的图库做出来的东西推广哈哈;1;1;2;18388;0.00010876658690450294
90208;大哭手工传统组上流传的立绘加建模一条龙，比ai绘画更灵动，人与人更有温暖的感觉，不要败给冰冷的ai啊大哭;2;1;3;18388;0.0001631498803567544
90212;你看別人生成了好看的皮直接拿過來用就可以了，反正都是ai生成的;2;1;3;18388;0.0001631498803567544
90216;为啥我的obs没有着色器啊？;2;0;2;18388;0.00010876658690450294
90220;LaunchedE迅雷下载EasyVtuberPPbinpythonexemainpycharacterlambda00mouseinput001463914debugsimplify1cache1gbgpucache512mbmodelstandardhalfoutputsize512x512CharacterImageLoadedlambda00MouseInputRunningTracebackmostrecentcalllastFileE迅雷下载EasyVtuberPPmainpyline812inmodulemainFileE迅雷下载EasyVtuberPPbinlibsitepackagestorchautogradgradmodepyline27indecoratecontextreturnfuncargskwargsFileE迅雷下载EasyVtuberPPmainpyline471inmainfacemeshmpsolutionsfacemeshFaceMeshrefinelandmarksTrueFileE迅雷下载EasyVtuberPPbinlibsitepackagesmediapipepythonsolutionsfacemeshpyline94ininitsuperinitFileE迅雷下载EasyVtuberPPbinlibsitepackagesmediapipepythonsolutionbasepyline237ininitvalidatedgraphinitializeFileNotFoundErrorThepathdoesnotexist;1;0;1;18388;5.438329345225147e-05
90226;讲的很细，但我还是不会;1;0;1;18388;5.438329345225147e-05
90238;可怕的是ai都能做视频了，你们做的的视频也可能被别人喂给ai，拼成新的。以后没人原创，全是缝合;1;0;1;18388;5.438329345225147e-05
90242;前面跟着教学走，不知道为什么在启动器的时候frame里一片黑只有左上角数字动;2;0;2;18388;0.00010876658690450294
90256;可以问下obs安装streamfx就黑屏吗不安装就没事;1;0;1;18388;5.438329345225147e-05
90259;问个问题，我的OBSv272虚拟摄像头卡住了，第一次选择OBSVirtualCamera后点击savelanunch显示器采集就没动过;1;0;1;18388;5.438329345225147e-05
90275;DJ;1;0;1;18388;5.438329345225147e-05
90283;脱单doge支持;1;0;1;18388;5.438329345225147e-05
90288;为啥我的OBS中没有着色器这个选项;2;0;2;18388;0.00010876658690450294
90293;为什么我的obs上不显示streamfx;1;0;1;18388;5.438329345225147e-05
90301;可以，这很虚拟doge;1;0;1;18388;5.438329345225147e-05
90308;这种不拆分的话，有办法匹配口型和动作吗;1;0;1;18388;5.438329345225147e-05
90310;对电脑有什么要求吗？;2;0;2;18388;0.00010876658690450294
90313;缺陷太多了;1;0;1;18388;5.438329345225147e-05
90315;为啥你ai的手好正常，是不是图载图啊;1;0;1;18388;5.438329345225147e-05
90317;主播，能不能给群里也传一份，我家网不太行脱单doge;1;0;1;18388;5.438329345225147e-05
90325;看到了好几张手没怎么出问题的图片，ai又进化了吗;14;89;103;18388;0.005601479225581902
90340;现在ai已经能克服手崩的问题了吗;8;68;76;18388;0.004133130302371111
90349;塞拉斯试图偷取你的图doge偷取失败无法点赞;1;52;53;18388;0.002882314552969328
90351;给你的NovelAI安装升级版大模型吧Anything30大模型哔哩哔哩httpsb23tv9uaOLuM;1;18;19;18388;0.0010332825755927778
90353;手居然不会鬼畜了;1;12;13;18388;0.0007069828148792691
90355;这几期能给图包吗吃瓜;1;8;9;18388;0.0004894496410702633
90363;Up求正面tag酸了酸了酸了;1;0;1;18388;5.438329345225147e-05
90366;只要有tag就必须热词系列三连;1;0;1;18388;5.438329345225147e-05
90368;可以私聊发我吗关注你惹脱单doge;1;1;2;18388;0.00010876658690450294
90370;白毛红瞳喜欢;1;4;5;18388;0.00027191646726125733
90372;什么设备训练，配置要求高吗;1;0;1;18388;5.438329345225147e-05
90374;是不是修过啊，ai已经能画出这种手了吗喜欢;1;5;6;18388;0.0003262997607135088
90377;三联加关注，再接再厉;1;1;2;18388;0.00010876658690450294
90382;大部分手都有问题或者直接画错;1;0;1;18388;5.438329345225147e-05
90384;那个2G的JPG是什么，怎么打开，不懂脱单doge;1;0;1;18388;5.438329345225147e-05
90386;up有通过生成特定大小的图然后再通过放大达到1080p分辨率大小的方法吗。doge;1;0;1;18388;5.438329345225147e-05
90388;问一下bgm是啥支持支持;1;0;1;18388;5.438329345225147e-05
90390;UP主加油看好你噢;1;0;1;18388;5.438329345225147e-05
90393;好看枝上凉初;2;0;2;18388;0.00010876658690450294
90396;UP主加油看好你噢;1;0;1;18388;5.438329345225147e-05
90398;你好，能问一下你这背景的关键词是什么吗？;1;1;2;18388;0.00010876658690450294
90400;鹤发童颜的现代解释白毛美少女调皮调皮调皮;1;1;2;18388;0.00010876658690450294
90402;西风丶无羽这个好看dogedogedoge;1;1;2;18388;0.00010876658690450294
90404;为啥我感觉，阿婆主的比我提取的要清晰很多？Whydoge;2;0;2;18388;0.00010876658690450294
90411;白毛，赤瞳，纹身;1;2;3;18388;0.0001631498803567544
90413;古风少女（）白毛红瞳（）;1;0;1;18388;5.438329345225147e-05
90415;up主用什么什么画的啊星星眼;1;1;2;18388;0.00010876658690450294
90417;已三連求個bgm;1;0;1;18388;5.438329345225147e-05
90419;UP主加油看好你噢;1;1;2;18388;0.00010876658690450294
90421;白毛红瞳好耶喜欢;1;0;1;18388;5.438329345225147e-05
90423;三连了速速发图doge;1;0;1;18388;5.438329345225147e-05
90425;我直接关注脸红;1;0;1;18388;5.438329345225147e-05
90427;好看耶;1;0;1;18388;5.438329345225147e-05
90429;热词系列三连;1;0;1;18388;5.438329345225147e-05
90431;多来点星星眼;1;0;1;18388;5.438329345225147e-05
90433;吃瓜;1;0;1;18388;5.438329345225147e-05
90435;绘画完犊子了笑哭;1;0;1;18388;5.438329345225147e-05
90437;AI是懂我的doge;1;0;1;18388;5.438329345225147e-05
90439;已投币doge;1;0;1;18388;5.438329345225147e-05
90441;真的会被你们榨干（内存真的不够了）C酱警告;1;0;1;18388;5.438329345225147e-05
90443;投币了，加油doge;1;0;1;18388;5.438329345225147e-05
90445;我真的好喜欢ai的画风，干干净净保卫萝卜哇;1;0;1;18388;5.438329345225147e-05
90447;答案就是白毛吗;1;5;6;18388;0.0003262997607135088
90449;好看，up我可以提点要求吗？;5;0;5;18388;0.00027191646726125733
90455;背景音乐;1;0;1;18388;5.438329345225147e-05
90457;投币了打call;1;1;2;18388;0.00010876658690450294
90459;UP主加油看好你噢;1;4;5;18388;0.00027191646726125733
90461;吃瓜有图吗;1;1;2;18388;0.00010876658690450294
90463;惊艳但累眼睛唉我们这些底层画师怎么活啊大哭;22;384;406;18388;0.022079617141614095
90486;ai的色彩真的强啊这色彩换真人得有很强的色感和很久训练才能达到跪了;38;293;331;18388;0.018000870132695235
90525;平时有些低级AI的一眼就是那种没生气但是这几张图你摆到我面前不说AI画的我根本看不出来。;13;256;269;18388;0.014629105938655644
90539;没有人尊重下这些AI吃的图的原作者么;19;232;251;18388;0.013650206656515118
90559;冲国人最爱的白发红瞳加萝莉星星眼;4;85;89;18388;0.0048401131172503805
90564;稍微整点动效就可以上wallpaperengine热度榜的水平;3;71;74;18388;0.004024363715466608
90568;哎，AI这么发达了，现在已经有人用AI的画改一改错误的地方，直接接单的了，甚至还有不改的;5;55;60;18388;0.003262997607135088
90574;现在，从给我笔刷，变成了给我tag微笑;1;49;50;18388;0.0027191646726125733
90579;想问一下up这种画风的tag是啥;1;4;5;18388;0.00027191646726125733
90582;话说假如给ai图拆分做动态的话，算不算侵权呢？;1;0;1;18388;5.438329345225147e-05
90585;提示词是什么脱单doge;1;0;1;18388;5.438329345225147e-05
90587;哇塞这也太好看了，真的没有改过图吗;1;1;2;18388;0.00010876658690450294
90589;参考up的图片上的tag试了下，不过那个tag是不是不太全呀。画出来的背景染色感觉不够丰富。;1;1;2;18388;0.00010876658690450294
90591;首先好看，但ai作画不亚于尸块拼接，这是原则上的问题;2;3;5;18388;0.00027191646726125733
90595;up的lora加载的哪几个呀，元素法典3群没看到合适的lora笑哭;1;0;1;18388;5.438329345225147e-05
90602;ai对大透视比例缩放（例如鱼眼镜头）或构图上以及人体大动态的表现能有色彩这么惊艳吗，如果没有的话，人画画还是可以强过ai的，我觉得ai再怎么训练也不好掌握这些;11;0;11;18388;0.0005982162279747662
90617;up主，我能用里面的图当头像嘛;3;1;4;18388;0.00021753317380900588
90623;我其实很期待这种图变成动画。曾经人力无法实现的东西，变得看到前景了。;17;1;18;18388;0.0009788992821405265
90647;众所周知，在叔叔这阴阳师标签对于播放来说就算debuff;1;0;1;18388;5.438329345225147e-05
90652;我超，校友？刚入坑两天，不知道最后能玩成啥样。;4;0;4;18388;0.00021753317380900588
90657;机器工具人识别歌曲;1;0;1;18388;5.438329345225147e-05
90667;用的是niji？;1;0;1;18388;5.438329345225147e-05
90675;大佬用的哪个模型啊笑哭;1;5;6;18388;0.0003262997607135088
90679;up，背景的tag是什么啊星星眼方便分享一下吗;2;0;2;18388;0.00010876658690450294
90683;我只能说抵制ai作画，ai正在模仿其他的画师与艺术家并且正在杀死他们。;17;9;26;18388;0.0014139656297585382
90703;请问是用什么显卡跑出来的呀，我12g显存爆了都跑不出这么大分辨率的图tv难过;3;1;4;18388;0.00021753317380900588
90708;啥时候出一期ai教程;2;0;2;18388;0.00010876658690450294
90711;下载的图都好模糊啊，该咋办;2;0;2;18388;0.00010876658690450294
90720;doge有没有风景画呢想看看;2;0;2;18388;0.00010876658690450294
90727;抽象这方面ai是真有想象力;1;0;1;18388;5.438329345225147e-05
90739;阿离的歌好听，up的画好看;1;0;1;18388;5.438329345225147e-05
90744;像那为见一人苦修千年，终于幻为人形的精卫，终究化入火海保卫萝卜哭哭;1;0;1;18388;5.438329345225147e-05
90752;up什么模型啊？;1;0;1;18388;5.438329345225147e-05
90763;致我们热爱向往的;16;38;54;18388;0.0029366978464215794
90780;可想而知，杰哥还是喜欢阿伟。doge;2;512;514;18388;0.027953012834457256
90783;这个AI绘画20遍是使用生成好的图片反复喂，还是用原图喂20遍;2;203;205;18388;0.011148575157711551
90787;人类的终点，就是可爱的女孩子吗星星眼;4;86;90;18388;0.004894496410702632
90792;牛仔裤是怎么变黑丝的doge;1;46;47;18388;0.0025560147922558192
90798;总结：杰哥喜欢平的，不喜欢大的，那不然把彬彬给各位B站网友，我们会好好教他当大人的;2;9;11;18388;0.0005982162279747662
90849;霍，我的渣渣2070需要差不多五分钟重绘一张10881088，同款渣显卡的朋友们尽量还是自己特别喜欢的再用这个方法重置吧（下个月换一个22g2080ti生气生气）;11;8;19;18388;0.0010332825755927778
90861;不使用高清修复，纯靠sd放大，第一次两倍放大效果特别好，再次放大脸有点崩;1;0;1;18388;5.438329345225147e-05
90864;啥无损放大，放大湖了ai帮你修吃瓜;2;11;13;18388;0.0007069828148792691
90867;为什么我采样里没有DPMadaptive？;2;3;5;18388;0.00027191646726125733
90870;请问up为什么经常放大后效果不如原来，甚至会有脸部崩坏（比如五官不对称，眼睛太大等），放大时加不加lora都这样;7;0;7;18388;0.0003806830541657603
90878;我前两天刚研究出来在PS里放大切片后拿去SD批量重绘，再合成，发现效果惊人，今天就刷到你这个教学笑哭早刷到我都不用花这时间研究了不过过程中也学到不少知识谢谢UP;2;10;12;18388;0.0006525995214270176
90881;话说为什么建议用的是DPMa，官网建议的是欧拉a来着脱单doge;1;3;4;18388;0.00021753317380900588
90884;Up大大，有写图片放大后会出现一两个很大的黑色矩形，是为什么呢？;1;0;1;18388;5.438329345225147e-05
90886;up为啥我出来是三张图拼一张，，，，呜呜;1;0;1;18388;5.438329345225147e-05
90888;为什么放大完右下角那块是黑色的;1;0;1;18388;5.438329345225147e-05
90890;我sd图片尺寸调大了就直接跑不动，或者中途崩掉了，我8G的显存，是怎么回事，有解决的办法吗？重装sd后会好上一段时间;2;1;3;18388;0.0001631498803567544
90893;图片中总是出现很多个人脸怎么办;3;0;3;18388;0.0001631498803567544
90897;不行了，4G已经爆显存了，能不能把显存低一点的也可以放大;3;0;3;18388;0.0001631498803567544
90901;两种方法都尝试了，但渲染出来图片还是角落有黑色块。。。我放弃了;3;0;3;18388;0.0001631498803567544
90905;找不到插件下载的地方;1;0;1;18388;5.438329345225147e-05
90907;如何拆成更多块来渲染呢;5;0;5;18388;0.00027191646726125733
90914;up，每次图生图都会跑出来两张是怎么回事，一张jpg，一张png;2;1;3;18388;0.0001631498803567544
90917;真人照片可以放大吗？比如老照片的？效果如何？求测试;1;1;2;18388;0.00010876658690450294
90919;请问一下，我按照设置放大会变成拆散的四块，人物不完整了，是哪里设置出问题了吗；；;1;0;1;18388;5.438329345225147e-05
90921;up，求问下你截图中script这一栏是加载了什么插件，我这下载的版本图生图里没有这一栏的;2;0;2;18388;0.00010876658690450294
90924;捂脸捂脸捂脸孩子的additionalnetworks下面没有script的扩展栏求问各位大佬在哪里打开，还是另外安装的插件？大哭大哭大哭;1;0;1;18388;5.438329345225147e-05
90929;up你是啥配置啊我的3060放大一次要十几分钟不知道为啥;7;1;8;18388;0.00043506634761801175
90937;为什么生成之后颜色变成白灰色了，不是原来的图颜色;1;1;2;18388;0.00010876658690450294
90939;修一张很耗时间，如果能只修一次特定部位其他直接用latent的结果就好了;1;1;2;18388;0.00010876658690450294
90941;请问为什么我的图会一半是黑的，然后图也是分块的？;3;0;3;18388;0.0001631498803567544
90945;请问一下，分辨长宽64有什么用吗？我发现我不加这个64效果也一样;1;0;1;18388;5.438329345225147e-05
90950;大佬，按照你的方法8G显存直接爆了，求解呀，分辨率是12061920，加的64分辨率。;3;0;3;18388;0.0001631498803567544
90955;想问下up已经是2048的图没法加长要怎么放大;3;0;3;18388;0.0001631498803567544
90961;没找到additional酸了networks;3;1;4;18388;0.00021753317380900588
90965;脑子不够，还是不知道怎么调分辨率控制块数嫌弃;1;0;1;18388;5.438329345225147e-05
90967;超过2048怎么放大;1;0;1;18388;5.438329345225147e-05
90969;为啥感觉没细化，反而多了笔触？;1;0;1;18388;5.438329345225147e-05
90971;1050炸内存了dogedogedoge;1;0;1;18388;5.438329345225147e-05
90973;运行到接近100就会报出纯黑图的错，关掉半精度也没用;1;0;1;18388;5.438329345225147e-05
90975;非常nice，不过用了这个还有必要在绘图时开高清修复hiresfix么？;3;0;3;18388;0.0001631498803567544
90979;图生图里没有additional脚本，在哪里能安装呢;1;0;1;18388;5.438329345225147e-05
90981;三次元的可以用这个方法吗;2;0;2;18388;0.00010876658690450294
90985;为啥每次放大64像素？;1;0;1;18388;5.438329345225147e-05
90989;请问报错AttributeErrorNoneTypeobjecthasnoattributelocaldatapath怎么处理;2;1;3;18388;0.0001631498803567544
90992;3060ti从576x1024放大到640X1088每次都到100的时候失败图片消失有没有大佬知道啥情况？？？？笑哭;12;1;13;18388;0.0007069828148792691
91010;太吃配置了，炸鸡谨慎使用;1;0;1;18388;5.438329345225147e-05
91012;超过1024就炸显存a卡用户玩起来真心累笑哭;1;0;1;18388;5.438329345225147e-05
91023;ValueErroretamustbe0forreversesampling，那个他显示要我eta为0，但是这是啥，找了老半天没找到。;1;0;1;18388;5.438329345225147e-05
91026;现在有了新插件multidiffusion好像更好用;1;0;1;18388;5.438329345225147e-05
91029;实测，这个方法真的还挺好用的。谢谢up的分享和教学。虽然没有弄清原理，但是跟着做就能出现不错的效果。热词系列吹爆;1;0;1;18388;5.438329345225147e-05
91033;设置中开启在哪弄;3;0;3;18388;0.0001631498803567544
91042;按方法跑了两次，最后两步也就是图片下半部分的时候变成黑图，出来的图只有上半部，求解;3;0;3;18388;0.0001631498803567544
91046;三次元的用什么采样器和放大算法呢;1;0;1;18388;5.438329345225147e-05
91051;几个放大的算法有什么区别吗;3;0;3;18388;0.0001631498803567544
91056;这个方法很好，比单纯放大多了很多细节，比如原本肌肤上的没有的肌肉线条和明暗，在放大后居然出现了;1;0;1;18388;5.438329345225147e-05
91058;所以说现在的游戏行业还需要画师干什么？花低价招一些萌新用AI量产不就行了吗？不仅省成本，而且美术质量也高一些没学过画画，或者说画的比较烂的萌新用AI也能取代一些大佬的饭碗，而且他们还比大佬便宜，AI时代更像是变革，机器流水线取代人力，对游戏行业来说是好事情，对画师来说是一件悲伤的事情。失业是难免的。;9;0;9;18388;0.0004894496410702633
91069;能批量处理图片吗;1;0;1;18388;5.438329345225147e-05
91073;samplingstep填多少好;1;0;1;18388;5.438329345225147e-05
91079;原图在这里链接：httpspanbaiducoms14mvCqWa3htzKEzHgTo6RMgpwdrmj6提取码：rmj6喜欢的小伙伴请三连支持一下哟脱单doge脱单doge脱单doge;14;216;230;18388;0.012508157494017838
91094;都不小啊;10;183;193;18388;0.010495975636284533
91105;这么大的事为什么现在才说？脱单doge;1;95;96;18388;0.005220796171416141
91107;都不错啊，就是眼神都很像doge不过无所谓，我腾不出手;2;43;45;18388;0.002447248205351316
91110;这是哪个网站或者应用啊？;5;33;38;18388;0.0020665651511855556
91117;以前我也以为是这样，后面我才知道有些色色的词无法加入大哭，我的本子梦啊;8;12;20;18388;0.0010876658690450293
91127;有这技术就给大家看这个脱单doge;10;4;14;18388;0.0007613661083315206
91138;我是龙骑士打call;2;12;14;18388;0.0007613661083315206
91141;为什么AI画的图下巴，绝大多数都是三角形，有点尖的，有没有什么tag，可以把下巴画的有弧度一点保卫萝卜哇;1;8;9;18388;0.0004894496410702633
91143;链接：httpspanbaiducoms1WtGXJLrBFm7Fq1PWmHCxApwdf29w提取码：f29w同期其他图片在这里哟脱单doge脱单doge脱单doge;6;3;9;18388;0.0004894496410702633
91150;好看哦喜欢;1;11;12;18388;0.0006525995214270176
91152;不错啊，如果更涩一点就好了;2;2;4;18388;0.00021753317380900588
91155;头上长树枝真绝了;2;3;5;18388;0.00027191646726125733
91158;好耶doge;1;2;3;18388;0.0001631498803567544
91181;为什么不是竖屏的。;1;0;1;18388;5.438329345225147e-05
91184;up你的飞浆有没有安其他模型啊;1;0;1;18388;5.438329345225147e-05
91194;找的有点麻烦呀，有没有好方法？;1;0;1;18388;5.438329345225147e-05
91196;人类真的败给了ai插画师们真的要被ai抢走饭碗了吗大哭;5;1;6;18388;0.0003262997607135088
91212;打call;1;1;2;18388;0.00010876658690450294
91214;你tm就是我的天使吧C酱AWSL;1;1;2;18388;0.00010876658690450294
91216;是过期了吗，找不到;1;1;2;18388;0.00010876658690450294
91218;好看耶;1;1;2;18388;0.00010876658690450294
91220;1;1;1;2;18388;0.00010876658690450294
91222;点开tag热度榜第一：yxh第二：观影体第三：大家看看我的xp（九图）;26;2195;2221;18388;0.1207852947574505
91249;而且现在老福特出了一些充值读彩蛋的功能，其实我并不反对这个，有些大大这么辛苦，本身就应该得到反馈，但是有的作者让我感觉根本没看过原作，都是擦边车，更有的当你充值了彩蛋，结果打开就只有一句话。你能想想我当时是什么心情微笑;60;8188;8248;18388;0.44855340439417013
91310;在空间刷到一个妈咪的提醒，在这里也想说说，不要急着销号如果作品真的被喂了有账号和发布记录还能维权证明你才是第一发布人和原创，现在账号协议里好像都有默认你允许作品被它们官方用辣眼睛;8;1158;1166;18388;0.06341092016532521
91319;最痛苦的不是大大跑路了而是在新的软件里你原本很火的圈变成只有几张图个位数热度的冷到爆的圈痛实在是太痛了大哭大哭大哭阴险阴险阴险;5;143;148;18388;0.008048727430933217
91325;从炸tag的风气起来的时候我就觉得老坟头离四不远了保卫萝卜哭哭保卫萝卜哭哭保卫萝卜哭哭我稳定产出的妈咪不知道跑哪了呜啊啊啊啊啊啊啊保卫萝卜哭哭保卫萝卜哭哭保卫萝卜哭哭;13;1255;1268;18388;0.06895801609745486
91339;老福特早就不咋地了。画画的太太质量不错，毕竟画画门槛高，但是分辨是不是好画门槛不高，几岁的人都能看出好画坏画。但是写手就是重灾区。。。恕我直言，我属实看不懂一些高点赞作品好到哪去，平平无奇。而好作品就没有流量。之前也看人评论过，圈子里有些人拉帮结派一个带一个，导致很多没什么水平的作品被吹得很高。当然，低龄化也有关系，初中以下小孩真不建议乱评论。。。;23;2660;2683;18388;0.14591037633239068
91363;求置顶这里去找了一下，比较冷门，并且看起来比较合适的新软件圈子，一定要冷门低质且无脑的人看到了又要霍霍了OK啊，软件如下：1inner2破圈3轻话社区4美篇5易信真的不推荐半次元，跟老福特一样乱，倒不能说全部，只能说有23都这样，并且有那种质量下降的问题，当然我说的不一定都是对的，也有好有坏，我每一个都下下来试试，有后续了就发评论OK;6;245;251;18388;0.013650206656515118
91370;贴吧回到我的怀抱吧OK半次元值得一试脸红微博看看我，大家友好互助给心心;63;1496;1559;18388;0.08478355449206004
91434;ai付费存图捏哪来的脸;2;213;215;18388;0.011692408092234065
91437;我只能说，很难，其它软件没有老福特的影响度大，流量多，绝大部分还是会留在老福特。别问，问就是我也曾经转过很多软件网站，最后冷圈人还是会回到最开始的地方。;21;782;803;18388;0.04366978464215793
91459;主要大家跑的地方，太多了，像飞鸽，冲呀，美篇，话本，晋江，长佩我一晚上下载了一堆APP，就蛮不方便的（而且APP，超级卡，一看就是刚刚开发的）请问大家有推荐吗？就是比较集中的抱拳抱拳抱拳抱拳拜托大家了其实之前还有AI续写功能，然后被骂惨了，那个时候就走了一批了（大哭大哭大哭大哭）;31;499;530;18388;0.028823145529693277
91491;确实，一个同人绘画作品平台上架ai功能，哪个画师不寒心，哪个画师不害怕，拿自己的作品喂ai，辛辛苦苦十几甚至几十个小时，ai几分钟几秒出图。;10;1733;1743;18388;0.0947900804872743
91502;冷门画师感觉更难过了产出了放上去又不是滋味，看着大家都在抵制，我没有玉石俱焚那种呐喊的意志，很敬佩那样的人，却做不到真的放弃，很难过，列表的朋友都在离开，另一波人又是拥护着算法ai的随波逐流着难过可我只是爱着画画和我的小人们而已;1;238;239;18388;0.012997607135088102
91505;走不了啊，冷圈人只能在lofter吃口饭，而且大大们离开后发展的平台都不一样笑哭虽然我也抵制ai绘画，但我真的无处可去大哭;8;88;96;18388;0.005220796171416141
91514;跟着太太们下载各种软件搞得跟收集七龙珠似的笑哭;4;117;121;18388;0.006580378507722428
91519;真的很难过。写文章真的不容易，热度低互动低真的很打击人。保卫萝卜哭哭有的时候一篇一万多字的一发完短篇真的要构思和创作很长时间，从电脑文档到pc端lofter存草稿之后为了考虑读者感官还要在手机改排版。发布前信心满满，发布之后无人问津。有的时候就真的特别怀疑可能真的是我写的太烂了才没有人看，还会怀疑评论说我写的好的应该都是为了安慰我。保卫萝卜哭哭保卫萝卜哭哭保卫萝卜哭哭那种感觉就像是你把你家宝贝精心打扮的漂漂亮亮的拉出来给大家见见，结果大家“吁”一声就散了。在你心里很漂亮可爱的宝贝不被大家喜欢。你理所当然的会怀疑自己是不是还把我宝弄的不够可爱，是不是我这个麻麻当的不称职。保卫萝卜哭哭有一次写长篇连载九章后因为看的人实在太少我就发了个小问询，结果下面有一个读者说了一句“可能是你写的太长了，大部分人没有耐心看完吧。”保卫萝卜哭哭保卫萝卜哭哭保卫萝卜哭哭这事没办法说，真的没办法说。关键我还有点清高，一般是不会在文章前后专门写上“求评论求红心求蓝手”这种话要求我的读者们点赞互动的。我是感觉阅读和创作本来就都是出于兴趣，读者没有要求创作者的创作，创作者要是要求读者就稍微有点没意思了。真的怪我，怪我太清高了。因为我不说，结果就真的无人问津了。保卫萝卜哭哭保卫萝卜哭哭保卫萝卜哭哭我没什么粉丝，最近也是真的真的扛不住了，数据真的太惨淡了。本来为爱发电，也是真的真的有点撑不下去了。写文和创作是一件特别好的事。创作的过程就是痛苦并快乐的。可能还是我做的不够好，写的不够好。读者也太少，让我连哪里写的不好都不知道。保卫萝卜哭哭保卫萝卜哭哭保卫萝卜哭哭我之前真的有拿笔杆子写文养活自己的浪漫想法，我感觉一辈子这么写下去真的很好很好。但我那惨淡的数据告诉了我一个事实：我的兴趣很好，但是我得活命，靠这个绝对养不活我。再用心也没有用处的，只是“不务正业”而已。保卫萝卜哭哭真的，真的有点想哭。我是真的舍不下写文字的心，但是写出来就真的只是一遍遍的打击自己。数据不会撒谎，它会一遍遍告诉你：你是真的不行。你的创作一文不值。保卫萝卜哭哭保卫萝卜哭哭保卫萝卜哭哭;2;25;27;18388;0.0014683489232107897
91522;流浪是我的命运百家饭是我的荣幸我了解微笑;1;108;109;18388;0.00592777898629541
91524;要不贴吧再崛起吧我写手本来就没地方发展了;36;642;678;18388;0.036871872960626495
91561;好崩溃谁能告诉我真人二创能去哪。。很多平台都不允许真人二创例如tagtreetv难过我只能转战微博和亚洲网了;11;132;143;18388;0.00777681096367196
91573;其实最好的还得ao3啊大哭;33;502;535;18388;0.029095061996954535
91607;泻药，我一个稳定产出的妈咪跑了啊啊啊啊啊啊呜呜呜呜呜呜妈咪带上我啊妈咪呜呜呜呜呜呜呜，你离开我一定要幸福你一定要幸福好吗？妈咪，没有你我该怎么活啊妈咪我现在靠着镜像凹三的稳定产出台湾妈咪续命，但妈咪考研去了，一个月一两顿饭我真的会饿死的;4;54;58;18388;0.003154231020230585
91612;我想跟Up主分享一下我今天做了什么我饿了想吃粮，打开老福特，看到关注的老师太太们的转台声明，感觉有点寂寞所以退了出去；喝了口水吃了晚餐，我又打开老福特，又看到更多老师太太们的转台声明，只是这次我不知道要怎么形容心情那种感觉就像是小时候的自己跟朋友花了好多时间用纸条折了小星星放在玻璃瓶里，然后有一天朋友说不折了，把自己折的那部份拿了出来，瓶子空了一半，然后一只不认识的猫咪把瓶子推到地上，里面的星星剩下不到13感觉自己好像那个被慢慢掏空的瓶子，明明我没有错，朋友也没有错，但就是不对，什么都不对。;8;703;711;18388;0.0386665216445508
91621;Lofter这两年的审核就劝了好几个太太走了，看来我得去存百度网盘了;18;374;392;18388;0.021318251033282574
91641;蹲个app，老福特和半次元都死了;31;146;177;18388;0.00962584294104851
91673;我也销号跑路了（）然后给大家推荐我觉得还不错的同人创作平台1tagtree（新软件人还不多但是是为爱发电做的软件）2qq空间（虽然很离谱但是qq空间发动态可以选tag，点进tag还有最热）3wb（不太推荐但是wb可以当第二个qq空间用（？））;2;7;9;18388;0.0004894496410702633
91677;老福特原来最开始根本不是同人网站APP好吧，是发布照片和分享日常的，只是后来有人在上面写同人，流量就大了，就改了自我定位;4;78;82;18388;0.00445943006308462
91682;要是QQ空间支持加tag将打败一切doge;3;138;141;18388;0.007668044376767457
91686;转移阵地吗对于看文看画的观众来说不麻烦，主要是创作者很麻烦啊;1;6;7;18388;0.0003806830541657603
91689;我都是海棠放飞自我的笑哭不求赚钱，求一个自由;13;30;43;18388;0.002338481618446813
91704;感觉越来越多的二次元软件变味了，bcy全是低龄小鬼，LOFTER被曝ai绘画抄袭太太的画，b站现在也感觉很多现充和小鬼，曾经最大的弹幕网站现在都不开弹幕保智商。。大哭;4;457;461;18388;0.025070698281487926
91709;冷圈人抱着自家CP爆哭;1;31;32;18388;0.001740265390472047
91711;有废文，ao3，随缘居，还有各种专门的同人论坛。我都很久不上老福特了;3;26;29;18388;0.0015771155101152925
91715;笑死，我平板上的老福特三年没更新了，现在要钱才能存的图它都还能存doge;1;65;66;18388;0.003589297367848597
91717;（玩老福特也挺久了，想说点心里话。父母健在，家庭和睦，无意引战，只是自己的一些心里话，请各位手下留情。保卫萝卜哭哭）感觉现在老福特上的小朋友越来越多了，大多数心智未成熟的未成年人本来就喜欢跟风吹捧，她们把某些作品捧上高地，打着喜欢的名义随意玩梗，写着一些极度ooc的文章，把受写成娇软无力的“娇妻”，我真的不明白为什么这种文章的点赞量会那么高成百上千的赞。我也断断续续地写了近一年的文了，热圈冷圈都写过，说不嫉妒她们的热度是假的，但我真的不明白，那种小学生文笔、极度ooc的文为什么会被那么多人喜欢，现在又来这一出，对老福特真的很失望。;13;202;215;18388;0.011692408092234065
91731;求个地方收留心碎同人女，我的太太们都很久没更新了，而且我还搞冷圈笑哭;1;24;25;18388;0.0013595823363062867
91734;我说那个如果说tagtree有瓜，inner有瓜，就甩个链接上来给我看看之前也有人在空间说inner老板有鹅厂背景结果发现是同名同姓而已。顺便我一直用wland基本没什么人看我。;5;9;14;18388;0.0007613661083315206
91740;lofter现在越来越像微博超话靠拢了，有点无语又有点不适应，两三句话没谈拢就开始挂人互撕，咱就是一整个看热闹的状态，十年前贴吧时代管你什么cp都有外交贴大家都很友好也其乐融融，现在年轻人戾气越来越重了，也不知道图点啥;4;42;46;18388;0.0025016314988035677
91747;老福特现在就是很低龄化，尤其是同人文，质量那么差的同人文还有人捧，要不然就是辣眼视频，还有参差不齐的画作，想找个高质量粮比登天还难，有的写的还不如小h文的剧情好呢，就这还给你搞个彩蛋，真的把自己当香饽饽呢;1;9;10;18388;0.0005438329345225147
91749;如果有好的平台请告诉我哦，大家可以来蹲脱单doge;16;8;24;18388;0.0013051990428540352
91766;我笑了，说着是支持原创，结果搞出这种破东西，然后画师还有地方能发展，写手根本不知道往哪走;10;258;268;18388;0.014574722645203394
91779;我的lofter主页全是这个辣眼睛;5;341;346;18388;0.01881661953447901
91798;有没有人可以推荐一下别的平台大哭大哭;40;14;54;18388;0.0029366978464215794
91841;之前看LOF热圈风气真的不太能接受所以就先提桶跑路了，没想到之后居然做了这种事，ai绘画出来就挺让画手难受的，辛辛苦苦花了五六个小时的画，热度比不上ai拼出来的，真的很难受，没想到作为创作平台的LOF会整这种花活，属于是，，，;6;3;9;18388;0.0004894496410702633
91848;我关注的tag里有一半是卖本子和片哥，还能呆在那里吗？这边推荐一个我现在用的叫tagtree虽然作品很少，但真的很干净;3;4;7;18388;0.0003806830541657603
91853;推推飞鸽博客;10;9;19;18388;0.0010332825755927778
91865;要不咱们文艺复兴一波回贴吧去吧保卫萝卜哭哭;2;15;17;18388;0.000924515988688275
91868;植物梗的结;2;1;3;18388;0.0001631498803567544
91874;有推平台的吗？，反正去哪里都是冷圈doge;1;2;3;18388;0.0001631498803567544
91877;ai挺好的把很多虚高的约画价格打下来;5;1;6;18388;0.0003262997607135088
91886;主要是老福特上有些太太就特别喜欢发在别的网站上面，以至于让我们都特别的难找，真的无语死了，我本来就是过来看同人文的，现在搞得我现在简直了;1;1;2;18388;0.00010876658690450294
91889;本来还想去飞鸽，结果飞鸽昨天自曝有ai白名单，白名单里躺着的是之前非常有名的ai碎尸机罢了罢了，tagtree也不赖藏狐;1;1;2;18388;0.00010876658690450294
91895;紫色电鳗就不错啊;1;1;2;18388;0.00010876658690450294
91907;米娜可以看看tagtree，感觉还不错，就是现在太冷了;4;1;5;18388;0.00027191646726125733
91916;呵呵我都屏蔽了乙女腐，老福特还拼命给我推尴尬尴尬尴尬;1;2;3;18388;0.0001631498803567544
91933;我从贴吧转战到微博转战到老福特，最后还是嗷3好用tv生气;1;0;1;18388;5.438329345225147e-05
91941;话说能问一下一个好的同人创作平台都需要具备哪些要点吗？（想做一个相关的APP项目，但是不知道大概从那几个方向入手奥比岛委屈;3;0;3;18388;0.0001631498803567544
91995;我当晚就把我的粮仓备份到我的个人主页了墨镜备到两点大哭;1;0;1;18388;5.438329345225147e-05
92007;无所谓，小蓝鸟会出手;1;0;1;18388;5.438329345225147e-05
92052;tagtree没人推我推一下就是现在太太少，而且禁真人（大概）;2;1;3;18388;0.0001631498803567544
92055;很舍不得老福特，，20年下架风波我就很愤怒，我可能1718年就在老福特了，写文，骂架，交友，语c。多少人看我写的文啊，，后来我弃坑跑路，这几天回来写文才没几天又出现这件事唉;2;0;2;18388;0.00010876658690450294
92067;另外给无家可归的同人女们指个路：inner很多太太集体跑路跑到那里，优点挺多的，堪称老福特平替就是没有草稿箱，需要准备一个码字软件当做草稿箱;4;0;4;18388;0.00021753317380900588
92089;要不要去攻占小鸡词典试试，创作团队多多少少都是圈内的，而且她们现在的确面临运营困难，感觉可以转型之类的;2;0;2;18388;0.00010876658690450294
92092;真没有类似app了吗，求个笑哭;2;0;2;18388;0.00010876658690450294
92095;推荐一下我最近发现的两个出来wb之外太太们的新阵地，in打callner和飞鸽打call博客，虽然目前人不是很多，但lof不道歉我估计是真的会凉;3;0;3;18388;0.0001631498803567544
92101;这个一个软件啊，我觉得他是个坑我钱的玩意，毕竟有一次我遇到了一个很好文笔的文。那篇文章写的我愿意为他立马花上9块9开通了他的会员。没关系，我看后面他给我烂尾，烂到我觉得跳楼跳下去我都不能平息我都觉得死而有憾;2;0;2;18388;0.00010876658690450294
92104;老福特真的不行了，打很多标签的热度就比较高，明明文笔超级差，啥也不是，写的好的就算我疯狂刷粮票，太太也不火，还有好的明星的图居然不可以保存要送礼物，想问问凭什么，还有好多太太画的漫画和美图，随便被转载，热度甚至比原作者还高，还不标注原作者微笑微笑微笑;1;0;1;18388;5.438329345225147e-05
92110;TagTree这个，我看着还不错，分类也挺多的;5;0;5;18388;0.00027191646726125733
92123;你好wland也登不上去了，不知道是换域名了还是没钱做了，有没有姐妹私信个能看的大哭;2;0;2;18388;0.00010876658690450294
92131;早就不爱用了写手文笔越来越低龄圈子里还喜欢抱团（写的一样烂）写得好的不混圈的根本没机会被看见彩蛋机制也很想吐槽链中链都没法无语哪里有装作自由;1;1;2;18388;0.00010876658690450294
92133;这是ao3镜像的网址，翻转再镜像就行了。发评论老被吞;7;86;93;18388;0.0050576462910593865
92141;他们都没说过，一定要点击下回车，才会把消息发出去啊;4;8;12;18388;0.0006525995214270176
92146;这个把人都弄成单眼皮试试CicelyMaryBarkerstyle我觉得蛮好看的。呲牙;1;5;6;18388;0.0003262997607135088
92148;为什么没有生成啊？;14;4;18;18388;0.0009788992821405265
92164;为什么我的不像;2;2;4;18388;0.00021753317380900588
92167;怎么把自己的图片链接提取出来？直接拖进discord没有那个选项啊;8;2;10;18388;0.0005438329345225147
92176;这种不是新海诚风格吧;1;3;4;18388;0.00021753317380900588
92178;请问为什么我出的图一点都不像原图呢;1;1;2;18388;0.00010876658690450294
92180;同样的操作步骤，为啥图片链接有时候可以用，有时候不能用;1;1;2;18388;0.00010876658690450294
92182;InvalidlinkPleasecheckthatyourURLisadirectlinktoanimagenotawebpagerepulsionpayeesnooze请问UP主这个怎么解决呀？我确定图片链接是对的;1;1;2;18388;0.00010876658690450294
92184;为什么我的显示无法验证此链接00;1;1;2;18388;0.00010876658690450294
92186;这玩意儿是付费使用吧，我看说的是要订阅，包年50月;3;1;4;18388;0.00021753317380900588
92190;v4里面支持q2么？;2;1;3;18388;0.0001631498803567544
92193;你好，为什么我先把我的头像发出去，然后复制链接，和关键词，他说我无效链接，无法验证此链接;1;1;2;18388;0.00010876658690450294
92195;请问为什么图片链接不可用呢？是什么原因呢？图片的链接有什么格式要求吗？谢谢;1;1;2;18388;0.00010876658690450294
92197;截图翻译那个是什么工具呢;1;1;2;18388;0.00010876658690450294
92199;前面是用image吗，我怎么做出来一点都不像呢;3;1;4;18388;0.00021753317380900588
92203;请问UP主为什么我照做了，不出现自动生成呢;1;1;2;18388;0.00010876658690450294
92205;UP主，是不是不能免费使用了，给我显示这个DuetoextremedemandwecantprovideafreetrialrightnowPleasesubscribeortryagaintomorrow;1;1;2;18388;0.00010876658690450294
92207;二次元画风要用niji吗;1;1;2;18388;0.00010876658690450294
92209;这个命令是不是失效了，怎么试都不行;1;1;2;18388;0.00010876658690450294
92211;咋生成出来的图完全跟照片不同的？一张大头照最后大头半身全身都出来了。。。喜极而泣;2;1;3;18388;0.0001631498803567544
92216;后面的q2v4是什么意思啊;3;0;3;18388;0.0001631498803567544
92220;为什么我复制不了图片的地址啊;1;0;1;18388;5.438329345225147e-05
92222;不是被好几个单位起诉数次盗图训练且不具备版权么笑哭首页满屏ai教学。笑哭;6;0;6;18388;0.0003262997607135088
92230;请教up主，上传的图像怎么删除？用共享账号，怕泄露隐私。;9;0;9;18388;0.0004894496410702633
92240;你用过自己的嘛;3;0;3;18388;0.0001631498803567544
92245;博主请教一下，我支付了每月10美金的订阅后，为什么以图生图不行了，老跳出让我选择V4之类的选项，你知道哪里出问题了吗？是我选项问题还是我的订阅的10美元不能使用此功能呢？;4;0;4;18388;0.00021753317380900588
92251;up，可不可以出一期国潮勾线风格插画的教程，感觉会火，找了好久没找到这种教程;1;0;1;18388;5.438329345225147e-05
92254;什么软件;1;0;1;18388;5.438329345225147e-05
92256;你好，为什么我右键图片没有复制链接选项呀;3;0;3;18388;0.0001631498803567544
92260;iw是不是得开会员呀;2;0;2;18388;0.00010876658690450294
92263;多刷次数是怎么搞的快捷键？;1;0;1;18388;5.438329345225147e-05
92265;请用尽量多的英文单词描述一幅画，描述词尽量丰富，每个单词之间用逗号分隔一个在阳光下的女孩请用尽量多的英文单词描述一幅画，描述词尽量丰富，每个单词之间;3;208;211;18388;0.01147487491842506
92270;魔法师下岗笑哭;2;162;164;18388;0.00891886012616924
92273;下一个ai：让ai帮你给ai写需求吧笑哭;3;126;129;18388;0.007015444855340439
92277;奥术法师：通过大量的词汇对魔法进行修饰与限制，只要咒语在这我就知道这个魔法效果如何魔法师：我要放个魔法，虽然我不懂咒语，但总之我要放这个魔法;4;86;90;18388;0.004894496410702632
92282;我多试了几遍，我找到的最好提问方式是：请为这幅画生成尽量多的英文单词prompt，单词之间用逗号分隔：阳光下的一个女孩;5;67;72;18388;0.003915597128562106
92288;魔法師怎麼可能比魔法本尊還了解魔法;2;26;28;18388;0.0015227322166630412
92294;Al画图用的是啥网站？;9;8;17;18388;0.000924515988688275
92305;ai消灭了一切岗位;8;16;24;18388;0.0013051990428540352
92314;可以直接要求ai生成prompt;4;10;14;18388;0.0007613661083315206
92320;求up的反向提示词;2;2;4;18388;0.00021753317380900588
92325;up能不能做一期用ai批量生产游戏素材星星眼;7;3;10;18388;0.0005438329345225147
92339;请问这个生成ai图片的网址是？;2;1;3;18388;0.0001631498803567544
92342;这东西感觉就是高维搜索引擎;5;2;7;18388;0.0003806830541657603
92352;请问UP主，你负面词都写的啥？;1;0;1;18388;5.438329345225147e-05
92354;这个通过描述生成图片的软件叫什么？;1;0;1;18388;5.438329345225147e-05
92357;这个图片生成软件是什么？？;1;0;1;18388;5.438329345225147e-05
92360;P，怎么让chatGPT生成的提示伺自带权重啊？脸红;1;0;1;18388;5.438329345225147e-05
92363;按哪个键进入文生图页面？;1;0;1;18388;5.438329345225147e-05
92365;我建了个GPT群，想加看我个性签名或者私信我;1;0;1;18388;5.438329345225147e-05
92367;请问生成图画的这个界面是下载安装的还是在线的？有链接吗？;1;0;1;18388;5.438329345225147e-05
92369;up主，问一下你的显卡是什么型号，一张图片那么快，我1650要接近2分半分钟;3;0;3;18388;0.0001631498803567544
92376;怎么生成的图像？用的什么？;1;0;1;18388;5.438329345225147e-05
92380;官网好像是挂了;5;0;5;18388;0.00027191646726125733
92386;为什么我的ai经常生成很长的句子，然后ai绘画就识别不了了;2;1;3;18388;0.0001631498803567544
92390;这个ai绘画是什么网站啊;1;0;1;18388;5.438329345225147e-05
92401;这个AI要钱吗？;1;0;1;18388;5.438329345225147e-05
92405;为什么在appstore都没有这个AI呀？;1;0;1;18388;5.438329345225147e-05
92414;这个画图的是啥ai？;1;0;1;18388;5.438329345225147e-05
92417;现在ai会画手吗在哪更新我的怎么还是不会画;2;0;2;18388;0.00010876658690450294
92420;bgm是啥;1;1;2;18388;0.00010876658690450294
92422;这个绘画的网站是什么啊doge;4;1;5;18388;0.00027191646726125733
92427;请问BGM是什么？;2;1;3;18388;0.0001631498803567544
92430;输入同样的句子，ai只会翻来覆去回答我：很抱歉，由于多种原因我无法满足您的要求。首先，作为训练有素的语言模型，我不具备看到或描述视觉图像的能力。我只能处理和响应基于文本的输入。;1;1;2;18388;0.00010876658690450294
92432;bgm是什么啊，好好听;2;1;3;18388;0.0001631498803567544
92436;求一下up的负面魔咒;1;1;2;18388;0.00010876658690450294
92438;ai不能直接理解什么是nai的tag吗，网上有一些这样的资料了吧，还是说数据库没更新;3;1;4;18388;0.00021753317380900588
92443;这个生成图片的软件是什么;2;1;3;18388;0.0001631498803567544
92447;ai画的总感觉有点阴间。。。;1;0;1;18388;5.438329345225147e-05
92449;求你的负tag;1;1;2;18388;0.00010876658690450294
92454;up用的是哪个模型啊，效果很不错嘛;1;1;2;18388;0.00010876658690450294
92456;龙兜不管在哪ai绘画都好可爱doge;9;595;604;18388;0.03284750924515989
92466;大野木：凭啥我连人都不是了？;5;321;326;18388;0.017728953665433977
92472;小胡子直接变异三只手了是吧0113;3;124;127;18388;0.006906678268435936
92476;ai就会画那几张脸，看久了就没意思了;2;96;98;18388;0.005329562758320644
92480;BV1aG411u7za这里是所有啊A忍，花一下午弄出来的2233娘吐魂来看看吧2233娘委屈;1;20;21;18388;0.0011420491624972808
92482;带土变面麻吃瓜;1;16;17;18388;0.000924515988688275
92487;我想看飞door啊哈哈哈（鬼渐音）;1;4;5;18388;0.00027191646726125733
92489;自来也还原度挺高;1;7;8;18388;0.00043506634761801175
92491;有几个木叶护额也是ai画的吗，它怎么知道这个主题是火影的（诚心发问）;2;4;6;18388;0.0003262997607135088
92496;Al画一张要多久;2;3;5;18388;0.00027191646726125733
92500;UP主加油看好你噢;1;1;2;18388;0.00010876658690450294
92504;求ai绘画软件或网站;1;1;2;18388;0.00010876658690450294
92509;带土那个，好像鸣人佐助的儿子（）doge;1;5;6;18388;0.0003262997607135088
92512;可以发个图片吗doge;1;1;2;18388;0.00010876658690450294
92516;举报了，标题党，明明有个b忍dogedoge;1;2;3;18388;0.0001631498803567544
92518;总结：ai除了画年轻的脸其他啥也不会;1;1;2;18388;0.00010876658690450294
92527;大佬可以把图放在动态吗;2;1;3;18388;0.0001631498803567544
92531;加油;1;1;2;18388;0.00010876658690450294
92536;up主求龙兜的那张AI图打call;1;1;2;18388;0.00010876658690450294
92555;为什么你的大蛇丸跟我的大蛇丸不一样;1;0;1;18388;5.438329345225147e-05
92558;想要弥彦的那张星星眼星星眼;1;1;2;18388;0.00010876658690450294
92572;什么软件？;1;0;1;18388;5.438329345225147e-05
92576;求猫娘兜的图;1;0;1;18388;5.438329345225147e-05
92581;这是什么软件画的？;1;0;1;18388;5.438329345225147e-05
92583;标题打错字了doge;1;1;2;18388;0.00010876658690450294
92585;有龙兜的原图吗吃瓜;1;1;2;18388;0.00010876658690450294
92587;什么软件？;1;1;2;18388;0.00010876658690450294
92590;有图包了喊下doge;3;26;29;18388;0.0015771155101152925
92610;白羊座怎么这么贫，我要喝羊奶我要喝羊奶生气生气;1;0;1;18388;5.438329345225147e-05
92626;站在原画师的角度想告诉一部分人：我知道料理包很好用但你也不能说自己就是五星级大厨了啊。没了料理包你能炒的出菜吗。;78;1882;1960;18388;0.10659125516641288
92705;AI做错的就像是：你做了一个配方，被一家无良公司偷走了，然后低价卖给别人看到有人用织布机的事情和抵制AI比较，织布机可没拿走纺织工家里的布，AI是给你把布都偷走了AI的存在合理，但是偷别人的东西不合理，AI公司应该买下来画师图片的版权再用它们训练，而不是私自用别人的东西训练保卫萝卜哭哭;56;1255;1311;18388;0.07129649771590167
92762;我听过一个美术外包老板出过这样的话：以后不听话的合作画师，就把他的作品投喂AI。;36;608;644;18388;0.035022840983249946
92799;作为搞过AI的计算机专业者来讲一下现在的深度学习网络，从哲学视角上讲更像是一种人造器官。这些AI是用一种仿似人类大脑某块区域来架构，并以仿似人类神经系统生长方式培育的人造脑区。它们对应于人脑的外设部分，负责处理视觉、听觉、语词断句等，其中不包含意识也没有决策能力，更不可能诞生智慧和自由。落实在目前的前沿研究方面，深度学习非常擅长处理“识别”“辨认”问题，不擅长处理“创作”问题，对“逻辑”“决策”问题束手无策。;50;404;454;18388;0.024690015227322167
92850;我希望所有AI的绘图会有水印，或者必定生成一个可以查询是否由AI绘制的可查询处;11;289;300;18388;0.01631498803567544
92862;其实最好是把人跟非人创作的作品区分出来，现在威胁的不只是绘画。拥有如此庞大的数据最终目标一定是朝视频发展，其实现在的Al配音已经和真人区分不出来了，配音行业有一部分人在抵制。因为你只需要让它一次采集位到那你就终身失业了。;8;150;158;18388;0.008592560365455732
92871;我作为一个底层画师最有感触，大学毕业，在一堆二次元角色中间杀出来，想着只要努力就能变成大佬，现在看见ai已经很迷茫了。本来绘画投入的成本极高，除了那些顶层画师，普通画师天天996赚的钱也没多少，能干原画的基本都对画画有着极大爱的，现在已经很迷茫了。哎，底层画师也没发言权，都盼望着底层快点死，我又不是漫天要价的小画家，就被一棒子打死了。撑过了好几年知乎微博的各种行业劝退，却没顶过这几个月ai抱脸。;10;153;163;18388;0.008864476832716989
92882;服务器，我一个星期生产了将近五万多张图，测试两百多个模型，各种各样的都有，只能说现在这个东西还有点太垃圾了。啊没有图层系统，没有空间预测，那甚至连补图做的都不怎么好。我预想中的最终进化是：有基于3D的透视检测（可以自己调整透视点），有图层系统，计算遮挡关系（可以设置很多个图层，然后综合遮挡关系生成一张图片。这样的话就不会因为某些东西被挡着，从而导致整个东西消失），拥有每个部位的标定功能（比如可以标定这一块区域，生存手，生成手指，生成头发等等，配合图层系统，各种遮挡问题和手不好的问题将会被完美解决），自动生成线稿和允许标定颜色（可以只生成轮廓线，然后由人拖拽色块，来给区域标定颜色）;32;138;170;18388;0.009245159886882749
92915;画画很累，要学习太多东西而且基本上是一个终生的过程。画画没有向任何人技术封锁，谁乐意练都能练成。但是不劳而获永远是最爽的呲牙;3;123;126;18388;0.006852294974983685
92919;这些艺术家不是很懂商业和政治。如果要反对AI利用图源，那就必须把这个问题明确化，把其他问题的态度也得说清楚，比如AI作为辅助工具、AI作为个人创意、公共图源的使用等，这样才能让共同理念的人站在一起，而不是无限扩大范围拉长战线。现在虽然本质是反对白嫖图源，却把“反AI”直接作为LOGO，就显得打击面太大，诉求也被模糊了，感觉很难成功。;10;113;123;18388;0.006689145094626931
92930;如果各位看看了请大家耐心看下去。我首先反对ai，但这里想曝光451的画师samyang，他去年在未经授权的情况下盗用了国内小姐姐的一张照片，照片里小姐姐穿着中国武侠装，然后samyang转头就把照片临摹成画发布在了推特上并带上了日本武士服的tag，这导致小姐姐的权益受到了侵害，也导致了中国文化输出收到损害当时真的有日本人以为是武士服还在下面提出建议我去年微博被他拉黑了，希望大家周知此事，不仅抵制ai，也要抵制劣迹画师，谢谢大家;4;97;101;18388;0.005492712638677399
92935;还没看到ai带来的进步，先看到了某些人败坏的道德。;20;868;888;18388;0.0482923645855993
92956;1431任天堂和迪士尼两大法务部出手了，可惜的是，他们不是对着ML（机器学习）本身出手。;66;46;112;18388;0.006090928866652165
93023;近年来人们对于道德的看法越来越离谱了甚至觉得这是对的很多人都觉得人吃人是正常的行为大家都这么愿意活在地狱里吗;37;507;544;18388;0.0295845116380248
93061;AI取代不了艺术家，但是会扼杀底层成为艺术家的可能性，而且会让绘画被资本垄断，前段时间那些和绘画饭圈化有关的垃圾综艺已经够恶心的了，资本还想动更大的蛋糕。。。。。总之，资本家不配，捡AI吃画家剩饭的也很恶心，你那一元十张的AI画还不如要饭来得体面喜极而泣喜极而泣喜极而泣;4;465;469;18388;0.025505764629105938
93066;原来艺术可以用简单的工业化来解释，看来很多人根本不把艺术家当人，也没有把自己当人啊;60;423;483;18388;0.026267130737437458
93127;作为一个计算机相关专业画师副业的普通人，我已经对一般大众的道德水平和审美能力失去任何信任了。之前还会跟人解释一下ai制图和人类绘画创作有本质区别，现在也懒得了。没用，也没意义不过这件事总的来说也让我回归了我画画的本心，渡过了emo期水平反倒提升了一截，挺好笑哭;54;291;345;18388;0.018762236241026756
93182;我们从未预料到AI“危机”会以这种方式出现，AI被自以为是的小人利用，伤害他人的权益。乌托邦不可能存在的根本原因之一就是人类强大的劣根性。;26;261;287;18388;0.01560800522079617
93209;为什么一群人在热捧AI，那是因为AI还没有触及到你的利益，AI的进化更要规范化。而不是轻而易举获得别人的成果从而获取利益。假如AI更简易化能自动贩卖模仿的图片时，那AI画家作为的人也会被取代。;5;195;200;18388;0.010876658690450293
93215;想要解放生产力，好歹先从彩漫流水线和动画中间帧工人解放开始吧，这些人才是真真正正的底层绘画民工，重复的纯手工劳动，没有一丝的创造性工作。只要明白如果这两类人没被取代，商业2D绘画永远就没有aibot插足的余地，目前的ai绘画和支持取代论的小鬼就是纯粹恶心大环境的人而已。老实说我根本不看好目前这个ai这个扩散模型原理的前景，要做的事情全是糊弄，不该做的事情乱七八糟自己乱加，画蛇添足就是对目前ai制图最好的评价。非常期待两年后是谁在桥洞底下哭。;15;203;218;18388;0.01185555797259082
93231;绘画是一件沉没成本非常高的职业，很多人学习多年，也赚不了几个钱，ai的出现更是大大的提高了这一点，以后的大环境很可能是除非达到顶尖水平，其他水平的画师将很难生存，cg画师将会骤减，可能过个120年，ai仍然在用着120年前学习到的画风，而真正喜爱绘画的人可能会回归传统美术，在实体材质上进行创作，毕竟ai生成的再好，也没法打印出油画、水彩的质感，而在实体材质上作画，也很难达到游戏美宣那种绚丽的效果。等我们生活中充斥着各种被ai用烂了的画风后，这些之前使用ai的各种公司，想要脱颖而出，又不得不花大价钱找真人画师，这就是一个轮回。就像古代到现代的演变一样，以前的绘画，是有钱人才能碰触的领域，而到了现代，大家都可以学习绘画并养活自己，ai实际上就是强行把绘画拉回了古时候，在ai盛行的时代，画师生存环境恶劣，绘画可以算是一件高风险高投资但回报低的行业。;61;181;242;18388;0.013160757015444856
93293;“AI只会杀死那些不愿意提高自己的小画家”AI杀死了“小画家”，既所有没有个人风格的画师都被AI杀死了，有个人风格的活着，但主要原因并不是画风难学，单纯是因为个人风格强平时没啥人模仿自然就没啥素材让AI学习，为了还能走下去有些人尝试着开辟新风格，但是这条路将会掀起腥风血雨，有些人选择模仿个人风格强烈的画风，结果导致这种小众风格变大众了，AI有素材就学了，直接杀死这个画风的画师，而那些在开辟新画风里挣扎的胜利者，又会进入循环，直到再也没有画师能从泥潭里爬出来，就算爬出来了，也已经不是一般人能理解的东西了;19;40;59;18388;0.0032086143136828365
93313;对于学习绘画的人来说，AI绘画可能会浇灭他们的热情，对于底层画手来说，可能会失去饭碗，对于艺术大佬来说，面临的可能是作品被盗窃绑架，被勒索，实打实的被侵害，对于普通人来说，AI盛行之后我们可能很难再看到有创造力的作品，AI离开了人什么都不是，就像病毒杀死了宿主，自己也再活不下去;2;180;182;18388;0.009897759408309767
93316;AI是趋势，没办法阻挡。但AI的部分支持者有点离谱，他们盗取了艺术家公开的作品，拿走拼凑一番重新展示出来，还要嘲讽艺术家一生的努力毫无意义，明明用着人类智慧的结晶，还把人的努力贬低得一无是处。tv皱眉;1;139;140;18388;0.007613661083315205
93318;个人觉得即使是作为非画师的消费者，也不应该支持AI，至少目前来说很多AI的大型插画都只是表面上第一眼看起来好看的，实际上完全不能精准描述整体的背景细节、人物动态和全局光影，但是对于大部分的消费者，或者说是基础的使用者，可能很多稍微画点时间筛选和写描述词的图在他们眼里就是“看得下去的”。最终很大可能是，在商业项目中原本需要专业艺术家来画的图，为了节省成本，会使用AI的图，就像是现在远超一半以上的电影解说换成了AI没有感情的读词，然后搭配上那几个用烂了的音乐，但是对于大部分“下沉用户”这也完全足够了，之后再发展的情况就是原本要求较高的用户将不可避免的被越来越多粗制滥造的内容淹没，整个市场会被裹挟着进入低成本的下沉螺旋，资本却对这种情况毫不在乎，消费者在完全没得选的情况下，也就慢慢接受这种现实了，不用说我危言耸听，现在全世界的影视、游戏行业都是在往重技术，轻文化、艺术，然后工业流水线似的生产低意义的内容的道路上狂奔;22;141;163;18388;0.008864476832716989
93341;我觉得现在在绘画方面像是回到了150年前普通人没有什么要求（自己用ai能勉强画），主要服务于贵族（有愿意花钱约稿，希望获得精美画作的），普通人很难学（没有资金支持），只能说挺可悲的;13;70;83;18388;0.004513813356536872
93355;有人抢了别人是东西，然后说是机器人偷得，人抢东西是违法的，但是机器人抢东西不违法。;15;23;38;18388;0.0020665651511855556
93371;所以那些高喊ai代替画师的人是觉得自己的工作是有多高的不可代替性吗。;3;65;68;18388;0.0036980639547531
93375;有没有一种可能，AI绘画根本就不是绘画根本不配出现在绘画交流网站上。;3;26;29;18388;0.0015771155101152925
93379;我早就说啦，资本家一定会重金去追逐这样的技术，即使最终质量和人类有差距，甚至差距还有点大，因为这样AI是成本很低的，炼丹么。扩大产能，拉大集群就行，画师还要养老还要医保，还要休假，吃饭睡觉打豆豆。AI只要你通电，多了关机，少了开机，可伸缩的，部署丝滑的。对科技史有一点的了解的人就会知道，技术就其本质来说就不可能是中性的。资本为了降低成本一定会allin这门技术，然后质量不行怎么办？那就是大家都用AI，就拉低质量呗，反正消费者观众没有选择。80，90年代的手绘动画看过么？多么美轮美奂现在呢？因为没有好质量的作品了，难得有个稍微及格的都会被吹半天。文明发展是曲折的，不是永远进步的。要明白我们消费的文化产品的最终目的，是人精神的享受和满足。但是这都被异化了。我自己就是AI研究者，我毫不客气的说，现在的研究者就是被圈养的技术婆罗门，财阀控制的技术种姓制度在无情蔓延。我当然希望AI技术能够做真正好东西，能真正为人类解决问题起到关键作用。但是现在科技进步，是被资本集团引导的。我们作为消费者要勇敢的表达，好就是好，不好就是不好。让这个行业丰富而非归一AI和画师互相互补，而不谁杀了谁。当然很难的，这种事先要剔除剥削者阶级开始。否则不可能的，再来就要元宇宙了，给你一封装，你作为被喂养的肉猪，就再没有什么价值可言了。给你插个管子，你享受虚假受控的荣华富贵人生圆满，你上头的阶级和你享受的毫无差别，我们都有美好的现实。就问你们要么？我是不要的，我要为了所有人的真正的自我实现而奋斗终身;2;68;70;18388;0.0038068305416576026
93382;复制一下我之前的评论希望各位明白吸血爬虫生成类ai不仅仅是视觉ai非常危险，不一定带来什么光明未来，消解人本存在和人类价值性会造成非常严重的后果。;35;174;209;18388;0.011366108331520557
93419;可笑的是，一些用ai生成图的人，还好意思标上原创，禁止二创，版权所有。Ai有个屁版权。还自称为Ai绘画艺术家，竟然还卖Ai绘画课？？我寻思这东西还要教？;1;42;43;18388;0.002338481618446813
93421;其实正常生态应该是原作者给AI吃自己画的图，培养一个AI助手然后辅助作者作画。现在这种情况，跟抄袭没有区别，这也是大家讨厌的原因。;2;42;44;18388;0.0023928649118990647
93424;个人的情感上来说，现在的人类发明了汽车和飞机，大部分人仍喜欢看运动员在赛场上追求更快的速度，更优美的动作，而且不会嘲讽不是第一的运动员说：“又不是第一，有何实用性？汽车飞机不比你快？还可以载东西。”而且痛恨打假赛，当你看到那个让你欢呼雀跃的人，其实是个高度仿真人的机器人呢？比如有些人喜欢偷看别人的日记，那个人的文笔的并不是太好，比起大作家就是逊了，他却依然喜欢偷看，AI是代替不了这些感觉的。从画师的角度来看，你用我的作品凭什么不交我钱哈？连我的名字都不提，一部分画师不是根本不想要让AI画，而是让AI作画制定相应的法律。来规范AI作画。;8;135;143;18388;0.00777681096367196
93435;现在中国大多数人还是认为艺术就是表现好看（视觉美）的东西，这里有两点问题：1好看的东西未必是艺术，也可能是色相2精妙的东西也未必是艺术，艺术最根本的是触及人性中知识和思想不能触及的部分，激发一种不可言说的状态。在我看来Ai艺术根本影响不了真正的艺术家，只会影响一些画行画人;2;38;40;18388;0.0021753317380900587
93438;感谢您做这个视频，当有人说“抵制的都是低级画师，那些厉害的画师根本不在意”的时候，我就可以把这个视频甩到他脸上了;1;32;33;18388;0.0017946486839242985
93440;我其实更悲观，我觉得大部分资本和人性是无下限的。预计不出十年，人工智能就能代替大部分人的职业。到时候怎么存活都是一个问题。说到底，现在资本都把人当工具，未来这个工具不好用了，那只有换咯怪我咯;5;14;19;18388;0.0010332825755927778
93446;抢夺他人正当的劳动成果，非常无耻;9;90;99;18388;0.0053839460517728956
93457;我也是一个AI绘画爱好者，最恶心的是这个技术被泄露出来的第一时间，国内各大皮包公司马上把人家开源的代码一复制到自己服务器上面搞付费跑图，还什么VIP解锁画风，微信小程序关注，付费获得私人存档什么的，我就知道国内互联网公司已经臭掉了;1;89;90;18388;0.004894496410702632
93459;这不就是卢德运动的高度再现吗，无论精神还是表象都极度类似，不难想象到，其实到最后，最害怕这种技术得到广泛应用的，实际上就是无法转变自身思维的那些名声在外的画家。而且近年来绘画行业的发展其实有着行会化的现象，一直以来的高准入门槛和劳动力成本的居高不下必然会将资本引向别的要素中去。倒不如说新技术对这些行业的冲击是必然的，而这种所谓的反AI运动最终也将影响一个徒劳无功的结局。而且绘画行业首先受到冲击，也是因为他的垄断程度相比唱片行业不高，所以从这种角度来考虑，ai对绘画行业的冲击是不是来得太早了？所以我更倾向于将这种冲击视为一种偶然现象，因为相关法律稍加约束就能暂时解决矛盾。但是换个想法，无产阶级的力量壮大了，社会主义离实现越来越近了doge;83;54;137;18388;0.007450511202958451
93543;艺术是对我们脑海中美好的事物艺术性（创造性）的加工，而ai只是对艺术本身拙劣的似是而非的模仿，这怎么可以相提并论;8;28;36;18388;0.001957798564281053
93552;全世界艺术家们，联合起来;6;38;44;18388;0.0023928649118990647
93559;要防止的是垄断，保证良性竞争。例如一个商家向20多名画师发布插画设计委托，甲方很满意，但嫌贵，于是把带有水印的插画投进了AI画画工具，得到类似画风的图画做成插画集售卖。画师受伤的世界完成了。类似的事情应该得到制止。;5;23;28;18388;0.0015227322166630412
93565;2022版法国大革命，明治维新，南北战争doge;12;24;36;18388;0.001957798564281053
93578;社会的发展就像树的生长一样，树根与树干就像社会上的物质基础一样。越广、越大、越厚才能支撑得起树枝与树叶所生存的养分。而绘画行业就像树枝的其分支的一方面，它的存在可以养活一部分树叶，来缓解日益增长的就业压力。但是在社会物质基础并不丰厚的情况下也就是社会物质基础增长缓慢而导致的社会就业压力依旧逐渐增大的情况下。强行切断其分担压力的分支，从而加重其就业压力的操作，我属实没看懂。（解释：“首先，如果你要跟我扯，这是技术的进步那么请问，技术的进步是为了谁？这个技术的进步，能够为我们增加就业岗位吗？不能我们人首先得活着，懂？如果连活着都做不到，我管你tm的技术的进步”“然后你硬要跟我扯过去，那么请问过去能够跟现在比吗？时间观念，你忘了”“懂不懂什么叫做今时不同往日？”;8;23;31;18388;0.0016858820970197955
93589;我是特别反感ai的不是因为没有灵魂而是他们把活生生的肉体撕成碎块再拼接起来;5;20;25;18388;0.0013595823363062867
93595;作为从业者，这玩意只是个工具。好处是可以给甲方模拟效果图不用自己白画。外行就是啥也不懂看热闹乱几把叫，要是这东西能完全取代人那也是几百年后的事情的。杞人忧天是什么意思知道吗;14;29;43;18388;0.002338481618446813
93610;已经有头脑不清醒的画师用ai交商稿了，怎是一句小丑得以形容的;2;28;30;18388;0.001631498803567544
93613;ai争论最热烈的那段时间我找过一个自称ai艺术家的人帮我生成一个简单的构图，他技术确实很厉害，但是连平涂和厚涂的区别都不知道，也缺乏二次元审美，200张图没有一张符合我对画面的预期。ai发展让太多不是这个领域的人想进入赚快钱，他们想的有点简单了。;1;9;10;18388;0.0005438329345225147
93615;之前半佛有期视频说的很好，AI在画画中可以充当甲方和乙方之间沟通的的过渡，甲方想要什么效果，乙方可以用AI来生成一些类似的效果，让甲方选择最好的效果并以此来重新作画改进;6;9;15;18388;0.000815749401783772
93622;版权问题还得看国外的艺术家去抗争了，国内根本没有这种舆论条件辣眼睛;2;56;58;18388;0.003154231020230585
93627;现在还是弱AI吧，连人用餐具的手都画不好，不少人借机对艺术家落井下石，能随意鄙视他人劳动成果，还真以为艺术家的末日到了？乐了，等吧，如果强AI出世了，众生平等，到时候是所有人的末日，到时候失业了，不知有没想过当初是怎么幸灾乐祸别人的;3;56;59;18388;0.0032086143136828365
93633;我想说的是我今天看了一个讲座，其中就网易的工程师，网易内部已经在使用大模型辅助工作，提高效率了。网易用自己的模型来辅助制作场景原画，NPC立绘，人物服饰以及各种UI绘制。网易缺版权，缺数据吗，根本不缺，他积累的足够多，实在不行还可以让员工画，效率大大提升了。网易还有AI写词，作曲，编曲呢，人家怕版权吗？也不知道有多少人能看到，奉劝有些人别做梦了，AIGC势不可挡。;9;23;32;18388;0.001740265390472047
93643;我个人认为AI最大的缺陷是不会表达，只会根据给定的要素和范围描述。AI控制不了画的细节和具体的内容，只能做到看起来好看。;1;16;17;18388;0.000924515988688275
93645;ai肯定是不可阻挡的，这是算力发展的必由之路，所以，大家应该学会使用ai;14;21;35;18388;0.0019034152708288013
93661;有一个很简单的逻辑，是外行人不懂的，所以外行人觉得AI合理。首先，所有人类认为好的作品，画的好的图像，创意报表的画作，都是通过十几年，几十年，并在这基础之上可能还有一点天赋汇聚而成的。不单单是一张图的问题。而，AI盗取或者说生成某一个艺术家的风格，是因为该艺术家的风格厉害而导致生成的这类作品有了价值。那么通过几个礼拜，你就窃取了别人甚至一辈子的经验，并且只是无情拼贴而已。那么这就是一种利用别人的劳动，智慧给自己谋利的行为。其次，从绘画学习的路径来看，除非是专门的艺术品修复或者画假画，否则一个人在学习任何一个人的画风都不可能完全一样，甚至会衍生出新的画风。因此，人类学习画风并不会遭到抵制。AI不会创新，他只是拿现有的图，现有的艺术家的作品，原封不动的组合。你不用跟我提什么他的生成原理，从结果上来看，就是这么一个机制。生成原理只是说让这个软件能够生成出人类的绘画作品，而不是绘画出一个作品。最后，现在AI玩家不停用别人的思考，别人的画面，自己随便搞一下就号称是自己的作品，甚至更加恶劣的行为。我甚至都碰到过高中生来嘲讽我一个专业画师画的不如AI，但是事实上我肯定比AI强大的多，但是比起用大师的画训练出来的，我又怎么可能比肩呢？但是这并不是AI的功劳，不管是比我画的好还是比我画的差的AI作品，都是建立在他窃取，复制，重组另外的画师的作品，跟AI本身的绘画水平并没有关系。而，AI轻而易举的取代了新手画师的地位，那以后将不会存在新生代的大师，那，绘画艺术也就死亡了。;1;14;15;18388;0.000815749401783772
93663;人是不可能打过机器的，这已经一而再再而三了，所以无论怎么折腾，最后ai变成广而用之将会是事实，考虑后面画师行业怎么活才是重要的首先，你无法证明ai抄袭了你的绘画，因为经过模型的手输出结果不可能百分百一样，而模型本身是黑箱没有人知道你用了什么东西训练，因此诉讼不太可能解决问题，立法将会漫长且难以执行（没办法监督）其次，ai绘画确实可以提高生产力，降低门槛，这就意味着画师注定被动，无论怎么折腾，无论怎么宣传自己有多重要，因为这在技术提高生产力目前无能为力在这里我要提点个人意思，我看了不少ai绘画，这玩意确实乍一看没看穿，这已经很离谱了，也是为什么造成现在局面的原因，在此先表示同情毕竟有人要失业的可能性很高。但是也请艺术家不要太自视清高了，在我大量跨领域的操作里，被各领域其他人利用信息差玩弄，最后愣是利用公开资源学到和人家能盘盘道才不被坑的事情，实在是太多了。绘画也是如此，如果有另一种手段对抗信息差或者说难听点的信息垄断，那么确实是对大部分人有利的，不是每个人都有时间练出绘画，但是ai可以绕过这个问题。在道德层面进行谴责毫无疑义，而其他途径要不慢，要不技术层面极难检测（就像私人训练完全没办法识别）;138;55;193;18388;0.010495975636284533
93803;以后大家看的动画打的游戏买的画都是AI做的，劣币驱逐良币，AI驱逐人类赛博朋克;34;15;49;18388;0.002664781379160322
93839;现在黑客把公司的程序泄漏出来了，情况是更好了还是更坏了？;4;6;10;18388;0.0005438329345225147
93847;我觉得以后版权制度会管的很严，画师自己画的画可以选择免费放出和需要版权，ai拿画来绘图都需要交版权费，违规可以被起诉到倾家荡产吃瓜;1;11;12;18388;0.0006525995214270176
93850;现阶段的AI需要大量同类型作品来学习，说好听点叫借鉴，说难听点就是抄袭。但这其实并不是AI的最大弊端，我对AI持保留态度，是因为他让懵懂的孩子尝到低付出“高回报”的甜头，他最可怕的，是会扼杀了一群人对于画画这种理想的追求。如果AI成为主流，那将会看到，100年后好看顶流的画风还是这些，因为AI的兴盛会极大打击未来孩子对绘画的热爱，没有人去钻研画技，现有风格即是全部。以后即使AI创作出远超人类画工所能呈现之作品，也跳不出已有风格这个大圈了，虽然想法比较悲观，但我可以说，AI兴盛的那一天，即是绘画死亡的那一天。;1;10;11;18388;0.0005982162279747662
93853;我想出了一种办法，凡是上传的ai绘制的图片中包含了a画师的画风，则收费上传，向画师支付费用，并且出现3个月的版权保护收费的时间。3个月内图片再次被指出并确定存在b画师画风，则再收费，并延长（剩余版权保护收费时间05）的时间。相信我，只要不到3、5年肯定会有出色的效果图片成为硬通货;2;10;12;18388;0.0006525995214270176
93857;织布机淘汰纺织工人是一回事，那是生产力的提升，但是你AI是直接把别人织好的布偷走然后随便画两笔说是自己的啊AI驱逐了入门画师造成人才断层后，没有创新能力的AI只会照搬缝合（换句话说就是剽窃的连皮都不换），最后只会造成图画界的八股文。;3;12;15;18388;0.000815749401783772
93861;真的不容乐观。;3;5;8;18388;0.00043506634761801175
93868;AI的盛行只会导致大众审美下降。当市场为了快速提供产品而使用AI作画时，市场便会充斥着这些劣质的缝合品，除了压榨画师的创造空间之余，也会把大众的审美观念定格在这些AI的框架中。你认为不会画画的人可以利用AI表达自己的想法，其实是把自己框死在AI的语言中。唯有想象力才是人类的未来，当我们把自己限死在这些看似方便，实则在麻痹人类感知的工具时，艺术就没有文化的意义，只剩下娱乐这个躯壳。所以抵制AI并不单指侵犯了画家们的版权，事实上也会导致人类思维的转变。当市场认为AI比人类画师好用的时候，市场便会自动排挤人类画师，并由市场定义艺术，“艺术”就只剩下哪些没有故事、逻辑，只有感官体验的垃圾食物。而且当我们依赖AI去表达的时候，难道我们就不会陷入同质化的表达吗？那一个个的描述、文字tag都指向类似的答案。当绘画能用文字拼凑时，视觉上的独特体验、画者和观者间的联系也会被标准答案统治着。到时候真的是你在利用AI帮助你表达，还是你已经词贫得只能通过AI给你的画面说出“阿对对对”呢？;1;9;10;18388;0.0005438329345225147
93870;ai作图的技术至上和艺术家的技术至上之间的矛盾并非不可调和，但让这场绘画界的“工业革命”来得过早恐怕会引起并不局限于创作领域的变革。;2;9;11;18388;0.0005982162279747662
93873;作为一个靠画画赚钱生存的人从来没有感觉被影响或者说听说身边的人被影响。那群蛆虫天天拿着生成的那几张屌图说着什么取代取代的，你看看人家商业公司鸟你不？还是说你看见哪个公司真的把AI的图投入商业项目了？;1;9;10;18388;0.0005438329345225147
93875;人类的艺术是对自然的模仿提炼和变形，ai的艺术是对人类艺术的模仿和变形，而ai自己仿佛是活在一个楚门的世界里，它无法看到真正的自然是什么样子的，所以它根本无法匹敌人类，只是把人类嚼过的东西再嚼一遍而已，除了成本低以外没有任何优点。就能让很多人拿来赚快钱，就像那个纯ai的儿童绘本。以后摆在人面前的快钱文化产品和真正优秀的文化产品的比例可能就是100比1，讽刺的是只有拥有良好审美的人才过滤得出。所以ai带来的“打破艺术垄断”其实会加剧垄断，普通人闭着眼睛就能选出的好作品会越来越少。;2;9;11;18388;0.0005982162279747662
93879;StableDiffusionlitigationJosephSaveriLawFirmMatthewButterick这里记载着最新的法律诉讼行动。律师MatthewButterick提出，侵权问题的关键在于，认定diffusion技术的实质是无异于MP3、JPG格式的存储技术，则相关ai公司非法存储有版权图片，进而构成侵权。这是否符合技术事实？希望各位自行判断。;3;8;11;18388;0.0005982162279747662
93883;反正我觉得错得从来都不是科技和ai，而是想要用这些，来达到自己更方便偷窃他人成果变成自己的某些小人微笑;1;8;9;18388;0.0004894496410702633
93885;A画一画没事啊，这也是一个技术进步。只是某些人用那些APP随手生成了两幅图，然后到处说“这是我的作品”有点难绷;1;8;9;18388;0.0004894496410702633
93890;吸取你，利用你，然后淹没你，淡化你，最后人们只知道“哇，AI真好看”，却对那些原稿置若罔闻。另一种意义上的，小丑在殿堂大师在街头。微软小冰曾经就是这样吸取VSV资源并打压，然后整个生态圈直接给它禁止任何使用，源头上掐灭火种，并且反过来自己也出AI声库，算是驯服了这头野兽了。总之，希望绘画界也能打赢这场自己的战场吧，不过这里的不可调和矛盾和VSV的矛盾不同，这头是技术直接窃取知识版权，那边是一家公司利用技术窃取原本存在的另外几家公司的亚文化知识产权，想要反击的话直接禁止对方的翻唱就可以中断这种侵权。矛盾还是不一样。这里的矛盾在于，一家公司一个平台，利用新技术，去对已经存在的文化知识产权的窃取，而且你还没法简单证明“你用了我的画”因为我有一万种代码规避你的“作者词条”而依然能用你的画来训练，当然，这的矛盾到头来还是需要“把对方拖进所有人类创作者的汪洋大海”，直面这个不可调和矛盾。;1;8;9;18388;0.0004894496410702633
93894;抵抗ai是徒劳的，但是对受害者落井下石是愚蠢的。;2;8;10;18388;0.0005438329345225147
93897;“这是一个光学全防拍摄的特殊防爆玻璃，它采用了一种保密的技术实现了防止机械窥视的技术，同时人眼也能正常看到这幅作品”“这是什么作品？这技术和保护措施比这作品本身都贵”“哦你应该知道，这是我们艺术馆最后一个不能被AI复原的作品了，来源于这最后的人类艺术家”;1;10;11;18388;0.0005982162279747662
93903;就说一句话，如果不加以立法规范，我可以很轻易的用AI抄袭你们的任何作品。;6;7;13;18388;0.0007069828148792691
93910;AI真正会制造出的危机实际上应该是两点，1优秀的AI生成器被垄断，一般创作者没有能力低成本的用上，大型跨国公司完全霸占艺术领域。2AI接手了所有创作流程，以后再也无法看到饱含情感的用于作者传达自己的思想的作品，大众的享乐消费被极端快餐化的AI制品充斥（就如同现在的短视频到时还会比现在严重得多），以后只会存在一个重复的低级趣味的市场，到那时人们的思想会有多空洞可以参考赛博朋克世界观;2;7;9;18388;0.0004894496410702633
93917;到时候浏览网站再也看不到形形色色的画师在平台百家争鸣，只有aiai和反ai。（个人观点）;1;6;7;18388;0.0003806830541657603
93919;挺好的，艺术逐渐消失，ai也无法炼丹进化，。就如同文明消散一样吃瓜;1;6;7;18388;0.0003806830541657603
93921;p站上ai图的那点可怜热度就说明一切了，连观众都不喜欢，就更不用提画师了总而言之就是你用来出图，可以，但你要是去跳脸或者当生产力，那目前只能忍受冷眼;4;6;10;18388;0.0005438329345225147
93926;ai的问题是只能模仿如果没有人类画师ai根本生成不出东西;5;6;11;18388;0.0005982162279747662
93932;抵制ai不可能获得完全成功的，无论是抵制什么方面，抛开发明研究ai绘画的公司不谈，因为就算把他们干倒闭了，ai绘画依然在民间如火如荼的发展，因为民间有抵制ai绘画商业垄断的组织，里面的很多大佬会免费分享最新的破解资源以及不断的创造新的模型，就算正版倒闭了，保留下来的破解资源还可以发展，给它制作各种模型。可以说在同一串提示词下，有些好的模型出图质量十分的高，这些ai绘画反商业垄断组织才是热度最高的，因为免费;6;6;12;18388;0.0006525995214270176
93940;我一直都觉得，画师其实和AI本身的冲突并不多，最近的AI风波本质上根本不是人与技术的冲突，而是正常使用技术者与滥用者的冲突；不是人与技术的对立，而是人与人的对立。首先，AI创作迟早会成为数码绘画乃至整个社会文化不可分割的一部分，这是大势所趋，是历史走向，不是哪个人或哪个群体就可以阻止的。我相信大部分抵制AI的画师是明白这点的，他们实际上不满不是AI本身，而是AI严重挤占了他们的生存空间与表达空间这件事，而这件事仔细分析就知道其实并非AI发展的必然，而是多方人为因素导致的。换句话说，不是AI发展了画师就一定要死光光，二者在合适的条件下完全可以良性共存；是的，AI无疑会对画师造成冲击，每个行业的技术迭代都会导致冲击，但这些冲击本身往往不是致命的，让这些冲击变得令人无法接受的是社会因素。举个例子，很多人都喜欢拿纺织女工与织布机的故事还有工业革命期间工人砸机器的事来做类比去堵画师的嘴，我暂且不提二者在合法性上的区别，大家可以想想，为什么那些工人会去砸机器？难道他们是对机器本身感到愤怒吗？不是，是因为不反对机器他们就没饭吃了，就要带着家人饿死在大街上。这个时候就有观众会说，唉，那是他们自己跟不上时代啊，被时代淘汰虽然很残酷，但也是必然啊，他们自己不进步也没办法啊。对，这个道理没错，但是仔细想想，为什么他们没进步，难道真的有人心甘情愿被时代抛弃然后失去工作吗？难道他们真的是脑子愚钝只能想出砸机器这种烂办法吗？不是，是社会环境让他们没得选了，当时的社会环境失业就很难再有工作了。一个工人去哪儿了解高级机械学？可能根本没人告诉他有这么一门学科，而且他知道了这门学科又哪有时间学习？他们通常都要养活一家人，哪有时间和资源让自己转型。而这一切，都不是机器本身的问题，而是社会问题。如果工人每天都有大把时间空闲且社会可以给予充分的教育资源，那工业革命开始时大家就都做好转型准备了，最后淘汰的也只是一些真正跟不上时代的懒汉而已。;2;10;12;18388;0.0006525995214270176
93943;知己知彼，百战百胜。就目前网友对深度学习的一无所知跟缺乏常识的“抄袭拼接”言论，我对ai绘画的前景更看好了，你们这些反对者起码对敌人有起码得了解吧;16;12;28;18388;0.0015227322166630412
93963;这种情况很麻烦，因为否则出台相应法律，否则一些网站特别资本家肯定没有道德感，肯定更爱用ai图，因为ai图的效益比人力真的高太多，特别是现在全球国际化。ai时代法律也记得更新还有只有ai图能够被人肉眼识别出同人画的图的区别（我觉得我个人可以？？？），否则，ai图带来的价值就会超过人绘制的图片，即便事实并非如此。所以我认为未来人类手绘还有的一比。因为如果无法用肉眼识别出ai图和人画图的区别，那么资本家们就会以，ai画的图同人画的图没区别为由，来否定艺术家创作的价值。;2;5;7;18388;0.0003806830541657603
93967;我已经不指望大众素质能高到区分抄袭和原创这件事了。只想催AI开发人员赶快发布合成人脸的作品，快，赶紧，趁着版权的风刮得不盛，Pathon之类偷图多方便啊。妙啊前期悄悄把大众上传到网络的私人照大量拿去喂AI，这样都能随意生成照片了。吃瓜后期把AI改成在线抓图，紧接话术说AI无图库是AI产生了意识，主动拍摄的摄影作品，版权归AI，图片还可以叫人体艺术。又一条发财路啊是不是吃瓜吃瓜吃瓜吃瓜;4;5;9;18388;0.0004894496410702633
93973;ai生成图除了把创作环境搞的乌烟瘴气还有什么好处吗？连人的想象力创造力都可以如此不被尊重，现今的资本社会人已经不是人了，只是随时被衡量价值，随时都可以替代的工具罢了，最好的时代要来力;1;5;6;18388;0.0003262997607135088
93977;我听过一位专业画师花了3000小时画一副好画，结果却被众人说太像AI画的了而被骂，AI绘画真的毁了很多画师的心血;1;5;6;18388;0.0003262997607135088
93980;关键是艺术家们谁为穷人考虑过呢？穷人搞得懂艺术吗？穷人占大多数还是有闲钱人占大多数呢？就像中国是盗版软件大国一样，我不支持盗版也不拒绝没钱人使用盗版，不支持Ai也不反对喜欢画画但没时间精力学画画的人使用Ai。我支持穷人也能有自己的娱乐方式，也能有自己约画的途径，广西平均工资2000左右，谁为这些人想想呢？他们约得起稿，买得起正版软件吗？现在开源暴露了自己在家有好点的显卡就可以Ai画画，我也一玩就是几个小时，我不说为人类贡献了什么，我只能说为打工人下班后提供了其他娱乐来源，一棒子打死所有人都不好。抵制Ai不可取，滥用Ai也不可取，我只想说，给穷人一张便宜又好看，自己独有的一幅画吧，至少目前为止，我的图库里有几百张我不需要花一分钱，还很喜欢的画。;5;8;13;18388;0.0007069828148792691
93986;我们不要从AI技术不行的角度去抵制AI，因为技术永远在发展。我们应从以人为本的角度去唤醒何为人的认知。;2;6;8;18388;0.00043506634761801175
93989;网上发布的任何图像都可以拿去喂ai，人脸识别已经让很多真人明星的脸被盗去涩涩了;1;4;5;18388;0.00027191646726125733
93995;从游戏的角度来说，ai就是在开外挂，大众能容忍那我也没办法。ai作图抄袭拼接，后果就是越来越少人做原创，看看中国游戏发展吧，一堆换皮和玩法借鉴，什么时候能才出现伟大的作品。和大众真的没法解释，毕竟大众不了解也不在乎，只在乎短期得利。当然，ai作图有用的地方是提供灵感，用处也非常大，。说实话也改变不了什么，这就是命运。;3;4;7;18388;0.0003806830541657603
94003;我认为在未来的某一天，ai会拥有智能，能真正理解艺术，无论是在一千天之后，一万天之后，还是一千万天之后，仿生机器人面对人类的艺术品时都不会闭上自己的电子眼;4;7;11;18388;0.0005982162279747662
94008;以为视频是ai配音直到听到叹气和迟疑笑哭;2;2;4;18388;0.00021753317380900588
94011;快进到铁人叛乱吃瓜;1;2;3;18388;0.0001631498803567544
94013;我其实更认可技术人员的观点，ai的最佳使用者反而是真正的艺术创作者。想从版权之类的方面下手，把已经出现的ai技术塞回去恐怕也未必是一个更“进步”的方向。我觉得不如让专业人士尽快拿起ai工具，自己画图自己喂，ai画完自己修。直接从质量上击溃滥用ai的乐子人，新的行业秩序一建立，现在的乱象自然就停止了。;7;9;16;18388;0.0008701326952360235
94022;明白了，这就成立humanart的ngo，然后你们可以找我们认证确保你们的美术资源由人类创作，不过我们可能会收一笔小小的费用用于该ngo的运营;1;5;6;18388;0.0003262997607135088
94024;傲慢，艺术家傲慢，使用AI的人也傲慢。;1;5;6;18388;0.0003262997607135088
94026;说到底其实就是没给钱，既然是钱的事我们就只谈钱就OK，就不要扯什么的艺术，百分之八十的画家就是流水线工，比如说以后要使用某位画家的风格请付费;2;7;9;18388;0.0004894496410702633
94031;虽然现在才看到这个视频，但我还是想说几句，现在白夜极光已经用了ai图了，明日方舟也有嫌疑，我已经几个月没画画了，以后把画画当兴趣，准备转行滑稽;1;4;5;18388;0.00027191646726125733
94033;还记得一开始ai作画还是购买训练集或画师允许的，但后来嘛捂脸;2;4;6;18388;0.0003262997607135088
94038;脸红AI绘画不得授予版权或运用于盈利，大家合力起来共同反对;1;3;4;18388;0.00021753317380900588
94040;笑死，到时候拿着低成本劣质AI拼贴卖个高价，想想就好笑;2;3;5;18388;0.00027191646726125733
94045;我还是希望ai绘画不存在2233娘汗;3;3;6;18388;0.0003262997607135088
94053;AI抄图就跟盗版游戏一样，明明是你做的游戏，别人却盗了你的游戏，并赚得比你多，甚至可能你的“版权”也被扭曲，跟窃取劳动成果差不多;1;3;4;18388;0.00021753317380900588
94057;是这样的，我前些天下载了个ai模型，安装后tm的是一个病毒，一整个桌面全是这个禁用ai的标志，把我电脑直接搞废了，重装了系统才好，你反对归反对，但某些去极端份子是不是有些过分了;7;8;15;18388;0.000815749401783772
94065;天天在讨论这些东西的人都不是艺术家。他们死了不会对世界有任何影响。说实话，这是一个极其无聊的讨论。因为现在泛滥的模仿就发生在这些所谓“自由插画师”中间。;12;9;21;18388;0.0011420491624972808
94078;虽然我不反对画师们维护自己的利益但是我还是想说ai与画师的关系就像是汽车与马车一样与其在这螳臂当车不如去学一学新的技术，给自己找条出路;4;5;9;18388;0.0004894496410702633
94086;艺术是人类伟大的创造他不应该被AI所代替AI不是一切，AI不是神圣的，我们必须搞清楚人和科技的关系问题;1;4;5;18388;0.00027191646726125733
94088;AI作画竟然能成为问题，有些人是不是忘了真正在作画的到底是谁？;6;4;10;18388;0.0005438329345225147
94095;设想，AI进步没有这么快，即使喂了大量图片，依然只会画一些无意义的抽象线条，还会有现在这么多人抵制AI吗？如果你的答案是否，那你就不是真的想抵制AI侵权。设想，之前那些喂过别人图的ai统统销毁，今后ai只喂公开的，免费的，和经过授权的图，然后出图质量依然取代了大部分底层画师，你们还会不会抵制呢？如果你的答案是是，说明你也不是真的版权卫士，你真正想抵制的是被AI取代。;5;4;9;18388;0.0004894496410702633
94101;幾個圖層文件就能分辨的問題為什麼要搞這麼複雜，我也是ai的使用者，那些什麼靈魂，什麼縫合的問題只不是有些自身沒能力的畫師的藉口罷了，再說了，現在市面上大多數小畫師自己也不懂什麼靈魂的，他們的用處跟ai一樣，畫出來好看就行了。;5;8;13;18388;0.0007069828148792691
94107;0;1;1;2;18388;0.00010876658690450294
94109;你的道德是悬空的，评判标准是脆弱的;15;5;20;18388;0.0010876658690450293
94126;其实是行业面对先进生产力的阵痛，原本自视甚高的专业者，面对更效率，更廉价，更模式化的生产形式时，仅仅抱着自己的手工优势是无法抗衡的，最终绘画也会像刺绣和错金工艺一样，变为只能容下少数“大师”的行业，中低端的产出全部由更工业化的生产单位占领全部市场。而这些“大师”，其实也只是能够去满足更定制化的市场需求而已。;1;2;3;18388;0.0001631498803567544
94130;说不定某些资本已经有动作了比如全网到处去爬各种图或者直接去爬danbooru之类的网站然后闭门造车训练最后训练好了就直接把训练集的源文件全删了说我们这个模型用的都是经过授权的图哦;1;2;3;18388;0.0001631498803567544
94135;你知道艺术是什么吗？是将你的想法具象化吗？我不知道我一直有个疑问如果有一个人长久以来他都在用ai作画他知道该怎么改ai的图片使它成为跟正常作品一样假设他工作的足够长，那到底谁才是ai呢，谁才是那个工具，他还能像以前一样思考吗，他还能去追求艺术吗;2;2;4;18388;0.00021753317380900588
94138;前几个月在pixiv逛一对腐向cp的tag时发现居然有几张ai，而且那ai绘图完全不还原角色。。现在p站里人像的风景的，全龄的的几乎无处没有ai的存在，看得我审美疲劳了。但p站好歹能屏蔽标签。。。虽然我没有会员就是了;1;2;3;18388;0.0001631498803567544
94141;三体人首先对艺术届展开了攻击;1;2;3;18388;0.0001631498803567544
94143;这些偷图跳脸的人既对艺术有害也对ai的发展有害，现在画师对ai还算包容的，数据集也好找，以后该怎么办辣眼睛;4;2;6;18388;0.0003262997607135088
94152;懂了，炒油画的又赢麻了坎公骑冠剑无语，AI现在画得再好，也暂时是电子绘画而不是实体画;3;2;5;18388;0.00027191646726125733
94159;就好比考试ai做卷答完题最后考生签个名就交卷了拿了个100分签名跟答题的字迹都不一样的十年寒窗的同学会服？;1;2;3;18388;0.0001631498803567544
94164;我认为问题是，这玩意最终能不能被工人、劳动者掌控，还是被资本越过工人这一层直接获得产品，这个才是最重要的问题。;6;2;8;18388;0.00043506634761801175
94171;这种趋势已经难以阻止了，基本一两百年以后人类本身的创作能力就会被限制甚至退化了，这可能不是危言耸听。文化的传承一旦断绝，想接续起来就很难了。每一代的艺术家创造的艺术影响了后续时代的审美，当下一个时代的审美是由ai塑造的时候，人类将很难打破这个桎梏，潜移默化的慢慢走进死胡同，在错误的方向不停的打转。就犹如人类自己创造了智子封锁了自己一样。;1;2;3;18388;0.0001631498803567544
94174;我看有些艺术家用AI做初稿，然后自己上手完善细节，这算正当利用吗？AI引擎背后是被爬虫的百亿张图片，这算某种抄袭吗？;5;2;7;18388;0.0003806830541657603
94180;版权问题确实应该解决，但是很多人对AI这件事情无限悲观和恐慌，一天到晚末日预言似的说什么：“你看看AI都已经战胜柯洁啦，AI无限发展一定彻底击败人类”这类的话属实是大可不必。AI技术目前也仅仅是在计算层面上击败了人类，现在在第二层“感知”上AI还是远远不如人类的，特斯拉自动驾驶出的事故，时不时跟智障一样的语音识别等等都是有力的证明，至于最高一层“认知”，人工智能现在连个门都没摸到，谈何与人类竞争？所以建议弹幕评论区很多人还是保持冷静，不要慌张，现在社会要做的仅仅是适应AI这个新事物，别一天天就想着人类在AI面前不堪一击。当然你一定要说未来AI总会超过人类的话，那我只能说再过足够长时间太阳还会坍缩呢，你要不担心一下太阳坍缩了人类怎么办？辣眼睛;1;4;5;18388;0.00027191646726125733
94182;人抄人的解决不了，AI问题就无从解决。法律不可能仅仅因为长得像就裁定侵权。况且艺术什么的本来对人其实就很奢侈，很多人需要的只是插画不是艺术。;3;4;7;18388;0.0003806830541657603
94186;哎，没办法，人类以后被ai取代，普通人将不会再有生存下去的权利，希望抵制能把这个时间延后到我这代之后吧;16;4;20;18388;0.0010876658690450293
94203;这玩意儿怎么抵制呢？干脆从源头上开始，喂画需要收费妙啊，ai收缴的费用会分给原作者一部分;3;1;4;18388;0.00021753317380900588
94207;新消息，美国版权局规定ai作品不受版权保护，这个会有什么影响;5;1;6;18388;0.0003262997607135088
94213;up现在进展到哪了，情况有没有好些，我对aigc时代还是有点害怕，现在真的没有动力画画，二轮复习也使不出劲;2;1;3;18388;0.0001631498803567544
94216;我们也是通过临摹喂出来的，但是我们在吃饱后不仅会拉还会吸收，而AI只会拉脱单doge;1;1;2;18388;0.00010876658690450294
94218;综述辛苦了。看完我的大脑感到无力，这个纠纷体现了现实问题的复杂和矛盾性，且看进一步发展如何，希望最终达到某种均衡的结果。;1;1;2;18388;0.00010876658690450294
94220;在这个时代，无论多么优秀的人才都可能被替代。就举个音频的例子，CD技术替代磁带和黑胶仅仅4年，数字音频技术替代CD更短。晶体管代替电子管也就几年，苹果打垮诺基亚5年，ASML光刻机代替尼康也就瞬间的速度，英特尔芯片弄垮东芝，数字技术代替胶片摄像机就1天晚上不应该和流氓讲道理，不要和强盗妥协，哲学和开放的思想在官司面前屁都不是。;13;1;14;18388;0.0007613661083315206
94234;抄抄时代开始了打call;7;3;10;18388;0.0005438329345225147
94243;谁支持ai谁就是制杖，完毕;1;3;4;18388;0.00021753317380900588
94246;这里的人真的是习惯自我权利被侵占了，以至于看别人被侵占的不够就要去踩上几脚，让对方变得比自己更惨才行。;5;25;30;18388;0.001631498803567544
94252;急得多是底层小画家，乐的多是普通乐子人。初音未来喜欢在人工AI没有触及到我相关的领域之前，我永远对AI的发展持乐观态度。你也不用急，我觉得历史发展进程中，很多东西被星星科技替代是早晚的事，当然我不认为AI绘画能取代人类的艺术。但这可不代表我认为你那种靠着大量枯燥模仿练习而出来的东西叫做艺术我从小就喜欢画画，但进过画室之后，对这玩意儿只有反感。;11;4;15;18388;0.000815749401783772
94266;我只能说AI绘画在我眼中很危险，可以想象的到未来的其中之一的发展我现在其实很反感AI绘画，从刚开始网上出现AI绘画时我就刻意忽略因为AI绘画是盗用了其他人的画风，然后在以自己的账号赚取关注，这是很气人的越想越气，唉我感觉无法阻止它，估计在完善的法律出现前得闹腾一番，估计得闹五六年甚至十几年几十年捂脸;4;4;8;18388;0.00043506634761801175
94271;额，理解不了，chatgpt也能写代码没见程序员抗议（虽然它主业就是个聊天程序），alphago打败人类后又被新一代的alphagozero轻松击败，棋手们现在还是该咋地咋地。到了画画就这么激动了按照现在说法，ai只会拼接融合画不出新东西，那不正好吗根本对人类产生不了威胁;6;2;8;18388;0.00043506634761801175
94278;什么纺织工人;1;5;6;18388;0.0003262997607135088
94280;原因很简单，Ai绘画影响他们赚钱了;9;4;13;18388;0.0007069828148792691
94291;我，悲观主义，大胆预测一波。以后的画师不会把自己作品发到网上，对画画感兴趣的新手也会越来越少，反正有了ai替代，只是ai以后不会再生产新的风格，人们也不在乎，人们的审美会降低，反正风格单一的ai已经足够满足人们低审美的需求。哈哈哈我以后只能准备去摆摊喽再见;7;1;8;18388;0.00043506634761801175
94299;很感慨，我也是学画画设计的，三年美术联考再到选视觉传达设计专业，原本以为AI发展再快也要很长时间才会波及到绘画设计领域，现在只能另寻出路，以前认为人工智能取代人类工作过于遥远，现在真的感觉自己太天真。我对AI绘画是能平静接受的，因为我明白它迟早会取代目前大部分人的工作，蛮担心自己未来处境的。;1;1;2;18388;0.00010876658690450294
94302;ai明明没有版权，更不可以商用，闲鱼上那些用来交易商用的，是不是可以举报起来啊？;2;1;3;18388;0.0001631498803567544
94308;评论还没了;1;1;2;18388;0.00010876658690450294
94316;物以稀为贵，大幅度降低门槛能被更多人使用的结果就是巨量贬值，绘画会失去现在的价值。;1;1;2;18388;0.00010876658690450294
94320;Ai绘画或许是未来，但人不会被淘汰，虽然确实会淘汰一堆低端画手;2;1;3;18388;0.0001631498803567544
94326;是应该把AI的作品和人画的作品区分开来。;3;1;4;18388;0.00021753317380900588
94333;能够投喂剧情就彻底完蛋了;2;1;3;18388;0.0001631498803567544
94341;我不能理解假如有人和你说有一台AI它主要分成两部分一个生成器一个打分器其中打分器的目的是模仿人类审美而生成器负责利用参数将一张白噪图像转化为可供打分器打分的图像。然后有意思的事情来了，数学家的思考使得打分生成的过程可以被揉合在一起。这意味着对AI而言，审美本身就是创作。而没有经过训练的人类，是做不到将他所想象的美景绘制到纸面上去的。这很重要，这一点特别重要，因为绘画本身是一门需要学习的技术，这一门槛使得众多人只能成为观赏作品的人而无法成为创作者。你可以想象一下，如果没有人类本身对艺术作品的筛选，没有人类本身的审美能力，艺术这一概念还会存在么？;11;1;12;18388;0.0006525995214270176
94354;我只是一个刚入门的二次元插图爱好者，一开始一大堆人抵制ai或是支持ai，我并没有感觉。因为ai对我而言就像是一个玩物，他就算画的再好，也难登大雅之堂。我也从未用过ai制图，我觉得画画的技术还有美学是需要自家去不断地做，才能传达的。ai只是拿了别人的东西，把一些旧的东西组合重置罢了，它可以成为我画画的参考，但是绝对不能成为我所创造的东西。一群用ai制图的人，并不热爱创造以及不愿意日复一日的下苦功，他们只是为了赚钱罢了，他们热爱金钱，资本以及不劳而获的快感。因为优秀的，愿意下苦工的只是少数人，一群狂欢的人群，本就是乌合之众。;1;1;2;18388;0.00010876658690450294
94358;这种技术扼杀内行忽悠外行本来绘画创作游戏动漫就是人们实现虚拟世界的一种手段快乐就完事儿了这个AI出现了之后先是告诉所有艺术家我是最牛的你们都别干了然后给外行人看说他一秒钟能画无数数张精致图就是手画不好而已然后这帮没眼光的人们就被忽悠了几年后从业者如你所愿一个个转行卖煎饼果子送外卖哈哈哈叫你们搞艺术傻眼了吧这时候的AI还是那一套永远那一套数据库让我们见证艺术的消亡人类本身就是废物机器不如AIAI才是这个世界的主人人的任何想法都是为AI提供数据而已你说说造出来这个东西和克隆人技术也差不多都是伦理bug就以为比人强还不用吃饭睡觉永远踩着人类人工智能的发展就是反人类社会一个没有欲望什么都会干的机器能给人类留下什么能到时候你人活着都没意思了况且现在他并没有什么造福人类的实质表现新冠并没有因为人工智能的出现而帮助人类抵抗病毒医疗也并没有因为人工智能的出现改善就医环境人们也并没有因为人工智能的出现感到幸福反而是人类对这个世界引以为傲的创造力被剥夺和取代我想问问这个没有思想的人工智能你的出现到底是为了什么资本的魔法吗最后就是资本家的孤独对着一帮冷冰冰的机器傻笑吧;1;1;2;18388;0.00010876658690450294
94363;主要是侵权问题？这也不只是ai带来的;1;1;2;18388;0.00010876658690450294
94366;我个人是计算机视觉方向的一个学生，比较好奇的一个问题是，网上这么多人抵制AI生成内容，到底是抵制这样一个快速绘图的工具，还是抵制制作这个工具的时候非法剽窃了一些画师的作品呢？;2;1;3;18388;0.0001631498803567544
94379;最关键的应该是禁止未授权的AI图商用，商用AI的训练集必须透明，而且生成的AI图的收益应合理分配给程序和训练集作者;1;1;2;18388;0.00010876658690450294
94381;如果有强制规定ai制图不能被商用就好了，普通画师也能用ai做做参考辅助设计什么的就是技术用在好的地方了;2;1;3;18388;0.0001631498803567544
94384;目前支持者的言论就是：人学也是学，ai不过是学的快，有什么问题？那作为局外人我觉得随意啊，作者们一直被偷就停止生产，ai以后就没有图可以偷，利用别人的作品去训练ai从而产出的行为与其用学习速度来打比方不如用洗钱来类比我觉得更贴切;1;1;2;18388;0.00010876658690450294
94388;过去总说AI能替代服务员，司机，工人，而富有创造性的岗位则比较安全没想到短短几年画手居然是第一批遭遇冲击的，还是这种不道德的方法接下来又会是什么意想不到的，被AI影响的岗位呢而这个会不会导致创意画音影这些行业被锁死想象力式微会不会影响到科技武器等发展呢;2;1;3;18388;0.0001631498803567544
94391;全世界艺术家联合起来;4;1;5;18388;0.00027191646726125733
94398;没用的，ai学习插画和我们学习大咖方式其实一样，只不过它们学得更快;6;1;7;18388;0.0003806830541657603
94413;本人业务绘画爱好者，电子板绘procreaterps水彩水粉蜡笔都画过，平时也会从画廊买画家的画签名版，真迹买不起，中西方各时期的绘画图片也鉴赏了不少，说实话我粗粗看的话没看出来ai绘画带来的“变扭感”。。。当漫画或壁纸看还是挺达标的，收藏就算了;1;2;3;18388;0.0001631498803567544
94415;以前试卷上那些各位大佬说ai无法画画写诗，现在看一堆人来抵制ai绘画，真是笑死。;1;2;3;18388;0.0001631498803567544
94417;一旦允许ai进入绘画界，哪怕是买版权给AI去学。这个行业或者说整个艺术圈都完了。不要说还有传统手绘，3D打印了解一下，人类学画要多久？5年？10年？20年？AI学画需要几年？有足够的图需要1小时吗？插画师画一副复杂的作品，不算找参考和构思的时间，需要10个小时？20个小时？或者若干天。AI生成图片需要1分钟吗？视频里说的那个AI使用者，自我宣传可以代替10个插画师，我觉得他谦虚了。设备跟得上他一个人怕是可以代替几百个人。在巨大的利益面前，人类的艺术将一文不值，这就是现状，虽然不愿意承认，但AI和人类画师的战斗，最终应该是人类画师输了。有钱人只会考虑成本和怎么赚更多的钱，这个世界又是由有钱人左右的。在巨大的利益面前，普通人一文不值。不要说AI是在解放人类劳动力，一个靠长期学习技法，靠想象创造力工作的人，都能被AI取代。那AI还有什么是取带不了的？现在反AI已经上升到哲学高度了，一方面AI可以带给人类巨大的利益，让科技飞速进步，但另一方面在科技进步的背后人类又会面临着被取代的命运。作为一个普通的人类，真的不想我或我的后人被机器取代，然后成为有钱人圈养的家畜。;4;2;6;18388;0.0003262997607135088
94422;看笑的人，不知道的是马上AI的铁拳就要到你脸上来了。AI基本能做一切，争对一切事情进行训练。当AI开始控评时，只要有一句反AI的就会被智能贴上标签，然后这种言论永远不会火在未来AI还会做更多事情。;1;2;3;18388;0.0001631498803567544
94424;提个猜想，允许ai学习画师，但必须注明ai。各企业需要购买插画时，可以相比以前较低成本，用ai。但任何使用ai者需收取少量费用，包括个人消费者。这些费用集合，按比分配给ai公司和画师。画师通过公开自己作品，和受众人认可程度，计算画师应得收入。通过以上，画师的画以正规渠道与ai合作。除此，若有更高艺术要求的人可以以传统方式直接与画师交易。。。大家看看这个方案有没有漏洞可不可行喜极而泣当然有些部分暂时技术达不到;3;2;5;18388;0.00027191646726125733
94429;21世纪的卢德运动;8;4;12;18388;0.0006525995214270176
94439;ai的画没灵魂看多了一眼就能认出来表情同质化严重到你甚至分不出角色的喜怒哀乐永远都是一副似笑非笑的雌小鬼样要么就是绷着个脸的面瘫人物设定啊背景啊甚至人体啊就更别提了;13;3;16;18388;0.0008701326952360235
94453;就像传统手工业者站在工厂门口抵制机器一样可笑;6;5;11;18388;0.0005982162279747662
94460;ai在我硬盘里，建议全地球挨家挨户去抢硬盘;5;4;9;18388;0.0004894496410702633
94467;艺术家无法容忍自己苦思冥想的构图，被AI几分钟就模仿，甚至是超越。可是假如我模仿某位艺术家的风格作画，再将自己的作品交给AI进行训练，版权如何界定？;3;2;5;18388;0.00027191646726125733
94472;一群ai小旗手，呵呵呵，ai做的作品不属于个人，更不属于用它的人。这点事都不明白，还嚣张跋扈。想用ai图买卖，等着做被告吧。;1;2;3;18388;0.0001631498803567544
94474;好产业升级阵痛期来了;7;6;13;18388;0.0007069828148792691
94482;都在讨论AI对绘画的影响，但有没有想过AI对网络程序专业的影响，现在的AI连真人都能合成了，而且好像也快成一个热门话题了，我就是学网络工程的，我们这边有个高年级小组已经开始研究AI建模了，听说已经能生成一些很粗糙的模型了但局限性还很大，但至少现在还没人推广AI编程吧，如果以后AI编程另一个AI程序会发生什么doge;4;1;5;18388;0.00027191646726125733
94488;既然评论区都在说ai的发展是为了艺术，那么是被吞的图不够艺术不够好看，所以才要ai去吃图创造出比被吞的图更好看的作品吗？就像那些动漫一样牺牲小部分人创造出神迹的感人反派吗？;3;2;5;18388;0.00027191646726125733
94493;事实上，艺术家本来不应该害怕ai的，因为艺术家本身是以灵魂在画上的渗透进而对世界的影响而感动世界的。但是，他们现在很怕，因为他们画蓝色的魔鬼兔子、洗钱。。。他们灵魂不干净了;76;2;78;18388;0.004241896889275614
94570;狠狠地拷打小画手;4;3;7;18388;0.0003806830541657603
94575;AI要投喂，那么艺术家是怎么学习的，不也是参考借鉴练习;3;1;4;18388;0.00021753317380900588
94579;发布条笔记;1;1;2;18388;0.00010876658690450294
94581;说句难听的都是为了自己的利益罢了害怕自己的定价受影响哪有那么多高尚的事情ai降低成本对真正的剧本创作者是很有益的对文化也是好事儿;3;1;4;18388;0.00021753317380900588
94586;艺术家们从来不害怕被ai取代，他们在抵制的是ai公司盗取知识产权的行为;1;1;2;18388;0.00010876658690450294
94589;这玩意就跟BT种子一样，只要开源，没有人可以阻止你用它。而且本来不开源的，也已经意外开源了，好好受着吧。反正AI就躺在我的硬盘里。想反对的人可以试着过来砸了他就这么简单。也许有可能砸得了我的但是我随便关注一个人，他硬盘里面也有，要不把他的硬盘砸了？就这么简单。你想要把一个种子搞掉。就把所有拥有资源的人电脑都砸掉这都做不到，也就别谈什么保护了。但是仔细想想，这确实做不到。拥有这个资源的人真的是太多太多了。起码我都有。我不会让别人砸掉我的硬盘，就这么简单。而且我也能熟练的运用BT之类的分享出去就这么简单。种子和磁力链你能毁掉哪个？这两个都回不掉的话，别说不让人用AI了，那个更难，就这么简单。晚安，好运。;32;1;33;18388;0.0017946486839242985
94622;我不是很理解，你们一边抵制ai生成的画，但自己又偷偷玩stablediffusion，昨天秋叶发布了整合包启动器直接给你们顶到首页第一位，评论都是评论电子菩萨。;4;2;6;18388;0.0003262997607135088
94630;他们根本不爱艺术，也不爱人类自己。他们只想一键批量生产本质上一样的东西，还建立在人血馒头上。如果稍微有一点艺术史或艺术修养都能看出来至少目前的ai画多么垃圾。在这些事件中，我唯一心碎的是这些群氓会伤害真正的艺术家，他们也伤害了我，使我远离我生命的激情;1;2;3;18388;0.0001631498803567544
94633;呼吁也好抵制也罢，想靠道德层面对抗利用ai技术的侵权的人，只在网络上发发评论，基本不可能在现实层面有作用。同时还可能被转移矛盾不去追究利用ai技术作恶的人，而是去抵制的ai技术进步。呲牙;7;1;8;18388;0.00043506634761801175
94641;其实传统艺术家学画画也是从临摹起步的。本质上和AI吃图没什么区别，相信大家在临摹的时候没有问过作者能不能临吧。整个AI事情本质上就是分蛋糕的事。举个不现实的例子假如AI抄了我的图，但不影响我当下以及未来的收入，不影响我在业界的地位。我会在乎AI抄没抄我的图嘛？从另一个角度来说。我个人对法律保护版权这事持悲观态度。人和人的版权都没有做的很完善。现在来个出图效率极其夸张的AI，官司永远都打不完。那现在这处境怎么办呢。其实我觉得不用太担心。人类每一次的科技个性确实会毁掉一部分职业，但同样会诞生新的职业。比如照相机诞生的时候，宫廷写实的画师也面临过跟我们当下一样的焦虑。那现在如何呢？艺术以另一种照相达不到的维度开始了发展，出现了各种新流派，依旧在人文艺术上大放异彩。再举一个例子，汽车刚发明的时候马车夫也同样很焦虑。现在马车夫很少见了但多出了以汽车为核心的更多岗位和门店。总结来说对于AI的未来，我自己认为靠法律来保护版权就是当下正版盗版软件的情况。大公司会按照法律严格使用正版，小公司就一言难尽了，同时我对于AI所产生的新职业是期待和向往的。那些被AI吃图的大佬未来可能会有新的商单，单纯为他们的AI图库出图，这种图是不留在市面上的。只进他们的AI图库。这反而是增加了大佬们的利润。中小画师则多了AI制图的这个技能，毕竟出200张AI图，选出合适的图再稍加修改还是需要一定的美术修养和基础的。未来会有变革，不是末日。;22;1;23;18388;0.0012508157494017839
94668;我对AIart持乐观态度，这是科技的进步，至于剽窃我觉得人在学习绘画的过程中也在不停的收集，观察，模仿其他画家的作品，这跟ai并无不同;3;1;4;18388;0.00021753317380900588
94672;其实你们在这里说ai这里不好那里不好，最终这些东西都会被当成反馈，让ai进化的速度越来越快doge这就形成了一个悖论想要遏制一个技术反而让技术的发展加快，也是有点神奇。。;2;2;4;18388;0.00021753317380900588
94683;不给AI吃好图，AI怎么吐出有质量的图啊，艺术家没有大集体意识嗑瓜子;1;0;1;18388;5.438329345225147e-05
94687;一个像素点的差别，本质上就是新的，就是创新。迭代次数足够，就会变成任何画。对人来说这当然不可能，工作量太大，但对ai来说，完全没问题。何况ai的改变是有规律的，是比一个像素点改变更高效的。这代表现在的版权问题只要ai进行几次迭代，就没有版权问题了，那时候ai喂的图是ai画的，甚至版权优势在ai公司手上。所谓没有人类画师，ai就没有资源，是一种虚假的假象。ai能画画，那在加一些人来审美上的筛选，那么ai完全能自产自销。所以喂ai的画的版权问题很可能很快就消失了。;3;0;3;18388;0.0001631498803567544
94691;藏狐记得围棋Al刚出来的时候，还需要大量人类棋谱来做训练。不过，等发展到阿尔法狗2代时，通过自己与自己下棋，短短几天就击败了一代;3;0;3;18388;0.0001631498803567544
94699;你们说的每一句话每一个标点符号已经在AI的素材库里了;1;0;1;18388;5.438329345225147e-05
94702;各位，我有个问题不太明白，当人在学习绘画的时候，不也是会照着别人的图临摹嘛，照着别人的图临摹也没有经过别人的授权，ai作图刚开始的喂图，为什么不能算做是人在最开始学习绘图时候的临摹呢，而且据我了解ai作图并不是单纯的拼接起来的，也是生成的，最终生成出来的画也跟原作者并不一致，为何要被抨击这一点呢？（没有任何恶意，只是单纯的不懂，希望知道的朋友解答下疑惑）;34;0;34;18388;0.00184903197737655
94740;谁来省流;1;0;1;18388;5.438329345225147e-05
94742;你们说AI以后会不会进化成不需要喂图，自动联网全网搜索，连加密网站都能破译进去那种地步doge;1;0;1;18388;5.438329345225147e-05
94747;问题是不给ai喂图，ai就没办法通过学习来进步，但ai的发展是势不可挡的啊，你不喂总有人喂，未来，ai会取代九成画师疼;4;0;4;18388;0.00021753317380900588
94752;为什么不能抵制技术本身？所有命运的馈赠，都在暗中标好了价码;1;0;1;18388;5.438329345225147e-05
94754;目前进度到哪了，筹款筹好了吗？;4;0;4;18388;0.00021753317380900588
94759;靠这样是没用的，只有商品化，图片商品化，不买不给看;1;0;1;18388;5.438329345225147e-05
94769;dlsite有一堆ai制涩图rpg了，虽然量大管饱，但并不太想支付，这个是大坑;3;0;3;18388;0.0001631498803567544
94778;脱单doge有一天ai懂的艺术了那一定会是人类的一败涂地。。。但现在来说我觉得ai还比较像熊孩子我只想打一顿以后长大了再说长大的话;3;0;3;18388;0.0001631498803567544
94791;不知道为什么，我总觉得nft，非同质化数字代币，会成为ai绘画以及大多数插画师版权问题的解决办法。当互联网上的图像不可以随意下载滥用，版权问题用区块链技术去追责的话，会不会更好思考思考思考;2;0;2;18388;0.00010876658690450294
94800;能被ai替代的不是艺术家，而是那些没什么艺术含量，只是差不多掌握了绘画这样一门技术的人，他们本身也就是在做着和机器一样的工作自然也就害怕被替代。;3;0;3;18388;0.0001631498803567544
94804;某些外国人的智商还有待提高;2;0;2;18388;0.00010876658690450294
94819;其实纳入版权化可以解决，用户按订阅或者使用次数或者自定义勾选对应tag和相应的训练图包，素材，进行规范管理和收费使用，所有结果法律层面规定不得用于商业，不受法律保护，能缓解当前的乱象;2;0;2;18388;0.00010876658690450294
94829;我在想，如果连艺术这种事都能被AI替代的话，那还有什么不能被替代的呢？那人类还能做什么呢？如果连创造力，想象力都能被机器代替，那还有什么不能被代替的？是潘多拉的魔盒吗？大哭;2;0;2;18388;0.00010876658690450294
94832;我是学素描的想要当一个漫画家为什么呢？因为我一开始就是因为没有AI的原因，到现在这个结果我也不该说什么好。;2;0;2;18388;0.00010876658690450294
94836;搞笑的。学习自由是普世自由。千百年来人类都是临摹大师的画作，这些人怎么不嚷嚷呢？;3;0;3;18388;0.0001631498803567544
94841;技术的发展就是这样残酷，当织布机被发明出来之后，所有抵制织布机织布熟练工，最后都下岗或者变成织布机操作员了。新技术会衍生新的职业，而对于AIGC来说，就是多了一堆炼丹家，而一大批艺术家都将难以生存，AIGC的训练集也会变得越来越乏味，缺少新鲜血液。算法毁灭了它的资源供应者，同时也终将毁灭它自己。制图的世界会不会变得越来越乏味，会的，可能最后没有人愿意训练绘画技巧了，就像人类失传得多种技术一样。希望能有转机，PS：我也是炼丹师的一员;9;0;9;18388;0.0004894496410702633
94851;Ai用受版权保护的作品做训练。训练的结果必然是：生成跟受版权保护的艺术家风格相仿的作品。但是这种风格在法律上不受保护。这就钻了法律的空子，也很大程度影响了原作者的饭碗。虽然新的艺术家成长过程中，也会用受版权保护的作品进行临摹，训练自己的各种技法。但是人类的生产能力并不足以威胁到整个创作行业的安危。同时人类画师往往也会在形成自己新的艺术风格。之后Ai又开始用更多不同风格的画师的受版权保护的作品，进行训练。进而影响了更多画家的饭碗，进而影响了更多的行业生态。这是我理解的本次冲突的原因。但是我觉得吧，很多艺术作品（比如up提到的儿童插画）就需要一些低质量，但是大数量的插画。就跟工业品泛滥之初，大家都会觉得不是手工业品没有灵魂。但后来也都逐渐接受了。我觉得Ai用好了反倒会提高画师的水品和净值。让不需要精致艺术品的行业就用Ai作画。之后人类画师逐渐转向高端和定制化市场。这才是真正的解决之道。同时我觉得立法方面，应该给受版权保护的艺术作品的原作者一笔Ai创作的分成。类似于版税。这才是艺术家们应该争取的。而不是裹挟着舆论反对Ai作画。毕竟消费者和商家也都想降低开销和成本。;1;0;1;18388;5.438329345225147e-05
94860;原来真有人以为ai可以代替画师啊吃瓜;2;0;2;18388;0.00010876658690450294
94867;被AI抢饭碗了吧;2;0;2;18388;0.00010876658690450294
94875;你画了十年画，终于在近几年找到了你的风格，并且市场接受你的风格，突然蹦出个AI，花了一个月时间就可以复制出与你风格大差不差的作品，然后再请一个专门修改AI图的画手，这样一来，你，我，他，他们的所有风格，资本家们都可以量产，并且只需要留下极少数的改图画家，就可以极低成本的量产。;1;0;1;18388;5.438329345225147e-05
94878;这ai让我感觉到，人的神经细胞在某些地方终究干不过cuda核心;1;0;1;18388;5.438329345225147e-05
94881;这是2000多粉丝up做出来的质量吗？那我是不是老粉了？;1;0;1;18388;5.438329345225147e-05
94883;这是时代的洪流，无人能够阻挡;2;0;2;18388;0.00010876658690450294
94887;AI训练和一个小白成长为大神没什么不同。历史上每一个画家成长都是靠临摹大师的作品学习现实世界，那些大师会向临摹者收版权费吗？画家临摹各类大师，最终产出的东西，有人会说他是剽窃吗？不要说画家最终是原创的哦，没有临摹的基础，画家不可能从0获得原创的能力。AI抓图训练本质上就是以千万级的速度进行临摹，它产出的东西为什么不能算独立的作品？AI可能暂时无法学习现实世界，但是当这个差距也被弥补的时候，艺术家们是不是该更加恐惧？某些画师不把AI当成工具，反而去抵制，没有什么高尚的原因，就是因为饭碗被抢。历史早就证明，手工业者的反对终将会被工厂碾压。大部分画师注定被AI碾压。我不能说这样的世界更美好，只是在阐述必将到来的现实。未来也许人类的脑部运行被完全解析，艺术创作成为公式化生产的产品，这种未来可能可悲，但终将到来。谁说我们的未来一定会越来越美好呢？;7;0;7;18388;0.0003806830541657603
94895;在我看来ai在以后会完全取代人类成为新的世界主宰，人类消失，ai出现，这是一种进化，符合适者生存进化论，毕竟肉体苦弱。当然你可以随时推翻我这个看法，因为作为人的我大脑也是有限的，只是我对现在的生命形态还是悲观，人类太脆弱了;1;0;1;18388;5.438329345225147e-05
94898;AI剧本AI作图AI动画，跟挖矿似的，躺着出动画doge，别人3000万成本，我这就100万，他出一部，我出30部，卷死他doge;1;0;1;18388;5.438329345225147e-05
94902;有没有好听的AI曲？;12;0;12;18388;0.0006525995214270176
94915;这个瓜好吃就好吃在国外特别注重版权问题，自己的图被拿去训练模型。有种牛头人的感觉。;1;0;1;18388;5.438329345225147e-05
94917;这个问题的终点是，人到底是作为生产者还是消费者而存在。AI是无法抗拒的，现在只是在视觉上的冲击，而现在已经有公司在训练AI从事文字输出的训练了，这个其实比自动生成图像的后果严重的多。美术风格可能还有迹可循，但是文字内容将更加难以辨别。最终的结果就是AI的逻辑将会影响思维逻辑，这些才是潜移默化的滴水石穿。大多数人其实不管对图像还是文字其实都是消费者，普通人大多可能只有简单的判断能力，根本没有生产能力，所以，面对AI大多数人只能选择接受，真正抗议的人，是那些生产者，尤其是掌握话语权的生产者，因为一旦AI的训练达到一定水品，这些人都会饿死。这些人只能不断的内卷，要么成为审美规则的制定者，要么从事低端的AI训练师。不过在现在这种环境中，操纵舆论，已经沦为金钱游戏了，也就是说，这些所谓的艺术家的结局基本已经能看的见了，顺者昌，逆者亡。;1;0;1;18388;5.438329345225147e-05
94922;没意义的，不要高估人性;1;0;1;18388;5.438329345225147e-05
94931;这是人类历史上第一次反抗ai，很重要;2;0;2;18388;0.00010876658690450294
94934;如果一个人最喜欢的画或音乐甚至文字出自ai，那么这个人真的是太逊了;2;0;2;18388;0.00010876658690450294
94938;礼问视频里的魂三BGM名字叫什么;2;0;2;18388;0.00010876658690450294
94943;AI技术在未来会有更强的延展性，目前应用于很多生产工业领域都取得不错的效果，解放了劳动生产力提高了产能。我很同意有人提出只有真正的艺术家才能更好的运用AI技术，就像手绘与数码绘画一样。而纵观目前的AI之争，除了理应维护画师的合法权利之外，更多是组织团体之间的博弈。最后也很有可能变成目前主流的一些团体利用组织谋取经济利益。罗小黑找彩蛋;2;0;2;18388;0.00010876658690450294
94946;其实和短视频、小说、歌曲等等等等的文化产品过去的发展有所类似技术便捷化一方面给了每个人更多参与机会，另一方面稀释专业者的权重，不可避免地会带来总体上的良莠不齐，质量下降而具体走到什么程度还得看AI后续发展，相关方如何对待，引导比较理想的结果是个人可以便捷地应用技术，同时保持专业人群的引导。两者中的一个极端完全封死ai显然已经不可能了，但是另一个极端淹没画师的声音也是非常有害的，审美，设计这些东西，它确实存在，需要积累，而且说实话其实非常有趣当然考虑这个问题的时候也有一些非理性干扰因素，比如利益受损下本能的完全排斥，或者是了解基础不足时过度参与判断定论的欲望希望无论站那一边都有个合理的预期不仅是实然预期，也有应然预期;1;0;1;18388;5.438329345225147e-05
94949;ai只是重复成本太低了而已，要是高一点都不会这么有这么大的水花。而且立法禁止根本违背了推动生产力提升，就像手工作坊要求立法禁止工厂似的。我预测到最后会变成私人定制更高贵;2;0;2;18388;0.00010876658690450294
94955;人工智能道德规范;1;0;1;18388;5.438329345225147e-05
94957;AI本身可以结合各种意向产生新的结合体，这本身背后关键词，或者模型的制造都包含了人类的主动创造。只是不需要你经过几百个小时的训练，你就可以借助工具做到融合。这就是毫无疑问的创造，只是目前的AI很大一部分StableDiffusion会把十分接近原图的图像进行输出。在不久的将来，当跨感知的迁移模型被发明出来，你根本就无从确认“灵感”来自哪里。这就是趋势，但是人类面临的问题是，如何保护人类原创？人类的大脑和感知尚无法被ai所复制，人类的创造才具有核心推动力。;2;0;2;18388;0.00010876658690450294
94962;支持AI者和抵制AI者争论的核心，是AI学习和人类学习是否可以同等对待，关于这两者的原理。我们清楚AI绘画的原理，但尚不清楚人脑的原理，无法证明AI学习和人学习有多少相似性。所以既无法证明AI绘画是抄袭，也无法证明它不是抄袭;8;0;8;18388;0.00043506634761801175
94976;我喜欢ai，因为我能通过对他的训练，来看到某些已经基本结束了的作品，那些作品人气日益下滑，相关的角色产出越来越少，但ai能解决，能给人安慰，ai不应该消失，它应该以更合理的方式来服务人类;2;0;2;18388;0.00010876658690450294
94984;那个网站还有人刷的yestoai的，而且这个禁止标还被人拿去跑ai玩了;1;0;1;18388;5.438329345225147e-05
94988;ai不只要替代中低端画图，还要替代中低端的音乐、建模、写作、拍摄等所有行业，甚至某些领域已经能比肩高端了;1;0;1;18388;5.438329345225147e-05
94990;ai是没有恶意的也缺乏真正的创造能力因此没有威胁，但是人有。只要ai被人使用，它缺乏的东西就可以被弥补，进而形成有真正威胁的碳硅结合生命体。;2;0;2;18388;0.00010876658690450294
94993;话说我用ai生成一个图，然后把图描一遍改一改，那这图算不算我画的？;6;0;6;18388;0.0003262997607135088
95003;说白了就是威胁到饭碗了，但绘画不是最后一个，最后的应该是程序员也回家种田了。。。;5;0;5;18388;0.00027191646726125733
95009;道德是可变的，可定义的，无意义的，纠结这些毫无意义。;3;0;3;18388;0.0001631498803567544
95013;再怎么无耻，再怎么失德，那也是使用的人的问题，和技术无关。从事实上看，ai绘画这项技术通过参考训练各类艺术家的作品获得了巨大的进步，这告诉了我们开源对于科学技术进步有多大的增益。（我只是陈述事实，不带任何观点）;32;0;32;18388;0.001740265390472047
95047;程咬金中间还打码笑死了doge笑哭;5;388;393;18388;0.021372634326734828
95053;脸太写实了，感觉怪怪的热热热;2;206;208;18388;0.011311725038068305
95056;八戒，对不起了，就这一次dogedogedogedogedogedoge;3;113;116;18388;0.00630846204046117
95060;真的不是夹带私货吗，这脸难道不是某个真人吗辣眼睛;3;74;77;18388;0.004187513595823363
95064;元歌比原来还man了;2;51;53;18388;0.002882314552969328
95069;好多菜10;2;23;25;18388;0.0013595823363062867
95073;庄周好像周姐;1;12;13;18388;0.0007069828148792691
95077;040;3;4;7;18388;0.0003806830541657603
95081;我来爆料一下，下周夏洛特至尊抽奖上架（如果猜对了就把预言家打在公屏上）;7;3;10;18388;0.0005438329345225147
95098;兔崽仔doge我全都要;2;1;3;18388;0.0001631498803567544
95104;还是庄周的最好看dogedogedoge果然盖住一部分脸可以让颜值有限地上升;1;1;2;18388;0.00010876658690450294
95175;求BGM星星眼;1;0;1;18388;5.438329345225147e-05
95186;脱单doge脱单doge脱单doge;2;1;3;18388;0.0001631498803567544
95189;UP主加油看好你噢;1;0;1;18388;5.438329345225147e-05
95193;有没有扔进去四五张同一个二次元角色，能自动帮你改图或者以此人物为原型生成新图的网站;48;813;861;18388;0.046824015662388516
95242;再追一个novelai的，送我上去，应该是大佬自建的服务器，这得多少米。toolsmikuacnovelai;21;548;569;18388;0.030944093974331087
95264;AI主要威胁的中下级的画师，AI没有自己的风格，不会画连续性的，有故事性的画。;13;288;301;18388;0.01636937132912769
95278;微信小程序“NovelAIAI绘画”;46;277;323;18388;0.017565803785077223
95325;推荐一个小程序：微云ai画师;19;134;153;18388;0.008320643898194474
95345;投币了，up要是能找到图生图的网站记得踢我一脚打call;11;87;98;18388;0.005329562758320644
95357;郊外的野花花是时候学一学AI绘画了吃瓜;2;18;20;18388;0.0010876658690450293
95360;up我看快手上很多人发那种欧美油画风格的ai图都是什么ai画的啊帮忙找找呗doge;7;52;59;18388;0.0032086143136828365
95368;有没有那种放一张照片就自动绘画的那种，脱单doge脱单doge;3;50;53;18388;0.002882314552969328
95372;可以搜索试试造梦笔小程序，质量非常高;6;38;44;18388;0.0023928649118990647
95379;不能生成我想要的本子，表示很失望doge;3;31;34;18388;0.00184903197737655
95383;最近好多人都在谈论Al作画，但是我跟我家的铝合金窗交谈了半天，它都说它不会画画，必须要纯Al才行吗？doge;10;33;43;18388;0.002338481618446813
95394;第五个，不要用，免费的画的丑的一逼，普通二次元形象一毛钱一张，手部优化两毛一张，画个露肚子大腿的衣服都会给平台撤回，而且今天手部优化限时一毛，我充了五块钱（他还送两块钱）作了60多个，没有一个手是正常的大部分不是六个就是四个，要不就是骨折到你想不到的地方;4;12;16;18388;0.0008701326952360235
95399;Draft开始圈钱了大哭;3;24;27;18388;0.0014683489232107897
95403;33artaiwebapp163这个也是免费的，最近倒是真的挺多;1;18;19;18388;0.0010332825755927778
95405;净是敏感词汇大哭;1;15;16;18388;0.0008701326952360235
95408;up，我发了一堆5为什么一个也不回;1;4;5;18388;0.00027191646726125733
95410;有没有不手崩的aidoge;7;4;11;18388;0.0005982162279747662
95418;再追一个novelai的，送我上去，应该是大佬自建的服务器，这得多少米。toolsmikuacnovelai;1;1;2;18388;0.00010876658690450294
95420;up，文心下载的图片不是直接在相册中显示，而是以文件的形式保存在百度怎么办;2;2;4;18388;0.00021753317380900588
95445;一个看coser的网站httpiiiiiiitopbcc695xb;1;0;1;18388;5.438329345225147e-05
95457;分享个网站;2;0;2;18388;0.00010876658690450294
95463;这5个绘画中哪个可以画涩图滑稽;1;0;1;18388;5.438329345225147e-05
95468;draft这个网站生成的少女有三条腿给我气笑了热;3;1;4;18388;0.00021753317380900588
95473;有没有一种软件AI绘画20遍把男性变女性？;1;0;1;18388;5.438329345225147e-05
95482;httpsdraftartdrawing这个网址生成的图片现在怎么下载不了？之前还可以下载保存的难过;1;0;1;18388;5.438329345225147e-05
95497;httpstoolsmikuacnovelai这个能生成瑟图打不开了是不是被封了;2;0;2;18388;0.00010876658690450294
95501;有没有能生成瑟图的脸红;1;0;1;18388;5.438329345225147e-05
95503;有没有不用注册免费的;3;0;3;18388;0.0001631498803567544
95511;求教各路大师，Ai绘画技术到底怎么用啊？笑哭只能用PC端使用吗？喜极而泣;2;1;3;18388;0.0001631498803567544
95517;收藏比赞多;1;0;1;18388;5.438329345225147e-05
95519;有没有生成环境的？怎么全是人物啊热;1;1;2;18388;0.00010876658690450294
95522;这几个网站有几个还行，那两个英文网站完全不会用，照着视频里面的方法试过了，还是不行，图片出都出不来;1;1;2;18388;0.00010876658690450294
95524;有没有那种把一个图片放进去，以人物为原型改动作改服装之类的doge;2;0;2;18388;0.00010876658690450294
95537;输入r18词汇，能不能出瑟图？;1;0;1;18388;5.438329345225147e-05
95540;第五个我还挺喜欢的，结果他要钱了;1;0;1;18388;5.438329345225147e-05
95543;都不好用;1;0;1;18388;5.438329345225147e-05
95551;5;1;0;1;18388;5.438329345225147e-05
95558;5;1;0;1;18388;5.438329345225147e-05
95573;5;1;0;1;18388;5.438329345225147e-05
95578;5;1;0;1;18388;5.438329345225147e-05
95587;5;1;0;1;18388;5.438329345225147e-05
95600;5;1;0;1;18388;5.438329345225147e-05
95607;upup，自动回复失灵了;2;0;2;18388;0.00010876658690450294
95611;有没有你放进去一张图片他给你画出来一个差不多或者更好的;1;0;1;18388;5.438329345225147e-05
95625;有没有丢进三次元图片改成对应二次元图片的网站？;6;0;6;18388;0.0003262997607135088
95632;5;2;0;2;18388;0.00010876658690450294
95636;iMeanAIGC助手;1;1;2;18388;0.00010876658690450294
95641;5;1;0;1;18388;5.438329345225147e-05
95648;5;1;0;1;18388;5.438329345225147e-05
95651;5;1;0;1;18388;5.438329345225147e-05
95654;5;1;0;1;18388;5.438329345225147e-05
95659;5;1;0;1;18388;5.438329345225147e-05
95667;嘿小家伙我发5了怎么没有链接崩坏3唢呐;1;0;1;18388;5.438329345225147e-05
95670;这该死的收藏量doge;1;0;1;18388;5.438329345225147e-05
95685;5;1;0;1;18388;5.438329345225147e-05
95687;ai听不懂人话都说了全身图、白色背景还硬是把头、脚截了一小段走了笑哭;1;0;1;18388;5.438329345225147e-05
95697;5;2;0;2;18388;0.00010876658690450294
95701;5doge;1;0;1;18388;5.438329345225147e-05
95705;5;1;0;1;18388;5.438329345225147e-05
95707;可以画色图吗脱单doge;1;0;1;18388;5.438329345225147e-05
95709;5;1;0;1;18388;5.438329345225147e-05
95711;你让画师怎么活啊？大哭;2;3;5;18388;0.00027191646726125733
95714;已投币;1;0;1;18388;5.438329345225147e-05
95716;大佬感谢顶一波;1;0;1;18388;5.438329345225147e-05
95718;我试了试关键词输入同学的名字，然后doge;1;0;1;18388;5.438329345225147e-05
95720;已投币;1;0;1;18388;5.438329345225147e-05
95723;画der这个也不错，小程序;3;1;4;18388;0.00021753317380900588
95727;怎么没回;3;0;3;18388;0.0001631498803567544
95732;5;1;0;1;18388;5.438329345225147e-05
95735;竟然没有我想要的doge;1;0;1;18388;5.438329345225147e-05
95737;这个能生成涩图吗doge;1;2;3;18388;0.0001631498803567544
95739;请问有没有图生图的网站？doge;1;1;2;18388;0.00010876658690450294
95742;牛;1;2;3;18388;0.0001631498803567544
95744;打call已三连;1;0;1;18388;5.438329345225147e-05
95746;热词系列好耶;1;0;1;18388;5.438329345225147e-05
95748;我爱DRAAFT，DRAFT爱我;1;1;2;18388;0.00010876658690450294
95750;nove那俩都用不了了;13;0;13;18388;0.0007069828148792691
95764;热词系列三连热词系列你币有了;3;0;3;18388;0.0001631498803567544
95769;大佬，问的问题是啥呀，能分享下嘛，我昨天还想着问它AI绘画，结果一直说自己只是个聊天程序笑哭;14;158;172;18388;0.009353926473787253
95784;赛博奴隶主获得了AI监工;16;3194;3210;18388;0.1745703719817272
95801;两个月前：画师失业，魔法师兴起如今：魔法师失业;94;2349;2443;18388;0.13285838590385032
95896;赛博画手会遇上电子甲方吗？;2;1280;1282;18388;0.06971938220578638
95899;再下一步来个能拍板的AI，行了，人类可以销毁了;26;921;947;18388;0.05150097889928214
95926;AI看ai做的ai教ai教ai画画的ai视频，和ai观众一起讨论ai到底是否有益的ai，最后被ai监管标记为可能是ai。;4;623;627;18388;0.03409832499456167
95931;这真tm的以后看谁还敢说ai是辅助工具的他可以连五彩斑斓的黑都给你解决了。;13;532;545;18388;0.02963889493147705
95946;世界发展的太快现在我完全相信以后可以用自然语言开发和部署网站了;31;320;351;18388;0.019088536001740264
95978;果然AI最大的短板就是画手脚，完全没有肢体结构和空间构成的概念。;18;67;85;18388;0.004622579943441374
95997;为什么我的chatgpt全给我整些古神tag无语，我让它生成，它就给我个tag，我翻译了一下。一个女孩，绿色头发，长体型，魔眼，辛辣，辛辣，辛辣，辛辣，辛辣，辛辣，辛辣。我看到这里直接无语了。无语;1;6;7;18388;0.0003806830541657603
96000;ai咒術師還沒就業就下崗;1;206;207;18388;0.011257341744616053
96003;GPT3总算是出来了，OpenAI捂了大半年。当初还不肯放出来，据说几千亿的参数。这东西写问答有模有样的。;7;81;88;18388;0.004785729823798129
96011;快进到aiup主让ai指导ai绘画;6;87;93;18388;0.0050576462910593865
96018;很棒的事例，一些特别图案也许也可以这样生成;14;68;82;18388;0.00445943006308462
96033;20221218测试，chatGPT似乎已经堵死了这种“教学”方法，至少我直接用视频里的方法已经无效了，望周知;5;60;65;18388;0.0035349140743963455
96039;我在哪看的说GPT4会有多模态，期待一手doge;2;68;70;18388;0.0038068305416576026
96042;现在的AI不准上网万一谁去把网线插上去然后运行网页学习然后就飞升了;13;70;83;18388;0.004513813356536872
96058;upAI作画能给个网址吗，星星眼我已经注册了CHATGPT了;2;3;5;18388;0.00027191646726125733
96062;让ChatGPT画它自己的拟人（;1;3;4;18388;0.00021753317380900588
96065;突然想到，ChatGPT能不能做调教呢？ai教虚拟歌姬唱歌doge;3;24;27;18388;0.0014683489232107897
96070;下面的prompt是用来指导A绘画模型创作图像的。它们包含了图像的各种细节，如人物的外观、背景、颜色和光线效果，以及图像的主题和风格。这些prompt的格式经常包含括号内的加权数字，用于指定某些细节的重要性或强调。例如，masterpiece15表示作品质量是非常重要的，多个括号也有类似作用。此外，如果使用中括号，如bluehairwhitehair03”这代表将蓝发和白发加以融合，蓝发占比为03。1illustration18bestqualitymasterpiece15masterpiecepngextremelydetailedCGunity8kwallpapercolorfulwarmChinesestyleinksplashingcolorsplashing2limitedpalettepinkfluorescentpaintnolineartsilhouettepartiallycoloredalternatecolor14dynamicanglepinkdarkviolet13darkvioletshadowsynthwavechromaticaberrationthickoutlinepinkoutlinesolofocuspinkneonlightsperfectshadowcowboyshotblankstareberetbowknotonberetflatchestwearinganoffshoulderfloatingjacketshortwavydelicatehairblankstaredelicatefacebareshouldersittingonthetopofthebuildingbeautifulanddelicateeyes1girl15solofromabovedelicatebackgroundstreetswithneonlights;5;46;51;18388;0.002773547966064825
96078;拒绝幼态审美，从你他做起。;2;15;17;18388;0.000924515988688275
96081;这玩意好像可以对抗啊;1;8;9;18388;0.0004894496410702633
96083;没人什么事了以后;4;4;8;18388;0.00043506634761801175
96088;解放生产力打call;2;4;6;18388;0.0003262997607135088
96106;我的建议是把a3下了换官模测a3跑二次元你tag再差都能出效果（;3;6;9;18388;0.0004894496410702633
96110;为什么我这个生成的是中文喜极而泣;3;2;5;18388;0.00027191646726125733
96124;借楼宣传一波我们对ChaTGPT的最新测评呲牙ChatGPT在内容创作方面的能力如何？测评链接：httpsmpweixinqqcomsfb09kAVeBmkDsll9Y8vQ;1;1;2;18388;0.00010876658690450294
96131;人只知道感觉，物自体不知道是什么，自我是无限的。;5;4;9;18388;0.0004894496410702633
96137;novelai怎么部署？需要服务器吗;3;1;4;18388;0.00021753317380900588
96144;ai已经反过来主动研究人类了，以后结合机器人上，可能会偷偷抓人研究;1;5;6;18388;0.0003262997607135088
96147;照这样发展下去手绘会不会变成情怀;1;1;2;18388;0.00010876658690450294
96149;能不能让AI赚钱脱单doge，我王多鱼投了;2;1;3;18388;0.0001631498803567544
96160;谁知道这个背景音乐是什么？愿意出5元钱作为回报;1;0;1;18388;5.438329345225147e-05
96167;迟早有一天会把chatgpt跟ai绘画ai配音弄到一起去只要让他写个剧本直接就生成动画还带配音的简直不要太爽你只需要提供几个关键字就行;1;0;1;18388;5.438329345225147e-05
96206;问一下up，这个stablediffusion是付费软件吗？对pc的配置要有什么样的要求？;1;0;1;18388;5.438329345225147e-05
96208;为什么显示不支持我所在的国家委屈;2;0;2;18388;0.00010876658690450294
96219;请问这个ai绘画的工具是什么，不是chatGPT，方便发一下资源吗;2;0;2;18388;0.00010876658690450294
96232;虽然手还是很奇怪，但画师稍微修修就是一张完美的商图咯;1;0;1;18388;5.438329345225147e-05
96240;每次重新进入这个ai都要重新输入一遍那段话吗？我之前生成过一次tap，退出后再进来它就不会了，还显示错误;1;0;1;18388;5.438329345225147e-05
96242;哥们啥显卡啊，分辨率生成这么高还不爆显存2233娘第一;7;0;7;18388;0.0003806830541657603
96254;我这种从事发电厂设备维修的应该不用太担心会被AI取代tvdoge，往后面看看发展;1;0;1;18388;5.438329345225147e-05
96293;登录chatgpt反复跳转，有人知道怎么回事吗？;2;0;2;18388;0.00010876658690450294
96298;好家伙这个BGM不是捉迷藏那作的BGM嘛（）;4;0;4;18388;0.00021753317380900588
96304;我操看大的都审美疲劳了，一股清流支持;1;22;23;18388;0.0012508157494017839
96306;很多人拿版权说事，其实ai没有版权难道不是好事吗？有很多优秀的ai图比如up发的这些就可以直接拿来二创，比自己抽奖效率高多了打call;8;12;20;18388;0.0010876658690450293
96315;生产队的驴Up，币给你，图包发我;3;9;12;18388;0.0006525995214270176
96319;好美;5;2;7;18388;0.0003806830541657603
96326;求图包脱单doge;2;1;3;18388;0.0001631498803567544
96335;感谢，昨天开始入坑的ai绘画doge;1;0;1;18388;5.438329345225147e-05
96337;哇大佬这个手怎么做到的;2;0;2;18388;0.00010876658690450294
96340;这是国风模型做出来的吗？有没有词条什么的分享啊;1;0;1;18388;5.438329345225147e-05
96344;我又来点赞了图包记得发;1;0;1;18388;5.438329345225147e-05
96346;投币等图包doge;1;0;1;18388;5.438329345225147e-05
96349;链接图包呢原神小事一桩;1;0;1;18388;5.438329345225147e-05
96352;没有图包么？;1;0;1;18388;5.438329345225147e-05
96354;3连了，图包呢;1;0;1;18388;5.438329345225147e-05
96357;怎么看着比迪加还肥;2;17;19;18388;0.0010332825755927778
96362;doge在闲鱼刷到的盖亚娘;1;6;7;18388;0.0003806830541657603
96368;大佬用的什么模型，求;1;2;3;18388;0.0001631498803567544
96371;怎么有几张那么像盖亚sv？脱单doge;3;1;4;18388;0.00021753317380900588
96384;我们砍掉了AI画的手为它安装了义肢吃瓜;3;358;361;18388;0.01963236893626278
96388;这个AI语音是学的谁啊？;6;46;52;18388;0.0028279312595170763
96395;可以雇个ai替我上班吗;1;5;6;18388;0.0003262997607135088
96397;当年相机出现的时候也说学艺的死了。doge;11;46;57;18388;0.003099847726778334
96409;画手都能画了，画脚应该也不远了;13;108;121;18388;0.006580378507722428
96423;AI并不理解美术，扩散模型被设计之初只是为了“生成图像”这个简单的目的，能够让部分画师感到害怕纯属意外。;2;20;22;18388;0.0011964324559495323
96426;ai仿你的脸，ai仿你的音，ai编你的故事，ai和你的家人互动，只要有你的个人信息人工诈骗还要休息8小时，但ai不用，要不了多久诈骗公司就会开启24小时自动诈骗模式了;3;16;19;18388;0.0010332825755927778
96430;doge失业也不远了doge能危险大佬也不远了doge但是换句话来说搞AI的人还是没有美术基础，其实是美术的应该也不会完全失业呲牙doge;7;21;28;18388;0.0015227322166630412
96438;请问你是youtube上那个台湾博主本人吗？;1;1;2;18388;0.00010876658690450294
96441;这玩意对操作系统有要求吗，win7可以不，还是必须要win10;2;3;5;18388;0.00027191646726125733
96444;这口音，打开主页一看，果然是台湾网友;6;13;19;18388;0.0010332825755927778
96452;装完了死活不显示DepthLibrary雪未来挠头扩展里也显示有，已安装，刷新过重启过都没用，关掉别的扩展是正常有效的;4;13;17;18388;0.000924515988688275
96460;有点麻烦midjourny都已经完全能画手了;2;0;2;18388;0.00010876658690450294
96468;开发者们再加把劲打call早日实现捏人自由呲牙;2;3;5;18388;0.00027191646726125733
96474;迟早干掉人类画师;7;3;10;18388;0.0005438329345225147
96483;depthlibrary为啥我安装没有;1;1;2;18388;0.00010876658690450294
96487;UP我想问一下我冲openpos导出来的图片丢到Depth中尺寸就不一样了是为什么;2;0;2;18388;0.00010876658690450294
96496;up，我想问一下，就是我的controlnet设置里边儿没有这么多选项，怎么办;4;3;7;18388;0.0003806830541657603
96503;为什么我导出的骨架是512x768的，可是出来的图是768x1152的？;1;0;1;18388;5.438329345225147e-05
96505;我就喜欢博主这样的台腔妹妹热词系列知识增加;1;0;1;18388;5.438329345225147e-05
96513;我想画一个题材，比如是一个历史性的题材，有士兵，有战马，他们构图各种知识要许多的模特和道具，请问如果有AI这种照片的话，可不是很省事。。他可以按照我的想法，摆出不同的姿势吗？;1;0;1;18388;5.438329345225147e-05
96515;ControlNet能不能支持多人的骨架啊，啥时候能支持dogedoge;1;0;1;18388;5.438329345225147e-05
96518;这个可以做涩涩的东西吗？;1;0;1;18388;5.438329345225147e-05
96520;点发送ControlNet后就没反应了，也没发送过去，还有就是model里一个模型也没有谁知道这是啥情况;4;0;4;18388;0.00021753317380900588
96527;所以手的动作不能编辑，只能选预设;1;0;1;18388;5.438329345225147e-05
96531;已三连，求助：RuntimeErrorCUDAoutofmemoryTriedtoallocate2000MiBGPU0600GiBtotalcapacity522GiBalreadyallocated0bytesfree529GiBreservedintotalbyPyTorchIfreservedmemoryisallocatedmemorytrysettingmaxsplitsizembtoavoidfragmentationSeedocumentationforMemoryManagementandPYTORCHCUDAALLOCCONF这是什么情况？;1;0;1;18388;5.438329345225147e-05
96534;发送不了到CONTRLNET？;1;0;1;18388;5.438329345225147e-05
96538;说实话手指等方面各种问题太多仍然不能实用，只是比原来完全畸形的强了，你这封面图里小拇指大拇指都是外星人的长度笑哭;3;0;3;18388;0.0001631498803567544
96542;好像还是没法解决当手指重叠姿势大哭;1;1;2;18388;0.00010876658690450294
96544;请问怎么固化脸型呢;1;0;1;18388;5.438329345225147e-05
96547;这个model1和model2的界面怎么调出来？;3;0;3;18388;0.0001631498803567544
96555;跟你们说一个negativeprompt，handfingers15以此类推，比如armhands12是用在反向里的，不过按逻辑说，应该是用在正向里面的啊，不过试验过，的确有效，但不保证100，还得根据你的CGF以及steps的设定;5;0;5;18388;0.00027191646726125733
96564;用了cintrolnet画质差了，狂吃显存怎么解决？;3;0;3;18388;0.0001631498803567544
96570;UP主有调参数摆弄软件的功夫，画都画出来了;21;3;24;18388;0.0013051990428540352
96592;全网所有的AI工具网站都在这里一基础介绍0005基础介绍有关AI的上面都可以找得到比如ChatGPT，AI绘画，AI办公一共有47个类别;2;237;239;18388;0.012997607135088102
96595;搜索ai的ai;2;73;75;18388;0.00407874700891886
96598;置顶futurepediaiohttptracemoedalle2Beautiful;4;235;239;18388;0.012997607135088102
96603;免费的不好用，doge。收费的才能用;3;35;38;18388;0.0020665651511855556
96607;OpenAIsservicesarenotavailableinyourcountry;6;54;60;18388;0.003262997607135088
96614;全网所有的AI工具网站都在这里一基础介绍0005基础介绍有关AI的上面都可以找得到比如ChatGPT，AI绘画，AI办公一共有47个类别;2;94;96;18388;0.005220796171416141
96617;有没有人知道那种我输入几个关键单词，然后就可以生成英语作文，作文会包涵我输入的单词的ai？;6;7;13;18388;0.0007069828148792691
96624;坐等这些AI批量下架doge;1;14;15;18388;0.000815749401783772
96626;唐家三少拿这个些小说比你自己强;2;9;11;18388;0.0005982162279747662
96629;收藏了;1;3;4;18388;0.00021753317380900588
96631;链接呢笑哭;5;3;8;18388;0.00043506634761801175
96641;这个ai绘画的我登上去说我们这个地区或国家不可用你们有出现这问题吗;1;0;1;18388;5.438329345225147e-05
96646;求个写作、编辑文案的AI和给条件就自动画图的AI，收费没关系;1;0;1;18388;5.438329345225147e-05
96652;全部都要钱的吗？;2;1;3;18388;0.0001631498803567544
96657;来就来吧本来以为艺术不会被AI取代虽然现在的确还没有还有很多无法实现和错误以及漏洞等但是感觉那天终会到来来就来吧已经看淡doge;1;0;1;18388;5.438329345225147e-05
96661;这恐怖的收藏量;1;0;1;18388;5.438329345225147e-05
96664;（叹气）还是那句话。“坚决抵制ai”;7;7;14;18388;0.0007613661083315206
96674;有ai修图吗;1;0;1;18388;5.438329345225147e-05
96676;看着英语头好大，UP你是怎么翻译出来的大哭;5;2;7;18388;0.0003806830541657603
96682;关注，点赞，投币，我做的对吗？doge;1;1;2;18388;0.00010876658690450294
96685;好像都要钱笑哭;1;0;1;18388;5.438329345225147e-05
96695;都是要钱的吧;1;0;1;18388;5.438329345225147e-05
96697;我想要个线下的，自己训练属于自己的;1;1;2;18388;0.00010876658690450294
96699;不是中？doge收集数据吗;1;0;1;18388;5.438329345225147e-05
96701;要注册账号呀;2;1;3;18388;0.0001631498803567544
96709;掉粉掉的怀疑人生，播放少的不敢直视，哎大哭，做UP真的好难做一名知识UP更难;2;2;4;18388;0.00021753317380900588
96712;网址;1;1;2;18388;0.00010876658690450294
96717;我找的怎么是英文版的？;3;1;4;18388;0.00021753317380900588
96721;是不是需要翻墙哎;1;0;1;18388;5.438329345225147e-05
96723;要钱的不？;1;0;1;18388;5.438329345225147e-05
96727;地址哪个;1;0;1;18388;5.438329345225147e-05
96729;试试;1;0;1;18388;5.438329345225147e-05
96731;尽快学习以后出图要有完美的手笑哭笑哭笑哭;4;3;7;18388;0.0003806830541657603
96744;图包呢？这币你不想要了是吧doge;1;0;1;18388;5.438329345225147e-05
96753;有无图包喜欢;1;0;1;18388;5.438329345225147e-05
96759;百度呢？？;5;0;5;18388;0.00027191646726125733
96767;解压还要会员坑爹;1;0;1;18388;5.438329345225147e-05
96778;链接：httpspanbaiducoms1VTyR9bHL0x5XQR4pNdaUrw提取码：pt4w来自百度网盘超级会员V1的分享欢迎大家进群714564924;1;17;18;18388;0.0009788992821405265
96780;艹，我现在真感觉有一批画师要失业了笑哭;1;3;4;18388;0.00021753317380900588
96790;加勒比女海盗doge;12;95;107;18388;0.005819012399390907
96803;其实这两期并不是我的菜，但我还是都点赞投币了不为啥，就为了UP主用百度网盘分享的文件，看着就高兴打call打call;1;31;32;18388;0.001740265390472047
96805;直接造一只海军出来doge;2;24;26;18388;0.0014139656297585382
96808;这下网页游戏又有素材了doge;1;18;19;18388;0.0010332825755927778
96810;草不要放加勒比海盗的bgm，不然我总想起来杰克船长。说实话，你是不是用杰克跑的图？滑稽;1;9;10;18388;0.0005438329345225147
96812;作为海盗脸上太干净了。应该多几道疤加个眼罩doge;1;8;9;18388;0.0004894496410702633
96815;李华梅吃瓜;1;5;6;18388;0.0003262997607135088
96817;星星眼坐等公告可以做pc壁纸了;2;4;6;18388;0.0003262997607135088
96821;众所周知，海盗船长是没有手的;1;2;3;18388;0.0001631498803567544
96823;已三连求百度网盘链接分享;3;2;5;18388;0.00027191646726125733
96827;up加油，请问私活怎么领取doge;1;2;3;18388;0.0001631498803567544
96835;蹲个图包打call;1;1;2;18388;0.00010876658690450294
96839;度娘的网盘值得一个三连关注;1;0;1;18388;5.438329345225147e-05
96845;加群的答案是什么;1;0;1;18388;5.438329345225147e-05
96887;侵不侵权已经是后话了，初级画师甚至中级画师的未来已经被AI干碎了，未来想要选择这个行业的年轻人会越来越少，那么最后绘画艺术将何去何从呢？;113;243;356;18388;0.019360452469001522
97001;画渣拿ai改自己画的h图表示很爽脱单doge;12;81;93;18388;0.0050576462910593865
97014;AI绘画是侵犯版权的，我们不能让这样的事情发生。;168;105;273;18388;0.01484663911246465
97183;主要是这个技术能够成立，本身就建立在必须侵权的基础上。doge建筑类3D的也许还可以规避，二次元，就算你训练的是自己的画，本质上依然是那么回事。;20;42;62;18388;0.003371764194039591
97204;技术已经变成是个有手的人就能自己搭建了，模型也能自己炼丹，怎么禁止？;3;35;38;18388;0.0020665651511855556
97208;我就这么说吧我现在使用的ai模型数值能够帮我把我自己画的草图直接细化到半完成品且不脱离我的画面结构。我在此基础上再进行优化成图。最后的作品你不可能知道有ai参与。但确实实打实的节省了大量大量的细化时间。在商业领域其实很给力tv思考tv思考（主要是在整体颜色和材质刻画上进行优化，比如我只需要在腿上涂一遍黑色就能让ai帮我画成黑丝。我再在这个基础上做优化tv目瞪口呆）;25;35;60;18388;0.003262997607135088
97234;我发现一个很有意思的点吧。画师的画被拿去炼丹了大家就一起出来嘲笑，但是大家的信息被互联网企业拿去炼丹了大家一个屁都不放所以这件事本质上还是利益和人的问题，而不是侵权不侵权的问题吃瓜;29;88;117;18388;0.006362845333913422
97264;一堆游手好闲的家伙拿ai来嘲讽那些正在努力向上的小画手们，我不明白这样做对他们失败的人升有什么作用;5;64;69;18388;0.003752447248205351
97271;ai真的能称为艺术吗，看着好看罢了，我作为画师打心底里不接受;46;37;83;18388;0.004513813356536872
97318;刀子不在自己身上永远不知道疼，还说什么热爱绘画的也能坚持，那画家面对“不如ai绘画”这种评论的时候该作何感想？只谈论对认真学但画的不够突出类型的人，等以后垄断了就知道厉害了;6;21;27;18388;0.0014683489232107897
97325;有些ai生成的画上面有某些画师的水印热;1;19;20;18388;0.0010876658690450293
97327;最难的中层画师。我给一下定义就是画的质量和ai差不多的那些。底层画师在学习ai后可以用ai帮忙创作并且微修改。而中层画师虽然也可以，但是他们之前本不需要和底层画师竞争。;32;14;46;18388;0.0025016314988035677
97360;看到这个新闻就赶快做出来了，给个不要钱的赞呗脱单doge;3;25;28;18388;0.0015227322166630412
97366;ai虽然对发展有推进，但是依然需要管控和约束。不然只会吹毁行业生态圈。不过我觉得现在ai已经不仅仅影响到绘画了，未来，小说家，摄影机，动画师，视频制作，游戏建模都能用到ai，甚至淘汰掉大部分打工人。人类的劳动力变得一文不值doge;10;12;22;18388;0.0011964324559495323
97378;stabilityai大概率不会有事。模型其实是个抽象概念，而他们提供的预训练模型基于的数据集是laton（可能拼错了）。至于novelai以及后续各种二次元模型，毫无疑问地引入了“有版权”的作品。所以讨论关键是说这种形式能不能被接受，能接受到什么程度。;2;20;22;18388;0.0011964324559495323
97381;这是生产力发展要经历的必然趋势，肯定会有人抗议，但不会改变ai作为历史车轮的碾压，毕竟ai被发明的初衷很大一部分原因就是为了解放劳动力，只要利益足够大，就不可能改写已经在发展期的事物;22;28;50;18388;0.0027191646726125733
97404;画师画都有可能侵权。你ai能不侵吗;8;18;26;18388;0.0014139656297585382
97415;都这个时候了还有人怀疑AI是缝合Lora小模型只需要一张图就能训练画风和人物特色，就一张图你告诉我AI怎么缝蛆音娘吃瓜群众蛆音娘吃瓜群众现在画师和AI绘画的关系就像是手工品和流水线工艺品的关系。老师傅们不愿意把自己珍藏的独家秘术拿出来，AI作为流水线自然根据老师傅们做出来的东西学了一套能够快速生产的方法。这你能说它是抄袭吗不能吧蛆音娘吃瓜群众蛆音娘吃瓜群众蛆音娘吃瓜群众;18;18;36;18388;0.001957798564281053
97434;如果出了ai设计，ai打螺丝，ai农业，ai建房子，ai一切你正在从事的职业，那未来是什么样的呢，我想到那时，评论区的各位一定都还是纯粹的既得利益者吧吃瓜吃瓜吃瓜;12;15;27;18388;0.0014683489232107897
97447;ai对我这种非职业的画画人很有帮助，没素材了就去ai区找，总能找到很多想要的。还能拿图片做参考，非常有用。;2;6;8;18388;0.00043506634761801175
97450;太阳系突发事件；一场源于画师与AI的道德问题产生画师们坚称AI绘画的侵权行为，表明人类应该保护自己的思考与创造能力来防止审美的停滞，并认为政府应当负起责任保障他们的权利。而部分AI使用者们坚称AI并未侵权，并认为画师的行为正在阻碍科学与社会的发展。你的选择是：A：给予忽视。AI只是时代变迁的前夕，变革一定会有牺牲者，我们不需要对他们有任何关照，随他们去吧。星系满意度5（10回合内）星尘金钱10（10回合内每回合）科技产出10（5回合内每回合）工业产出5（永久）星系满意度10（10回合之后永久每回合）增加科学党的势力有5的概率造成一场重大政治危机B：进行限制。不受限制的发展一定会导致不稳定性，我们不能放任一个新生事物的随意发展。科学产出5（5回合内每回合）增加宗教党的势力;2;6;8;18388;0.00043506634761801175
97453;一个显而易见的地方就是模型，只是个算法集。他并不包含任何图片。他只是一个记录了很多种可能性的大文本。里面没有任何图片或者与之相关的东西。而且。有一个显而易见的事实。算法集只有几GB甚至更小，然后得到他们用了多少的图片，那肯定就是以tb算的。甚至可能几百tb就这个大小而言，本来就不可能和他的训练集有任何关联。因为它本身只是个记载可能性的大文本而已。每张图只是在几个点增加或减少它的可能性。和那张图片本身完全无关。所以说就只能是扯皮了。我是不支持这样的扯皮的。我有点无理取闹了，讲真的。;3;10;13;18388;0.0007069828148792691
97457;这个找不出证据的，ai学习之后你根本没法证明它是抄袭，或者用了谁的图源，因为最后生成的是算法模型，就好比人学了出名画师的画，你也不可能从他脑子里拿出证据来说他抄袭。这就是个利益分配问题，法院管不了;14;15;29;18388;0.0015771155101152925
97472;好好好;3;3;6;18388;0.0003262997607135088
97477;这个告人AI侵权就很有意思，且不说深度学习训练出来的模型是一堆数学函数不说，你去告连人家用你的图的证据都抓不出来，甚至人家一句我就是个卖算力生成图像的，你就那人家没办法了，这不是什么版权纠纷问题，这就是个妥妥的利益分配的问题。;13;25;38;18388;0.0020665651511855556
97491;可ai没法在纸上作画呀怎么会对绘画界造成很大的影响呢笑哭笑哭应该说板绘界吧;2;5;7;18388;0.0003806830541657603
97496;如果画师的画没有版权，ai作品也就没有版权，你甚至没法宣称你用ai出的图属于你，谁都能说你的ai图可以随便用，人们对艺术作品的付费意愿没了，毕竟你随便熔原神迪斯尼，谁都能拥有就没有价值，如果你认为原神迪斯尼有版权，那么画师的作品被商用自然是一种侵权;8;15;23;18388;0.0012508157494017839
97506;解决ai的一个好办法就是“发我图层，谢谢”;12;12;24;18388;0.0013051990428540352
97520;感觉根本的问题就是其算法是窃取别人的作品算出来的。如果法律上得到认同那么是不是就等于承认你用非法手段获得的资料训练AI后AI导出的作品属于你受到法律保护。那么未来那些大的企业公司是不是就可以疯狂的采集训练AI然后疯狂的低价出图，如果一个画师约稿要1000，但是这些公司可以10块一直出到你满意为止；甚至可以想坏一些可以疯狂出各种风格姿势的图然后如果其他人出了类似的图就告抄袭赔偿什么的，那么对环境的影响是破坏性的。而且不仅是绘画领域，还包括了其他的文娱领域，比如小说，而且现在其实也有用AI做动画的了，还有用AI做虚拟主播的。现在很多支持觉得没有问题的人纯粹是影响不到他们而已，临时想一个比方就好像那些拉车的马夫笑话工厂里因为设备升级而不被需要的工人，但是没有想到背后马车公司准备把他们替换下去换出租车一样;3;10;13;18388;0.0007069828148792691
97524;怎么说呢，ai绘画确实强。但是如果要求的人物细节太多，目的性很强的话有点难实现，要细节的话还是请画师吧;2;5;7;18388;0.0003806830541657603
97528;主要是ai学习的前提是要喂图啊，有些人不想自己的图被喂啊，没有授权就是侵权;14;4;18;18388;0.0009788992821405265
97544;如果一個ai音樂程式窮舉所有的音符組成那是否可以申請對於所有未著作音樂的版權？;3;4;7;18388;0.0003806830541657603
97548;我记得mj是找了很多画师要了版权的吧;1;6;7;18388;0.0003806830541657603
97550;AI绘画是对真正艺术家的冒犯，它将毁掉我们的行业。;9;4;13;18388;0.0007069828148792691
97560;隔壁呼吁非艺术家也要抵制AI，那么反对法律禁止ai是不是会被打成工贼笑哭;4;5;9;18388;0.0004894496410702633
97565;我们人类能学习别人的画，结果AI就不能了，而且AI也不是缝合别人的图，这群告的人太六了;16;9;25;18388;0.0013595823363062867
97582;玩sd玩了几个月无语，所谓日以夜继的训练学习就是个笑话;2;9;11;18388;0.0005982162279747662
97585;可爱捏;1;2;3;18388;0.0001631498803567544
97587;美国律师把ai律师按下去了，程序员忙着告copilot，画师群体起诉stabilityai，谷歌的音乐ai明确不敢侵权，chatgpt帮助写论文引发学术界争议。总之未来有一段时间好多关于ai各行业的的口水战了。关于ai立法迟早回来的。;3;8;11;18388;0.0005982162279747662
97591;AI绘画是未来的趋势，我们应该欢迎它而不是抵制它。;2;9;11;18388;0.0005982162279747662
97594;AI绘画带来的利益已经远超画师，这还是在有限制的情况下（模型需要设备训练），这跟挖矿有什么区别呢？;1;8;9;18388;0.0004894496410702633
97596;文生图，我最喜欢的画师：mikapikazo，配合原始模型，过拟合严重。那些给我说ai有创造力的想想，是还是有官模基础的。另外之前有人在mj用文生图出来个和曾经迪士尼宣传图上动作姿态等等一模一样的米老鼠，被mj连夜退款封号了诚然不是拼贴，但除了效率，我不觉得它会对美术发展有什么大的贡献。猜猜哪个是原画师画的doge;3;3;6;18388;0.0003262997607135088
97601;底层画渣表示现在心态其实就两个字开摆;1;3;4;18388;0.00021753317380900588
97606;个人十分期待Ai绘画可以出个步骤教程起到教学的作用;1;6;7;18388;0.0003806830541657603
97609;没想到AI能创造出这么棒的东西;1;3;4;18388;0.00021753317380900588
97612;这个事情的关键在于，真的有用么？ai的进步是各界主流意见，模仿和学习也是主流技术不可能消失。画师们看到的是自己艺术全领域这个“大行业”，却忽视了“智能发展”这个小事情。我觉得“难说”。;6;5;11;18388;0.0005982162279747662
97619;似乎只要宣布AI绘画无版权，手绘画师就能高枕无忧了？他们有没有想过，该如何在保护隐私尊重人权的情况下证明一副画是不是ai生成后被二次加工出来的？吃瓜当自觉标注AI的行为因新增法律被禁止，使用ai的人会就此放弃，还是混入手绘人群，带来一场人机无间道？思考;1;4;5;18388;0.00027191646726125733
97621;赢了也无所谓，还能跑过来删了我硬盘不成吃瓜;8;4;12;18388;0.0006525995214270176
97631;没事，这一次zb站在我们这边doge;3;5;8;18388;0.00043506634761801175
97635;我说句公道话，学习分两种。一种是教学，教授技巧。一种是发出来人家自己学。说实话，第二种是不用给学费的。你让别人不学都难好吧;1;2;3;18388;0.0001631498803567544
97639;AI只是一个程序，或者说只是一个工具，真正的使用者是人，商业用途才有版权的说法，单纯的看是没有版权的（除非画师画出来不让人看，画师画画不让人看那就真的是自寻死路了），过去是用人眼看然后用人脑来计算然后动手画，也就是说画师也是在模仿他人的画的基础上创作自己的画，现在只不过把人眼人脑手的工作交给AI来完成了，与学画画没有本质的区别，所以告侵权是不可能成立的，人家根本没用你的画牟利，只是用软件“看”了一眼，然后生成了另一张画。大势是不可逆的，中低级画师抵制AI就跟一百年前写实画家抵制相机、黄包车司机抵制自行车一样可笑。另外就是涉及到AI收费问题，目前有部分AI已经开始收费，上面说了，AI只是工具，工具付费是理所应当的，就跟画师买颜料买画笔要花钱一样，这是一件再正常不过的事。;22;2;24;18388;0.0013051990428540352
97662;反正潘多拉的魔盒已经打开了，这官司就算打赢了也是猫盖屎，一点都没用。;4;2;6;18388;0.0003262997607135088
97672;AI真的在创造与原始图像相同的艺术吗？;17;2;19;18388;0.0010332825755927778
97690;AI绘画不能替代人类的创造力和才华。;1;2;3;18388;0.0001631498803567544
97692;学习模仿画风就成了侵权，都是利益问题，我支持ai，但不希望ai绘出来的画用来赚钱就是了，画师也魔征，别人在qq群随手发了一张ai图，也没有利益，他们就在那里不停在骂。明明那个群不是讲画画的。原神生气原神生气;2;3;5;18388;0.00027191646726125733
97695;现在也有可以画三次元萝莉的模型了，我在想如果用单个coser炼个私炉，岂不是比ai换脸来的快。好家伙感觉越来越违法了，犯罪都市要来了doge;2;3;5;18388;0.00027191646726125733
97710;ai绘图只能作为辅助工具，而且目前的ai绘图是拼接元素，还有人觉得这是创作？;18;1;19;18388;0.0010332825755927778
97729;我就是个画渣，只是用AI绘画来找乐子吃瓜;1;1;2;18388;0.00010876658690450294
97733;AI也要遵循版权法？;1;1;2;18388;0.00010876658690450294
97735;我觉得是不是我们也可以告AI绘画公司，因为如果想避免数据量过大而造成版权争议，另AI学习办法就是生成对抗网络，就是利用互联网上无版权的图像生成，然后另一边使用判别器来确定生成的图像是否过关。那么有没有一种可能，所有互联网用户都充当了“判别器”的角色。;2;1;3;18388;0.0001631498803567544
97738;吾乃江湖神偷也，稳定扩散百家艺;1;1;2;18388;0.00010876658690450294
97742;这是AI和人类艺术家之间的大战;1;1;2;18388;0.00010876658690450294
97746;版权这件事情很难吗？一旦资本入场，版权问题不就解决了吗？;1;2;3;18388;0.0001631498803567544
97748;既然一隻猴子可能用無限的時間，生成任何的作品那猴子是否應該擁有所有的版權;3;2;5;18388;0.00027191646726125733
97752;不可能赢得，要是赢了，以后所有图片给人学习都是困难的了，我一万福图片输入ai，让后ai学习创作出新的图片，如果这是违法，那我一万福图片输入一个美术生的脑子，他学习并创造出新的图片，怎么可能不违法呢？而且ai的加入对我们绘画界的创造性而言是好事，因为本质上人脑和ai没什么区别，都不可能凭空创造，不止ai，人也不可能创造出一个自己完全没见过的东西，只能在已有的东西上进行改造。ai的加入可以说是极大丰富了我们的创造性。;5;2;7;18388;0.0003806830541657603
97758;AI绘画能帮助我们创造更多令人惊叹的作品。;2;2;4;18388;0.00021753317380900588
97761;由衷的希望ai胜出，不多逼逼，只是趁现在这个空挡存上几个g的ai图。;3;2;5;18388;0.00027191646726125733
97765;别自己骗自己了，画师完蛋了，绝大部分指望绘画吃饭的人，基本都是商业美术，不是艺术。大厂已经开始来替代人力了;2;1;3;18388;0.0001631498803567544
97770;说ai侵权咋不说机器人抢别人工人饭碗，不做出更大的进步就会被淘汰，是历史必然;1;1;2;18388;0.00010876658690450294
97772;我觉得，它有平替，你告赢了它想用的人还是可以用别的。能打游戏的电脑都能本地部署。打赢了也只能证明赢了，但你还是阻止不了。智苯的特性就是现在赚以后的钱，它怎么会在乎以后有没有画师呢难过;1;1;2;18388;0.00010876658690450294
97793;AI绘画是生产力的进步，我不反对;1;0;1;18388;5.438329345225147e-05
97797;ai的画画面再好，也不可能突破目前绘画画面的峰值，毕竟是拿现有的图训练出来的，画面上的突破还得人来完成，这玩意如果管控得当是可以成为一个提高效率的工具的。;1;0;1;18388;5.438329345225147e-05
97799;AI技术不能私有只能公有化我就支持AI;1;0;1;18388;5.438329345225147e-05
97801;画师没了就没了呗，我是很相信ai的实力的。那些说ai不行的基本都被打脸了，也不急这一次偷笑;3;0;3;18388;0.0001631498803567544
97808;不多逼逼了，阻止不了进步的。;17;0;17;18388;0.000924515988688275
97840;AI艺术和人类艺术有什么区别？;1;0;1;18388;5.438329345225147e-05
97844;这个诉讼可能会改变AI的命运;1;0;1;18388;5.438329345225147e-05
97855;来了来了，啥时候5黑带我doge;1;0;1;18388;5.438329345225147e-05
97857;对于我这种刚入门的自学3D和游戏开发的人来说，如果以后想制作独立游戏，美术的时间成本会毫无疑问的降低，也包括金钱成本，效率更高，所以，有没有一种可能，以后的AI可以通过引擎生成一些游戏，通过学习知名游戏背后的代码逻辑，美术等各方面热词系列知识增加;88;2492;2580;18388;0.1403088971068088
97946;美术不会被ai取代，但是行业可能会，因为资本家只想要效率和利润;169;4454;4623;18388;0.25141396562975854
98116;从业多年的美宣来简单回答一下这个问题，其实提出AI会不会取代美术这样的一个问题，是背离了它诞生的初衷。先给出结论，并不会。不知道大家有没有思考过一个问题，AI已经完全可以自动生成各式各样的音乐，那么编曲师有没有失业？音乐也早已实现数字化，可人们又有没有放弃对于传统音乐器材的学习呢？也没有。十九世纪中第一台相机诞生时，人们认为相机会取代绘画，结果只是诞生了一个新的职业，叫做摄影师。从我们现在的角度来看我们认为相机取代不了绘画是正常的，因为它们要实现的目标和满足的需求是不同的，但对于那个年代的人来说，其实不然，当时的绘画主要服务对象是人物肖像的绘制，人们会以这种方式来纪念自己的容貌。那时的一位名叫安格尔的画家说“这是魔鬼的巫术”。他说“我的眼睛和手永远都不可能赶上照相机”。“绘画从今天开始，寿终正寝了”。随后令人未曾想到的是，写实绘画非但没有因此没落，且抽象派风起潮涌。而到了二十世纪，数字绘画诞生，人们又坚定的认为数字绘画会全面取代传统美术，但结果也只是传统美术的从业者多了一个新的选择，传统美术自身依旧金身完好。为什么，是因为传统美术已经形成了一种独到的文化，与音乐器材一样，是不可被替代的。到了现今，我们在讨论着AI会不会彻底取代数字美术创作，其实从一开始这个问题就是错误的。我们关注的不应该只是那副画，绘画实际上是一种创作欲，而从业者的创作欲是不可能被剥夺的。AI最终无非也只是成为美术从业者的一个新的工具，工具会进化，人们的需求也会随之进化，最终都只是服务于需求，切忌不要本末倒置;406;5712;6118;18388;0.33271698934087446
98523;即便AI绘画达不到某些商业原画要求，但AI的学习能力和进步空间仍然令我感到不适。成熟开放的AI绘画如果以软件形式全面问世，首先冲击的是私稿领域：我可以花几块钱用软件生成无数的图片为何还要用巨款去找画师？;212;1518;1730;18388;0.09408309767239505
98736;我看到那些AI绘画真的挺受打击的。在我脑海里我所能想象出的创意极美的插画居然就跟那些精选出的AI绘画如出一辙，甚至我看到它们都有被震撼，不敢相信是机器算出来的。这比替代人的手更令我谵惧，它让强烈感受到机器的“才华”，我根本不在乎它能不能替代艺术或者自己的饭碗会怎么样，我现在已经无法再相信支撑着自己的信念了，我无法骗自己，它就是我所追求的美但它却是工业品我现在只关心自己要如何走出去;302;2042;2344;18388;0.12747443985207743
99039;毫不夸张，我们项目的美术概念图已经开始用AI生成了，但主要是策划出需求用，细化设计还是需要美术同事来做;88;705;793;18388;0.04312595170763541
99128;肯定会的，25年前，人类信誓旦旦的肯定ai这种东西不可能在国际象棋这种脑力计算中胜过自己，20年前，我们说中国象棋这种具有智慧的东西不可能被ai攻克（如今顶尖ai可让职业一马而不输）10年前，我们说代表着文化和大道的围棋不可能被攻克，现在katago最新权重已经到了13500分以上（世界第一申真谞3845，而且是独一档的垄断优势）于是又有人说ai只能在这种全知博弈中战胜人类，现在，以欺骗为重要战术的德国扑克已经在三年前被ai攻克，现在轮到了游戏美术，我们还是一样的说辞，如同上面四次一样的相信自己;201;1179;1380;18388;0.07504894496410702
99330;我感觉这张图给3d，3d做不了，而且感觉不清楚的东西太多了，我承认ai的氛围感色彩不错，画师可以利用，但是设计方面一塌糊涂，不能用，设计更多要用准确的线稿和良好的美感构成来表达，这一切都需要设计师有良好的审美和知识储备;34;431;465;18388;0.025288231455296933
99365;不会取代，只会精简人数与提高效率。单纯只是创作的话或许AI可以一定程度上胜任。但是游戏美术需要做的并不仅仅是画出一副概念图这么简单。;41;481;522;18388;0.028388079182075268
99407;画画属于创作领域，如果AI可以在画画方面完全替代人类，那它很快就可以在任何领域替代人类。因为不管音乐、绘画、舞蹈，甚至科学、经商都是属于集合之前所有知识，加一点新的灵感而成的。大部分的基础是已有的东西。像搭积木，用零件来创造不同的东西。我不觉得这是人类想看到的未来。;39;431;470;18388;0.02556014792255819
99447;ai绘画可能不会取代人但ai学习的是无数画师的绘画这样窃取了别人的劳动成果反过来给画师造成危机感谁都不好受;99;809;908;18388;0.049380030454644334
99547;这个东西能让画师省去构图，光影造型设计，色彩搭配，这些前期步骤，画师只需要在这个基础之上具体造型关系，刻画一下细节就好了。;33;280;313;18388;0.01702197085055471
99581;高情商：可以利用AI概念图获取灵感，使得行业大佬们有更高的创作空间，更高效地出图。给心心低情商：学习成本增加，新手短时间内无法就业，成了大佬才能入行，真正成为财富自由者的天堂门槛。辣眼睛;9;279;288;18388;0.015662388514248424
99591;别跟我说这种岗位还需要画师来填改细节，真正喜欢绘画创作的人没有想给AI擦屁股的;26;269;295;18388;0.016043071568414183
99618;一直觉得AI绘画这事，和别的人工智能还不一样，AI绘画不会自主产生作品，其来源是对网络上收集的图片库进行拼贴再创作，说白了还是需要人类创作出的绘画作品支持。这不像自动扫地机自动分拣机这种没有创造性的工作，完全替代我们也只会觉得是解放劳动力，没人会觉得不妥。也有人会说AI下围棋，确实AI最开始也是学习无数棋谱，但到最后实际还是算力碾压，毕竟围棋也只是一种数学游戏。我担心的并不是以后AI会完全取代人工绘画，我担心的是你在网络上发表的任何创作都会被AI肆意的拿去当素材库使用。举个不好的例子AI深度学习了老累的作品最后量产老累画风会怎么样;59;327;386;18388;0.020991951272569066
99678;作为一名场景原画，想说一下自己的观点：第一、游戏美术不止是原画和概念，还有很多其他职位，比如地编、TA这些。第二、我之前试过一阵子DD和MID这两个工具。就目前AI绘画的程度，仅仅用于出个草图或者提供一些灵感和想法是够的，但是真正的设计和审美AI是没有的，而这恰恰是美术的核心，这是AI目前学不来的。AI只是工具，和PS或者3D辅助一样，关键还是使用者。或许有美术造诣高的策划或者制作，但是术业有专攻，美术的活还是交给美术来干吧。第三、我认为目前的AI绘画功能是远远达不到工作要求的，可能能达到简单的2D游戏的要求，但是对于高质量的游戏还是差很多。AI是不懂透视的，你无法让AI画一张完全一样的画，但是只是简单改变视角，AI理解不了。另外如果AI绘画能够像blender一样开源，那么它或许在两三年内就能够成为一个优秀的创作工具。但是目前各个AI绘画软件直接圈地赚钱的做法，我觉得可能要更久。不是说不能赚钱，但是我个人觉得功能不完善就出来卖或许人家的目标客户也不是我们游戏原画，毕竟平面设计、插画这些对AI绘画的需求更大吧，毕竟现在央视新闻的宣传海报都用AI画的图里;23;243;266;18388;0.01446595605829889
99702;有些人自己不是画手才会说风凉话，等你的专业可能被ai所取代时你就笑不出来了。ai会学习你的画风，而你并不会因此盈利哦。特殊的画风也是可以被学习的，然后别人用ai复制你的特殊风格赚钱，然而你拿他们一点办法都没有。别拿古代的绘画大师和后来的画手来偷换概念，举个例子：霓虹金在古代学我们的文化呢，最后演化成他们自己的东西了，韩人在现在直接偷我们的文化无演化马上就说是他们的，这二者有什么可比性吗？;39;315;354;18388;0.01925168588209702
99742;人类不愿意承认AI会取代人类只是因为害怕被取代，再过几十几百年，技术完全成熟之后，就不是取代你美术的问题了，整个游戏都直接给你做出来。想要什么游戏，输入关键词，AI就啪啪啪几分钟给你做出一大堆游戏让你自己挑，然后把自己生成好的游戏低价售出。玩AI玩得很熟练且审美优秀的人，可以生成更有意思的作品，可以卖出更高的售价。甚至AI自己就有着人类无法企及的独特审美。人类大脑的工作方式终究只是在这个宇宙的基本法则下运行的，那早晚可以被AI所复制和超越，那时候也许你终其一生的学习和思考，AI几分钟就做完了。甚至当未来AI开始自己给自己敲代码的时候，AI能有多强人类自己都不知道。;51;267;318;18388;0.017293887317815965
99794;总感觉一堆人都搞错了关注点，这不是什么取不取带，而是这个工具让工作简单的，代表啥，岗位会少了笑哭，画师，美术人员可不会被取代，这些工具终究是要人来操作的，也要有人进行部分位置的精细加工，但是这代表着以前可能要好几个美工一起头脑风暴啥的工作量可以缩剩下12个人和ai进行头脑风暴就行了笑哭，会用，用得好的人会更吃香跪了，取代是不可能取代的，你看现在工厂，不少机械化设备了吧，之后不还是得招募一帮子拧螺丝的跪了;51;518;569;18388;0.030944093974331087
99847;产业升级就一定会有人失业，这是无数历史证明过的事情，但是产业升级也意味着我们能做更多的事情，比如一个人就能快速产出高质量游戏，或者游戏公司能建立更大更宏伟的游戏世界;38;269;307;18388;0.0166956710898412
99886;会画画的人压力巨大，不会画画的人拍手叫好;35;316;351;18388;0.019088536001740264
99922;可以用来快速获得概念图，但是如果想要制作完全符合自己的经典作品还是得手绘;3;274;277;18388;0.015064172286273656
99926;有些人还天真的以为ai会成为画师的工具，搞搞清楚，你和ai都是工具。你画的快了你老板不知道加工作量啊，你是有更多个人时间了还是提高了生活质量啊？除了画的快了你还得到了什么？;18;263;281;18388;0.015281705460082663
99945;美国科罗拉多州博览会把画作一等奖给了一个用ai作画的设计师。第一名已经打不过ai了。;9;57;66;18388;0.003589297367848597
99955;想一下未来全是小公司或个体户生产同一种画风的东西就算当下你认为很好看，当铺天盖地反反复复每一天的互联网图片都是ai生成的图片，设计师摆烂不在创造新的风格高级ai合成怪没有新的资源合成，这是进步呢还是退步呢，重复的工作可以被替代，具有创造性的工作无法被完全替代除非有一天ai拥有像人类一样的情感从人类的角度去思考。;28;312;340;18388;0.018490319773765498
99984;会淘汰完全不用ai的人吧我觉得。本人是游戏美术，从早期辣鸡页游到现在走动作手游和那种3a方向动作手游（你理解的3a就好）。根据up出的几张血源相关图，我觉得特别像早期页游拿别人作品扣过来改和合成的效果（虽然ai更抽象更自然一些）笑哭。看某些ai高还原关键词的时候，这种感觉特别强。;5;57;62;18388;0.003371764194039591
99990;ai绘画让美术成为了工业产物。可能很多人会说，ai不会表达，只会排列组合，只是凭借着庞大的数据库在剽窃着艺术创作者的结晶。但是，十几秒生成的入门级画作，比起几十上百上千并且需要消耗大量时间精力的设计绘画，在成本上已经赢了太多太多。更可怕的是，ai会学习，会升级，艺术创作者的水平越高，ai的能力也越强。发人深省，令人感到反感。。。甚至恐惧。;6;56;62;18388;0.003371764194039591
99997;其实，虽然如此，就和摄影与3D一样，至少现阶段的AI还是不行的，毕竟生成了你其实也不敢用，它“抄袭”的味道太浓了啊，不过拿来当工具使用是真的不错。比起担心原画来，我倒是觉得动画行业才是真的危机了，你想啊，学会了原画的风格，一口气生成几百帧不合玩似的？顺带提一嘴，各行各业都是这样，人工智能出来之后，成熟之后，哪行能不卷呢？程序就不卷吗？然而连自动写代码都出来了，就玩死自己吧。比起这些，我倒是期待3D，而且比起2D来，3D如果只是单纯的按照原画来建模的话嗯，卷死吧。大家都没饭吃之后，我看谁还有兴趣在这里讨论AI会取代什么。指不定哪天AI自动做视频就出来了，不需要你找素材，不需要你剪，只需要输入文案。（至少我对此很感兴趣）脱单doge;11;54;65;18388;0.0035349140743963455
100009;各位趁早转行吧，等你把线条结构色彩虚实明暗一堆鬼东西练好之后，却发现AI和你画的几乎一模一样，谁会花钱雇你，就视频里的那些有些AI画你想想你又要练多久，你还要练的超越AI，而且就算你练的比AI画的好又如何，资本只会选择更加廉价的平替。;71;157;228;18388;0.012399390907113336
100081;在资本主义中，人和工具的对立永远不会结束;2;59;61;18388;0.0033173809005873395
100084;现在作为画师说啥都像是嘴硬，但时间会给出答案，我的想法是，大量重复的作画现在有可能被替代了，但内容创作依然坚挺，插画中表达剧情，这ai大概不可能做到吧？比如有些画师能用一张画讲完一个凄美地爱情故事，ai怎么学？;38;167;205;18388;0.011148575157711551
100123;做了七年3d。被取代就被取代呗。。。我热爱。不妨碍我创作。。我不会依赖ai。。ai要是盛行。。我就吃低保在家做雕塑。;7;52;59;18388;0.0032086143136828365
100131;感觉就是AI辅助美术达到更好的美术;15;149;164;18388;0.00891886012616924
100147;个人看法：低端美术职业（制作型）会受到很大冲击，高端美术职业（创作、指导型）工作内容可能会发生改变，从完全人力的创意流程走向指导型。AI也好PS也罢，再往前的纸笔也好，本质都是工具，工具的使用需要有对应技能、素质的人去完成。随着工具的自动化、易使用性的提高，在非纯艺的追求效率的商业制作领域，自然相关工作者的工具技能偏向性会降低，这就自然淘汰了一批只会使用工具的人。而那群拥有极致审美、美术素养的人，将会依旧作为人力的指导者，指引工具的产出。说到底，现代商业追求效率的模式下，很多普通画师能够被另外随便招来的其他画师替代的话，本身就说明已经成为一个工具人了无非是从工具人变成了纯工具AI而已。但AI不会替代绘画艺术，正如上文所说，商业绘画和纯艺，有本质目的的不同。创作和制作也并不相同，并不是画的快、好就是艺术品，但确实这是商品所追求的。;1;47;48;18388;0.0026103980857080703
100149;还记得Ai文章吗？乍看之下有板有眼，实际上谁会去天天看ai文章。还有ai语音现在已经很逼真了，但是声优失业了吗，那种味道感情是ai无法办到的。工厂自动化的预制菜，快速，便捷，味道也还行，但是你总想去吃一口大厨亲自做的饭菜。;44;119;163;18388;0.008864476832716989
100194;答案：不会。AI会收集现有数据，不断构出符合人类审美的事物，即AI作画，这是极其符合人类审美的。但是，人类艺术里不单单包含了这种明显有序的艺术，还包括隐约无序，即混沌的作品。简单粗俗地说，就是“这种艺术对于人类来说为时过早”，也就是说，人类这种极其混沌的物种不单单会构造出有序、符合人类审美的作品，还会构造出极其混沌、反向的作品。简单举个例子就是，克苏鲁这一系列。当然有人会说通过视频所说的软件AI也能做出有克苏鲁画风的作品。但是我想说的不是这个。最开始的创作者的时代是没有克苏鲁这种文学体系与形象的，是他从无到有一步步构建起来的，即从0到1。但是机器只能从1到正无穷，而不能从0到1。这就是机器与人类的本质差别，也就是为什么我说的为什么AI不能杀死艺术与游戏。当一个风格已经普罗大众时，人们就会追求更新鲜的事物，会创造出新的体系，这就是人类“创造”的权柄。如若当机器（人工智能）也能做到这一步（从0到1）时，那大概机械生命就出现了吧。PS：一家之言，请勿深究，如有错漏，欢迎斧正与讨论。但请注意，可以讨论与深究，不要上头与人对骂。谢谢。doge;19;49;68;18388;0.0036980639547531
100214;也就大锤没落到自己头上还能在这说风凉话，不会真有人信人工智能取代了部分工作的同时，会有等量就业机会提供给你吧，;16;138;154;18388;0.008375027191646726
100231;如果只是单纯的一张画的话，AI做到确实很好，但这些很好看的画却不一定能拿来用。对于要用在游戏里的画，好不好看，细节多不多其实是次要的，重要的是画面的风格和画中的信息是否与游戏内容相符，比如说画一张赛博朋克街道，AI轻易就能完成，但是要画一张“创伤小队空降到人流量高峰时的街道上与赛博精神病展开火拼”，或者讲述这些内容的漫画动画，那AI就会歇b了，而这种有内容有信息还符合游戏内容与风格的画才是能用的画，这种画至少现在为止，还是得让人去想，让人来画藏狐;2;48;50;18388;0.0027191646726125733
100234;藏狐以后能不能代替美术从业者我不敢说，但是现在很多漫画APP里的作者已经在用廉价的AI绘制各种风景背景了。让不少以前不知名的作者做到了惊人的一天更一话的地步，最近在看的很多条形漫画就发现了。;2;40;42;18388;0.0022840983249945617
100237;好家伙，我还没就业就先失业了是吧微笑;4;97;101;18388;0.005492712638677399
100242;寄了，设计专业连夜学习炒粉技术大哭大哭大哭;12;44;56;18388;0.0030454644333260824
100255;文章自动生成会取代文学吗？ai绘画会取代画师吗？虚拟歌姬会代替歌手吗？无人驾驶会成为主流吗？请问这些问题和机器人会替代人类有什么区别吗？微笑这个或下一个）时代有什么职业是Ai不能替代的吗？;28;102;130;18388;0.007069828148792691
100284;先说一下我一个音乐生的看法吧，ai用处的确能造成大量人员失业，但也不足以毁灭这个行业，看了这期视频里的大多数画之后我并不认为ai的能力怎么样，单从目前来看他的确能说得上一个底子很好的美术生水平，但是美术和我所学习的音乐归根揭底是要引起心底情绪共鸣，我看完视频去琢磨了一下这个作画，大多是注重表面而没有内心情态细节等过多表现，其差别就像是一首用歌词来表达情绪的曲子和一首古典乐系，作为一个古典派的人我并不觉得这种曲子难听，但是用歌词无疑是表面传递情绪，当我用恐怖的词缀去给他的时候出来的图片很吓人，但是也仅仅只是这样，与专业画师能给我心底里长期带来压抑十分不同，ai做出来的画固然优秀，但是缺少了所谓的底蕴，从游戏作画来出发，一个游戏的画面必须要让人感受到画师传递的情绪，一个恐怖游戏里的画面大多十分简陋，但是却能通过细节等多方面来让我感受到压抑乃至于后背冒冷气的感觉，这显然不是ai作画能给我带来的感觉，当ai已经能够掌握人类思想并将其转换为音乐美术文学等方面的时候人类恐怕就要被取代了;11;43;54;18388;0.0029366978464215794
100296;真的，隔一段时间就冒出一个谈ai作画的，还危言耸听的说ai替代人类，我真的很难不怀疑是蹭热度啊，就是你但凡动一点脑子都知道ai绝对替代不了人类，别说围棋之类的，绘画比围棋抽象多了，围棋有一套具体的规则，而绘画没有具体的规则，有很多大佬为了出效果也是会故意扭曲透视和颜色过渡的，而这一点是ai做不到的，ai说白了就是素材拼接，就开头那个所谓的“设计图”，我真的看不出任何逻辑，就是拿到什么素材拼上去就完了，大佬的设计图你可以自己去搜，我是能看出他们的设计流程的，也能学到东西，所以别再说ai吧啦吧啦的了，你ai想替代人类还是再过个几百年吧;137;232;369;18388;0.020067435283880792
100434;AI作画取代游戏美术没错这个ai真的强作出的画放出去卖大几万而且十几秒种的速度量产只是觉得2D美术会被打击吗想多了你画画为了感情那你继续你画画为了给甲方交差要你何用？2D美术的作用大多数是来满足对于某个事物的寄情，包括设计方面的表达AI如果为了色彩绚烂，形体高级而作画，也只是用于观赏的事物除非给AI定义处作出的画要蕴含一个意思差不多的命令，否则ai的画只有其表没有灵魂大多数人画画是为了展现某件事物，寄托自己的情感，有一部分人画画完全是为了商业运作照相机发明后，肖像画师们惊恐，因为自己的作用将会被取代。没错，到了现在肖像画虽然还存在，但是意义远不是记录样貌，而是一种更高级更奢侈的追求。时至今日，绘画ai出现了，美术行业开始担忧，因为自己的作用也即将被取代。同理，不追求蕴含人文情感的画作当然可以被取代。ai的强大技术力可以作出任何，注意是任何你想要的样子。担忧会不会被取代毫无疑问是自讨苦吃。绘画本身，是一种人文作品，他代表的是画师的心血与情感，这个绝不可以替代。画师像，啊我给眼睛点个高光表达我的欣喜，人物也变得欣喜。ai只会想，在人物眼睛加高光会表现更加欣喜，而不会自己感情拥有波动。区别就是这个。就像3D建模，3D打印出来了，你会说断臂维纳斯就毫无价值吗不，艺术品的价值就是艺术，是拥有人文情怀的产物。总而言之，人类的生产力是不可能比上工具，因为工具就是人类创造出来用于提高生产力的事物。就像你养个可爱宠物来取悦自己，你还要和他比谁更可爱更能取悦别人吗接上文，工具既然就是生产力的衍生，那么人力所能达到的，只要借助工具必然可以达成。画师被取代是的，游戏美术会被取代，但是概念美术不会，艺术美术不会。ai模仿的达芬奇手稿绝不可能被放进博物馆。至于现在非艺术创造为目的的从业者，毫无疑问未来是觉得会被代替，他们现在的杞人忧天不是可笑的，因为天真的会掉下来。;4;47;51;18388;0.002773547966064825
100439;作为一个学习深度学习和卷积神经网络的研究生，同时还有绘画的爱好，我认为目前这种ai生成技术画插画，画头像这种肯定是绰绰有余了，但是如果说要生成一系列相关的美术作品肯定是不行的，你可以让这个ai给你生成一个人的正面，但你无法让他给你生成上一个人的侧面，因为他压根不认识上一个人的锚点和特征，除了你所描述的关键词之外，其他对于他来说都一样。但是人认知一个人或者说是一个角色是全方面的，就像两个明明都是瓜子脸，双眼皮但我们能够做出区分，但是ai不能。风景画也是一样的，他无法给你再现同一个风景的不同角度，除非你能把这个风景的各种特征和细节都描述出来。;10;104;114;18388;0.006199695453556668
100450;可以画一树梨花压海棠吗？可以画深山藏古寺吗？它应该是只能画一些可以技术化生产的东西，这种东西多了就会审美疲劳。意识流和艺术性质的应该画不了。如果这项技术非常廉价的话，就会砸了许多绘画小作者的饭碗但有另外一部分人，由于这个成本的下降，就获得了成长空间人们就已经不能单靠一门手艺活下去了，需要掌握多门技能，然后整合它们，用它们创作自己的作品。;7;35;42;18388;0.0022840983249945617
100458;多吹一吹，我行业内少点未来的竞争对手;2;36;38;18388;0.0020665651511855556
100461;最好笑的笑话就是用ai直接生成图的人称自己是艺术家;14;80;94;18388;0.0051120295845116384
100476;那些说什么ai杀死的都是不入流的低端画师，撼动不了高端画师的，有没有一种可能，就是你在河里放一张绝户网，然后把大鱼都扔出去，美其名曰我只杀死小鱼，再过个几年你看看河里还有没有鱼;1;30;31;18388;0.0016858820970197955
100478;ai不会杀死游戏美术，但是会杀死很多从业者热;15;70;85;18388;0.004622579943441374
100494;画师要是可以所想即所得，也可以像ai一直样快速产出图片而且AI绘画还是需要一个素材库不是无根之萍，随着AI大规模普及，素材复用现象会很快出现，那么到时候买断一个素材库就是选择之一，而为了新的素材库产生，或者画师组件自己的素材库，到时候画师不是去画一个一群人在祷告的教堂，而是画很多个一个人和一个教堂，存入素材库，让AI去把这些素材组合，得出分图层的画面，给甲方看直达满意然后精修一下，画师的价值肯定还是在的。;6;33;39;18388;0.002120948444637807
100501;我说个实话，很多低端画手本身的工作就是在搞抄袭，抠图，拼素材，改素材的工作。但有了花瓣网，难道就不需要画师了吗？很多游戏的ui，特效，图标从网上素材就能找到改改就可以用的，但是游戏画师消失了？实际上很多时候，常见的画师画的那些什么二次元头像，半身像角色也没啥意义，网上随随便便就能找出精美一百倍的画作，更加精致的人物图，但是现在仍然很多画师在产出这些东西。;3;91;94;18388;0.0051120295845116384
100505;AI目前看来在相当长的一段时间内依然是人类的工具，AI绘图依然需要人来给出需求，以后可能审美和想象力要比画技更重要。不过AI让人失业是不可避免的问题，但这是社会发展伴随的阵痛;5;25;30;18388;0.001631498803567544
100511;挺好的以后跟ai一起高考，成绩低于ai的全部进厂打螺丝好了，哦不对，以后都是机器人打螺丝，那么全部扔焚化炉无害化处理掉就好了。永雏塔菲1883安心永雏塔菲1883回旋永雏塔菲1883开派对咯永雏塔菲1883开派对咯;9;68;77;18388;0.004187513595823363
100521;下一步就算把3D建模师也干掉，以后直接写好剧本和分镜输入Ai，自动就能生成一部3d电影了，或者直接生成一个可以直接沉浸的元宇宙;1;23;24;18388;0.0013051990428540352
100523;我只能说这个东西就像是工业革命一样，打爆了普通人，让高手感觉地位受损而且获利的全都是资本家。资本家不管什么灵魂和感觉，他们就在乎效率和低成本。我只能说这种东西和公式游戏很搭，套公式然后做几张画游戏就能上了，而且巨便宜。;2;103;105;18388;0.005710245812486404
100527;其实真不难，开局那五张图，我就最后一张猜错了，其他四张画一眼就能看出区别其实ai画图最大的问题就算逻辑性，画要表达什么，和怎么突出表达的东西，根据这两个方面去思考，第一张图一眼就能看出是人画的，所有的东西都是在突出和迎合城堡，配合着火一般的场景，这就是大多数画师惯用的逻辑在看后三张，虽然画面精致，但其实完全看不懂“画师”究竟想表达什么，也就是说这些画没有中心思想，越是复杂的画面越混乱虽然这些大画ai还不行，但第五张这种主题简单，主体明确，背景简易的，ai确实已经达到了中上游画师的水准了（不过怎么感觉像是从某个画师那直接照办过来的）其实现在最可怕的不是ai技术，而是由这项技术侧映的，大多数人在作画这方面鉴赏美的能力并不高;15;79;94;18388;0.0051120295845116384
100543;真的吹这个Ai是对于那些自己没什么本事的人。你能力却强越觉得这玩意鸡肋，而且这里的强我还是指的业余人士，已经入职工作一年的新人都比不上的那种。你美术功底到了半小时草图就出来，我就只说草图阶段。你用Ai你要生成100张图，然后再去一个个去筛选出来自己最满意的图，然后再去修改成自己满意的样子。绝对不止半小时。不是这玩意有啥好吹的，我逛了一圈没有一个up是专业美术的，自己的审美不到，见一个就觉得可以用当然觉得Ai厉害。而且就算Ai发展，但是美术这玩意你们别忘了，这是双方面的，对于欣赏者和创作者而言都是有作用的。应该没人会拿着Ai出的图，然后对着大家吹自己选图的能力有多强吧。也不会有人会崇拜这种人吧。;30;39;69;18388;0.003752447248205351
100574;人类最宝贵的是什么？创造力啊这要是被取代，人类就没啥意义了。这个AI构图，能把原画师挤死。入行门槛从此高的离谱，等现在这群大师不在动笔后，还有人愿意画吗？有人学吗？;7;19;26;18388;0.0014139656297585382
100582;如果ai能学习人类所有的思维流程的话，那ai和人类有啥区别，这是一个哲学问题，但真发展到这种程度，人类说不定连创新都比不上ai;1;17;18;18388;0.0009788992821405265
100584;世界上有五种辣，分别是，微辣，中辣，特辣，变态辣和云姐活辣;1;20;21;18388;0.0011420491624972808
100587;之后就是AI自动3D建模了，接着就是让AI自动绑骨骼调试动作，再然后就是你说几个规则AI自动编程以后人人都是独立游戏开发者，你就给AI说一串关键词，它就还你一个3A大作游戏行业全自动无人化产出的时代来了妙啊;6;14;20;18388;0.0010876658690450293
100595;你怕是没看懂他的意思。德州扑克就是靠欺骗的游戏都已经被ai打败，说明ai已经会识别谎言这种复杂的人脑思维。还有开头那几张图，你看得出哪张是ai？;3;17;20;18388;0.0010876658690450293
100600;就目前来讲，我觉得，那些写小说，并需要剧情插画的作者，肯定开心死了。不用花钱请插画师，自己稍微动一动手，就能得到心仪的剧情插画。;2;16;18;18388;0.0009788992821405265
100604;画画不是一蹴而就的，需要大量的时间精力去学习，更别提像我这种就那么一丁点的天赋都被磨没了，看着好难受啊，我画不出来，我真的画不出来，谁能明白我啊大哭大哭大哭;2;13;15;18388;0.000815749401783772
100607;不会，ai只会学像已有的东西就像httpsb23tvBV1114y1b7Dk这个三流视频的受众会被淘汰，那些更高层次，总结其他概念的设计师，现在的构成范围不仅仅在视觉上，要复杂的多，做的东西也不是杂糅缝合，更多有很多理解上的内容和自己的想法投射，所以不会，至少暂时还不会，除非哪天ai全面了解社会学，文学，音乐，历史，人文等等的所有东西，这才有替代的基础;5;13;18;18388;0.0009788992821405265
100614;我小时候，没人相信电脑下围棋能下赢人，因为围棋太复杂，不像象棋那么简单，这才隔了仅仅10年，现在的AI棋手都人类来说就是不可超越的神，因为绝对没有赢的希望，人会看错，AI却不会。;1;12;13;18388;0.0007069828148792691
100619;唉，累了，AI美术的出现让我不知道学美术的意义了，怎么说呢，我现在对以后感到迷茫了;7;12;19;18388;0.0010332825755927778
100627;感觉AI的学习是停留在现在已有资源的整合阶段，不具备突破的创造性，就比如在追求真实的古典画时代诞生以光与色为主的印象派，乃至后来众多的后现代主义流派，这是跳出已有框架的思维。不过感觉AI这项能力成熟，感觉真正的一流美术不会受到太大影响，但会极大压缩中低层画师的生存空间;3;14;17;18388;0.000924515988688275
100631;这玩意不是网上搜图然后合成吗为什么会取代美术热热;2;14;16;18388;0.0008701326952360235
100634;我动漫专业的，真是有被无语到了，板子扔了算了;1;11;12;18388;0.0006525995214270176
100636;虚假的人工智能：端盘子送快递打螺丝被ai替代，大家有空去学习和创作。真正的人工智能：创作性的工作ai干，大家都去端盘子送快递进场打螺丝。;1;11;12;18388;0.0006525995214270176
100638;ai会取代普通画师，但不会取代艺术家;8;11;19;18388;0.0010332825755927778
100647;人类的创意也不是无米之炊，无非也就是混合各种意向的三维表达，这个机器完全可以做到，甚至可以做的更完美。就和alphaGo一样，人类几千年的文明，显得如此可笑。;1;13;14;18388;0.0007613661083315206
100649;老实说机器代替人力劳动这么快我却毫不欣喜，因为人们的工作时间相比老一辈没有明显下降，我甚至担心未来很多人都只能干毫无意义感的工作，赛博朋克可以变成现实;5;10;15;18388;0.000815749401783772
100655;AI是通过其他人的画作和作品来自动生成的，如果没有画师的作品它拿什么来生成？人也是有不断的想想力的，AI是随机生成，帮助你达到想象中的样子，并不能替换画师，因此我觉得画师永远在AI之前，除非人工智能到了能让机器人有像人类一样的“大脑”那就是另一个维度了，个人观念思考;1;10;11;18388;0.0005982162279747662
100657;把三体里面罗辑幻想的女孩子描述出来，看看AI眼中的庄颜是什么样脱单doge“出生在一个高级知识分子家庭，过的不是富豪的生活，但比一般人家要富裕得多，她从小到大享受着充分的父爱母爱，但与社会，特别是基层社会接触很少。一个东方女孩，为中国人，文化程度应该是大学以上博士以下。喜欢穿那种素雅的衣服，在这种年龄的女孩子来说，显得稍微素了些。但总有很洁白的部分，比如衬衣呀领子呀什么的，与其余深色的部分形成挺鲜明的对比。个子不高，一米六左右，身材很纤细，一阵风就能刮跑的那种”;3;10;13;18388;0.0007069828148792691
100661;代替是不可能的，但是减少就业岗位是必然的。虽然会相应增加一些就业岗位，但是总体来说肯定是会减少的。;1;10;11;18388;0.0005982162279747662
100664;Ai学习绘画，某些人不行，抄袭画师，不尊重别人的版权。有些人类画师模仿别的画师，千篇一律的画风，某些人哎，只是学习而已，不算抄。玩双标有一手的大笑;8;12;20;18388;0.0010876658690450293
100673;会不会被取代只要参考餐饮行业就好了，十几年前很多人还会说烟火气，各地特色无法被工业化餐饮取代，现在看呢？除了少数高端餐饮，剩下的全是工业化半成品。;1;9;10;18388;0.0005438329345225147
100675;建议约法三章：1：AI绘画只可学习使用者自身作品，若学习他人作品必须征得其同意。2：任何绘画比赛需明确说明是否可以使用AI参与绘画，参与的程度，或分为AI组和手绘组。3：发布有AI参与的作品需标明作品由AI完成或由AI辅助完成，并且此作品作者不具有版权。;4;9;13;18388;0.0007069828148792691
100680;画师有了ai辅助，我能更好地创作了资本家有了ai辅助，我可以在相同时间里让画师画更多画了;1;9;10;18388;0.0005438329345225147
100682;热评第一举了相机和数字绘画不能取代传统绘画的例子，事实上相机和数字绘画从诞生开始就和架上绘画不是一个赛道的，可ai绘画可是直接和数字绘画在一个赛道竞争啊。虽然现在ai生成的作品漏洞百出，缺乏逻辑，可三五年后呢？或者ai和建模相结合呢？这一切都说不准;1;9;10;18388;0.0005438329345225147
100685;相机被发明以后很多人认为这个世界不再需要画家，但事实证明人类总能找到机器替代不了的东西;3;9;12;18388;0.0006525995214270176
100689;这是否意味着可以用ai来辅佐自己写小说时想象一些画面。比如我想设计一个遗迹的场景，拥有百间密室的大坟墓，黑暗，诡秘作为基调，那我是否就可以借助于ai生成的作画以进行一定的借鉴，让我能够更好的想象这样的一个场景到底是什么样子，而我又能够在里面做些什么。像我以前想象的冰与火之地，我很大的会借鉴怪猎世界的那张地图以及巨大陆珊瑚群系，我现在也可以用ai辅佐自己进行想象。像是视频展示的那张道教与怪物的结合体真的是震撼，我脑子里从来没有过这种画面，但是立在不可名状的巨兽上的道观灵感一下子就上涌了。多少有点语无伦次了，就算不写小说，似乎也意味着可以用ai作图来低成本实现一些自己曾经所幻想过的画面，我有时候会很沉迷于做梦这件事，因为梦境中的魁丽世界往往是不曾设想过的，又会在做梦时带来极大沉浸感与真实感的幻想世界，以至于我醒来还时常回味，而用ai作画或许在现实中也能感受到那种只存在于幻想中的奇幻世界。感觉看到了未来。;1;11;12;18388;0.0006525995214270176
100691;瞧一瞧看一看阿，落榜美术生个人作品按斤出售啦，各种xp一应俱全，既能挂在家里也能拿来当厕纸，一斤5块钱便宜出啦大哭大哭;1;8;9;18388;0.0004894496410702633
100694;讲真，很多AI绘画（特别是风景和建筑）都能一眼认出来，跟真人画的是两种感觉;4;8;12;18388;0.0006525995214270176
100701;如果连画师这种职业都能被取代，那我觉得到时候该担心的可不是画师了，这世上有多少人的工作是可以被ai取代的，你们自己好好想想吧，但凡做过项目的接触过团队的也不至于在这哔哔赖赖，还有说什么策划用ai就能作图用不着美术的，真的搞笑好吧，真就以为项目画师画画是给个参考就完事了？？？那种小游戏这么干可以，一旦项目大点没画师设计师你试试，就凭策划程序员的盛美做游戏早凉了，至于ai生成的设计，说真的能有多少是能用的，你把ai生成的图给别的部门试试，看看建模能不能揍你一顿，现在就是一帮外人看到点花里胡哨的的东西然后天天在这隔行指指点点，就真的很可笑好吧，还是那句话，画师这么一个抽象的职业要是都能被取代那这世界上要面临失业的可就不止画师了，所以焦虑个p啊有那时间不如多学点东西;8;6;14;18388;0.0007613661083315206
100710;资本逐利大多数商家他们不需要多精美的设计他们只需要一个凑合便宜的图就行;2;6;8;18388;0.00043506634761801175
100713;汽车的出现让很多人力车夫失业，但生出了司机的新职业tvdoge;2;6;8;18388;0.00043506634761801175
100716;AI生成的图没有图层，有些效果需要去掉就需要抠图，这对于复杂环境的AI效果图是不可能完成的。即使随机生成再多，也无法找到一张完全符合设计师的图，总得修，懂行的人知道每一张精美的图都是经过非常细致反复修改后的成果。;2;6;8;18388;0.00043506634761801175
100719;行业改变是一定会改变的。但我觉得AI有两个方向不足，一个是它不会产生超越时代的作品，第二个是它细节混乱含糊不清（有些设计和细节无法落地）。AI生成的图画，只是在模仿，他并没有真的理解它自己在做什么，只是根据已有数据得出最有解，它分析它生成的这些图片现在看是符合现在大众主流审美的，但是对于顶尖的概念设计师来说他们有时候会创造出引领下一个风潮的设计的和画风，这是具有超越性，有可能不完全符合当下大众审美的，所以这些年来游戏美术的概念效果和设计理念才会不断迭代。我觉AI很难做到在没有新的采样信息下进行自我迭代。但另一方面来说，就算AI做不出超越性的作品，但是对于当下来说，已经完全足够，并且水平已经很高，以后应该会加入到游戏行业里来，用于辅助做前期的概念设计，会提升极大画师们的效率。也许会替代一些人。所以我也准备赶紧去学下这个笑哭;2;6;8;18388;0.00043506634761801175
100725;感觉不一定会取代吧，因为至少这些游戏概念，或者设定是人来提出的，在已有的设计上ai可以让人们看到更多的选择，但ai还没到创造那个环节吧，至少现在还没到;10;6;16;18388;0.0008701326952360235
100736;感觉会演变成原画定好分镜，总体风格剩下的由ai生成一遍然后交给底层画师基于设定修修补补;2;6;8;18388;0.00043506634761801175
100739;放心吧，没有游戏或者电影会把AI画的东西当真的概念图的。顶多找个灵感扩展思路。;2;6;8;18388;0.00043506634761801175
100743;这种图交给3d，3d提着刀就来看你。妙啊;3;6;9;18388;0.0004894496410702633
100747;作为AI从业者，个人认为对于AI来说，文学艺术领域相对简单，目前是处于一个突破小瓶颈的爆发期，未来5年会有越来越多效果惊人的项目。但全半流程的科学和技术研究几乎不可能。目前AI擅长的是已有大量数据或评判标准，粗粒度，对实时响应要求低，且担责成本低的领域;3;7;10;18388;0.0005438329345225147
100751;谢谢专业已经改成人工智能了OK;1;5;6;18388;0.0003262997607135088
100757;完了。我感觉这辈子比不过ai了。这是一种很气馁的感觉。;1;5;6;18388;0.0003262997607135088
100759;题目本身就很二极管。答案是不会，但会造成很大的影响，会一步步的蚕食;1;5;6;18388;0.0003262997607135088
100762;以后会分成三派，纯AI派，纯手绘派，AI加手绘派。其实这是废话现在就已经是这样了尴尬;1;5;6;18388;0.0003262997607135088
100767;Ai写引擎，编曲，作词，作画，建模，编剧，加速发展到脑机接口只要幻想一下，几十秒就做好一个游戏;1;5;6;18388;0.0003262997607135088
100769;ai满足不了万恶的甲方，所以暂时还不能取代珈乐Carol大哥;5;5;10;18388;0.0005438329345225147
100775;人工智能太恐怖了，会迭代和淘汰掉多少岗位呆;12;5;17;18388;0.000924515988688275
100788;以现在的水平是取代不了高水平原画的，肉眼能看出来的差距。但是要是它把动漫风格学会了，那些oc圈、绘圈肯定会受冲击的。成稿快还好看又不用花钱，有这种好事谁还去约稿啊画风独特精美的或许能存活，很多水平不高但想搞点钱的肯定被淘汰了。从消费者角度来看我举双手赞成AI发展。;3;8;11;18388;0.0005982162279747662
100792;除非AI能跟甲方对接歪嘴;1;6;7;18388;0.0003806830541657603
100794;看了一下，很多人都在说一个问题，到底这个行业会不会被AI取代，或者某种幅度上的改变。这个我不好评价，我只能以学物理的思维来看待这种事。其实很早就有AI对人在某些方面、比如说围棋、象棋、或者评论区有些人说的德州扑克这种有博弈性质的。我的理解是，围棋、象棋、德州扑克都没触及到AI代替人这个问题的本质。象棋、围棋。本质上是公开信息的游戏，那自然理论上算力越强就表现越强，人类毕竟算力有限，计算机发展算力潜力目前来看找不到上限。计算机在这方面获胜并不奇怪，德州扑克本质上还是一个期望上的问题，虽然确实是存在博弈行为，但是计算机算力可以搜集极大数据趋向最优点。说白了，扑克本质上也就是赌博，自然是期望问题。所以依旧是一个算力上的差异。但是对整个行业的取代，就涉及了一个最重要的问题，抽象思维。你必须承认的是，现在计算机的智能学习，只是在通过大量经验实践在某些方面趋向某个最优点。我指的抽象思维是什么？比如说给你第一个多米诺给骨牌，中间所有骨牌都会推到下一个骨牌，那么最终会推到所有骨牌。这显然是一个数学归纳法，我要的是，计算机能理解的不是这一个例子，而是通过这一个例子明白数学归纳法的本质，懂得归纳法背后的逻辑。这才是我想要的抽象思维，同样，也能明白其他的逻辑方法，AI当且仅当到这个程度及其之后，我才能肯定这类行业会被AI取代，否则都是很难说明到底会不会。;4;9;13;18388;0.0007069828148792691
100799;有人没有意识到一个东西，ai这个玩也，本质上和摄影之类根本不一样，人类绘画随着人类历史本身已经有了自己完整的风格体系，摄影催生了印象派的诞生。但是ai能干什么，他就是对人类绘画的模仿，哪怕你再出来任何的绘画派系，他都能迅速学会，这和以表现真实的摄影就本质不同了。有人说他是工具，殊不知我作为一个画画的人，有他没他没有任何区别。有人说降低了大众门槛，恕不知你还真觉得平时线都没画过几条的普通大众能用ai来干嘛，无非就是这是我词条生成的，我好牛逼。说真的，ai绘画是在入侵人类艺术界。当一个出来不能为人类服务，而是入侵人类的艺术界（音乐，文学，绘画，舞蹈）那他确实没有存在的必要。;1;4;5;18388;0.00027191646726125733
100802;我真的很迷茫，作为一个刚刚起步的绘画新手，我还在一步一拐的走路时就被人告知这辈子或许都超不过一个ai，我喜爱的艺术，轻而易举的就可以被模仿出来，而模仿的一方甚至不是人，整个过程不带任何感情，没有一丝艺术气息。我不懂，我真的不懂，难道说人类引以为豪的东西其实就是个笑话，一个可以被数据解析，可以被批量生产模仿出来的吗迷茫且痛苦;5;4;9;18388;0.0004894496410702633
100808;AI绘图对美术的威胁不仅是对现役画手的威胁，更关键的是对未来的影响，AI绘图的越发成熟只会导致未来从事绘画职业的人越来越少，初出茅庐的新人在发现自己辛辛苦苦得到的作品比不过AI用几分钟就可以量产的作品，还会对绘画产生热情吗？这样的话，绘画领域的新鲜血液会越来越少，除非AI发展到与人的思维无异，否则未来的美术领域将如一潭死水，;3;4;7;18388;0.0003806830541657603
100813;你以为的ai绘画：没有画师就歇菜事实上的ai绘画：实景拍摄也行，来者不拒很多人以为的想象力创造力指的是自己承认的才算所有能用限制阻碍的缺点都不叫事儿，不去呼吁反而迷茫真的是有趣全世界的粮食是够全世界人吃的，ai绘画和喝拉撒衣住行一样不会对你吃饭有什么影响游戏动画行业暴涨又不是不能用真心为非洲儿童发愁？如果只关心自己的肚子那就真的只有你关心了，因为利好别人只有做奴隶做出滋味儿来了的人担忧，反正打定主意自己吃自己的人不会为了自己的饭碗发愁，因为饭碗是自己的;3;4;7;18388;0.0003806830541657603
100819;鄙人有幸体验过不过出来的好像不怎么样好像是我填关键词不对？;1;4;5;18388;0.00027191646726125733
100827;加油兄弟;1;2;3;18388;0.0001631498803567544
100831;为什么还有人要在那嘴硬呢？概念美术本身就应该是概念在前美术在后，AI能够帮助高效完成概念的绘制我认为是好事，身为人类的我们应该去寻找其他路，而不是在这跟AI较劲;3;5;8;18388;0.00043506634761801175
100838;当AI生成的艺术变成主流，那对人类的整个艺术领域都是致命的，到时候遏制的就是人类的审美和创造力，从而导致艺术停滞不前。拿最简单的例子来说，老是有人说AI吊打萌新画手，高端画手不会被取代，但哪个高端画手不是从萌新走来的？而AI的存在势必会导致学画画的人越来越少，况且AI也是“吸取”了人类画手的作品才能有今天的技术，到时候高端画手都没了，那人类的艺术领域就彻底完了。笑;2;3;5;18388;0.00027191646726125733
100841;看了这么多视频，我只觉得，画师好惨。因为ai被迫内卷，好多画师还会直接失去饭碗。画的画应该也会贬值。说实话，他们要是反抗的话，我认为是很合理的。而且ai的进步可是需要喂图的。就，画师努力了十几年得到的结果，练成的画风轻易就被ai分析，模仿出来了，还要被砸饭碗，换谁能乐意。画风确实没版权，但是不喂画师的图ai也造不出好画，ai也是用了画师的图的。是，学习都会参考，人也会用别的画师的画进行学习，但是人学了，一般不会砸画师饭碗啊，而ai就不是。人和ai还是不一样的，首先人学会别人的画风是很难的，培养稳定且好看的画风也难，所以哪怕是模仿别人的画风，主要还是靠自己，学完了之后也得告诉大众自己模仿了XX的画风，也要心存感激之心。而ai不一样，它就数据组成的啊，不会它背后一堆科研人员，它想学啥就学哈，就和破解器一样。它不会感激你，不会说模仿了谁谁谁的画风，甚至还砸你饭碗。要我也是画师，画不经同意就被拿去分析，我也不乐意，更别说要砸饭碗。（不知道为什么，人学画师大佬的画风，我就觉得像一个不入门的学生参观，领悟大佬的东西，ai学画师大佬的画风，我就觉得像是小说里那些机械大师擅自研究别人创出的绝世武器，大概是因为双方水平，和侵犯利益大小的关系吧）;4;3;7;18388;0.0003806830541657603
100846;说实话AI绘画这东西让我想到了刘慈欣的小说，诗云;1;3;4;18388;0.00021753317380900588
100848;那些认为AI不会杀死绘画的，能不能给我立个字据啊，真的，我现在压力巨大，只要你能给我立个字据，能保证以后10年，20年，50年，AI都杀不死绘画。给我立个字据，我就能欺骗自己心安了。;1;3;4;18388;0.00021753317380900588
100850;好多人要失业;1;3;4;18388;0.00021753317380900588
100852;个人风格在未来应该算是一种专利。;1;3;4;18388;0.00021753317380900588
100854;学建模？哈哈哈AI建模也不远了哈哈哈哈哈哈哈哈哈脱单doge脱单doge脱单doge;2;3;5;18388;0.00027191646726125733
100857;其实我感觉被打击到的人应该是刚学画画没多久的或者是刚接触画画的人吧，或者初次接触艺考生或者差不多行业里刚接触的人吧虽然不知道以后艺考的标准会怎么样，但是如果家里不缺钱或者是这个不是主业的人还毕业很多年了，我感觉影响也不会很大吧。;1;3;4;18388;0.00021753317380900588
100868;ai是工具，人又何尝不是。行业会因为工具而进步，但大部分工具却只会因为效率低下而淘汰。;1;3;4;18388;0.00021753317380900588
100870;车夫跑不过汽车然后当了司机。。。;4;3;7;18388;0.0003806830541657603
100876;AI发展下去最大的问题可能就是会让那些初出茅庐的新人画师活不下去，继而导致画师金字塔地基崩塌。上层的，有自己风格在画作里的画师是AI难以取代的。但像那种只能做体力活，靠着体力活来养技术的人，活起来就不容易了PS：实际上，现在的AI技术完全可以支持让刚毕业的程序员都失业（刚刚毕业的学生写的代码绝大多数都是体力活）。但目前我是没听说有大张旗鼓做这种编程AI的毕竟，AI是程序员写的，应该没多少程序员会傻到断自己行业的路吧。;2;3;5;18388;0.00027191646726125733
100881;ai对低端画师就是致命打击，那种淘宝100块钱画个头像的，我用ai直接生成几十个自己挑不香吗还有说ai现实中应用少只能玩玩的，那是你的行业和ai关系小吧，我在医院工作已经有ai诊断了，我们的医生都是ai辅助看病的，正确率相当高，只是目前伦理上不允许完全放权给ai写报告而已。;3;3;6;18388;0.0003262997607135088
100889;AI无法理解人类的xp，所以色色画师永远不会被取代doge脱单doge;1;3;4;18388;0.00021753317380900588
100891;用AI出图需要甲方给出精准的关键词，所以AI取代不了原画师OK;1;3;4;18388;0.00021753317380900588
100893;让甲方去给AI下命令AI立马自爆OKOKOKOKOKOK;2;3;5;18388;0.00027191646726125733
100898;但是他的素材库里面一分钱都没有给过原作者吧吐吐吐吐;2;4;6;18388;0.0003262997607135088
100904;有这么一群农民，他们有的干活好，有的杂交搞得好，还有些花钱买了农机。这一天，从城里来了一个机器人，它不干农活，它到处从农民那里偷走稻谷，精挑出优秀的颗粒，打包成精品礼盒。然后它去到农民们兜售大米的市场里，当着他们面，卖从他们那偷来的大米。一些农民卖不过它，它说，我挑的比你们精细，当然比你们卖得好。我还花了好多钱建了筛谷子的工厂，也不能算不劳而获，你们要接受技术得进步。再后来，机器人的筛谷工厂还开放给农民使用。一些农民开始接受和感激，甚至享受这一切。但是偷盗并没有停止，随着越来越多的人使用，工厂也变得更大，偷盗变成了明抢，但是不知道为什么，没人来管它。好像它天生就可以做这些事情不用负一点责任。而城市中一些吃大米的看客们，一些会谴责一下机器的不道德，另一些会为着精装礼盒拍手叫好，他们都不怎么在乎农民，他们其实都在想，这些农民终究会被时代大潮碾过。或者从一开始，他们就看不上农民。翻白眼;1;2;3;18388;0.0001631498803567544
100909;不知道有多少游戏美术的从业者，我觉得至少角色原画是不会被取代的，AI只能做一个工具。因为角色原画要出产符合世界观、性别、表情、配饰的材质等等元素。而最主要的一点，要出三视图，甚至多视图，甚至局部的三视图或多视图。众多周知，AI是喂图学习的，那需要AI生成多视图的角色、怪物、场景物件等等图的时候，怎么保证它是连贯的，统一的？简单点说，怎么保证生成一个正面图和侧面图的时候，还是同一个人？身上的配饰不变，角度变化后配置的透视是正确的？如果生成了复数的角色，如何保证每个角色都符合项目的世界观？从全球无数张图中，我认为也选不出多角度连贯且统一的角色，或者场景物件的图来。最终还是需要调整或者加工，而且这个调整和加工的难度并没有想象中的低，那么AI还只是一个工具。可能有人会说，AI学习功能强啦，未来总会有办法解决的，这个我不敢苟同，因为从目前的AI绘画程序来看，它学了无数张图，在无数张图里拼接，但是始终局限于二维，它没有三维的思想或者逻辑。也就是说，你丢给AI一张大象的照片，让它帮你把大象转个身，如果它有智慧，估计也会臭骂你一顿;1;2;3;18388;0.0001631498803567544
100913;受到冲击的不只是画师这个职业，还有画画衍生的一切行业，当人很轻易大量获取目前最难获得东西，也就不会珍惜，消费者少了，画作会变得不值钱，利益消失了，行业也就消失了;1;2;3;18388;0.0001631498803567544
100916;我是稍微解释一下吧。首先，现在ai画画所有网络都是深度学习的范畴。只不过不断升级网络从最初的卷积神经网络到迁移神经网络到现在最新的对抗生产网络。深度学习的原理就是仿造了生物的大脑，利用计算机通过神经元构建神经网络，然后不断学习调整其中的激活函数和不同神经元的参数。所以本质上和人类的大脑构造一样，都是真真正正地学习，而不是拼凑。只不过神经元的量级，运算速度和人类完全比不了。但是ai能够不间断的学习和投喂大量学习资料。至于所说的抄袭，其实ai学习就是和人看书或者去观摩，只不过ai能每秒看大约2万副画，如果这算抄袭的话那其实所有人的所有学习过程都是抄袭。但由于ai的特殊性，如果以后画家画画的时候标注不允许ai参考，那么是归法律管，但目前来说不是违法;1;2;3;18388;0.0001631498803567544
100920;不会取代，因为它的素材全都来自于学习人类画师的创作，如果没有人类的创造，它也就无法学到更多的东西。就目前来说，ai是计算、储存、程序、执行、学习、理解、推演模拟、思考等逐步进化出来各种惊人能力的集合，但最终它还是不会创造。不过即使他不会取代;3;2;5;18388;0.00027191646726125733
100928;以前走路用腿，于是有了轿子，后来发明了轮子，抬轿子的人就会失业，抬了一辈子的轿夫似乎很可怜，但又衍生出了新的职业：驾驶员。未来的你只需要驾驶轮子，而不是去做轮子。;2;2;4;18388;0.00021753317380900588
100931;不久前还再说什么工作都可以被AI取代，绝对取代不了需要想象力的工作。如：美术，音乐，写作等但现实是第一批受AI威胁的可能就是这帮所以的“艺术工作者”们。事情往往就这么讽刺。;1;2;3;18388;0.0001631498803567544
100933;目前的人工智能还冲不死画师，因为要是让AI作画，甲方必须要清楚描述自己的要求。;1;2;3;18388;0.0001631498803567544
100945;佬们，现在小白自学画画还有必要吗保卫萝卜哭哭我怕以后吃不上饭保卫萝卜哭哭;9;2;11;18388;0.0005982162279747662
100955;很多人说ai现在不可能替代人类，但有想过它恐怖的发展速度吗。;2;2;4;18388;0.00021753317380900588
100960;我是搞维修的，会被牵连吗？;1;2;3;18388;0.0001631498803567544
100965;对于艺术本身，更多时候，我们享受的是创作的过程。举一个很简单的例子，我脑补的oc，我更愿意自己亲手把他画出来，而不是让AI给我画出来，我享受的是这个绘画的过程，我自己创造的一个人物，我自己把他画出来，我会有成就感，会有满足感，如果我只是在电脑说输入几个关键词，他虽然会很快给我出一张图，但我不会有任何感觉;1;2;3;18388;0.0001631498803567544
100967;就这么说吧，就算AI能代替这个行业，只要人类还在，艺术就不会消失。绘画的出现，最初的目的并不是为了赚钱，为了盈利，而是表达情感的一种方式。有的时候当我们悲伤时，可能会用画画来发泄自己的情绪，而不会有人在电脑上输入几个文字生成一张图就能表达自己的情绪。那些名垂青史的艺术家们，有几个是为了赚钱才去创作的？;1;2;3;18388;0.0001631498803567544
100978;我为什么要在意ai绘画呢？我绘画是享受绘画的过程，是自己精神上的满足，就算ai再强大，我还不是可以画自己的，我感觉这就完全是两码事嘛。tv黑人问号;4;2;6;18388;0.0003262997607135088
100984;以后人们的生活会不会是这样我想看什么什么关键词的动漫或电影，ai会直接给你生成几部让你选着看热词系列知识增加;1;2;3;18388;0.0001631498803567544
100986;要知道一件事情，ai是工具，这东西不会思考，只是把经过学习后认为是美的东西拼凑起来，没有了，不会有什么说是想要表达的东西。ai会替代掉无用的重复性工作，但最后仍然是人。会替代掉一些岗位，但也会创造新的岗位。相机的产生让人人都可以拍照但不影响摄影师，同样也带来了更多的角度和光影图片。事物是发展的;1;2;3;18388;0.0001631498803567544
100988;身为一个美术从业者，刚开始看这个视频的时候，我的心情是平静的，看了一分钟之后，就有点惊讶了，又看了2分钟，心情越发急促，大龄失业的危险止不住的从脑海中冒出来，又看了2分钟，各种还贷的催收通知铺面而来，压得自己呼吸都变得艰难，浑身发抖、冷汗直流，意识也慢慢变得恍惚眼看就要昏厥过去的时候，突然间一个激灵，脑子瞬间清醒了过来：“我是3D美术啊那没事了”;1;2;3;18388;0.0001631498803567544
100993;快进到AI画本给心心给心心给心心;2;2;4;18388;0.00021753317380900588
101007;什么是现代性，就是解构，资本和技术这对孪生子，要的是大规模生产6070分的东西对于艺术品这种120分的东西肯定是替代不了，但是如果人追求的120分的东西对大多数人都没什么价值，那么以后可能每个人都会变成落魄艺术家，人的价值到底给如何被重新定义呢;1;2;3;18388;0.0001631498803567544
101009;怎么说呢举个例子吧，打游戏，打排位，ai不需要强大到战胜职业队，他只需要可以战胜大部分低分王者以及以下的就行了，将整个基础打碎;2;2;4;18388;0.00021753317380900588
101016;以后ai能自动画画，ai能自动出视频，ai能自动出音乐，ai能自动编程，ai能自动出游戏，ai能自动出软件最后资本家发现，自己有的东西，普通老百姓靠ai就能做了也别说什么画画和编程什么的不一样，都是靠学习以前知识的积累和逻辑的判断处理出来的，画画能干几乎没什么干不了了。;3;2;5;18388;0.00027191646726125733
101021;它能画那个吗，就是那个;1;2;3;18388;0.0001631498803567544
101023;绘画要是真能死所有设计专业都是一样的下场脱单doge想开点你没了也有一堆垫背的;1;2;3;18388;0.0001631498803567544
101028;以下个人观点，看不少人都说AI会取代画匠，而不会取代设计，我觉得恰恰相反，所谓设计不过也是根据过往已有的知识经验等进行拼贴，这正是AI所做的，而AI所拥有的知识库绝对要高于一个人类个体，因而在今后的不断完善中，AI在既定关键词中所作出的设计绝对要优于人类。但AI作图也是满足不了全部需求的，并且会有诸多瑕疵，需要基本功扎实强大的画匠进行修改才能投入使用，况且AI的出图逻辑仅是纯粹的拼贴，不会拥有人类的主观处理能力，根据这种状况分析，我认为画匠是吃香的，设计行业可能会发生大变动思考;5;2;7;18388;0.0003806830541657603
101036;从个人程序猿的角度回答一下这个问题，有可能。看了一下大家的很多看法，有些东西我也非常认同，但是我和大家的看法不太一样的地方在于，我觉得我们似乎把自己想的太独特了，有点自大了。就像一楼说的，照相机出现之后，数字绘画出现之后，美术不是也没事吗？对，因为这两项技术的革新是停留在工具层面的。什么叫工具层面？就是这幅画的呈现的样貌虽然会以技术改变，但是这幅画带给你的东西，色彩，构图，内容，意境什么的，这些是画家才有的。所以当相机出现之后，超写实艺术基本上被杀死了，而侧重到这一部分的印象派兴起，因为这些东西是照相机没有的。而现在，人工智能正在试图抹平这些差异。现在人脑与人工智能而言，最大的差异更多是算力和算法上的。特别是随着对抗生成网络的出现，AI也会开始调整自己，类似于某种进化的低级形态。举个例子，或许之前的AI停留在分类聚类的任务中，它们可以区分猫，狗，人，但是它们对这三者并没有一个成体系的认识。可能看到长耳朵就是狗，大眼睛的就是猫。分类和聚类这样的任务是不要求AI需要完整地构建起一套标准来认知的。而现在AI学会了生成。AI能够凭空生成一张人脸，一个厨房的场景，这意味着AI现在已经有了一套标准，它们学会了人的界限在哪，人的眼睛，毛发，鼻子，皮肤等等等等是什么样的。而实际上，AI已经开始投入到以往我们所认为的富有创造力的事情上，比如作诗写小说，比如绘画。我们的前景没有那么乐观，AI已经有相当的领域是胜过人类的，在我看来其他的领域几乎是迟早的事，因为人的意思思考，本质上就是神经细胞对输入做出输出反应。只不过目前人脑的算力更大，有上亿年进化训练出的算法。而这些东西在我看来，不是AI无法企及的。;12;2;14;18388;0.0007613661083315206
101057;太好了，以后压力就到甲方这边了，毕竟我永远不明白五彩斑斓的黑是什么样子的。;1;2;3;18388;0.0001631498803567544
101065;都说不会被ai取代，但有没有考虑过ai会替代多少普通人的工作岗位？资本市场注重利益，甲方注重效率，当一个便宜且快速的ai可以替代多个打工人的时候就是集体失业的时候，世界不止有优秀的人，更多的只是普普通通的平凡人。当然创作ai是取代不了的，ai终究只是模仿。;1;2;3;18388;0.0001631498803567544
101067;最不可能被AI取代的就是艺术，艺术并不是科学模型，也不是思维模式，他是意识的投射，是不思议的产物，而ai则是刚好相反的产物。;4;2;6;18388;0.0003262997607135088
101076;布鲁RC弟弟太牛壁了;1;2;3;18388;0.0001631498803567544
101078;不能，因为ai无法理解甲方奇奇怪怪的要求吃瓜;5;2;7;18388;0.0003806830541657603
101084;AI是需要大量图片训练学习的，画师都不画了哪儿来原画学习;2;2;4;18388;0.00021753317380900588
101096;基本上讨论ai的时候，你理性分析ai带来的弊端，抄袭问题，对底部市场的冲击问题，你就输了格局，你必须吹，反正你也阻挡不了，不如就一顿吹自己多牛能完美驾驭ai辅助自己，这样别人哪怕想到了弊端还是被你的格局震撼。;7;3;10;18388;0.0005438329345225147
101106;答案是不可能，即使ai再np，也需要甲方准确无误形容出他想要的画面妙啊众所周知这是不可能的;1;3;4;18388;0.00021753317380900588
101110;美术不会被取代，但美术资源肯定会被覆盖，就如同当年的图画与照片，加上资本的选择，ai未来大概率会成为主流，很多人都焦虑美术未来怎么样，但对于美术从业者来说，ai可能对他们的创作帮助超乎想象，但将来会很卷倒是非常肯定的藏狐;1;2;3;18388;0.0001631498803567544
101113;现在学画画是不是就等于49年入果军？;1;1;2;18388;0.00010876658690450294
101116;AI本身不就是程序吗，程序本身怎么可能会画画，都是盗的辣眼睛;7;1;8;18388;0.00043506634761801175
101124;ai绘画：短期获利，长期断根，科学界智子。ai绘画离不开的根源是用于学习的图库（用于界定最终成品），而图库的根源是搜集画师已有的作品。当图库不再有新来源的补充（智能完全取代画师的情况下），或只能吸收来源于ai绘画的作品，偏差将会扩大（与人类审美），或局限于已有的框架，直至达到无法接受的程度，即无法更进一步发展。（根源是创造力的缺失，人与智能的最大差距在于大脑随机性更强，而智能程序的随机是基于数列组合的伪随机）根源是创新性，人类与人工智能的根本差距在于创造力，而不是在于效率。人类败于效率是必然，但是为了效率完全舍弃创造力，是一种自我封锁，相辅相成才是最好的结局（画师与ai绘画合作，创造力效率），而不是一味地对立。但资本的逐利性显然做不到这点（无脑追逐利益），所以预判未来的结局是：画师凉凉，受众满足于ai的高效率，但业界不会再有基于艺术性的革新。;1;1;2;18388;0.00010876658690450294
101127;那AI能在白纸上画吗？它能取代我的手绘？;3;1;4;18388;0.00021753317380900588
101131;培藏一个画师要十年，训练一个AI只需要一年doge;1;1;2;18388;0.00010876658690450294
101133;看来未来，虚拟世界快要出来了。;1;1;2;18388;0.00010876658690450294
101135;以后ai自动作曲，音乐家懵逼了;2;1;3;18388;0.0001631498803567544
101141;我只是想说“认为人工智能不会做到某某事情”这种想法是十分傲慢的，且无道理的。;1;1;2;18388;0.00010876658690450294
101155;一个简单的逻辑，你用ai画图去商业约稿，会亏本。好的体验100收费，而它给的服务是随机的，但客户要的是指定的，矛盾不可调和。当然，相比一开始的抽象画，现在起码能随机到一些好看的，进步空间很大，现在我就等它“成熟”后再来体验。;1;1;2;18388;0.00010876658690450294
101163;感兴趣的其实可以去看看谷歌的imagen模型，应该是最近最好的开源生成图像模型了。这些网站应该都是用那个为核心改的。doge;1;1;2;18388;0.00010876658690450294
101166;几百幅画合成一张，那能算侵权吗，因为是元素的组合，具体构成早就支离破碎了;2;1;3;18388;0.0001631498803567544
101170;没有引战，我就是挺好奇，你说Ai能不能成长到能直接写文学作品类的？毕竟AI的成长速度这么快热词系列知识盲区热词系列知识盲区热词系列知识盲区热词系列知识盲区思考思考思考思考思考思考;2;1;3;18388;0.0001631498803567544
101173;不会杀死，但是Al会侵权;2;1;3;18388;0.0001631498803567544
101180;记住，ai是没有创造力没有感情的，对于他来说一幅画只是一个个像素点罢了，而他只是把人类的作品模仿出来，没有创新性，更无法表达内在的东西，也就是给人一种流水线的感觉，很平庸无亮点。;4;1;5;18388;0.00027191646726125733
101185;ai的东西不具备能动性，他也就自然上限比不上人。还有从事美术行业的兄弟看见那些冷嘲热讽的那些“看热闹的人”来唱衰这个行业，我觉得不要生气比较好，和外行没必要较劲，他们的目的只是要惹你生气罢了。;2;1;3;18388;0.0001631498803567544
101190;来张对ai的地狱考验图兽耳豹娘百米冲刺一脚禁区劲射以时速300公里速度破网随后足球穿透龙门球网不受控制直飞向前把vip席上的老皮登脑壳“啪”的一声老皮登头破血流生成得出吗？我怕ai构图也生成不出个什么来为什么？因为美术水平不够的人，让他选图，也选不出个什么好构图来。而互联网也没有相关素材库可供ai参考所以0乘以0永远是0不服的门外汉可以来试试生成看而我，只需要不到10秒就想到这个镜头和构图应该怎么表达，不过需要花点时间重现而已，这就是内行人，专业的。;6;1;7;18388;0.0003806830541657603
101198;AI这么牛逼什么时候可以替代人类做科研写论文啊，让AI验证一下哥德巴赫猜想，推演一下弦理论，推进一下量子力学的发展，揭示一下表观遗传密码和肿瘤发生机制啊;1;1;2;18388;0.00010876658690450294
101202;故事啊，故事，现在ai不能生成故事，而我们的想象将得到发挥;2;1;3;18388;0.0001631498803567544
101206;大概很惊艳，细节拉的要死;3;1;4;18388;0.00021753317380900588
101211;只是把绘画作为爱好的感觉已经被秒的渣都不剩了，才1年而已;1;1;2;18388;0.00010876658690450294
101215;信誓旦旦说ai绘画没有灵魂只是排列组合的那一部分人真的像是负隅顽抗，大量练习、灵光一闪ta都有了，你怎么知道ta没有灵魂？人类画画又不是排列组合了吗？;2;1;3;18388;0.0001631498803567544
101220;能不能画那个东西滑稽滑稽;1;1;2;18388;0.00010876658690450294
101225;取代不了。人只能是目的而不能是手段，而ai是手段。也就是说艺术在于在于表达了什么而不是画了什么。;1;1;2;18388;0.00010876658690450294
101230;可以试试“光刻机”“尖端医疗设备”“美国高超音速飞机”“零件”这些关键词。;1;1;2;18388;0.00010876658690450294
101239;为什么，你们资本家要直接搞画画的，去搞搞音乐的，搞唱跳rap的啊，可恶啊，混蛋;1;1;2;18388;0.00010876658690450294
101244;ai作的图能看大体，不能看细节，比如结构，光照这些;1;1;2;18388;0.00010876658690450294
101246;以后也就医生这种是铁饭碗了;4;1;5;18388;0.00027191646726125733
101252;高端画师或许不会收到太大影响，但是低端毫无意义会被ai彻底抢占市场，然后等这批高端的不画了画师不就彻底再见了？总不可能死路一条的低端还能持续发展吧;1;1;2;18388;0.00010876658690450294
101256;ai画画不可能完全取代人类，不止画画，所以艺术领域都不能被ai完全取代。ai在这些方面的作用更多是给创作者提供灵感。;3;1;4;18388;0.00021753317380900588
101282;我觉得这是仁者见仁智者见智的问题，你们有没有发现手机进化了之后，对我们的工作提供了很多便捷，但为什么我们现在的工作却变得比手机没进化之前还忙;1;1;2;18388;0.00010876658690450294
101285;乐观点如果无法打败ai那就成为ai吧？可行吗？滑稽;1;1;2;18388;0.00010876658690450294
101288;会代替，国外大量杂志已经愿意使用ai生成的插画;1;1;2;18388;0.00010876658690450294
101309;嘿嘿，现在诗词ai都写的比大部分人好，甚至达到很多二流古代诗人的程度，再过十年超唐迈宋都有可能;1;1;2;18388;0.00010876658690450294
101329;人工智能一定会取代人类画师的，因为人工智能会越进化越厉害而且进化的速度越来越快，一年前，人工智能只能进行一些抽象的画面绘制，但是只过了不到一年的时间，人工智能绘画的水平已经超越了大多数人的认知，要知道，这只是过了一年不到的时间而已，也许现在有很多人会挑剔人工智能画面中的各种所谓的不够灵魂的一面，但是想一想，如果人工智能绘画的水平在这个基础上再提高十倍呢？然后再提高十倍的基础上再提高十倍呢，这个时候你认为人类顶尖的画师还能够和人工智能相抗衡吗？更要命的是，人工智能只要看过你的绘画风格，就能根据你的绘画风格来完善你的画作，画出和你风格类似的作品，也许你创作一幅绘画需要很长的时间。但是，人工智能未来只需要不到一秒钟的时间，就能够生成很多服务，和你类似风格的画作，而且画的比你更完美，在这样的情况下，挂失就不可能再作为一种职业继续猫生了，但是这不代表人类会放弃绘画，只是人类的绘画不能再作为获得收益的手段了，我相信，随着人工智能技术的不断进步，专利水平的不断提升，也许有一天，现在所谓的3a大作，人工智能只需要很短的时间就能制作完成，比如现在制作一款黑神话，悟空需要很久很久的时间，但是人工智能只要技术足够强大，可能一分钟左右的时间就能制作出来了，在这种情况下人类不可能和人工智能竞争的，大概在5，6年前那个时候，人们认为，人工智能只能取代一些重复性的劳动，但是现在的发展趋势已经让我明白一个道理，未来不单是重复性的劳动会被取代，连一些创造性的工作也会被人工智能取代，也许有很多人不愿意接受这个事实，但是这就是发展的方向，这就是发展的趋势，科技的发展，生产力的提高，不以人的意志为转移，也就是当人工智能能更好地满足消费者的需求的时候，那么消费者肯定会选择人工智能，想一想，如果你有一个和贾维斯一样聪明的人工智能助手，你是选择贾维斯还是选择人类呢？;3;1;4;18388;0.00021753317380900588
101339;刚刚用ai画画试了试，很美，但美得空洞;2;1;3;18388;0.0001631498803567544
101342;打不过就加入，学人工智能呗;1;1;2;18388;0.00010876658690450294
101346;取代是无法取代的，只是以后的画家不再需要技法，而是需要有想法，设计的理念，艺术素养，AI提供一副画，画家通过不断输入改进反馈来一步步完善画作。因为完全靠AI的话，它没有美术鉴赏能力，他只会模仿，糅合。但他无法分辨哪个好哪个坏。阿尔法狗下棋要不断的选择下一步棋，最终获胜，但艺术没有逻辑和对错，要艺术家不断选择下一步怎么走。所以它只能是艺术家的工具，而不能自行完成艺术品;2;1;3;18388;0.0001631498803567544
101380;可别让AI学代码太哈人了吧辣眼睛;1;1;2;18388;0.00010876658690450294
101386;那岂不是能大量缩短动画绘制所需的时间，比如每60针的间隔直接能创造出每针的图片从而大量减少绘画量。;1;1;2;18388;0.00010876658690450294
101392;好希望这些ai只是帮助人类寻找灵感，而不是代替人类，不然的话不然的话我马上就要失业了;16;1;17;18388;0.000924515988688275
101409;两年后会咋样，，，我会饿死吧，，，我怎么想走美术的呢？造孽啊;2;1;3;18388;0.0001631498803567544
101414;那现在ai已经自动编曲了，难道不需要作曲家了么。。。;1;1;2;18388;0.00010876658690450294
101416;流水线的衣服百元一套，手工的礼服有价无市。;1;1;2;18388;0.00010876658690450294
101418;有多少顶级的画师？如果一个ai能超过百分之八十的画师，那百分之九十九的市场就会被ai取代。别说ai做不到，科技发展很难说。智能学习比绝大多数人类优秀;2;1;3;18388;0.0001631498803567544
101423;会杀死百分之99的美术，艺术诞生的过程就是模仿，学习，总结，再创作。这和Ai的设计思路是一样的。;2;1;3;18388;0.0001631498803567544
101428;说不定可以辅助个人自制游戏？美术不行靠ai补补;1;1;2;18388;0.00010876658690450294
101430;美术不会被AI取代，但会大大降低美术生的就业率，原本需要几十甚至上百美术生的团队可能用了AI后只需要几个人就搞定。这样大大增加了美术行业的内卷;3;1;4;18388;0.00021753317380900588
101441;ai依旧在进化，现在做不到的，以后可不好说，如果以后出现人把很简陋的大概构图画出来，ai能根据描述词细节，甚至可以进化到随意改动，那才是真的美术生全失业，比起计算机这种划时代的产物都能面世，ai绘画进化到完全成熟也不过是时间问题;4;1;5;18388;0.00027191646726125733
101446;美术绝不会被杀死。但大胆猜想一下，现在的原画设计行业将会迎来大革命，他们的工作方式需要转变。过程中应该会有部分老手无法快速适应而被大部队抛在身后。也可能催生出新的职业。不过可以肯定学习原画的人数一定会变少。原画行业可能会逐渐淡出历史的舞台。;3;1;4;18388;0.00021753317380900588
101476;用这玩意画漫画肯定会便利很多，产能狂涨;2;1;3;18388;0.0001631498803567544
101499;照相机发明以前，画画一切为了逼真照相机发明以后，画画开始走向谢意和抽象：因为比真是比不过照相机的现在AI写意抽象都会了，那人类的美术将会何去何从;2;1;3;18388;0.0001631498803567544
101515;那么有没有可能之后会有一种假的画师，通过风格的不断筛选，让ai画出和自己风格一致的图，或者就直接拿ai的风格当自己的风格;3;1;4;18388;0.00021753317380900588
101519;这些ai图我都好喜欢啊，还有一种不确定的随机的美感。;1;1;2;18388;0.00010876658690450294
101521;不可能的，顶多造成冲击。不过现在已经有ai作画，ai配音，是不是能自动生成动画了？;1;1;2;18388;0.00010876658690450294
101527;个人觉得，AI只是一个辅助工具，帮我们打开一些灵感，不管是什么画师，什么风格的，都是需要大量的阅读积累的，人的一辈子有限，你看再多的书，去过再多的地方，也总有你没去过，或者你没见过的东西，那这种时候AI就能很好的通过网络，通过你的描述去生成一些你没见过或者你没想到过的东西，一秒几百张甚至几万张图片的图片并结合现在已有的构图，比例甚至是你希望的艺术家的画风，去给你呈现一个“灵感”，这只是一个灵感，去辅助你打开你的想象力的一个来源，这并不能当作成品去展示，因为但凡是用过各类AI软件的人都知道，他生成的再复杂，再细节，这也只是一个灵感，因为很多东西都是不完善的，可能是画面糊掉了，可能是这个地方不对称，另一边歪了，也有可能是脸都是乱七八糟的，但是当你看到AI给你的这个“灵感”之后，我相信很多人会被AI做出来的东西折服，就是感叹为什么我没想过这样子去创作，或者这个东西我压根儿就不知道是什么，但是整个画面感特别棒，可能通过AI生成出来的东西说不定你就有了一个新的思路和灵感。虽然AI很聪明，但是还是希望大家不要把AI想的会抢走艺术家饭碗的东西，我本人也是个画师，我偶尔也会使用AI来帮助灵感枯竭的我，让我打开思路，看一些我从来没见过的新奇的玩意儿，世界这么大总有你没见过的东西，在我这里我反而觉得AI是一个让艺术家更容易吃上饭的工具。;1;1;2;18388;0.00010876658690450294
101533;现在的装饰画大多是打印的。以前可都是画师画的，以后也一样因为便宜效率所以概念美术照样会被取代就像大量的动捕取代动画师一样。没有人会再花几年时间去练习一个动捕几分钟就可以搞定的事情;1;1;2;18388;0.00010876658690450294
101543;你说的是对的，但是人是要吃饭的，要以现在生活说事的。本来底层画师有想法创新但是画工没有那么好也是可以吃饭的。现在AI可以根据甲方的要求生成了概略图，这不就扼杀了底边的画师吗。画功差些的怎么办。别说什么你可以练习啊，等到画功好了就可以用AI当辅助啦。关键是现实要吃饭啊。不然怎么坚持呢？;1;1;2;18388;0.00010876658690450294
101577;反正对于我这种完全不会画画却想创作的人有足够大的吸引力有没有离线版的下载;2;1;3;18388;0.0001631498803567544
101593;完蛋，传统美术行业凉凉。现在的年轻人如果再想加入美术行业，就该天天用这玩意然后看看能拿他干什么;1;1;2;18388;0.00010876658690450294
101599;目前看过一些ai的作品，很少能见到以假乱真的，他们都有一个特点就是没什么灵魂，很好看，但是，什么都没有的感觉。笑哭这种感觉有点玄学，只能说ai还没有学到视线引导之类的作者的心思，因为ai还没有表达欲。不过经过反复的调教，是能够生成一些看上去比较像人画的东西的。不过无论如何它仍旧需要学习人先有的风格，意味着一个新的风格仍旧需要有人去做。至于它得到创造的能力那就是后话了，呃，甚至可能就不是单纯我们需要考虑的事情了。当然，底层美术人多少还是有点担心的，但担心也没用，多少还是得提升自己呗）再不济，教美术的总不能也是ai来教是吧）;1;1;2;18388;0.00010876658690450294
101617;虽然画师永远不可能替代，但在多数非硬性美术需求的地方会选择ai来制作东西，因为比真人便宜太多笑哭比如独立小游戏想做一个背景插图、小吃店想要一些图片宣传等，用ai会大大减少这方面的成本。可能在做这些事情的人会面临失业风险吧笑哭;2;1;3;18388;0.0001631498803567544
101626;毫无疑问，这样下去，为了保护美术业界，五年内各种版权保护条款就会落地，ai就会被迫加上各种各样的限制，而且，ai和人类最大的不同就是ai是随机，而人类是精准，一个无智慧，一个有智慧，ai永远不可能在需要脑力原创的行业取代人类，只能作为工具，写代码更是天方夜谭，ai学会自己写代码好比人类完全掌握生物科技，一个不小心那就是智械危机了，最多就是工具，写些简单逻辑，因为ai要写出复杂逻辑的东西，它本身必须具有更复杂的逻辑，而逻辑本身不是可以学习的，现在的ai逻辑终究靠人类堆积，一时半会是上不去的;2;1;3;18388;0.0001631498803567544
101631;我弱弱问一句，有没有可能有没有一种可能画那种画，就是那种画笑哭别打我笑哭;3;1;4;18388;0.00021753317380900588
101637;迭代真快，应该还和过去历史的例子相仿。全界广式基础ai代码还有多远。我觉得对于普通观众来说，应该是一件好事。人们可以更便捷享受到更多有趣的想法蛆音娘卖萌;1;1;2;18388;0.00010876658690450294
101644;upup软件哪里得到的啊，求软件啊;2;1;3;18388;0.0001631498803567544
101648;不可能的。就算乙方再怎么完美，他甲方不明确知道自己想要什么，理性的ai就搞不定，搞定了甲方也会变。;1;1;2;18388;0.00010876658690450294
101653;不能，因为ai的xp不够奇怪;2;1;3;18388;0.0001631498803567544
101660;完了，为啥我突然有个奇怪的想法笑哭笑哭;1;1;2;18388;0.00010876658690450294
101668;人和ai最大的区别是自主意识吧，如果ai没有自主意识，那它的作品只能是好看，美术这种不是具象化的东西，是和人的思想紧紧相关的;18;1;19;18388;0.0010332825755927778
101688;都在说ai代替人类，多么多么牛逼，但多少人还在996，我只想说ai快点在工作上把人类代替吧;1;1;2;18388;0.00010876658690450294
101690;美术是一种艺术形式，自古至今都是如此，每一张画都是画师用心创造的就这一点而言就赢ai太多了;1;1;2;18388;0.00010876658690450294
101699;感觉都没几个说到点子上，全都是往又大又远的方向想的。就好比设计，难道ai就认不出来了？343做得光环的场景，大大的方块，特定的切割方式，都能让你知道它是343的。难道说这种东西没有一套固定流程去做吗，但凡有固定流程的无非是多做几套零件的事情。估计也用不了多久，这狗比玩意就能随机造几个大小比例631的盒子，然后往里面套不同体系规则。你想要343那种大方块，那就大方块，你那破画想要什么阮佳的效果，他就能做阮佳的效果。关键就是有那么几个屌毛特地去做了这种针对性的变化，然后做成了某种一键出图的外挂，卖给一众小萌新，瞬间就能将中游的选手变成入门的选手。只要它的传播代价一直在降低，总有那么一个时间会突破临界点。什么说设计不能如愿，逗呢，设计师本身学东西就跟ai的逻辑差不多，都是东凑西凑，最终总结了一套专属的零件语言，这种小心思在别有用心的人手里，无非就是针对他编一套语言的事情。到时候编程的学习成本一下来，说不定特异化的处理都不用了。结果就导致了永远都有那么几个最优解，没个十年功力有也不一定都没法子叫板;1;1;2;18388;0.00010876658690450294
101704;我觉得不会，ai只能学习已经有的东西但不能产生新的东西。它会是很好的辅助工具。但对于那些画风独特的巨佬来说，ai一时半会是模仿不了他们的画风。美术设计需要各种对历史，文化，自然的了解。ai可能会带给从业者灵感。就像现在的ai画，我只能说这个风格好像什么什么。但没有让我惊吓到的新风格。;1;1;2;18388;0.00010876658690450294
101706;都说了ai算法就是给行业人员寻找灵感叠加素材源使用的，减少和甲方沟通的时间成本。;2;1;3;18388;0.0001631498803567544
101717;利好独立游戏嘛？思考;3;1;4;18388;0.00021753317380900588
101721;刚玩过ai绘画挺好玩的比较需要注意的就是给ai准确指令的训练要不然什么牛马绘画都会可能出现现在的ai你出图能七七八八手和鼻子有些不完善的软件还有点问题相信两三年后就差不多解决了笑哭;1;2;3;18388;0.0001631498803567544
101724;现在ai画的图更难分辨了，nga那边满分100分的调查问卷平均分只有35分，仅比四选一盲选的25分高10分（数据样本有15W，算比较准确的了）;2;2;4;18388;0.00021753317380900588
101736;感觉ai应该算是属于那种语言描述加上关键字，现在的ai重点的模仿，那么ai不会取代原画师，只会无限的拔高了画师的入门门槛。因为大量的应用将不断压缩低层次的画师，因为创新这点ai还是不行。毕竟ai只是关键词，就像小说诗云里面神级文明想要利用超级计算机将汉字的所有可能组合，穷举，写出所有的诗，最终打败李白。可是它们失败了，人工智能永远也无法真正超越李白。再举个例子，ai写诗，它的上限是汉字的可能，但，如果我们再造一个字呢？doge;1;2;3;18388;0.0001631498803567544
101738;不会的，AI的强项在于模仿，有一个词up用错了，“学习”，AI不会学习，它只是不断完善，模仿，它不会学习，也没有智慧。所以就有一项它做不到的，“创新”，一味的依赖AI是不会进步的，创新，目前只有靠人类自己了，而每次创新AI都要再次完善。目前人类的技术做不到让它出现智慧，所以指望它创新就要等很久了;1;2;3;18388;0.0001631498803567544
101742;脱单doge脱单doge脱单doge被误删了重新评论一次作为一个从业多年的游戏美术，只能说国内游戏行业缺的不是美术，美术已经非常卷了，完全是世界一流，我们缺的是“合格”的策划，要求不高，仅仅是合格而已。。。。。当一些啥也不懂的策划拿着AI画图来和我说这效果多好能替代美术时，我想说AI最容易替代的其实是策划。这些策划真的天真的认为以他们那点外行的不行的设计审美可以靠AI来替他们作画。就好像一个没驾照的人觉得自动驾驶可以带着他们跑赛道。只能说哪怕以后真AI作画普及了，来负责操作的肯定依然是一个美术专业的人，，就像辅助驾驶上路依然是需要有驾照的人。;1;5;6;18388;0.0003262997607135088
101750;最近ai绘画被实锤是叠图了;17;3;20;18388;0.0010876658690450293
101769;弹幕一堆代替不了的，你也不看看今年的ai绘图和去年ai绘图进步多大，两年后，五年后又会咋样;4;3;7;18388;0.0003806830541657603
101776;评论区忽略了一个现实，就是如果大量的AI图教育市场，把观众调教成了喜欢看AI图的审美，那么所谓的高端人类审美，是不是会被取代;1;1;2;18388;0.00010876658690450294
101778;看了这多么多的评论，我发现其实许多行业都在慢慢被ai替代，所以我突然想到了一个根本性的问题：人类到底为什么要发明ai？人类为什么希望ai拥有人的创造力想象力思考力？或者说，人为什么想要让机器产生人的意识？难道人类想要生造个“人”吗？如果哪一天，ai真的拥有了人类的意识，那人类将让他们做什么？人类将如何与他们相处？人们致力于创造ai，可是人们想没想过这些后事呢？还是说，人们一开始就冥冥之中坚定了机器人不可能拥有人类的创造力思维，所以才毫无顾忌一往无前地去发展ai呢？;1;2;3;18388;0.0001631498803567544
101781;弹幕有些人可能不了解AI，我摘选了几个进行反驳。1AI生成的图片会越用越少2AI生成的图片会审美疲劳3AI生成的图片不能满足甲方的需求上述描述错误的地方在于他们只是单纯认为AI是一个软件，是有局限性和上限的。但事实恰恰相反，AI是没有上限的，它能超越人脑的极限。有人主观认为AI生成的图片是没有灵魂的，类比于机器制造的工艺品是没有灵魂的说法，这个就见仁见智了。不过有一点是可以肯定的，当AI能做得比人更好时，多数人会选择AI，灵魂只能是有钱人的追求。;2;2;4;18388;0.00021753317380900588
101785;毫不客气地说，我喜欢AI多过人类。人类总喜欢在作品里表达自己的思想，并且渴望得到认同。然而人类亦是孤独的个体，这世上根本不会有人能够完全理解另一个人。所有对原作的解读都是其他自我的二次表达。但AI能够包容我所有的臆想，它的作品本没有意义，我的解读赋予了它灵魂。这不是一件浪漫的事吗。转自B站某用户;2;3;5;18388;0.00027191646726125733
101789;ai画图老早就有了，为什么现在开始讨论了呢，无非就是怕了，刀子快到身边感到痛了;2;1;3;18388;0.0001631498803567544
101793;如果这样全部靠AI后面所有的艺术类创新都不复存在了目前AI也只是拼接而已所有做出来的图都一股子裁缝味;2;1;3;18388;0.0001631498803567544
101796;说句难听的画师本身在做的事情就是排列组合，所谓的人的灵魂只是你在排列组合的过程中对不同的元素进行了你个人的一些加工或者改变。;1;1;2;18388;0.00010876658690450294
101835;危言耸听的评论太多了。我15年开始就关注这块了，当时爆火的项目叫ostagram，我测试完结论就是神奇，潜力很大，但图片放大到100后ai特有的笔触太过明显，不能直接用，只能把它当草稿概念图在上面重绘。七年过去了，各种项目功能发展挺快，但这个痛点始终没一丁点进步。过不了这一关，ai的画不论多好看，一放出原尺寸图立马露馅。;2;1;3;18388;0.0001631498803567544
101839;评论区的小画家低估了ai绘画进步的速度;2;1;3;18388;0.0001631498803567544
101843;其实AI的水平是可以超过绝大部分人类的，而且这一天比大部分人想象的都要早，只有极少数的人立于一个另类的巅峰上不被时代所裹挟。仅据我所理解，对于一般的技术来说，画画里元素的组合尤为重要，弹幕里有很多伙伴仍然认为AI作画的水平还停留在拼接已经存在的作品上，其实当总量的元素提取出来，再加以修饰就可以通过排列组合大量产出，而我们感觉到的它与人类作画的不同在于它缺少了“灵魂”，缺少了让我们体会到美和感情的那一种力量感，但其实这种灵魂也并非不可模仿，大数据的强力加持下，有了上亿人数年潜移默化的思维导向，很容易就可以选取出符合大众审美的和谐感，从而创造出那份美感，这个进程并不是天方夜谭或是遥遥无期。但也如同我提到的，因为大众而生的始终不能脱离大众，美妙的灵魂也会独一无二不可替代，那种机械也会趋于平庸，即便是这样，许多的画家连这一份平庸也无法达到，甚至出现以后仅存天赋派选手的境况。但那也无需害怕，因为我们一直都在向前走，不能因为可能出现的情况就畏缩不前，工业革命的普及与自动化的发展会让多少体力工人失业，电子通信技术让多少信使就此停马驻地，机械纺织业的发展让多少手工编织者沦落至此？但是同样的，技术的发展始终服务于人类，工厂流水线解放了多少人的工作量，电话的普及让多少人日夜思念的对象有了希望，机械纺织业人更多的人有了衣服穿并且他们也从未就此消失过，仍然活跃于我们的视野中，诞生于人类心中的对未来的想象是最美好也最不可替代的，正因为爱与情怀的存在让我们变成了独立而感性的生物，所以请不要妄自菲薄也切勿视之如毒蝎唯恐避之不及。我们哪曾想工业革命将人类推向了世界舞台呢？若是以后的AI解放创作让更多的人拥有了自由发挥的空间呢？现在的过多猜忌和忧虑无疑是电梯效应，时间会证明一切是否值得。;1;1;2;18388;0.00010876658690450294
101846;看到评论有人表达了人和机器的不同，或者说对ai的轻蔑，比如：机器不会创造它没见过的。这就要说一个有趣的事了：人类可以想象他没见过或者没概念的事吗？;1;1;2;18388;0.00010876658690450294
101848;就像一些评论说的，肯定会的，别嘴硬了，以后所有画家都得失业大笑大笑大笑大笑;3;1;4;18388;0.00021753317380900588
101852;打击画手是一方面，但另一方面是，诈骗犯数量随之大量增加。前两天我朋友才举报了一个用ai生成的背景假装是插画然后试图骗三千块的。为什么我看出来了？因为它角色和背景格格不入，而且背景有很明显的wanbo生成笔触。诈骗，模仿，造谣，诽谤。和这些比起来，我觉得比我画了十五年被ai瞬间超越还要紧张。不知道会多出来多少被诈骗的倒霉蛋。;2;1;3;18388;0.0001631498803567544
101865;ai绘画又不是创作。只不过把网素材拼凑而已，急什么。;4;1;5;18388;0.00027191646726125733
101883;回看现在新晋崛起得chatGPT评论区得各位想法们会不会有所改变;1;0;1;18388;5.438329345225147e-05
101891;未来一定会，但现在还不行，现在的ai绘画仔细看就能看出来，ai画的画都是气氛且概念的，有些东西本吧没有明确主体，或者有主体的你想自己看，却啥也不是。;1;0;1;18388;5.438329345225147e-05
101904;在后互联网时代，起初ai取代了美工，我没有说话因为我不是美术工作者；接著ai取代了文字工作者，我没有说话因为我不写小说不做自媒体；后来ai砸了生物学的饭碗，说是能计算所有蛋白质的三维结构，我听不懂也没有说话因为我不是科学家；此后ai取代了产业工人，我没有说话因为我工程师；最后ai奔我而来，却再也没有人站起来为我说话了。;2;0;2;18388;0.00010876658690450294
101916;这是网页版的吗？我也想玩一玩咋用呢？;3;0;3;18388;0.0001631498803567544
101921;杀不死，因为它没有版权，就好比一个吃百家饭哪来的父母一样，没有版权就意味着无法商业化，会被四处盗用，抄袭;3;0;3;18388;0.0001631498803567544
101929;你们说的我都懂，但是这玩意侵权啊;5;0;5;18388;0.00027191646726125733
101939;不会，因为ai画的东西没有情感。这是人能拿捏的住ai最根本的点。你可以说ai它画里有情感，但是不好意思，以我目前的观感，还感受不到，好吧？恕我直言，它只是个冰冷的工具。;2;0;2;18388;0.00010876658690450294
101947;沒用的，我跟外包溝通一些設計上的問題都是改了又改，人都不能馬上理解ai能嗎？你讓他注意下疏密關係，注意下元素搭配等等我就不信他能聽得懂説白了AI發展這麽多年理解不了的還是理解不了，除非ai有思想。那麽問題來了ai如果有思想那大家一起完蛋，可不就是單單是游戲美術。;3;0;3;18388;0.0001631498803567544
101971;突然想到一个问题，al能画四d图吗？微笑;17;0;17;18388;0.000924515988688275
101997;谢谢，把我从进入美术就差临门一脚拽了回来。大学专业打算报人工智能，打不过就加入;4;0;4;18388;0.00021753317380900588
102007;不了解，发问一下：AI目前是不是还是只能将网络上所有图片的形式和元素进行重组得到新的东西。就是真原创是否存在就是包括哲学思想，历史背景，宗教信仰等可以深刻解读的作品;4;0;4;18388;0.00021753317380900588
102014;我看到这个突然想到，以后ai不断发展，会不会可以直接把小说生成漫画、动画;3;0;3;18388;0.0001631498803567544
102018;ai挤压美术底层从一方面来说已经算是杀死美术行业了;2;0;2;18388;0.00010876658690450294
102021;ai抄袭人而已;4;0;4;18388;0.00021753317380900588
102026;生成的画是ai自己弄出来的还是在网上获取到;1;0;1;18388;5.438329345225147e-05
102028;AI要取代动漫还有很长的一段时间，如果用漫画就能用ai直接制作完成，甚至把小说也生成动漫或者漫画，这估计得百年后才能做得到，我是等不到了，科技进步没想象的快;2;0;2;18388;0.00010876658690450294
102033;还能进化吗，我看了大部分的ai画完一张人物图后，再画另一个角度都画不出一模一样的人物了，而且好像不能精确到配饰的具体形状，目前感觉还是很难代替人工画师;3;0;3;18388;0.0001631498803567544
102041;我认为前景还是没有想象中的那么差，首先前提就是ai不具备人的思维，无法在细节上完成人的需求，底子的创建也需要人的引导，使得画师在ai绘画上仍是需要的，用于ai的指导和后期的精修，这样一来，虽然可能一个工作室的美术会精简到一个人，但是原先请不起一个工作室的也可以请画师作美术了。你看市面上很多低成本作品，美术都是很捉急的，而很多有潜在美术市场的地方因为成本问题还没有很多美术介入，比如小说插图等。将来美术的成本会降低，但美术成本降低带来的也会是市场的扩大，但是在产业升级的时间内很多人会不好过，同时画师的收入会被ai方分一杯羹，这些问题还是要投入考虑的;1;0;1;18388;5.438329345225147e-05
102043;这技术难道就不是创新吗技术只会越来越好要想活着就必须跟着时代走;2;0;2;18388;0.00010876658690450294
102049;现在ai那么智能为什么没有出现ai程序员，我只要跟它说一段想法，它就立马给我生产一段代码。;3;0;3;18388;0.0001631498803567544
102055;不会，但会更卷。总需求会降低。很多时候我们并不需要那么好的图，过得去的就行了。而现在没得选择，你要个过得去的也得找专业画师。;1;0;1;18388;5.438329345225147e-05
102066;艺术都用大数据了，创造力的工作都会被替代了，人类干嘛去呢？就剩体育运动能容纳人口了;2;0;2;18388;0.00010876658690450294
102072;说得好，可他好像不会画分镜？;3;0;3;18388;0.0001631498803567544
102076;好像这些ai绘图大多使用GAN做的，感觉前几年就有了，咋突然火起来了，我还记得我有同学用这套神经网络做过面部补全用来去口罩;2;0;2;18388;0.00010876658690450294
102083;有一个点不知道大家想到没，ai作画实实在在的剽窃了艺术工作者的创意，但它是不可能被版权影响的，因为根本无法界定抄袭了谁的作品，如果让这玩意不合法，又会催生黑色产业链，因为它已经出现了。它就在那，不可能不用的。所有艺术创作者只能眼睁睁看着自己的创意被ai吸收，会造成什么后果，深了想挺恐怖的。这条评论就放这，感觉想到了了不得的东西。;1;0;1;18388;5.438329345225147e-05
102092;开头我猜对，第一张我隐约见过原图，所以知道是人画的。第二张，看起来光影写实，其实内容凌乱。第三张，太明显不说。第四张，别看手稿图纸的感觉就上当，明显里面的内容都是各种不对称的，有明显拼接痕迹，如果里面不这么凌乱，再模糊一点可能还真不好猜。第五张是最不好确定，只是单纯觉得这种样子和看过的不少Ai做的卡通图片类似就5是靠直觉纯猜的）;2;0;2;18388;0.00010876658690450294
102103;就像照相机和手机摄像头的普及，每个人都是摄影师，但专业的摄影（广告摄影）依然要摄影师一眼，AI绘画的普及，只会让绘画风格普及，而想要做的好，就要美术基础审美，更加推动美术绘画行业的繁荣，，与其说代替画师，不如说是画师的春天呢;8;0;8;18388;0.00043506634761801175
102112;3D设计的表示特别需要灵感藏狐如果打几个关键词就能有东西可以参考那是极好的;2;0;2;18388;0.00010876658690450294
102116;ai必然取代人类，人类的结局只有全人类的毁灭，全人类的洗脑，或者被“神所统治”。;3;0;3;18388;0.0001631498803567544
102121;其实不至于AI可以让AI和单独美术从业者配合学习这个美术从业者的画风人提出点子AI给出大致模型画师再把画改成心目中的样子;1;0;1;18388;5.438329345225147e-05
102123;这个软件哪里下载？;1;0;1;18388;5.438329345225147e-05
102136;AI有一个致命缺陷，就是它几乎不犯错，你输入给他什么，他就为你创作什么，几乎没有意外，而人类很多美的东西往往是意外所得，就比如美食，有很多美食的诞生就是因为古人失误犯错得到比正常做还要美味的食物，平面设计师和画师朋友们不少也应该遇到过理解甲方要求的时候理解偏差，但出来的作品反而甲方更满意以至于推翻了之前的想法。我的意思就是说，只要人类思维能够保持个体独特性，就永远会比AI有优势。比起担心AI代替人类，我觉得更应该担心的是人们会逐渐适应习惯AI这种必然性，而不再享受事物的随机性，到时候人类的思维趋同，那就太可怕了。;2;0;2;18388;0.00010876658690450294
102149;玩家表示，怎样都行，快点把刀剑神域那样的游戏做出来就行;1;0;1;18388;5.438329345225147e-05
102155;讲真看到这个ai绘画我想起了大刘写的《朝闻道》，高等文明的社会中艺术消失了，感觉如果真的所有画师都失业，虽然很可惜，但也是发展的必然，我也很喜欢画画，不过学了后发现也许也不是那么喜欢，只是想把我脑海中那奇怪的xp表现出来，最后没学会还白瞎了大几千，有了这项技术后我能实现脑海中的画面了，而且很轻松，就这点而言对于我这种不会画还懒的学的感觉是一种好事，就是苦了各位画师，我还挺喜欢看直播画画的;1;0;1;18388;5.438329345225147e-05
102157;一张精美的画作人需要很多时间去构思，练习，ai只需要几个关键词，搞艺术的没影响，但是靠画画吃饭的绝对要转行了;4;0;4;18388;0.00021753317380900588
102170;ai现在已经可以做视频了，我想知道up你觉得你会失业不。;2;0;2;18388;0.00010876658690450294
102173;棋类有输赢美术有输赢？大家伙审美都一样？CG人物多少年前就有了吧怎么现在电影还找真人演;4;0;4;18388;0.00021753317380900588
102189;个人感觉原画师可能要去转建模了;1;0;1;18388;5.438329345225147e-05
102197;我觉得的ai不应该取代人，目前ai学习的素材来源是人，不具备自我创新发展的能力，如果人的创造消失，那么ai能利用的素材就是有限的，产品同质性就不可避免，难免会产生审美疲劳。但现实情况来说，替代状况也有很大可能发生，因为现在已经有人在用ai绘画赚钱了，在ai高质量批量化低成本的生产下，势必会挤压画师的生存空间，随着ai的发展，AI绘画可能会变成商品本身收费，也可能普及大众从而直接将画师等行业全面AI化。我觉得就目前来看，AI绘画有很多问题，AI用人的素材学习将人的劳动成果占为己有却几乎没有什么成本，受害最深的就是那些画师，莫名其妙的成为被抄的素材却得不到任何补偿，还要被AI搞得失业，颇有点过河拆桥，卸磨杀驴的味道。;1;0;1;18388;5.438329345225147e-05
102203;我学画画报名都花了好几万，但现在这情况说实在的，AI会干掉98的画师;1;0;1;18388;5.438329345225147e-05
102205;我觉得ai作画恰恰能打开画师的思路，提供更多、更丰富的想象力和灵感;1;0;1;18388;5.438329345225147e-05
102207;只能说人类还没有到达不用工作就能活下去的时候。机器总不能替我去娱乐罢给心心;1;0;1;18388;5.438329345225147e-05
102211;以后开发游戏，直接用AI找美术灵感，然后用AI写BGM，用AI辅助写代码，用AI写游戏里的AI。这实际上是好事。;2;0;2;18388;0.00010876658690450294
102216;学漫画的表示不慌;5;0;5;18388;0.00027191646726125733
102222;ai，没法形成连贯的故事;2;0;2;18388;0.00010876658690450294
102225;原创画家作画，形成资源库学习库，一个优质的有针对性的学习库可以像现在的一幅名画一样卖高价，被收藏。我觉得这反倒给了画师新的机遇。;2;0;2;18388;0.00010876658690450294
102231;ai永远不能自称是画师，本身就是剽窃各种原创;8;0;8;18388;0.00043506634761801175
102242;ai不吃大米，拖拉机也不会抢你饭碗，1970年我国没有任何人觉得拖拉机抢人饭碗为什么同样是人，工人不会抢人饭碗，马云却会？如果ai是个人，你会觉得怎么才会抢你饭碗？;1;0;1;18388;5.438329345225147e-05
102246;照这个发展趋势以后用的人越多人只需要负责一些框架的东西什么其他的都能交给AI来实现结果就是人逐渐变成啥都不会的废物;3;0;3;18388;0.0001631498803567544
102253;太可怕了，幸好我是法律行业从业者，这部分职能要被取代会产生伦理上的阻力。;1;0;1;18388;5.438329345225147e-05
102257;请问up主这个midjourney需要翻墙才能使用嘛？给心心;1;0;1;18388;5.438329345225147e-05
102280;我怀疑画不了美女帅哥否则为啥不展示毕竟拼凑出来的只会是怪胎不会是美人;3;0;3;18388;0.0001631498803567544
102287;最重要的是人;1;0;1;18388;5.438329345225147e-05
102292;这种场景概念美术差不多可以失业了吃瓜，随便生成一张图透视基本功已经吊打中层低层的画师了;3;0;3;18388;0.0001631498803567544
102302;你以为游戏美术是画画的么游戏美术是拿钱受气的。;1;0;1;18388;5.438329345225147e-05
102307;这个ai软件是什么;3;0;3;18388;0.0001631498803567544
102316;好奇ai作画的逻辑是什么是读取大量的照片或者画然后把不同图的元素合成吗;1;0;1;18388;5.438329345225147e-05
102320;在谈取代人类之前，还是先问一下，这个能画本子吗;3;0;3;18388;0.0001631498803567544
102335;一个疑惑。ai会让低端美术从业者失业，为什么大神不受影响？既然ai大大降低了绘画难度，影响最大的难道不是绘画上最顶尖的那批人吗？大神苦练几十年的技法ai几秒就能学，而且效率还更高，那大神的美术功底优势何在？低端从业者甚至业余人士都能用ai画出一幅好看的画来，要大神干什么呢？目前看来ai真正影响的是只会画画的那批人，因为目前的ai基本功上已经无人能敌，那么剩下来拼的就是创造力了。目前阶段ai也是要人来操作的，操作的人想象力越丰富创造力越强，ai表现出来的东西也越强，对于某些创造力强但基本功不行的画手那绝对是咸鱼翻身了，即使你不是美术专业出身画的很烂，但你会讲故事，有了ai你就有机会把金字塔顶的那批画手拉下神坛。另外ai绘画未来大概率会促进漫画的发展，因为ai可以取代一切美宣插画数字绘画等一系列只有单独画面的画种，唯独取代不了漫画，因为现阶段的ai包括未来都无法完成一个逻辑清晰符合现实生活具有一定文学价值的剧本。同理ai会淘汰一群只会画画的画手，让一批不太会画画但创造力极强的剧本家翻身。;1;0;1;18388;5.438329345225147e-05
102347;不能，有种东西叫甲方，;2;0;2;18388;0.00010876658690450294
102369;我觉得以后美术的出路就在于能不能画出与人心灵产生共鸣的，拥有独属于人类之间默契的那种画作了，“心”，或者叫做“爱”？;1;0;1;18388;5.438329345225147e-05
102398;我觉得最急的是资本家，耗尽大半辈子的心血金钱组建起来的人才资源，结果被那些刚出道晚辈资本家利用AI就轻松超越了自己的优势，资本家能不急吗;3;0;3;18388;0.0001631498803567544
102404;说实话有点打击，画了七年，从基础一步步学起，结果ai画了几分钟就把我给秒了東雪蓮睡觉;1;0;1;18388;5.438329345225147e-05
102408;这在我看来就是个系统信息库呀，顺便一提这时发这条评论我才看开头两分钟，数据库里要什么，就把那些信息采集出来然后拼合在一起，本质上还是没有创造能力，他们只是拼接融合，人类可以从无到有，创新，而AI无法创新，他们只能收集现有的因素到数据库中然后再重新融合拼接出来，而且别讲什么智械危机机械文明傻话了，就以现在的条件继续发展，如果将来是万一有什么东西能够让程序异变出智慧那自然不是我们预料的事，但就目前这样正常的进程人工AI智能再高级他也是程序，不可能拥有智慧的，就算再怎么像人类也只是极其高级的程序;1;0;1;18388;5.438329345225147e-05
102414;al诞生的意义是为人类创造福祉，不是为了替代。你们要是真这么想，我也好减少几个竞争对手，默默做一个内卷王。;1;0;1;18388;5.438329345225147e-05
102428;最好还是不要过于依赖吧不然后果不堪设想;2;0;2;18388;0.00010876658690450294
102436;只能说ai偷东西还是太方便了;3;0;3;18388;0.0001631498803567544
102443;个人觉得AI只会淘汰水平低的人员;1;0;1;18388;5.438329345225147e-05
102457;不会的因为只要有甲方画师就不会被淘汰;1;0;1;18388;5.438329345225147e-05
102466;感觉以后得裁员百分之九十，留下几个修图的和ai使用得心应手的。;1;0;1;18388;5.438329345225147e-05
102468;偷偷告诉你们，AI已经可以编程了，只不过开发AI的工程师怕失业于是一直没有公布出来;4;0;4;18388;0.00021753317380900588
102478;我好倒霉噢热唉。。。;1;0;1;18388;5.438329345225147e-05
102486;ai只会复制粘贴，最终到美术工作者手里肯定还得自己修改。美术这一块怎么说呢设计是没有尽头的脱单doge;6;0;6;18388;0.0003262997607135088
102501;如何下载MIDJOURNY;1;0;1;18388;5.438329345225147e-05
102504;会杀死中低水平的所有绘画从业者，高端水平的反而赚得更多，总之就是一切向内卷发展;9;0;9;18388;0.0004894496410702633
102524;感觉明年高考想学程序设计专业了;1;0;1;18388;5.438329345225147e-05
102530;有个问题，ai软件做的图有版权吗;2;0;2;18388;0.00010876658690450294
102533;ai消灭人类的第一步：先让一些行业没饭吃;1;0;1;18388;5.438329345225147e-05
102554;低成本带来的就是低价值，无论怎么变社会的本质就是人与人的交流。就跟货币没了信用就跟纸一样。ai围棋天下无敌然后呢，人类就放弃围棋了？关键还是人与人之间的博弈才有乐趣。想这么多完全是杞人忧天，ai可以生成好看的图片，后面就会有ai搭配师之类的工作出现，而怎么搭配好看还是要美学专业的人才有优势。所以ai就是一个工具，木得感情的，如果有一天ai有感情，那人类就成神了。;1;0;1;18388;5.438329345225147e-05
102581;但是ai绘画的不确定性也是它的缺陷啊，我觉得单独几张还行，多了的话很难做到整体风格的统一，因为关于整体风格是否协调，这东西是宏观视角，机器人是没有这种思考能力的。;1;0;1;18388;5.438329345225147e-05
102587;其实对普通人来说还挺不错的，我脑子里的梦终于有可能具现;5;0;5;18388;0.00027191646726125733
102593;虽然都很宏大精细，但是一对比那些原画师就能看出来太模式化就是看起来好看又河里，没有那种“特别”，你随便拉一个画师的图都能在里面看到不一样的东西，但是ai的图你感觉那个地方好像都见过。而且吧感觉这风格很明显的都是一种（说他ai风得了），但是人类的风格是多样化的你可以用几次，但是没人愿意一辈子看这些既视感过强的ai图。目前来说，智能所有的产物始终基于人类已有的创作，文化艺术类的它没法替代（毕竟我不能预见以后，但是我目前来看是不太可能。我们的压力还是来自于优秀的同类）;1;0;1;18388;5.438329345225147e-05
102599;人工智能配音让配音员失业了吗？不人人都能用配音了。但是高端配音谁都玩不起。dogedogedogedoge;2;0;2;18388;0.00010876658690450294
102612;其实ai并不会画。只是把别的画中的可识别物体进行一种组合，再对整体色彩进行一种混合计算。某种意义上来说和画师在绘画前搜集大量参考图再进行缝合加工的过程是一样的，所以才给人感觉像是印象里的一些概念。其本质完全是一个美术用搜索引擎的可给出部分预览效果图的升级版罢了;1;0;1;18388;5.438329345225147e-05
102619;AI需要大量其他人的作品当轮椅，而人永远可以从生活中汲取灵感。AI写作也有很多人搞吧？但是反响不如AI绘画。因为人们很容易从前言不搭后语的文章中发现漏洞，而视觉不一样，它有足够的冲击力就行了，这就足够把人唬住。我讨厌现在的AI绘图成品，除了花里胡哨的颜色就没有打动人的东西了。仔细一看，细节全是杂乱无章的组合。就我个人来说，现在AI生成的东西看多了只让我头疼。这东西作为画师的辅助还可以，但是作为成品，如果我是消费者，我可不想为这种东西花钱;3;0;3;18388;0.0001631498803567544
102627;不会，AI可以辅助，但制造出来的东西意义不精确。;1;0;1;18388;5.438329345225147e-05
102638;摄影取代绘画了吗？没有，但摄影让绘画的市场份额巨幅减少了，没有任何绘画基础的人也可以做视觉创作、记录，现在摄影的产出数量已经是绘画的数百万倍乃至更多，人们终其一生都不太可能找个人给自己话肖像，但是拍照已是再平常不过的事情了。AI绘画也是一样，绝对会给绘画带来更沉重的全方位打击，甚至它还会去侵袭摄影创作的空间。未来，所有专精职业都会变得岌岌可危，人最重要的价值应该就是逻辑和统合能力，在AI与机械的加持下，每一个人就相当于一个巨型团队，在殖民星球上随意调遣资源，就像玩个模拟经营游戏一样便完成了神创世纪的壮举。;2;0;2;18388;0.00010876658690450294
102643;生成2d绘画只是第一步，未来的ai也许可以直接生成以假乱真的虚拟世界，游戏行业或即将迎来范式革命。这其实是ai研究中一个重要方向“世界模型”，目标是让AI拥有关于外部世界的常识，能像人一样根据自己对世界的认识进行逻辑推演，这个方向也被认为是通往强AI的必经之路。;1;0;1;18388;5.438329345225147e-05
102656;什么时候ai可以画漫画，我想看jojo第9部dogedogedoge;2;0;2;18388;0.00010876658690450294
102662;水墨风格的画现在AI能画吗;1;0;1;18388;5.438329345225147e-05
102670;刚想下定决心学插画，该怎么办委屈;1;0;1;18388;5.438329345225147e-05
102672;ai可以取代游戏策划吗？;2;0;2;18388;0.00010876658690450294
102685;作为十年的场景美术，这玩意看看就好了，能做辅助生产，但替代谈不上最多又多了个工具，;8;0;8;18388;0.00043506634761801175
102699;请问up。ai绘画版权归属，法律是怎么定义的？;1;0;1;18388;5.438329345225147e-05
102724;该机械飞升了;1;0;1;18388;5.438329345225147e-05
102726;艺术是最不可能被ai取代的啊;1;0;1;18388;5.438329345225147e-05
102735;甲方我要一个这种那种的感觉要又有华丽和破败的感觉ai啊对对对doge;1;0;1;18388;5.438329345225147e-05
102748;可以画本子吗？;1;0;1;18388;5.438329345225147e-05
102755;其实差的还是挺远的，离远了看有那个感觉，放大看细节那就差的比较远了;1;0;1;18388;5.438329345225147e-05
102759;看到今天一条新闻，就是说有人拿AI画画的作品参加艺术比赛最终获奖。所以比起AI会不会取代美术，其实我更关心的是。AI作画，画出的成品到底算AI画的，还是操作AI的人画的？就像有人说的“这个人根本就没有在画画，难道购买一张别人的作品就可以去参赛了吗”问题就在于这个提供者它不是人。但本质上还是使用了非自我创作的东西简单ps之后拿去参加比赛，在某种程度上这不就像用工厂机器织了一件毛衣然后去参加手工毛衣的比赛吗？多少有点像作弊行为。然后关于AI的另一个令人担忧的地方就是，它不止会变成艺术家的工具，也可能会变成资本家剥削艺术家的工具（比如让你一天先出几十张图来看看之类的），虽然这不是工具的错。;2;0;2;18388;0.00010876658690450294
102774;不会，ai根本就画不出感情，毕竟机器还是机器;1;0;1;18388;5.438329345225147e-05
102776;个人挫见：AI对于创作者而言并非对立的关系，我们大可不必为谁将替代谁争论。技术终究是工具，当我们在讨论技术的发展时，需要落实到操作层面和实践更新才有意义。AI绘图的兴起和发展，仅仅只是启示创作者们需要革新认知和操作方式的一个新节点，而不是创作的终点。同样的，未来还会有更多的技术会推动各行各业的劳动者更新自己的生产方式。自古以来这样的例子不胜枚举，文字打印、器皿冶炼、影视制作等等。人类是需要依靠大胆想象来推动进步的，各位大可放开点，在遥远的未来，我们的概念设计师未必是在电脑前或在纸上画画，也可能是躺在某座椅上，通过某设备在虚拟空间里直接创造场景。所以说他们失业了么，并没有。某种意义上，取代，是只有少部分停止更新的群体才会使用的词，大部分人终会被历史推动，或许没有意识到，但是自身已随着技术革新在同步进步。;1;0;1;18388;5.438329345225147e-05
102781;ai画出来的东西大多数就是看起来很厉害，但是看细节完全看不清是什么玩意;1;0;1;18388;5.438329345225147e-05
102783;但还是要人去修改微调的吧，人力还是有价值，有点像打字、自己写字，因为可以打字了，就不用学写字吗人的价值是无法取代（因为人不想被取代）机器只是辅助，如果机器有能力超越人类，超出了它辅助的功能，那人类一定会先一步限制它，因为人类先出生，它再聪明“先”这个概念依旧有优势。但如果万一人类作死，那么;1;0;1;18388;5.438329345225147e-05
102801;很简单，如果你相信ai会取代人类，就赶紧把车辆的驾驶权完全交给程序，看你敢不敢把自己的命交给一堆毫无思维能力的代码，小鹏汽车，特斯拉的辅助驾驶可是有不少自行撞车的记录呢，连不撞车都做不到还想替代人类画画，异想天开，就是个缝合怪软件？到时候公测版本收你一年几百块会员费一大帮白嫖党就都得弃坑，等艺术家再给自己的图库加上版权，你用了艺术家的词缀生成了他风格的图像没经过授权就商用，侵权了被告了再给人家赔巨额的赔偿资金，那才叫一个精彩嗑瓜子吃瓜滑稽;2;0;2;18388;0.00010876658690450294
102831;徐云修;1;0;1;18388;5.438329345225147e-05
102863;话说啥时候研究用于政治社会治理的ai啊，这种视觉类的感觉有好多;1;0;1;18388;5.438329345225147e-05
102879;打个比方就是ai歌，ai早就能替人唱歌了，但还是有歌手，ai现阶段只不过是一种工具罢了。ai歌也是人编曲作曲的，而且就我听ai歌这么多年的经验来说，ai没有那种感觉。;1;0;1;18388;5.438329345225147e-05
102884;发表一下个人观点，因为人类创造了这门艺术，因为人类有着这样的需求，才有着这样的AI。如果人类一味地依赖AI去进行作画，那么我们的审美观将很难得到提升。到时候，就算是AI有了自己的意志，绘制的东西我们可能也难以欣赏。如果人类真的走到那一步，那我觉得这AI存在的意义也就不大了，甚至有可能会逐渐消失。;1;0;1;18388;5.438329345225147e-05
102890;很简单，至少剧情向引起人类共鸣的画ai是画不出来的，比如本子吃瓜;1;0;1;18388;5.438329345225147e-05
102894;这个midjourney，好像不太擅长画二刺螈（）;1;0;1;18388;5.438329345225147e-05
102903;ai只能生成厚涂风格吗？？？还好我是二次元平涂风，不担心。。。;2;0;2;18388;0.00010876658690450294
102911;有些人可能不明白大厂美术岗位的人都是干什么的，以为就画两张图就行了，其实你们看到的游戏宣传图基本上都是外包出去的手工活，我建议可以去买一些大厂游戏的设定集，游戏美术不是单单一张画就搞定的，一个超越现实的机器设计出来，要明确的展现它的结构，运作原理，功能性。如果AI能办到这些，那ai发明东西指日可待。（举个例子，比如ff14里的弓箭手都会戴一个巨大的宽边帽，为的是在太阳下面遮阳才能更好的瞄准，就更别提一些机甲和身上的机械义肢，它是要美术岗位拆解出来让别人看清楚，这玩意儿是怎么动起来的）;1;0;1;18388;5.438329345225147e-05
102954;那以后网络小说是不是也可以有插图了打call;1;0;1;18388;5.438329345225147e-05
102959;你应该去问问珠宝行业为什么不用机器全自动，手工做出来的工艺品和机器做出来的，那差别可太大了，我不知道该怎么说，抽像点说就是机器很死板没有灵魂。;1;0;1;18388;5.438329345225147e-05
102961;我感觉ai只能借鉴已有的美术进行创作，让它创造一个全新的概念是不太行的;1;0;1;18388;5.438329345225147e-05
102964;阿尔法狗杀死围棋了吗？人类以后不下围棋了？;2;0;2;18388;0.00010876658690450294
102988;AI绘画说实话还差得远呢。看这些图片的时候你们也应该能察觉到，AI画乍一看非常惊艳，但是根本不能细看。这是因为AI能画出某种氛围，但是却无法画出任何“东西”。比如04：48这张图。一个杂乱的工作室，乍一看很象那么回事。但是如果我问你，“这是那种职业的工作室？”你马上就会懵比。你完全回答不上来，甚至连猜测都做不到。因为要回答这个问题，你就要去看杂乱的工作室中究竟堆积了什么东西，什么机器。而回答是，什么也不是，一堆又一堆难以名状的线条和图形，仅此而已。这就是AI绘画目前难以逾越的高峰，真正去画出”内容“来。一张好的原画，包括《马拉之死》等经典画作，每一张都在讲述一个故事，。但是如果AI连一个具体的东西都画不出来，又何谈去讲述一个故事呢？;1;0;1;18388;5.438329345225147e-05
102993;现在很多画画是设计工作，做数字绘景和场景概念设计也是用很多照片合成一个画面。AI绘画如果没有版权问题，也可以当设计师的素材;1;0;1;18388;5.438329345225147e-05
102998;虽然我不是美术行业的，但我已经开始感到头疼了灵魂出窍这ai怎么进步这么快啊热虽然目前二次元还在开发，总感觉再过上个几年连某些大佬都能学会，已经开始害怕了;3;0;3;18388;0.0001631498803567544
103033;还是有时间成本的Ai看似有无限可能性可以一直重复但一次不行试个十几次都达不到初步设想的话基本上ai就达不到使用标准有一个很重要的点人在学习美术的时候会根据经历和想法审美结出名为风格的果实ai很难学会可能你到死也看不到那么大家都用ai市场千篇一律（就像3年前的游戏行业）你看国家会不会给你版号就是了目前来看ai的方向和游戏美术不太一样游戏美术会要求统一风格就这一点把ai打的稀巴烂;1;0;1;18388;5.438329345225147e-05
103039;像极了那是说相机能代替画家的吃瓜;1;0;1;18388;5.438329345225147e-05
103044;危机个屁，甲方可不知道自己想要什么该怎么出关键词，而且现如今的ai绘画产出的作品就突出一个“好像有什么但仔细一看有啥都不是”，就这样的图再交给画师去进一步具体刻画有时候痛苦程度不亚于重画一张，在游戏美术这个商业领域里面，能看和能用可是完全不同的两个概念;14;0;14;18388;0.0007613661083315206
103085;只要还不会写小说，就还有救辣眼睛;3;0;3;18388;0.0001631498803567544
103092;上午还在跟做人工智能的家父讨论这事没想到云妹这就更新了;1;0;1;18388;5.438329345225147e-05
103105;1httpswenxinbaiducommoduleApiernieVilg2https6penartgenerate3httpshuggingfacecospacesstabilityaistablediffusion4httpsdeepaiorgmachinelearningmodeltext2img5httpsdraftartdrawing;51;1636;1687;18388;0.09174461605394822
103157;httpstestcloudserverapicom神乐七奈随便画画;6;197;203;18388;0.011039808570807047
103164;httpscloudserverapicom;24;401;425;18388;0.023112899717206873
103189;这AI甚至可以画涩涩辣眼睛;41;179;220;18388;0.011964324559495323
103231;昨晚忽然用不了了，太痛了，up大善人星星眼，三连了;16;120;136;18388;0.0073961279095062
103248;httpsdraftartdrawing;7;132;139;18388;0.007559277789862954
103257;问一下阿up生成点不了怎么办感谢;2;56;58;18388;0.003154231020230585
103261;httpsmoeyycnai;2;38;40;18388;0.0021753317380900587
103264;挺卡的，，估计人太多了;1;32;33;18388;0.0017946486839242985
103266;“notfound”是怎么回事啊？;2;18;20;18388;0.0010876658690450293
103269;QQ小程序，ai绘画体验馆，能画黄图尴尬，加上nude之类的tag;9;13;22;18388;0.0011964324559495323
103280;总问我是不是人类笑哭;1;10;11;18388;0.0005982162279747662
103282;这张图是不是ai绘画兄弟盟妙啊;6;12;18;18388;0.0009788992821405265
103293;泳装，精致的面容，二次元美少女，白毛，可爱，浴池里，散发，纤细的四肢，脸红，白丝脱单doge;2;17;19;18388;0.0010332825755927778
103298;怎么保存啊;4;5;9;18388;0.0004894496410702633
103305;能搞真人照片吗;1;6;7;18388;0.0003806830541657603
103313;还得是我坤坤子嘟嘟;1;5;6;18388;0.0003262997607135088
103315;两个人都穿白色绅士服，在赞叹美食的美味，喝迎宾酒，会员制餐厅，我修院、德川，十分的美味，甚至有九分新鲜，林檎;1;3;4;18388;0.00021753317380900588
103317;我推进一个网站xunfuaicom，或者微信官方搜索公众号：AI驯服二次元绘画，目前免费哦。;2;3;5;18388;0.00027191646726125733
103324;这AI可是能画涩图好像有传播什么罪来着doge;1;4;5;18388;0.00027191646726125733
103327;怎么花涩涩委屈委屈;42;5;47;18388;0.0025560147922558192
103371;跑路了;8;1;9;18388;0.0004894496410702633
103386;咋保存;1;1;2;18388;0.00010876658690450294
103391;toolsmikuacaff639329279025474f57c8ffberefaff这个;1;2;3;18388;0.0001631498803567544
103393;整张图片被打码了doge离谱;1;2;3;18388;0.0001631498803567544
103395;已经患上AI恐惧症了b站绅士专栏里莫名出现一堆AI;1;4;5;18388;0.00027191646726125733
103397;简介的第二个网站没有中文吗？;2;2;4;18388;0.00021753317380900588
103402;别展开趁人少，欺负一下uptvdoge你看到这个硬币了吗吃了也不给你开玩笑啦给你给你诶，我又抢回来啦给你啦给你啦不开玩笑辣诶，骗你的略略诶诶你怎么哭辣硬币点赞给你给你都给你发现了：好吧，你展开了，那么在24个小时之内，把这句评论转发到10个作品，否则倒一辈子霉，我也是受害者;2;4;6;18388;0.0003262997607135088
103449;别展开趁人少，欺负一下uptvdoge你看到这个硬币了吗吃了也不给你开玩笑啦给你给你诶，我又抢回来啦给你啦给你啦不开玩笑辣诶，骗你的略略诶诶你怎么哭辣硬币点赞给你给你都给你发现了：好吧，你展开了，那么在24个小时之内，把这句评论转发到10个作品，否则倒一辈子霉，我也是受害者;1;0;1;18388;5.438329345225147e-05
103454;就没有免费的吗;2;0;2;18388;0.00010876658690450294
103459;httpsh5tuqqcomwebai2dcartoonindexparenttraceida60d1c110f2af7674bdbbfd5248ee90dcurrentchannellinkrootchannelqqsousuolevel17神乐七奈随便画画;1;0;1;18388;5.438329345225147e-05
103466;项目已经结束了，可以去原up视频下面看看up的经验分享，或者自己部署到本地;4;0;4;18388;0.00021753317380900588
103476;下次就这样女装吧脱单doge;5;120;125;18388;0.006797911681531434
103482;可以撅吗脱单doge;1;93;94;18388;0.0051120295845116384
103485;up用的什么软件啊？求十一周年送礼物;2;12;14;18388;0.0007613661083315206
103488;UP好帅;2;11;13;18388;0.0007069828148792691
103493;up主用得什么软件啊，推荐一下呗脱单doge;2;7;9;18388;0.0004894496410702633
103496;咋让ai绘画20次的;6;6;12;18388;0.0006525995214270176
103503;upup，什么软件？doge;1;4;5;18388;0.00027191646726125733
103514;初音？笑哭;1;2;3;18388;0.0001631498803567544
103519;0053doge;2;9;11;18388;0.0005982162279747662
103523;此时一位ai绘画两次就变性别的不知名路人路过doge;1;7;8;18388;0.00043506634761801175
103525;我还以为是若露姬;1;1;2;18388;0.00010876658690450294
103528;地铁秒变售货机dogedogedoge;1;4;5;18388;0.00027191646726125733
103531;日常给币（21）;1;1;2;18388;0.00010876658690450294
103535;up这是什么软件dogedoge;1;1;2;18388;0.00010876658690450294
103537;啥软件啊doge;1;1;2;18388;0.00010876658690450294
103540;好像EK;1;1;2;18388;0.00010876658690450294
103543;这个AI绘画是什么软件？我也想试试喜欢打call;1;1;2;18388;0.00010876658690450294
103563;戒哥对自己很失望doge;4;35;39;18388;0.002120948444637807
103568;up主用AI画的真好啊;1;28;29;18388;0.0015771155101152925
103570;ai还是画不好手，不然真的绝杀吃瓜;2;22;24;18388;0.0013051990428540352
103573;两个圆圆的东西支持一下星星眼;2;20;22;18388;0.0011964324559495323
103576;两个圆圆的交换原图doge;2;11;13;18388;0.0007069828148792691
103579;有这么大;1;8;9;18388;0.0004894496410702633
103581;呦西花姑娘doge;2;9;11;18388;0.0005982162279747662
103584;喜欢你的视频;1;8;9;18388;0.0004894496410702633
103586;0;1;8;9;18388;0.0004894496410702633
103588;0;1;8;9;18388;0.0004894496410702633
103590;太好了，正愁最近没什么新桌面呢。;1;4;5;18388;0.00027191646726125733
103592;想起来了，徒然喜欢你酸了;1;1;2;18388;0.00010876658690450294
103594;这惊人的存储量doge;1;2;3;18388;0.0001631498803567544
103596;非常爱看doge;1;1;2;18388;0.00010876658690450294
103598;Ai画得的确漂亮，但手还是画错了笑哭;1;4;5;18388;0.00027191646726125733
103600;直接来吧doge比划比划;6;7;13;18388;0.0007069828148792691
103607;你这ai怎么不会把手画成一团浆糊啊doge;1;2;3;18388;0.0001631498803567544
103609;求Tag喜欢喜欢;1;1;2;18388;0.00010876658690450294
103611;AI画手是真不行，经常六根手指。;2;2;4;18388;0.00021753317380900588
103614;没有链接啊tv思考;2;6;8;18388;0.00043506634761801175
103617;cy，有图了踢我一下doge;4;3;7;18388;0.0003806830541657603
103622;蹲图星星眼;1;2;3;18388;0.0001631498803567544
103625;崩坏3光辉矢愿瞄准;1;4;5;18388;0.00027191646726125733
103627;用什么软件画的脱单doge;1;2;3;18388;0.0001631498803567544
103631;搞点竖屏啊，硬币大大的有doge;1;1;2;18388;0.00010876658690450294
103638;收藏比点赞多哎;1;1;2;18388;0.00010876658690450294
103640;好好好;1;1;2;18388;0.00010876658690450294
103642;胡桃Usa比心;1;1;2;18388;0.00010876658690450294
103644;加油哦;1;1;2;18388;0.00010876658690450294
103650;这也太大了吧星星眼;1;2;3;18388;0.0001631498803567544
103652;吃瓜;1;1;2;18388;0.00010876658690450294
103657;你可能错过了;1;1;2;18388;0.00010876658690450294
103659;就这？邦邦给你两拳doge;1;1;2;18388;0.00010876658690450294
103664;夏诺雅nya;1;1;2;18388;0.00010876658690450294
103667;求图;1;1;2;18388;0.00010876658690450294
103669;关注了吃瓜下次还有我;1;1;2;18388;0.00010876658690450294
103671;我要看女装;1;2;3;18388;0.0001631498803567544
103673;收藏比赞多，说明了什么doge;1;1;2;18388;0.00010876658690450294
103676;up这个是什么模型跑的呀tv疑问;1;1;2;18388;0.00010876658690450294
103678;全程看手和手机，这手机不是异形就是一条;2;0;2;18388;0.00010876658690450294
103682;想知道bgm是什么脸红有点耳熟;2;0;2;18388;0.00010876658690450294
103686;图85分，观感92分;1;0;1;18388;5.438329345225147e-05
103688;我可不可以自己创建语言呢？比如我让ai生成一个人物，我给这个人物命名，让ai记住创作这个人物时的感觉。下次我要做其他作品中加入这个人物的时候，直接提这个人物名字就好了？;9;49;58;18388;0.003154231020230585
103698;呜呜，赞叹于高技术力的同时心也在流血大哭未来还想靠原画插画吃饭的说，这得给我提多高的门槛大哭可怜可怜学美术的罢虽然但是，up高技术力;12;158;170;18388;0.009245159886882749
103711;ai绘画快速体验入口画宇宙Nolibox：httpscreatornoliboxcom即时设计ai20：httpsjsdesign欢迎大家在我们的同名微信公众号Genji是真想教会你后台回复AI绘画，领取视频中提到的所有资料，加入我们的AI创作者社群，我在群里等你们此外本期视频感谢Nolibox、即时设计提供的ai绘画平台，也感谢百度文心（花了好几十个W）的算力支持，明天我会发布AI绘画的原理深度解析和国内首个奖金池超6W的AI绘画有奖征稿，欢迎大家关注;5;133;138;18388;0.007504894496410702
103717;大家如果看6070年代或者更早的的老电影，会发现这些电影的海报都是手绘的，后来ps技术的崛起，让电影海报画师这个行业消失了，但这种技术的进步不会让这些人失业，因为美术最本质的生产力是审美的高低，只要你有足够高的审美，那么只不过是换一种工具从事相关工作罢了。ai绘画还会降低绘画相关行业的准入门槛（就如手机摄影降低了摄影师的门槛一样），让很多喜欢美术但天赋不出众的普通人进入这个行业，但无论如何，你能在这个行业走的多远，根本上还是取决于你审美的高低，这是任何技术革新也夺不去的东西;6;114;120;18388;0.006525995214270176
103724;呆先进是先进，好用是好用，只是我想以后的绘画者会不会连笔都不拿了直接对着键盘一顿输出，我个人感觉没啥意思，绘画直接变成文字游戏了，这图甚至不是你自己脑子里的是机器给的，我还是喜欢全程自己手动，说实话我特别不喜欢过多的智能介入，我车上以前不是有自动驾驶嘛，我直接把那块电路板扯了，我宁可放弃保修;38;73;111;18388;0.006036545573199913
103763;想拿来画本子用音律联觉期待;13;46;59;18388;0.0032086143136828365
103777;已经人工智能了，还需要学习，那算哪门子智能？实锤智障;36;38;74;18388;0.004024363715466608
103814;十年苦画无人知，一键生成亿人来还好转行了tv笑哭;7;13;20;18388;0.0010876658690450293
103822;不好好磨练真本事锻炼画画手法在这投机取巧？什么懒人思路;62;26;88;18388;0.004785729823798129
103886;简单易上手的ai绘画教程1、3分钟速通（软件Nolibox）0113基础部分11通过关键词，文转图进入页面，在页面左边可以找到一个图形，点击;1;13;14;18388;0.0007613661083315206
103888;这也太厉害了doge我说的是关于我白嫖这件事;1;8;9;18388;0.0004894496410702633
103890;裤袜啊;1;1;2;18388;0.00010876658690450294
103894;感觉可以个人完成gla游戏吃瓜;4;10;14;18388;0.0007613661083315206
103904;AI绘画;1;1;2;18388;0.00010876658690450294
103906;话说这些图可以商用么;2;1;3;18388;0.0001631498803567544
103909;工具不重要？工欲善其事必先利其器，一个连武器都没有士兵，你让他上战场当肉盾吗;1;1;2;18388;0.00010876658690450294
103912;比起愤怒无奈，我更多的是诧异，冷眼旁观也就罢了，为什么这么多人幸灾乐祸，落井下石，以掠夺为荣，对支持偷窃马首是瞻，他们有没有想过，连绘画这种主观创作领域都能被ai侵蚀，他们凭什么觉得自己能置身事外呢。;3;9;12;18388;0.0006525995214270176
103919;好难过，学美术的以前想往插画发展，现在发现自己几天画出的一张插画，随便一个普通没学过的人几分钟就能弄出来;3;5;8;18388;0.00043506634761801175
103924;根本不实用啊，上手弄了一下简直吐了，不就是粗糙的拼接怪嘛笑哭美术生可以暂时放心了，这项技术根本不成熟。;1;1;2;18388;0.00010876658690450294
103929;BV1CY411f7q4快来看我刚刚更新的科普视频可以配合本视频一起食用脱单doge;1;4;5;18388;0.00027191646726125733
103932;为啥我没有风格转化功能;2;3;5;18388;0.00027191646726125733
103935;进我收藏吃灰吧;1;3;4;18388;0.00021753317380900588
103937;个人建议如果真的想在相关行业找就业机会还是去学一下webui，这玩意儿是目前最专业的，包括更换乃至训练模型等功能这些ai软件还都是用了一些训练好的模型，源代码也还是那一套，而且没有权重词条，只能说上限有限，玩一玩还是可以的;4;1;5;18388;0.00027191646726125733
103942;看起来好强大，感谢GenJi分享支持;1;1;2;18388;0.00010876658690450294
103944;生成出来的照片怎么删除啊;5;1;6;18388;0.0003262997607135088
103951;感觉这个Ai学的主要是西方画作，有没有国内的？我还是更喜欢国画。;1;4;5;18388;0.00027191646726125733
103953;刚试了一下，确实不错;1;1;2;18388;0.00010876658690450294
103955;审判庭警告，这简直就是魔法阴险;1;1;2;18388;0.00010876658690450294
103959;genji牛啊星星眼;1;3;4;18388;0.00021753317380900588
103962;6W奖金AI绘画征稿：httpswwwbilibilicomvideoBV1Pt4y1K79B这个视频为什么没了，赛事不搞了吗;1;1;2;18388;0.00010876658690450294
103977;高庭城堡，我输入一样的内容为啥出来不一样啊;1;0;1;18388;5.438329345225147e-05
103993;求一些ai绘画作品分享平台;1;0;1;18388;5.438329345225147e-05
103996;都晕了，生成的完全不是我描述的;1;0;1;18388;5.438329345225147e-05
104014;这软件似乎没办法制作人物和风景的混搭图片，我试了好久都没成功;1;0;1;18388;5.438329345225147e-05
104026;网站登录了打不开啊，搞笑呢;1;0;1;18388;5.438329345225147e-05
104035;需要手机号注册登录才能用打搅了;1;0;1;18388;5.438329345225147e-05
104038;老师，啥时候出一期虚幻5引擎的教程啊，真的看别人的教程学不会;2;0;2;18388;0.00010876658690450294
104051;你不发链接是没有前途的，这话我都说了八遍了总之我劝你不要不识好歹doge快点把图交出来;2;5;7;18388;0.0003806830541657603
104054;图包有了踢我吃瓜;1;1;2;18388;0.00010876658690450294
104057;投币求图;1;0;1;18388;5.438329345225147e-05
104059;用的是什么软件？;2;0;2;18388;0.00010876658690450294
104062;有链接三连不放链接三光吃瓜劝你耗子尾汁;1;0;1;18388;5.438329345225147e-05
104064;图包呢;3;0;3;18388;0.0001631498803567544
104068;图包不给一律不赞dogedoge;1;0;1;18388;5.438329345225147e-05
104071;图发出来了踢我一下。;2;0;2;18388;0.00010876658690450294
104074;求图包;1;0;1;18388;5.438329345225147e-05
104076;已三连求图包;1;0;1;18388;5.438329345225147e-05
104078;同;1;0;1;18388;5.438329345225147e-05
104080;已三连求图包;1;0;1;18388;5.438329345225147e-05
104083;这画的确定不是一无所有，披上人皮的样子吗？;2;26;28;18388;0.0015227322166630412
104086;生异性啊哥俩;1;13;14;18388;0.0007613661083315206
104091;点赞数达到400就做笑靥哦呲牙;2;3;5;18388;0.00027191646726125733
104101;求求了，up开个副业吧大哭往隔壁粉色APP也发一套吧;5;34;39;18388;0.002120948444637807
104107;颜值九分胸部100分奸笑;2;19;21;18388;0.0011420491624972808
104111;能换个妹子不？已经审美疲劳了笑哭;5;9;14;18388;0.0007613661083315206
104117;最后一个交流学习群546967811，为啥画不出？群文件里vae装上，你再看看，嗑瓜子没电脑的咋办，不绘图？放弃？nonono没电脑的也帮你解决了，用群里的机器人绘图，机器人具有30多个云端服务器。很多是腾讯云v100。授人以鱼，不如授人以渔，渔你学会了，啥图不都来了？我这些图也不是啥好的作品，只要你们愿意去学，你们肯定也能画出这样的图，直接给你们图，我觉的那就是相当于限制了你们想象的空间了。我觉得哪样不好，这期的图包之前分享过，不过没人珍惜，轻易得来的又岂会珍惜，图包刚给，就有人拿我的图去发作品了。所以比较靠前期的图都没了，;1;5;6;18388;0.0003262997607135088
104125;什么时候手指能完美就好了;3;1;4;18388;0.00021753317380900588
104129;没分享包吗，求高清大图;1;1;2;18388;0.00010876658690450294
104136;求图或者购买。;1;0;1;18388;5.438329345225147e-05
104164;请问up这个是哪个模型啊;1;0;1;18388;5.438329345225147e-05
104166;用的哪个模型？星星眼;1;0;1;18388;5.438329345225147e-05
104168;哪天我进橘子了，一只拷我，一只拷你doge;44;1891;1935;18388;0.10523167283010659
104213;丸子佬越来越厉害了;1;204;205;18388;0.011148575157711551
104215;半身像太好了，这个小肉腿真的很可爱，多来点;26;583;609;18388;0.033119425712421144
104242;说吧，喜欢什么样的麻袋;9;192;201;18388;0.010931041983902545
104252;拒绝幼态审美，从广东做起doge;16;185;201;18388;0.010931041983902545
104269;这要是我的宝贝女儿，那我不得打断她男朋友的腿;8;104;112;18388;0.006090928866652165
104278;三次元了反而不太喜欢了还是二次元的好看这种趋近于真人的没啥感觉了doge;4;73;77;18388;0.004187513595823363
104284;完全没有任何想法，只是觉得好可爱，人喜欢可爱的事物不是很正常吗？;1;12;13;18388;0.0007069828148792691
104286;UP我要关注你了，你让我夜不能寐你就来陪我脱单doge;1;7;8;18388;0.00043506634761801175
104288;我用ai画过这种，太罪恶了实在是捂眼;4;13;17;18388;0.000924515988688275
104293;拒绝幼态审美，从我做起;4;33;37;18388;0.002012181857733304
104299;每期必投币up来一期横屏全身吧球球了大哭大哭大哭;1;24;25;18388;0.0013595823363062867
104301;星星眼精品;1;19;20;18388;0.0010876658690450293
104303;有点奇怪，可能是因为太真实了，就有点练不起来，要是纯二次元那随便怎么练都没有背德感，这个太真实反而被自己现实中的理性给压下去了笑哭（以上为个人观念不喜勿喷）;2;13;15;18388;0.000815749401783772
104306;这种图确实很可爱，但看有人留言感觉这种太真人让人思想有点危险啊，思想污没事，但有的底线不能碰啊;2;10;12;18388;0.0006525995214270176
104309;我是萝莉控，我忠诚的爱着每一个二次元小女孩，我以爱着她们为荣，别人的任何语言都不会动摇我炽热的爱意，我会以萝莉控作为我直到生命终点的标签，我是一个光荣的萝莉控，萝门;4;9;13;18388;0.0007069828148792691
104318;拒绝犹太审美，从你他做起;1;8;9;18388;0.0004894496410702633
104321;我得娶个哪样的才能生个这样的啊？;3;8;11;18388;0.0005982162279747662
104327;拒绝又太审美，从湖北做起脱单doge;1;5;6;18388;0.0003262997607135088
104329;喜欢长相幼态的成年姑娘我可以理解，那身条一看也不是未成年。但这种一眼小孩子的，也能在这玩梗？;2;7;9;18388;0.0004894496410702633
104335;拒絕幼態審美，從澳門特別行政區做起惊喜;1;3;4;18388;0.00021753317380900588
104337;我好像突然明白，当真正美好的东西摆在我面前的时候，破坏欲就不见了。取而代之的是无尽的怜惜保卫萝卜哭哭;1;3;4;18388;0.00021753317380900588
104340;那个怎么白幼瘦审美了标题不说养娃的嘛？你们在想啥;1;5;6;18388;0.0003262997607135088
104351;她是女儿只能是女儿;1;5;6;18388;0.0003262997607135088
104353;拒绝犹太审美，从你他德国做起。;1;7;8;18388;0.00043506634761801175
104356;拒绝又太审美，从外蒙古做起doge;1;7;8;18388;0.00043506634761801175
104359;喊老婆的建议去看心理医生，实话，不开玩笑口罩;1;8;9;18388;0.0004894496410702633
104361;完了我好像当父亲上瘾了，我觉得可爱就像那种父亲觉得自己女儿可爱的的感觉囧完了我踏马是不是有点什么大病囧;1;3;4;18388;0.00021753317380900588
104364;我说一个名custom懂得都懂dogedoge;2;3;5;18388;0.00027191646726125733
104367;我已经在局子路上了，谢谢大家doge;1;5;6;18388;0.0003262997607135088
104369;拒绝犹太审美观从你他做起;1;5;6;18388;0.0003262997607135088
104374;拒绝幼态审美，从你她他做起。;1;2;3;18388;0.0001631498803567544
104377;有点太像小孩了，心理不适了;1;2;3;18388;0.0001631498803567544
104383;很像我看过的一个本子的画风，也是这个年龄的;2;2;4;18388;0.00021753317380900588
104391;这个风格我不太喜欢，可以画到16岁吗？;1;2;3;18388;0.0001631498803567544
104394;完全没有那种欲望，只有保护欲的我正常吗笑哭;1;2;3;18388;0.0001631498803567544
104397;小小的，也很舒服呢;2;2;4;18388;0.00021753317380900588
104404;拒绝你他从我做起;1;2;3;18388;0.0001631498803567544
104406;我先来拒绝幼态审美，从我们山西做起喜欢;1;2;3;18388;0.0001631498803567544
104411;拒绝幼态审美，从湖南做起脱单doge;4;2;6;18388;0.0003262997607135088
104416;这，这不对吧，我老弟年纪小，经受不住这种冲击doge;1;2;3;18388;0.0001631498803567544
104418;ai还是有缺陷，牙齿和手指画不好，好多张都是3个手指4个手指;1;2;3;18388;0.0001631498803567544
104420;怪怪的，看作二次元吧，又很真，看作真人吧，又很假。;2;2;4;18388;0.00021753317380900588
104423;这么可爱，一拳下去应该会哭吧？doge;1;4;5;18388;0.00027191646726125733
104425;分全扣我们广西的doge;1;2;3;18388;0.0001631498803567544
104428;为什么你的ai画的那么好看，我的就和屎一样，用的是啥软件;2;2;4;18388;0.00021753317380900588
104431;拒绝幼态审美，从你做起doge;1;2;3;18388;0.0001631498803567544
104438;哥们，不行咱进夜羊社吧，你不去真的屈才了大哭;1;1;2;18388;0.00010876658690450294
104441;所有目光，像我看齐，我宣布个事，我是个萝莉控;3;1;4;18388;0.00021753317380900588
104452;拒绝白瘦幼审美，从苏州、无锡、镇江、南京、南通、扬州、泰州、盐城、淮安、宿迁、常州、连云港做起;1;1;2;18388;0.00010876658690450294
104464;给我女儿看了，她说好看，以后要长成这样。;1;1;2;18388;0.00010876658690450294
104468;拒绝幼态审美，从我们河北做起。doge;1;1;2;18388;0.00010876658690450294
104483;三年学会绘画和三十天学会ai我选三年;3;1;4;18388;0.00021753317380900588
104497;真的很可爱，想养大，每天一定很开心鼓掌，以后有女儿了也这样养;2;1;3;18388;0.0001631498803567544
104500;拒绝幼态审美从山西做起;1;1;2;18388;0.00010876658690450294
104510;苏剑玖White诶嘿magicai开始成熟了妙啊;2;1;3;18388;0.0001631498803567544
104513;应该是漂亮的，为什么有种害怕的感觉;1;1;2;18388;0.00010876658690450294
104517;真的会有小孩子留这么长的头发吗;3;1;4;18388;0.00021753317380900588
104523;doge;1;1;2;18388;0.00010876658690450294
104525;拒绝幼态审美，从我们河北做起微笑微笑;2;1;3;18388;0.0001631498803567544
104528;正常人对幼态度审美真的就停留在审美上，我很好奇发出“拒绝”声音的人当时是怎样的一个精神状态星星眼星星眼星星眼星星眼;1;1;2;18388;0.00010876658690450294
104531;那请问小男孩的一生呢doge;2;1;3;18388;0.0001631498803567544
104568;要是被治愈的一天。这种萝莉娃娃上哪买doge;1;0;1;18388;5.438329345225147e-05
104585;璃梨子科技Officialwatcher今天吃什么胡铁花和他的朋友们摸摸鱼的日常AVIDINTELNimiNoa;1;0;1;18388;5.438329345225147e-05
104592;我为什么要拒绝幼态审美我看的开心的飞起OK;1;0;1;18388;5.438329345225147e-05
104643;我看弹幕有一个说要是自己女儿的话做梦都能笑醒，然后我趁他高兴给他说一句，这是你女儿长大了，跟女婿走了，然后那个女婿是个该溜子。。。。;1;0;1;18388;5.438329345225147e-05
104664;我想要AI绘画，不要图集，找到的AI绘画全部都是开局，开局就要米效果都没有试过就要米;1;0;1;18388;5.438329345225147e-05
104679;拒绝幼态审美，从你们做起范进中奖咸汪布丁丿Pudding;1;0;1;18388;5.438329345225147e-05
104717;某站有不少这样的ai图，而且是。。脱单doge;4;0;4;18388;0.00021753317380900588
104726;拒绝犹太审美，从我重庆做起doge;1;0;1;18388;5.438329345225147e-05
104729;我老婆要是长这样，坐牢我都不怕我爱六花;1;0;1;18388;5.438329345225147e-05
104739;这算25次元？感觉是那三次元图片用Ai处理的;1;0;1;18388;5.438329345225147e-05
104743;别让ai画手;1;0;1;18388;5.438329345225147e-05
104757;现在AI终于会画手了;1;0;1;18388;5.438329345225147e-05
104760;作者关键词;1;0;1;18388;5.438329345225147e-05
104775;AI绘画现在最大的缺点就是手画不好;1;0;1;18388;5.438329345225147e-05
104780;啊啊啊好想和老婆生一个九碗不过岗;1;0;1;18388;5.438329345225147e-05
104811;想要这样的女儿啦，又想找老婆然后生娃;1;0;1;18388;5.438329345225147e-05
104813;拒绝幼态审美，从你他做起脱单doge;1;0;1;18388;5.438329345225147e-05
104818;拒绝幼审美，从广西做起脱单doge;1;0;1;18388;5.438329345225147e-05
104832;求告一下背景音乐，感谢;1;0;1;18388;5.438329345225147e-05
104855;好戳我的xpdoge;2;0;2;18388;0.00010876658690450294
104859;鱼丸烫嘴很刑;1;0;1;18388;5.438329345225147e-05
104881;我的评价是这技术真是充满希望但是又充满绝望，真是前进的车轮上沾满了牺牲者的血迹，去向不知道是否正确的道路。反正我是不会想再画画了，辛苦画半天别人给你来句不如ai，再大的热情也要被磨灭。我运气不错不靠这个吃饭，但是总是有人要靠这个吃饭的。一面被人打击不如ai一面挣不到钱，这怕是跑路要比土木都严重。人类文艺事业真是个迷，也不知道未来还有没有真正意义上的人类艺术（作曲ai摄影ai都出现了，写作ai尚不成熟，但是也是迟早的事）。吃瓜吃瓜吃瓜热吃瓜;85;1485;1570;18388;0.0853817707200348
104967;不知道未来路在哪，我相信ai绘画无法完全替代人类，但是可以替代我。热;7;531;538;18388;0.02925821187731129
104975;在微博看的国外一个画手开直播画画，结果没画完呢被人拿走喂ai了，那人把喂出来的图先发布说是自己的，这不纯出生吗;17;740;757;18388;0.04116815314335436
104993;10年之后还会有人作画吗;83;558;641;18388;0.03485969110289319
105077;幸灾乐祸的人我只能说，绘画已经是人类所有工作里最不容易被替代的一种了，如果绘画也可以被ai替代的话，你想想你们自己的工作;153;1623;1776;18388;0.0965847291711986
105231;我刚刚从novelai吧回来，这技术真的利大于弊。首先，我是用过这玩意的，并且用它跑过图。去看看novelai的贴纸，这软件拯救了多少怨大种甲方。一开始是抱着同情画师的心情去的，回来的时候，真的觉得，tmd活该。多少自信小画手坑甲方，我tmd这辈子就没见过这么卑微的甲方。然后根据我的使用经验来看，ai至少在很长一段时间内，是不可能代替画师的，前提是你水平够，至少能跟得上ai的水平，再不济会画手画脚（ai这个是真的不行）如果都如自信小画手那般，被ai替换掉真的怨不得谁。ai对于很多情况画的并不好，甚至可以说是一团糟。很多情况是，ai跑了整体90分的图，但是某个细节却只有10分，这种情况比整张图70分更令人难受。在处理多人物互动的情况，尤其是有肢体碰撞的那种情况，ai完全可以说是一团糟。并且短时间里看不到有质的变化。ai对竖向图画的比横向图好。横向图经常出现人体结构错误的情况。总之，如果是真正会画画的那类画师，基本上不需要担心ai取代，但是同时，会使用ai将会是画师的基本功。;254;1980;2234;18388;0.12149227757232978
105486;好看是好看但抵制ai作画我也只是个十八线小画手但我也怕我的画被融到ai作图里成为一文不值的一部分;499;4854;5353;18388;0.2911137698499021
105986;乐不出来。只感到可悲。你所看到的美丽作品，其实是人家画师辛勤的心血。可是现在只需要写上AI作画，就完全和人家没有关系了热;13;534;547;18388;0.029747661518381555
106000;AI绘画这种东西我还是觉得自己私底下玩玩就行了，毕竟都是融合抄袭画师的，发视频还标自制多少有点;127;897;1024;18388;0.055688492495105504
106128;首先AI并不是缝合，而是在学习分析像素点分布，成熟后并不会涉及到侵权，因为学习并不需要版权，学习完后它算是真正在自己画，想要抵制AI，目前的法律不适用，AI继续进化的方式是迭代算法，或者更多图片进行学习，其次，认为AI没有创造性，其实不然，不需要猴子创造出莎士比亚，仅仅是创新，AI只需要画出足够的数量，就能做到前所未有的创新，哪怕它的创新率是人的万分之一甚至更多，但数量到了其中必有合适的，惊艳的创新。说这么也不是支持或抵制AI，只是说一点个人理解，不喜勿喷。;140;555;695;18388;0.03779638894931477
106269;到后面反而没有第一张的惊艳感了，属于逆细化了，A老师，快让AI画画粉毛猫男tvdoge;3;269;272;18388;0.0147922558190124
106273;热我那层楼已经吵得不可开交了，我在里面，本人观点就是不希望AI取代人类，工具和取代是两回事，当人们获得工具速度变快的时候，是高兴的，但是当某样工具使徒取代它的时候人们是愤怒的，一个站在高台上的王，是不会允许自己的工具超过自己甚至取代自己，潘多拉的魔盒，被打开了那么现在这些看着AI欣喜若狂的人，终将也会得到这个魔盒“诅咒”现在反噬的人只是不是你罢了，最近已经有Ai辅助编程，现有的有，AI配音，AI画图，AI写作，;44;385;429;18388;0.02333043289101588
106318;感觉现在的情况的话，有点像，画师：一张1000一个周之后取Ai直接来一个：一分钟出图一个月180多人民币，然后画家罢工，Ai懵逼我该学谁的呀？然后再也没有那种惊艳的作品，;87;209;296;18388;0.016097454861866433
106406;只有我一个人觉得应该支付使用素材的版权吗;30;161;191;18388;0.010387209049380031
106437;这种事不画画的就别说了，很简单的东西，我的每一幅画都注入了自己的想法，我赋予这副画我的感情，而ai只是一个冰冷的拼接者。往大了说，这玩意不配叫画，最多叫图。;63;253;316;18388;0.017185120730911465
106501;对绘圈印象真不太好，亲身经历花了钱还得哄大爷，结果出图质量和主页展示的作品不成正比;6;167;173;18388;0.009408309767239505
106508;这种创作过程，应该叫拼画，而非绘画;39;290;329;18388;0.01789210354579073
106548;ai出现以后我目睹了外圈人对底层画师的极大恶意藏狐恨不得用ai将底层画师抹杀干净;26;168;194;18388;0.010550358929736785
106575;怎么说，不论怎样争议都是阻止不了ai进步的我现在比较绝望的是除了ai，ps，cdr，3dmax，ae，pr，ppt，我tm还要多学一个软件而且之后ai兴盛了之后，人人都能简单上手，我还要提高自己美学素养和想象力，而且说不定还要补充排版，颜色搭配等相关知识，woc想想就好困难热热热我前几年就应该努力学习的可恶，果然不能把事情堆到最后做;6;128;134;18388;0.007287361322601697
106582;求绘画过程doge;2;27;29;18388;0.0015771155101152925
106585;这不就是工业化降维打击传统手工业的过程吗？拿鞋举例，现在设计鞋的人并不会织鞋，织鞋这件事交给机械来做，有设计机械的人，维修改良机械的人。以后作画设计将变成工业一样的分工合作，有设计的人，制作工具的人，维护工具的人，和作画有关的动画，插画行业的效率提高，成本降低。创作者只管发挥奇思妙想，其余的都交给工具，创作者可以轻松的驾驭各种风格，降低了学习成本，明显是行业发展的好事。尽管客观上确实损害了“传统手工业者”的利益。;11;162;173;18388;0.009408309767239505
106597;AI不是复制粘贴你们的图。。真的啊。。。AI是一种工具，你们也可以用，如果出现了你们不学习，那么你们才会被淘汰。。。不要倒打一耙，反向抵制。;72;139;211;18388;0.01147487491842506
106670;依旧是那句话：对于还没入职但想要从事绘画方面的人来说，AI绘画简直是灾难，但对于单纯想要好看的画的人来说，好时代来了;3;99;102;18388;0.00554709593212965
106674;啊这，ai输入的都是一些画师的画然后让机器分析的吧，这和抄袭有什么区别热热;7;48;55;18388;0.002991081139873831
106682;以后只有大佬和AI，然后最后只剩AI，艺术就停滞不前了脱单doge;24;94;118;18388;0.006417228627365673
106707;作为一个同时学了画画和计算机的人来说（主业当然是计算机）其实没有必要太过于紧张，虽然确实很多比较差的画师会被淘汰。（比如我的三脚猫水平）第一，其实ai没有强到你们想象的那种强度（当然，如果你说给了关键词能出图也算能取代画师的话那我就没话说了）第二，这玩意最后算出来就是一个函数，他的本质就是一个纯数学的东西（虽然数据量大到一定程度程序员自己都不知道里面是什么样的）所以它在复杂情况下注定是不能取代人工的（起码目前）（毕竟甲方不能和它面对面交流。自然语言识别是单独的人工智能。）第三，能取代画室的原因是因为数据量太大了，而其他的应用场景不可能给他如此大的数据，所以诸如工地，医生这类出错就会产生重大错误的行业是最不容易被取代的。当然对应的就是绝大多数具有大量数据量，同时可以随意试错的行业，相对来说容易被取代。事实上，不知道你们有没有注意到，代码本身就是一个具有相当大数据量，并且允许被试错的行业。藏狐没错在绘画之前写程序的AI就已经出来了，而且是那种你给他一段需求，可以帮你生成全套代码的那种，但是程序员还活的好好的，ai只是作为工具来使用的而已。其原因就是因为AI对实际的需求理解并不会特别的准确。所以说各位，不要太过于惊慌，人相对于机器的重点是能够理解意思，能够根据甲方的需求进行微调，而不是单纯的关键词机器。藏狐;1;24;25;18388;0.0013595823363062867
106709;其实真搞不懂画手们为什么这么恐慌，AI绘画这次轰动这么大，最大的原因是过去绘画的门槛太高了。不是所有人都能拿起笔就可以作画。但现在不一样了。利益相关：网文写手。已经在0门槛的赛道上摸爬滚打很多年了。现在年纪大了，只希望写作AI尽快出现（但估计以机器学习的逻辑原理来看，还差的很远）如果以后写作AI真的成熟，能达到我所希望的那种标准，可以帮忙码字。那我以后只要制定人设、书写大纲、再对细节进行修改修文，就能简单创作出我一直想要写但估计这辈子都没办法写完的庞大故事了。好事啊。创作拼的是什么，是故事、是生活。是热爱。AI绘画再成熟一些，你们这些没有工作室，画不了漫画的画手也可以很简单的个人去画漫画了。设计分镜，AI打底，然后再进行修图。实在违和的部分再上手微操。这不是好事么？为什么要抵制呢？;24;220;244;18388;0.013269523602349358
106734;昨天干翻棋手，今天干翻画手，明天又会是谁？;2;20;22;18388;0.0011964324559495323
106737;把运动逻辑算一下，动画师也失业;14;77;91;18388;0.0049488797041548835
106752;只能说风格不够强烈的画师被ai取代的可能性更大吧，特别是二次元领域同质化比较严重;3;23;26;18388;0.0014139656297585382
106756;其实底层画师不是死了是转行了以后就叫ai修图师了藏狐;2;60;62;18388;0.003371764194039591
106759;ai出来后特色画师更抢手了（6）画画有特点的画师的画很容易分辨，ai是不是抄袭了也很明显;5;19;24;18388;0.0013051990428540352
106765;吵起来很正常，一边是想靠画画为生的，一方是想不靠画师靠ai获利的，最大的原因还是某些当搅屎棍的;2;67;69;18388;0.003752447248205351
106768;快进到ai取代所有职业最后代替人类嗑瓜子;6;18;24;18388;0.0013051990428540352
106775;ai的模仿学习能力极高，但是创新能力较弱，它迅速复制并占领高点的同时会使从业者下岗，于是导致创新力下降，最后只能维持现水平而无进步。;3;18;21;18388;0.0011420491624972808
106779;真的很唉ai作“画”其实就是从网上扒小众画师的作品去融合，侵权不说，真的很寒心;32;106;138;18388;0.007504894496410702
106812;关于ai绘画我一直自认为ai绘画早已是板上钉钉的事了，为什么人们会焦虑，比较于流水线工人被机器替代，人们更讨厌自己长时间的热爱被机器替代，所以大部分的人会抵触ai。但是这也是不可避免的，因为大部分大佬的网站里只要你赞助就可以拿到图，而给ai喂图这一举止也不算商用，只不过更加给ai绘画一个留有充足的理由罢了。而不过谁在刚开始画画的时候，或多或少都会去临摹，但是这期间又有没有授权呢？难道单纯因为ai的快速学习就自卑了？酒香不怕巷子深，就像现在很多厂出牛肉丸里，还是有人愿意花钱去吃手打的，画画也同样如此，毕竟我从古至今未见过哪次守旧派能胜利;5;69;74;18388;0.004024363715466608
106818;哦呼画呗，反正是开源了，这玩意你也申请不了版权，就像网图一样随便被人用，你只是合出来一幅画，这副画跟你根本就没什么关系;7;23;30;18388;0.001631498803567544
106826;这种东西不能叫绘画，应该叫生成;5;54;59;18388;0.0032086143136828365
106832;支持Al作画;39;76;115;18388;0.006254078747008919
106872;AI是个非常棒的工具，它可以大大解放生产力，对于画师非常有用，对普通人也是福音。画师反应大是我们相信科技的便捷便利，但是我们不相信国内市场和某些人的底线，肯定有人拿ai绘画来敛财，而且是没下限。试问类似的围棋ai，你觉得ai能参加围棋比赛去挣奖金的吗？AI绘画不能用做商用，但是肯定没有公司或者个人遵守，这种没底线的行为会要了画师的命。另外不要再说ai绘画过程就是学习绘画啥了，人没画过的它不会画就很说明问题了。;8;71;79;18388;0.004296280182727866
106882;这就是把不知名的画师的画东拼西凑出来的画，仔细看脸部，好多时候都是同一张脸;4;81;85;18388;0.004622579943441374
106887;别的不说，除了爱好者，靠这个吃饭的放现在起码能筛选掉一批自信小同学。内容创作者永远是行业刚需的，但低质量高姿态的是该淘汰的。;1;18;19;18388;0.0010332825755927778
106889;对于我这种外行人来说感觉绘画ai并没有那么厉害，甚至很多画师会在没有灵感的时候让ai出草图让自己提高效率。我是音乐行业的人，ai音乐也已经发展到一定程度了，自动编曲、自动伴奏在几十年前就已经有了，ai编曲也是相当于在“吃”大师的技法，普通人可能觉得好厉害但实际根本达不到设计的要求，圈里人士貌似并没有太大反应，大家只会利用ai提高自己的效率反而方便了行业人士。因为真正懂一行的人才看的明白，ai是没有创造力的东西对自己确实构不成威胁，积极的一面就是对专业人士来说可以提高工作效率，不好的一面就是确实会让一批人士失业;10;70;80;18388;0.004350663476180117
106900;不支持AI但是也不想抵制它，我觉得作为辅助工具是很好的。工具发明出来不是错误的，错误的是某些使用工具的人。同样该抵制的不是AI本身是那些用心险恶的人。还有我觉得如果AI真的能够创新，那我觉得是很恐怖的一件事。;4;23;27;18388;0.0014683489232107897
106905;你们不觉得，就算再抵制也已经是覆水难收么，咱们可以把开发程序的人扬了，难道还有可能把每个计算机上已经下载完的本地的程序全部一一删除么？;6;50;56;18388;0.0030454644333260824
106913;小问题，干机械的表示几年前就被自动化替代了现在在厂里打螺丝呢doge不过马上打螺丝也要被自动化替代了;3;58;61;18388;0.0033173809005873395
106917;好奇，画师们版权意识这么强，可以用一下正版ps吗星瞳疑问;33;65;98;18388;0.005329562758320644
106951;虽然很残酷，但这一代中低层的画师真的成了试验品（牺牲品），ai的成熟已是必然，只希望这方面上面官带人能出面缓缓，让这部分可能失业的人找到出路，怕是就是一锅端，就踹那目前的版权和道德水平，怕是要遭重;1;39;40;18388;0.0021753317380900587
106953;时代巨轮滚滚前进，没有常识的螳螂却妄图挡住它;8;21;29;18388;0.0015771155101152925
106962;我就一句话，艺术圈ai和人类的未来，大伙觉得哪个更有趣？;3;40;43;18388;0.002338481618446813
106966;ai甚至会计算头发落在衣服下的影子响指;16;20;36;18388;0.001957798564281053
106983;我希望普及，我就是想做做galgame练练手，但是画师贵请不起，配音现在人工合成的也不错，可以试着做了doge;2;50;52;18388;0.0028279312595170763
106986;你有没有想过，拯救大冤种甲方是因为现在甲方们还不知道这款项技术，等日后这项技术普及了，甲方知道了，你就失业了;1;11;12;18388;0.0006525995214270176
106989;虽然我不太懂ai绘画，但这和论文抄袭差不多吧？以后不会也要搞个绘画查重，高于百分之十五算抄袭算侵权，画师就根据ai画的基础上修修改改，降重后才敢交稿捂眼;5;38;43;18388;0.002338481618446813
106995;艺考都没过的落榜生路过，我咋开始乐了呢，倒不是幸灾乐祸，以后画画可以让AI画一半自己再改改，给自己的小说画插画，就不用像以前那么费力，也不用考虑出大钱了，以后肯定会有一大堆版权相关的破事，但只要我不盈利，也扯不到我头上脱单doge;3;29;32;18388;0.001740265390472047
106999;评论区的小画手别想太多，ai是人在使用，你们也可以使用，但记住最重要的一点，ai就和花瓣一样是给你提供思路的工具;19;72;91;18388;0.0049488797041548835
107020;其实换个思维来想，AI作画能商业系统化，专门建立一个图库，你用来训练的图，上传后，AI识别出画师是谁，根据你上传的图数量支付版权费，画师就只需要上传自己的画给自己的图生成一个代码，谁使用AI用了他的图就得支付一笔钱，AI产出的图也无法商用（除非签订商用协议），因为产出的同时也被记录了，一旦商用就有被告的风险，然后平台推出个人VIP企业VIP吧啦吧啦的，其实就和现在的素材平台一个逻辑。;4;16;20;18388;0.0010876658690450293
107027;人从这里学习从那里学习然后创作有灵魂ai从这里学习从那里学习然后创作没灵魂抵制剽窃;14;16;30;18388;0.001631498803567544
107042;AI和人类学习的过程是类似的，现在还有其他人的风格，等到AI可以随意开创各种风格的时候才是小画家的末日。AI太抢饭碗了;2;12;14;18388;0.0007613661083315206
107047;就像全自动加工厂制作的包子和手工包子啦，两个都可以吃，为什么要对立呢？脱单doge;4;8;12;18388;0.0006525995214270176
107052;怎么会有人抵制，太好笑了吧，你能力不足不是时代发展，工具更强的过错，ai绘画很强又没有弊端，为什么要给你关了;7;15;22;18388;0.0011964324559495323
107061;我不抵制AI，我觉得有AI辅助，我能更快画完我想画的东西，但我厌恶该软件制作者“擅自把未经授权的图拿去喂AI”这种事。我希望的是有公司能制作一个正经好用的AI，它的训练集图片应该都是有授权的，也可以让使用者在本地自己训练AI完全模仿自己的画风;1;9;10;18388;0.0005438329345225147
107063;现在没看出ai作画怎么样，倒是收割流量挺快吃瓜;2;67;69;18388;0.003752447248205351
107068;同样40r，普通画师顶多给个精度很低的大头（排除亲友无偿等等，就正常约稿），而ai却能生成几十张不同的很好看的插画，虽然有瑕疵但这样一对比我会优先选择ai捏）;2;5;7;18388;0.0003806830541657603
107072;相机发明出来的时候有些人也是这样说的doge;3;8;11;18388;0.0005982162279747662
107076;为什么我会看着看着，有点想哭;1;6;7;18388;0.0003806830541657603
107080;现在从事绘画的年轻人居多，在网络上声音比较大，但是声音大又有什么用呢，想想看高效廉价的ai，再看看你自己，市场会选择谁不用我多说了吧嘘声;4;9;13;18388;0.0007069828148792691
107085;这说明ai的进化比人快的多;53;8;61;18388;0.0033173809005873395
107139;请教一下up，AI绘画作为辅助是趋势嘛？版权一类的问题怎么说脸红;18;5;23;18388;0.0012508157494017839
107176;一旦扯上所谓的AI，就会有争论，但是我个人的想法便是，你们想那么多是干嘛？他现在影响到你了吗？未来尚不确定，谁知道未来会怎样？我活了这么多年，瞎猜测对你来说是没有用的，因为你压根就不知道会不会这个样，老是瞎猜测这些，整天活着不累吗？因为这种事情跟别人吵架不觉得很傻吗？就算你猜测中了，你在这里不满，它就会停止发展吗？你说这种ai在抄人家的图，但是你再抱怨他也不会停止啊？;8;7;15;18388;0.000815749401783772
107186;觉得ai不好不就是觉得ai取代了自己辛辛苦苦画的画了吗，不就是了吗，ai技术成熟之后可以替代，但是很多领域，还是有部分人追求艺术，需要人力的绘画的无语;1;4;5;18388;0.00027191646726125733
107191;其实画手真的不用担心我用过才真心觉得这纯粹是一种苍白的美，哪怕是少数触动我的也离不开“苍白”这个形容，人为绘画更多的是表达某种创造某种情感，那些独特的设定，细节，那种朦胧的感觉是ai所无法拥有的;5;1;6;18388;0.0003262997607135088
107197;我坐着看。毕竟时代比人走得更快更远。我知道了AI画的存在，但我还是会继续画。即使AI会代替我，我依旧会自己创作。更多人担心的还是利益吗？未来有你头晕晕;2;1;3;18388;0.0001631498803567544
107206;我只能说，目前来看受影响的只有只会画头像的;1;1;2;18388;0.00010876658690450294
107208;可不可以专门训练一个画手的AI，再把它们结合在一起;1;1;2;18388;0.00010876658690450294
107210;这样真的一半画师失业吧然后留一半是改ai图的，等ai解决了手等问题九成的都失业了;1;1;2;18388;0.00010876658690450294
107215;现在的问题就是AI是把别人的画撕碎了重新拼一张出来，你想要的画是AI撕碎了无数张画拼出来的，自己用也就算了，你信不信要是不做好准备的话以后会出现画师还没画完有人拿AI绘图直接拿画师底稿去喂AI然后在画师好容易画完画或者卖出去之后没有几分钟就把和画师的画能有8成像的AI画放出来说画师侵权，当然了，这种事要操作起来还要专业人士，但是这确实是一个途径，以及现在画师们反对的就是未经许可拿自己的画喂AI这个行为，你要是所有的喂食都是经过同意的，画师也没话说，问题就是AI想要拼出一张好图是需要大量的优质画喂，那偷窃的行为是势必会产生的，你不能因为AI把画撕的足够碎，碎到你根本不知道这幅画是由几千副画拼起来的就说这和原画师没关系;7;3;10;18388;0.0005438329345225147
107224;我记得最开始是围棋被AI爆杀吧;1;1;2;18388;0.00010876658690450294
107230;我的人生因绘画而起，救赎了曾经绝望的我，我把未来孤注一掷的投入到绘画上。现在想想，我的未来一片黑暗;1;1;2;18388;0.00010876658690450294
107237;比我画的好大哭;2;1;3;18388;0.0001631498803567544
107245;这第一张确实牛逼了;1;1;2;18388;0.00010876658690450294
107247;这是有参考图吗为什么发丝位置都一样;1;1;2;18388;0.00010876658690450294
107257;有没有一种可能，很多画师刚开始描的线稿也没有给原作者付费？我以前也画过一段时间，就没见过谁学习和训练的时候拿的图是付费的。;7;2;9;18388;0.0004894496410702633
107265;拜托，画画门槛一直都在那里，画画是需要练习的，不管是用什么工具，任何人都不是拿起笔就能画的，是需要付出努力大量练习获得的。而且画手们这不叫恐慌，为什么恐慌，我们有ai所没有的东西，叫人脑，我们这是觉得可悲，画画如果能被ai代替，那还谈什么传承？而且ai对于科研技术来说的确是一项突破，是好事，但对于文化的传承来说并不是，而且画画本身就是去体验这个过程，在学画的过程中收获乐趣，其中下的功夫耐人寻味。如果以后一键出图，那么画画很快就会被人淡忘。这是文学与创作的灾难。你说创作拼的是故事，生活和热爱。那么你跟我说，ai哪来的故事，生活和热爱？你可以说ai的创作是创作者的热爱，但是ai绝对没有心，没有感情，因为它只是一个冷冰冰的机器，它是没有脑子的。ai生成的故事是来源于我们，生活也是我们的生活，热爱从哪来？只有画手们，创作者们的热爱。;8;1;9;18388;0.0004894496410702633
107281;有没有可能啊，低学习力的人类总结出来的艺术不值一提，所以被高学习力的ai较早碾压了呢思考;6;1;7;18388;0.0003806830541657603
107302;在諸位還在爭吵AI時，黑白妹的作者已經在用AI做新遊戲了錯的不是AI，是麻煩的大老闆甲方，有了AI只是讓他們能更有效率的提升我們的血壓;4;0;4;18388;0.00021753317380900588
107324;ai绘画怎么搞;2;0;2;18388;0.00010876658690450294
107327;就怕有人拿AI去接稿原神生气;1;0;1;18388;5.438329345225147e-05
107343;很魔幻，刷评论区的时候我不自觉就想到了大刘的小说《镜子》。好吧不是抵制这种AI作画，而是抵制在有AI作画这个前提下去踩真正的爱好者或者真正虚心求教的画师的那些人以及，我单纯觉得AI在绘画方面是不可能取代人类的）;2;0;2;18388;0.00010876658690450294
107350;小画师跟其他行业的“低端职业”还是不太一样的，很多大画师都是从小画师过来的，一点点改变画风画技，以及探讨自己想表达的东西，是要时间的，哪能全靠天赋异禀一步登天呢？ai真广泛取代画师了，人类美术的真正尖端产出就要减少了，除非以后人能把自己脑子里的东西直接变成画。;2;0;2;18388;0.00010876658690450294
107354;抵制AI的原因就是很多没有成长起来的画家，如果中途没有饭吃啊，后续的话就没有足够的图来喂，那现在的大佬可以赚钱。那等现在的大佬老了以后，没有后面继续坚持画画的大佬呢因为中途没有收入，疲于奔波画技没有进步，现在有图喂过几年没有新的图出来了以后，市场上就只剩下那几种了因为没有人在创新AI收不到新图，毕竟人又不是拼图机，成长为大佬也是要有过程的;1;0;1;18388;5.438329345225147e-05
107362;咱就是说支持ai的除了老累还有哪个是学画画的热;4;0;4;18388;0.00021753317380900588
107398;到底谁可以来和我指条明路啊大哭;2;0;2;18388;0.00010876658690450294
107417;说实话有些图画风好棒，有谁知道ai向哪个老师学的吗？;1;0;1;18388;5.438329345225147e-05
107424;我的评价是关我屁事，我又不是画家，天天看个乐子还要看评论区一堆人在那吵，时间会给出答案的;1;0;1;18388;5.438329345225147e-05
107433;带着一股残酷滴的美感，充满时代和命运的气息。ai绘画真的，从理论角度上，帅。我的意思是，艺术不可能被替代，人本来就需要找到艺术的意义，而不是说描绘它的美丽。很多画师是不能代表艺术的，最多是美感。所以，我认为利大于弊。而且它是个工具，用来练手多香。;3;0;3;18388;0.0001631498803567544
107438;为什么最近这么多ai画;1;0;1;18388;5.438329345225147e-05
107441;绘画艺术要为无产阶级服务;1;0;1;18388;5.438329345225147e-05
107447;说实话，如果AI哪天真的学会了创意，学会了发明创造，能力比每个人类都要好，那人类存在的意义是什么？;1;0;1;18388;5.438329345225147e-05
107450;人们真的是害怕AI吗，这件事情的根本还是人与人之间的矛盾。;1;0;1;18388;5.438329345225147e-05
107453;这个画也不包括所以的画，不要一棒子打死了，真正的艺术绝对不可能来自AI。;1;0;1;18388;5.438329345225147e-05
107457;油画、岩彩画、水墨画在旁边笑笑不说话;3;0;3;18388;0.0001631498803567544
107480;呜呜求问bgm，听起来真的太温柔了;2;0;2;18388;0.00010876658690450294
107486;传统的分类器存在无法拟合复杂的数据就是学习度不够深，目前的神经网络是一个能克服学习度不够深的数学模型，AI作画缺点也很明显，就是把最基础，最无聊的一笔一笔画轮廓，上色的部分自动实现了，所以AI的作品风格基本是固定的，它不懂风格的概念，无法做到细节的实现，无法创作精细的画作，不会有内涵，无法对提取的特征分类总结，无法创新，打标的数据集只告诉了它什么样的像素点比较像人物，衣服的样式是大概什么样的，为此它总结出了10000条特征规律，但其实里面可能只有100条符合真实人类的认知。当前的人工智能甚至不能叫人工智能，只是一个分类器，基于明明白白的数学原理，是一个优化度非常高的高阶拟合器，恰巧擅长卷积核运算的电子器件快速发展，才得以实现。深度学习的目的很明确，就是实现隐晦的，复杂的，不明确的，抽象的，非量化的，但从人为验证上又极其简单的规律提取，编程是目标明显的，需要多次沟通需求的，涉及到大量自然语言的，量化的，不可分类的，不可简单人为验证的需求，同时代码本身就符合复用的特点，压根不需要做无用功来拟合多余的特征，深度学习最多做单项深度算法的处理。强人工智能涉及到将有效思考过程具象化，包含大量逻辑学基础，数学基础，符号学基础，信息论知识，要做到这些，需要这些领域的人才共同合作来构建这个框架，而且许多看似简单，但深刻的自然哲学原理我们目前仍未发现，比如哥德尔不完备定理的更深层次解释等，强人工智能可能缺少理论支持，对比上面，编程反而是最微不足道容易实现的一环。;2;0;2;18388;0.00010876658690450294
107489;好兄弟不考虑发展点副业？doge;6;4;10;18388;0.0005438329345225147
107497;这个系列最好，挺优雅有图包就好了赞欣赏你;2;1;3;18388;0.0001631498803567544
107501;很写实，可以以假乱真了。;1;0;1;18388;5.438329345225147e-05
107514;喜欢这个混血能不能给个下载链接大佬;1;0;1;18388;5.438329345225147e-05
107520;更新了，AICosplay以后可以自产COS照片了httpsb23tvBV1nM411P7XJ;1;0;1;18388;5.438329345225147e-05
107522;up给个tag教程呗，我也想画这种超写实的照片画;1;0;1;18388;5.438329345225147e-05
107524;请问这个怎么弄的？;5;0;5;18388;0.00027191646726125733
107530;我只能说66666。我的朋友，你是真正的英雄jpg;2;0;2;18388;0.00010876658690450294
107534;三爷抗住了九回才变性，不愧是三爷打call;1;214;215;18388;0.011692408092234065
107536;飞飞变菲菲了doge;1;118;119;18388;0.006471611920817925
107541;所以大家知道刘关张为啥寝则同床了吧doge;1;13;14;18388;0.0007613661083315206
107547;求把AI绘图20遍的图片男的变美女的关键词借我用用傲娇;1;4;5;18388;0.00027191646726125733
107579;这个视频让我对婚姻有了一丝向往脸红;2;2;4;18388;0.00021753317380900588
107582;关键词是什么？;3;1;4;18388;0.00021753317380900588
107597;别揪着手的问题不放，这画面氛围但已经能比下去大多数画师了，重点是画的还快，我先摆烂了灵魂出窍;93;1404;1497;18388;0.08141179029802045
107691;我的天，第二张图真的好有感觉，如果发到p站可以直接上热榜的那种这是训练的结果吗？;48;1093;1141;18388;0.06205133782901893
107740;很难想象大约20周之前的ai只是笑话10周之前的ai连人有几根手指都搞不清楚今天的ai已经能画出乍看之下还不错的图了（不过经不起细看就是了）;12;607;619;18388;0.03366325864694366
107753;“人类与智能的生命，都在眺望着那洁白的宇宙”;8;634;642;18388;0.034914074396345446
107762;效果很好，缺点就是细节一团浆糊，一些结构和光影错误;68;421;489;18388;0.02659343049815097
107831;很多装置感觉ai还没搞懂是干啥的，还有空间提升，但是这个画风色彩正好在我xp上，对空天范围的画，这个画风最喜欢了;8;239;247;18388;0.013432673482706112
107842;2022年人类开除了画师和autoaim制作者，经过简单训练的ai识别已经达到了绝大多数cheat软件越来越简便的魔导书已经威胁了二流画师的就业所以有这技术为什么不给兄弟们看点想看的dogeai换脸应该早就是归去式，该整新活了不是吗脱单doge;8;86;94;18388;0.0051120295845116384
107851;冷知识，在空间站不允许留长发。因为头发会因为静电变成爆炸头;5;38;43;18388;0.002338481618446813
107857;最离谱的是画出了一种氛围感，意味着光影背景构图人物都要相当得协调得当才行。AI在用知识和理性合理化细节上存在不足，但在想象和感性层面，也许隐隐地超越人类了。;22;107;129;18388;0.007015444855340439
107880;现在都是综合艺术，我们最重要的是训练自己想法，让自己保持不断的思考，在创作方面，无论是音乐、绘画等等甚至是交互、数字、编程还要很多，都尽量要去学习，最好是能做到一人成军，这才能把AI当工具，而不是成为为AI改图的工具人。能做到这些的前提无论自己落魄到什么地步都坚持用心。说实话，如果是想赚钱，那还有很多其他路可以走。;3;48;51;18388;0.002773547966064825
107884;觉得ai其实擅长画的是人们不熟悉的东西。越远离现实生活的越让人震撼。;8;109;117;18388;0.006362845333913422
107894;不扣细节，薄纱几百块那种;10;27;37;18388;0.002012181857733304
107905;三连，原图，懂;1;11;12;18388;0.0006525995214270176
107907;现在开始tag已经变成各个法师的传家秘籍了吗;1;7;8;18388;0.00043506634761801175
107913;构图是真的没话说，大体上看还算过得去，看细节就是一脱答辩;3;6;9;18388;0.0004894496410702633
107924;ai只不过是完成任务罢了不具有人类丰富的情感自然它们不懂艺术品背后的感情;2;4;6;18388;0.0003262997607135088
107927;很多构图完全可以做素材练习用，ai还是很有水平的;1;1;2;18388;0.00010876658690450294
107931;请问有没有“战斗机驾驶舱”相关的关键词？我的naifu老是画不出来“飞行员坐在驾驶舱”这个概念;2;2;4;18388;0.00021753317380900588
107936;ai作画要是能大规模用到动画行业给动画补帧就好了;1;4;5;18388;0.00027191646726125733
107945;啊啊超绝无敌喜欢，就爱这种少女与太空元素的结合;1;3;4;18388;0.00021753317380900588
107953;AI好像很喜欢白毛蓝瞳;2;1;3;18388;0.0001631498803567544
107965;总是刷到群里的大佬捏;1;1;2;18388;0.00010876658690450294
107969;等ai建模也岀了让我看看什么情况doge;1;1;2;18388;0.00010876658690450294
107971;人脸太幼了，很多图甚至人都多余了，只有空间站背景更酷炫笑哭;2;1;3;18388;0.0001631498803567544
107998;有种奇怪的血腥感，是画但好像又不是画，毕竟他是偷别人的作品拼接的，挺恶心的（形容一下，不是“真”拼接。），有种怪核的恐怖感觉;1;0;1;18388;5.438329345225147e-05
108002;你的这个模型的影响明显超过tag了，不是和你相同的模型达不到这个效果;1;0;1;18388;5.438329345225147e-05
108008;说真的，ai在这方面真的牛逼，这几种基本是天花板了;2;0;2;18388;0.00010876658690450294
108014;其实AI学的不错出图又快，可以AI绘画，然后新手画师照着AI出的图进行创作或修改不就能快速的出一个比较好看的成品图;3;0;3;18388;0.0001631498803567544
108024;这用的什么ai？;1;0;1;18388;5.438329345225147e-05
108030;音乐叫什么？脱单doge;3;0;3;18388;0.0001631498803567544
108042;人类放弃一切跟电脑有关的工作和艺术创作吧，给自己留点作为人的尊严;1;0;1;18388;5.438329345225147e-05
108050;图包出了哪位好心人踢一脚脱单doge;3;0;3;18388;0.0001631498803567544
108061;第二张的构图从整体上来看很完善，瑕疵很少啊;1;0;1;18388;5.438329345225147e-05
108067;al是懂白毛的，;1;0;1;18388;5.438329345225147e-05
108077;贤良淑德HK416;1;0;1;18388;5.438329345225147e-05
108080;这个画师是谁啊？;3;0;3;18388;0.0001631498803567544
108091;这AI也不咋地呀，宇航服给画个裙子;3;0;3;18388;0.0001631498803567544
108128;所以AI最令我讨厌的就是画什么东西都要带个人;2;0;2;18388;0.00010876658690450294
108148;ai画手还是不行啊笑哭;1;0;1;18388;5.438329345225147e-05
108158;大佬，能拿来当头像吗？星星眼;2;0;2;18388;0.00010876658690450294
108167;好看顺手分享个调色板调色板红Novelai中实际颜色的效果哔哩哔哩httpsb23tvdFbtQNw;1;0;1;18388;5.438329345225147e-05
108169;白纸卡密我是你的信徒啊（飞扑抱大腿）;1;0;1;18388;5.438329345225147e-05
108177;涩情的日系精灵吃瓜;1;37;38;18388;0.0020665651511855556
108182;加油;1;3;4;18388;0.00021753317380900588
108186;tv害羞老婆又增加了;1;2;3;18388;0.0001631498803567544
108189;继续加油;1;1;2;18388;0.00010876658690450294
108194;这怎么有那么一点像;1;1;2;18388;0.00010876658690450294
108221;我发布了一篇笔记，快来看看吧;4;229;233;18388;0.012671307374374592
108226;本以为是依托答辩，没想到捅了史窝呲牙;9;2179;2188;18388;0.11899064607352622
108236;从答辩变成撒满香料的答辩;8;994;1002;18388;0.05449206003915597
108245;看视频状态微笑呲牙囧呲牙呲牙囧捂脸呲牙辣眼睛囧脱单doge辣眼睛呲牙捂脸呲牙阴险呲牙阴险;5;388;393;18388;0.021372634326734828
108251;答辩Ai和答辩up;1;230;231;18388;0.01256254078747009
108254;天天做答辩都不知道当初为什么关注你了任何邪恶终将绳之以法;1;84;85;18388;0.004622579943441374
108256;up快说软件名，不然终将把你绳之以法doge;4;37;41;18388;0.00222971503154231
108261;小时候看这集社了UP一嘴;3;67;70;18388;0.0038068305416576026
108265;想问一下为啥会在二次猿和卢福宫之间反复横跳，太搞笑了哈哈哈;2;53;55;18388;0.002991081139873831
108269;依托答辩伊沰哒辮;1;77;78;18388;0.004241896889275614
108271;亡灵召唤骷髅骷髅军团骷髅弓箭手骷髅士兵酋长骷髅死亡大法师仙界亡灵;10;60;70;18388;0.0038068305416576026
108282;答辩稀释到一定程度就是香水;2;53;55;18388;0.002991081139873831
108289;我是对答辩心动的屑迪亚哥布兰度啊车上有空丶条叫我初子就行;2;1;3;18388;0.0001631498803567544
108298;这是什么软件做的AI生成;1;1;2;18388;0.00010876658690450294
108304;想看拿这ai办一个抽象画展，然后看艺术学院那帮人去点评;1;21;22;18388;0.0011964324559495323
108306;你们天天玩的都是什么梗啊？一个都看不懂，是我落后时代了捂脸;1;1;2;18388;0.00010876658690450294
108319;骷髅骷髅军团骷髅长弓手骷髅士兵A酋长骷髅死亡大法师仙界亡灵骷髅王sans安兹乌尔恭;1;5;6;18388;0.0003262997607135088
108325;bgm是什么;1;1;2;18388;0.00010876658690450294
108334;积尸气冥界波王者荣耀腾讯游戏穿越火线火影忍者手游情报君和平精英腾讯QQ腾讯幻塔手游;8;6;14;18388;0.0007613661083315206
108343;bgm是什？有的耳熟但想不起来;2;2;4;18388;0.00021753317380900588
108382;Future乄;1;0;1;18388;5.438329345225147e-05
108412;啥软件;1;0;1;18388;5.438329345225147e-05
108483;哥小条看答辩;5;0;5;18388;0.00027191646726125733
108507;这ai画出来的图总感觉在哪看过;1;0;1;18388;5.438329345225147e-05
108509;Al生成或绘画的图越来越好了，但有两个消息，一个好消息和一个坏消息好消息是Al生成图将会成为画师的辅助工具，还有以后二创可能不在需要花钱了坏消息是喜欢抄袭某游戏的公司不再需要请画师了，还有喜欢抄袭的就会越来越膨胀;68;2334;2402;18388;0.13062867087230803
108578;AI画出来的话，那最终版权属于谁？属于AI？属于制作AI的公司？还是属于用AI作图出来的人？还是AI从别的画里一块一块拼起来的那些画师们？藏狐;86;2726;2812;18388;0.15292582118773113
108665;第一，看到有些人说为什么要拒绝它，它明明可以变成很好的画师辅助工具，不努力适应不去学习活该被它取代。这样说吧，这个东西并不是为了成为辅助工具而诞生的，他不是整理参考的，不是帮你拉透视的，不是帮你贴素材的，不是方便你整理思路的，不是帮你模拟光源的，不是帮你寻找灵感的，它是为了一步成图取代画师的。那些热爱绘画的大佬根本不屑用，普通人生成图片不会调整（以后会进化到不用调整就是完美成图），它的进步靠什么呢？靠吞噬你现在可能看不起的那些”曾经或者现在仍在用努力和天赋跟上时代脚步，十年磨一剑，不走捷径“的笨拙的画师们的心血，它不会为此付出任何版权费用。没有人在拒绝它，是它正在可预见的蚕食掉这个行业，而且速度只会越来越快。有的人说不要危言耸听，真正的有创意画工好的画师根本不担心这些，都是些底层画师在跳脚，但是这是基于现在的成图而言的，而几个月前很少人能预测到它的进步会如此巨大，几个月后的它同样是难以预测的。你再能画，你能一秒练习和同步消化吸收成千上万张不同类型的图吗？你再有创意，能保证时时刻刻每分每秒都在吸收最前沿信息的它不会有一天超越你吗？你看过和这个类似的设计（AB），你知道这么设计这么应用能出效果然后你应用在自己的设计中（AC，AD），看上去就是原创设计而且完全不涉及抄袭，你能做到，终有一天它也能做到而且比你快得多躬耕苦练多少载，磨练审美为修图，没有真心喜欢画画的提高审美画技是为了变成AI修图师第二，创新型人才根本支撑不起一个行业的健康生态，努力型人才才是大多数，才是创新型人才赖以生存的土壤转;35;873;908;18388;0.049380030454644334
108701;当车轮来到我们头上，我们才会感受到无力与恐慌吧;39;476;515;18388;0.028007396127909506
108741;画师不是打印机。亲们。真正意义上的画师是美术概念缔造者。ai还拥有科技成本。很多人玩不转。所以就是。没干扰。但是中低市场可能被ai抢走。或者是会用ai的人抢走。如果ai可以减少我的工作量帮我做简单重复工作的话感谢不尽。（比如动画行业。）实现大型美术个人化。;29;421;450;18388;0.02447248205351316
108771;可以，全部ai化吧，ai机器人自动种田自动售卖自动为主人购买日常用品，ai机器人不会疲惫24小时工作，国家只需要每个月给人类发钱养活人类，我们就可以只需要在家躺着等着ai给自己做饭就行。傲娇;51;342;393;18388;0.021372634326734828
108823;虽然咱不是画师，但还是说几句吧。全是个人体验后的观点，说错了请让我删除。它只是个工具，也不是什么智械危机里的归零者AI，更不可能取代大部分画师，产出的图非常单一，有时候你tag拉满也可能产不出你想要的图更有可能多出第三条腿。辣眼睛个人感觉，它最多最多就是部分画师的辅助工具藏狐;15;232;247;18388;0.013432673482706112
108839;冷知识，这都是网络上各种画师的画拼起来的，有时候还能看见某些画手的签名在上面，而且它的要求越多就越崩，有时候可能八根手指甚至六只手没有脚;10;110;120;18388;0.006525995214270176
108850;有本事让ai自己画，从素描书开始学习到人体，画出来的不能跟某一张图叠上而是分别跟很多张图叠上就不算抄跟拼贴加模糊一个意思星星眼;28;309;337;18388;0.018327169893408744
108879;原来这么多人想要不劳而获啊哈哈，画的烂就想着偷别人图是吧;15;287;302;18388;0.016423754622579945
108895;ai绘画就好比查重率100论文一样，基于数据库，就是可怜了那些画师，自己被侵权了都不知道;16;137;153;18388;0.008320643898194474
108912;现在这些网站都有dao版了，大家不要去付费，要让这些dao取画师心血的人知道什么是盗人者恒被盗;8;97;105;18388;0.005710245812486404
108921;等于把一百个人搅碎，一人一块拼成一个人，说这是自己生的。法律也应该进步了;3;95;98;18388;0.005329562758320644
108925;谢谢，这样我以后写小说就可以放AI插画了，如果不涉及盈利的话。;22;113;135;18388;0.007341744616053948
108948;真的，个人不希望AI绘画技术发展起来，，说真的，说的难听点，就是抄袭其他画师，然后东拼西凑自己的程序在那里改的东西，终究是取代不了人类画师，即使好看，那也是东拼西凑的零件组成的残缺品捂脸无语没别的意思没有别的意思，真的没有别的意思，轻点喷热;2;84;86;18388;0.004676963236893626
108951;你猜ai是怎么计算怎么画的，都是抄画师。。这个抄一点那个抄一点热;13;81;94;18388;0.0051120295845116384
108965;有些人可能认为Ai可以代替低水平甚至中等水平的画师，但我觉得，每个人的手法和画画的方式都不一样，Ai再怎么强对真正热爱画画的人们来说也都没有威胁性，虽然会让指望画画吃饭的人变得更困难，但作画中感受到的一点点把作品完成的感受是无比美妙的，没有必要去和AI比较，就像那些大佬说过的，你可以参考别人的手法提升自己，但和强的人比是没有必要的，那只会消磨你的兴趣“继续努力罢，我们努力的程度，还没有到拼天赋的那一步，加油”;13;63;76;18388;0.004133130302371111
108979;ai尤其是二次元的那种ai大量偷盗无授权的作品进行进行裁剪拼贴，很多ai生成图甚至完全可以看出是一位画师的某张画，ai的发展需要更多法律的维护，不然偷盗猖獗，只会将原创者逼上死路，那么人类的绘画也就停留在这里了;9;59;68;18388;0.0036980639547531
108989;感觉自己有电子洁癖，特别排斥ai的画，即便很多作品观感确实很好。;13;56;69;18388;0.003752447248205351
109003;好消息：画师画画更便利了坏消息：侵权也更便利了建议以后AI画作必须附有有训练图包公示;15;48;63;18388;0.0034261474874918425
109019;Ai酱，你猜我往你的图库里放了什么（密斯卡，慕斯卡，米老鼠）;7;37;44;18388;0.0023928649118990647
109028;我反而觉得人们看多了这种量产的精美画作会审美疲劳转而去审丑;5;9;14;18388;0.0007613661083315206
109034;别搞得像ai绘画已经完全超过人类一样，目前来说也就粗看还行，自己玩玩还是足够的，但细节上还是差的太远了，特别是手的部分，画的一塌糊涂，与其担心ai会替代画师不如多去练练自己的水平吧;9;38;47;18388;0.0025560147922558192
109044;我觉得对于我来说，ai作的画可能无法真正表达出创作者脑中的创意，自己画出的在某些方面可能会更好。加上素材库问题。这玩意可能得在看看未来的发现吧。;1;8;9;18388;0.0004894496410702633
109046;说实话，并不喜欢AI自动生成画捂脸;12;30;42;18388;0.0022840983249945617
109060;AI画更像是市面上画师作品的缝合每生成一张就有一位大佬的影子这软件更像是对版权的冲击不管这软件未来怎么样还是希望能向好的方向发展吧;3;29;32;18388;0.001740265390472047
109064;我觉得ai可以根据我的设计帮我完成中期的工作帮我节约视角。但是实际情况是它目前做不到，我知道我要什么只想ai根据我的设计帮我细化，但我把草图传上去以后把关键词输入生成后出来的往往是截然不同的图片，与我的原图关系不大。这个比较适合一开始不知道自己想要什么只有几个关键词的人使用（比如“甲方）。这类工具出现无疑降低了独立游戏制作的门槛。;1;8;9;18388;0.0004894496410702633
109066;我觉得是方便内行，外行拿来用？，我就问外行哪有客源，去哪里接单？怎么抢生意doge;12;8;20;18388;0.0010876658690450293
109079;ai的不是绘画，是从数据库里合成，用的别的画师作品合成，无版权后患无穷，而且ai不会思考，没有感情，用程序代替人思考创作，那要人用什么用，直接人类毁灭，ai统治世界得了;9;35;44;18388;0.0023928649118990647
109092;捏马我破大防，自学四五年小画手。现在出来这个ai取代画师，那我之前算白学了吗？懂了，这就回家种田修仙。（问一下ai生成也是需要图源拼凑吧？这是什么吸血行为啊我趣。）;13;36;49;18388;0.002664781379160322
109106;乐死，有些人有没有上过高中必修4哲学啊？把ai和人比？哲学选择题大脑两字都是错的，必须得写人脑诶？;4;30;34;18388;0.00184903197737655
109111;不懂这样的产物为什么要教大家使用，这不是明摆着提倡使用ai代替绘画吗;13;7;20;18388;0.0010876658690450293
109125;施工单位工程师，因为AI不能坐牢;3;7;10;18388;0.0005438329345225147
109129;劣币驱逐劣币而已，优秀的画师不会被ai取代。被取代的只是那些学几个月画画就想接稿赚钱、不求上进只喜欢商业互吹的网络绘圈的量产小画家罢了。;8;35;43;18388;0.002338481618446813
109138;ai绘画设想：这项伟大的发明将会使大量水平不足的画师背迫放弃绘画现实：用ai绘画自动生成弔图;8;24;32;18388;0.001740265390472047
109147;西困老师的科普音好温柔;1;7;8;18388;0.00043506634761801175
109149;各位画师请放心，除非甲方明确知道自己想要什么，不然呢AI不可能取代画师的脱单doge;4;20;24;18388;0.0013051990428540352
109154;这不仅仅是工作会是否被取代的问题，而是创作真的死了;2;18;20;18388;0.0010876658690450293
109157;现在绘圈大部分画师不也是拼拼凑凑换个衣服一幅画吗？说得好像这些画师比ai能有多少创作能力一样，差不多得了但是ai绘图商用还是算了，自娱自乐就好;1;14;15;18388;0.000815749401783772
109159;当初相机发明出来的时候，也有人说画师会被取代脱单doge;7;14;21;18388;0.0011420491624972808
109167;评价是侵权了東雪蓮流汗;1;17;18;18388;0.0009788992821405265
109170;现在的绘画ai不就是爬虫到处偷素材然后碎尸缝合么，干什么啊，，这种学习方式真的很可笑，不顾及背后画师的心血，不在乎金主花多少钱约稿，无授权全部偷了;2;17;19;18388;0.0010332825755927778
109174;明明就是把别人的血肉绞碎拼成新的五官。，你觉得哪个好？;1;16;17;18388;0.000924515988688275
109176;人类什么时候被取代呢;5;8;13;18388;0.0007069828148792691
109182;以后一定会催生出ai绘图版权猎人的，放心，专门研究你的图是不是用ai生成的，让你交罚款和原作者分成这种好事怎么能放过你呢吃瓜，一旦发现你用ai了而且还没手工修改到让人看不出来，等着交赔偿金吧嗑瓜子;5;15;20;18388;0.0010876658690450293
109188;有什么法律问题？等以后ai绘画发展更成熟了，资本自然会推上去，谁不喜欢一分钟几百张的便宜画师呢？;1;7;8;18388;0.00043506634761801175
109192;有些人到底明不明一旦某一种人工技能只能站在顶尖才能有收益的时候，会让有多少人望而却步，往后大概率就是人才逐渐凋零甚至行业凋零;1;5;6;18388;0.0003262997607135088
109194;对于不爱画画的人，不知道对于爱画画的人等于没吃饭就饱了。;1;11;12;18388;0.0006525995214270176
109198;我想知道怎样才可以训练ai，让它画出我喜欢的画永雏塔菲1883最爱你了;4;5;9;18388;0.0004894496410702633
109204;标题不适建议修改;7;11;18;18388;0.0009788992821405265
109212;这个小男孩是不是网站通过大量人类画作学习出来的，那这样的话AI绘画的基础还是人类啊，如果人类画师被取代的话，AI绘画是不是就停留在现在的程度，不懂AI单纯问一下;3;4;7;18388;0.0003806830541657603
109217;支持薄纱，一些画师没这好还搁这收费贼高滑稽;1;3;4;18388;0.00021753317380900588
109220;男孩？看看吉儿;2;3;5;18388;0.00027191646726125733
109223;主播，第一张图是什么关键词啊喜欢星星眼，想要这张图;1;3;4;18388;0.00021753317380900588
109226;AI画的图一眼就能看出是Al画的看多了有点审美疲劳。;5;11;16;18388;0.0008701326952360235
109243;能画涩图那就太好了喜欢;1;2;3;18388;0.0001631498803567544
109246;动画中割有难咯;1;2;3;18388;0.0001631498803567544
109249;两百年前，蒸汽火车刚发明的时候跑得没有马车快嗑瓜子;8;3;11;18388;0.0005982162279747662
109268;问题不在于人工智能将取代人类的创造力，而在于人们的核心是便利。如果潜在客户需要艺术作品并认为人工智能是1便宜，2更快，3足够好那么一些艺术家将因此失去生计;1;1;2;18388;0.00010876658690450294
109273;至少画头像已经完全不需要约稿了;19;1;20;18388;0.0010876658690450293
109293;就我一个想要第一个图吗囧;2;1;3;18388;0.0001631498803567544
109299;这玩意儿能画本子吗？doge;2;2;4;18388;0.00021753317380900588
109302;可以画18么doge;2;1;3;18388;0.0001631498803567544
109308;道理我都懂。为什么那个男孩的臀部。和腰中间有个大空。;1;1;2;18388;0.00010876658690450294
109313;看这些图完成度还是不错的，应该会有一些“约稿”的画师去用这些图卖钱，尤其适合那些没有分辨能力或年纪较小，画技不成熟又不肯学习的人吃瓜吃瓜吃瓜;1;1;2;18388;0.00010876658690450294
109315;al始终有瑕疵，看着太怪了，第一张图那个腰和腿的位置根本不对，非常失败;1;1;2;18388;0.00010876658690450294
109320;想要开始的图片捂眼;1;1;2;18388;0.00010876658690450294
109332;吃瓜恰一波烂钱，风头过了屁都不是;2;5;7;18388;0.0003806830541657603
109352;最好笑的事有个人发了所谓的一段代码，说关于ai的，然而这里面竟然一个分隔符也没有，看到的时候我笑飞了;1;0;1;18388;5.438329345225147e-05
109364;会不会有人拿al画，然后说是自己画的。微笑;1;0;1;18388;5.438329345225147e-05
109371;这个行业真完善好对于普通画师真的是打击;1;0;1;18388;5.438329345225147e-05
109379;我是在学这条路的人，以后也是准备走这条路，看到这个我有点怀疑自己，看着这个现在在学打基础的自己，有ai可以画，那我现在做的是否有意义，就心里很复杂也不知道怎么表达这感觉;16;0;16;18388;0.0008701326952360235
109406;ai就是串代码，他能有什么坏心思？科技的发展不是原罪，罪在利用科技满足自己贪欲的人。;1;0;1;18388;5.438329345225147e-05
109428;我是第一千条评论;1;0;1;18388;5.438329345225147e-05
109430;话说开局那张图就没发现不对劲嘛？腰和裤子明显不匹配，这是ai画图？说是拼图我都信;1;0;1;18388;5.438329345225147e-05
109434;有些作者绝对不会被替代，因为其个人风格过于明显。比如荒木，比如ZUN;1;0;1;18388;5.438329345225147e-05
109440;这ai是哪个教会的神父编程的藏狐;1;0;1;18388;5.438329345225147e-05
109442;当初柯洁痛哭画师该站出来的doge;2;0;2;18388;0.00010876658690450294
109453;等到哪天，画了一幅画发网上，被人说用的ai吧。那就好笑了害羞;1;0;1;18388;5.438329345225147e-05
109456;一张图缝合十几个角色捏;1;0;1;18388;5.438329345225147e-05
109464;这种AI生成的东西还有版权能控制呢？生成出来后谁知道是自己画的还是AI画的;9;0;9;18388;0.0004894496410702633
109474;我觉得挺好的，十年前大家还在用按键手机，现在不都用着智能手机了么？而且我觉得ai作画威胁不到有质量的画师。这种ai作画应该是不能自定义的，也就是画不出使用者心中想要的样子，最多也就威胁一些作画水平不高收费又比较离谱的画师。很多画师都有自己的作画风格，ai是模仿不出来的，人类的审美ai也很难学习，至少我认为ai作画是利大于弊的。;1;0;1;18388;5.438329345225147e-05
109480;那这样子的话，那些画插画的和那些特别厉害的画师以及专业涉及到这一领域的会不会饿死？;1;0;1;18388;5.438329345225147e-05
109482;所以这玩意如果遇到甲方说这里衣服褶皱改一下眼睛内部细节手指的弯曲细节改一下ai能应付得来吗;1;0;1;18388;5.438329345225147e-05
109484;说实话是个好事，卷剩下的都是艺术家;2;0;2;18388;0.00010876658690450294
109487;重点还是是版权问题，ai调用素描速写书各种允许使用的素材和名画都无所谓，直接把现在人都健在的画师的每一张画甚至私稿搬过去喂ai然后再拿ai绘画来说薄纱画师甚至拿来赚钱是不是有点太过分了;9;0;9;18388;0.0004894496410702633
109508;永远都画不出来本子没多大用;1;0;1;18388;5.438329345225147e-05
109519;着还学个锤子线条小狗难过FukamiNatsuhiko易舒菌;1;0;1;18388;5.438329345225147e-05
109535;我不觉得AI能超过人类，AI通过学习现在的绘画可以快速达到或者超过大部分画师的水平，但是问题就在于，AI可以通过各种元素的堆砌来生产一幅幅作品，AI是辅助而不是创作，脱离人类设定的目标，它并不能从零去创作一副优秀的画作，不知道大家有没有读过一个科幻小说，大致是用超级计算机写诗，以人类语言能写出来的所有的诗歌，都被计算并储存起来了，在它完成后人类写出的任何一句诗句都能在数据库里找到，但是，AI分辨不出哪一句才是有价值的诗句，才是“美”的，AI可以帮助我们去描绘美，但我们仍将继续用自己的眼睛去发现美;4;0;4;18388;0.00021753317380900588
109540;AI可以代替人类棋手，但是AI至今没有代替小说写手。现在的AI画画只是初级，不说只能素材拼凑，而且几乎所有的AI作画都不能细看，只是第一眼看上去漂亮，人体结构经常出现反生理的现象。说AI画画是抄袭，但AI靠的就是大量的数据堆积，然后才能推演。AI能代替人类棋手是因为围棋本身比的就是计算能力，谁能比得过AI？但画画与小说靠的不是计算，或者说要“计算”的东西，比只有棋盘和黑白二子的围棋多太多。所以AI至少几百年内都威胁不到画师的地位，顶多能取代一些低端画师，满足普通人的yy需要，让定制画的价格降一些？不过有实力的画手完全不用担心，因为AI作画绝对比不过找专业画手定制一张画。;2;0;2;18388;0.00010876658690450294
109549;江上对愁眠;2;0;2;18388;0.00010876658690450294
109554;敢用AI接稿，那我就有权利举报AI抄袭微笑;2;0;2;18388;0.00010876658690450294
109567;最近才开始学美术，总觉得未来我要寄捂脸;2;0;2;18388;0.00010876658690450294
109588;拿别人辛苦的成果来喂AI，还想把别人的饭碗踹了星星眼;1;0;1;18388;5.438329345225147e-05
109598;但这就是AI必须的过程啊;2;0;2;18388;0.00010876658690450294
109612;话说西困老师现在能接ai绘画的约稿吗脱单doge;2;0;2;18388;0.00010876658690450294
109616;为啥我弄出来的图是灰色的;1;1;2;18388;0.00010876658690450294
109618;西野七濑？吃瓜;1;0;1;18388;5.438329345225147e-05
109620;有个本地部署的，使用英语代码可以可以自己画，也可以对已有的图片进行修改，重要的是没限制;10;106;116;18388;0.00630846204046117
109631;可以画h的吗dogedoge;7;59;66;18388;0.003589297367848597
109639;前三个都是是异形生成器，第四个才是人类生成器奸笑;1;35;36;18388;0.001957798564281053
109641;第一个不免费啊;4;6;10;18388;0.0005438329345225147
109646;手机可以用吗？;2;3;5;18388;0.00027191646726125733
109652;有没有可能在大数据里找的图片;1;1;2;18388;0.00010876658690450294
109663;有没有以图生图的？;2;0;2;18388;0.00010876658690450294
109666;收费了;2;0;2;18388;0.00010876658690450294
109673;目前最不公平的是ai算法“学习”窃取了的大量画师的作品，这些版权问题谁来解决？被“学习”的画师又何处取证;52;1877;1929;18388;0.10490537306939308
109727;ai的出现动摇了我的对绘画的初心，现在只是为那些苦学多年画手感到悲哀捂脸;34;501;535;18388;0.029095061996954535
109762;说真的有几个画师愿意用ia绘画辅助自己的工作啊，了解一下就知道这完全就是把别人的肉搅碎做出来的人肉包子，但凡有一点有版权意识和底线的都隔应。要么就以合法形式获取输入源，要么现在就别搞这个破东西。一个合法正常的前提都没有还在这讨论讨论星星眼;12;309;321;18388;0.017457037198172723
109776;艺术是人赋予事物予情感，赋予事物予人的意义，可以是以后看到今天画的画想起画这幅画的心情，是可以感受到其创作者给予画的情感与意义。梵高把痛苦和磨难注入予画中，予画以不同于布和颜料搭配的物质的意义。如果有一种科技能从分子层面完全的复刻《星月夜》，我相信它的价值是不会比原品强的。这就是艺术，是AI给予不了的东西，AI创作出来的东西是不被给予情感和意义的，人类自然也无法做到共情。你可以说AI的美图很好看很美，但我觉得是无法与之共情的，也就是说AI画的东西不能称之为艺术。个人观点。;13;142;155;18388;0.008429410485098978
109790;AI绘画不都是剪的别的画师的吗捂脸拼凑的罢了，没了人资源照样枯竭;12;93;105;18388;0.005710245812486404
109803;都是拼装的，应该无法超越顶部画师吧，不过中低端的要受影响;6;79;85;18388;0.004622579943441374
109810;个人观点啊，艺术难道不是经于创作者的感情，想法和能力所表达出来的事物吗？ai有感情么。。;24;66;90;18388;0.004894496410702632
109835;就像是当年摄影取代了一大批水平一般的画家一样，如今的AI绘画也是同样的道理。同样我认为摄影竟然在绘画面前找到自己独特的出路，那么AI的绘图作品也将会寻求到自己独特的艺术性。;5;69;74;18388;0.004024363715466608
109841;嗯嗯，这个话题从年初就开始辩论，现在已经年末了，等取代的时候估计都已经智械危机doge;1;37;38;18388;0.0020665651511855556
109843;一直在讨论版权，著作权毫无意义，应当正视差距，客观面对。而非一直用版权，著作权声讨AI绘画不该出现。就像是当围棋界阿尔法狗出现时，那些棋手在悲叹围棋失去内涵，哀叹棋心不古。不愿面对现实的柯洁被打断了脊梁，曾经领先一代的思想沦为了笑柄；而他的对手积极学习AI的小申成为了新时代的棋圣。绘画AI也是一样，它只是存在就足以击溃一切，哪怕从法律上禁止它存在，学习它的人会远胜于拒绝它的人，使用它的人速度将远超其余人。客观正视AI，利用AI，使用AI，认识到AI的不足，更要认识到自己的不足。市场不会因为你们的一厢情愿而拒绝AI，AI不会因为法律的禁止而不存在。更何况，若是将AI的学习行为判定为非法，那如果我认为一个人学习了我的画风他又是否侵犯了我的著作权呢？I;11;42;53;18388;0.002882314552969328
109855;是艺术吗？个人看法仅代表个人，哈哈哈）一、对于这个问题我们首先需要思考的是什么是艺术？我们从艺术的本质问题出发，艺术生产本身就是经历了一个漫长的过程;3;8;11;18388;0.0005982162279747662
109860;海德格尔认为艺术就是大地跟世界的斗争，它是我们跟虚无混沌的大地搏斗的痕迹，是我们尝试理解世界、表现世界、赋予世界意义的过程，是我们跟世界的互动，从这个角度来看，它就不仅只是一个物品，背后凝结的正是我们人之为人的基本感受和意义。这个过程远不是输入几个关键字弄出一幅好看的画能带给我们的;7;18;25;18388;0.0013595823363062867
109868;都说AI没有情感，但它学习的对象有呀今天是没有逻辑的拼贴，往后学习了人类的思维方式和情感模式之后呢？你视其为工具，那它便是提高效率的工具；你视其为有待进步的主体，那么有一天超越人类也不是不可能。智商可超越，情商为什么不可以？是不可能，还是不情愿？我们可能都害怕有一天不再被世界需要吧doge;4;23;27;18388;0.0014683489232107897
109873;我觉得有点像工业化对于手工业者的巨大打击，打击十分沉重，但肯定不会是致命的。;1;8;9;18388;0.0004894496410702633
109875;我看过一篇文章题目是《创造在人工智能的挑战下》里面有几句话我觉的真的很有道理“如果诗人写下的只是一段段分行的苍白语词，只是自动复制的语言和造作叠加的诗意，那么被人工智能超过并不为奇。而真正有内在动力与激情的创造，真正以人的全部主体性去和主题碰撞才写出来的诗句，是永远不会被取代的。”“一件优秀的人工智能作品的意义，不是让之前无数的人类作品变得黯然失色，相反，它让我们重新看清了其背后那些世代经典的真正价值。人类投注于创作中的爱与智慧、丰富的情感与充沛的精神、对生命的观照与超越生命之上的追求，值得我们永远珍视，值得一代又一代创作者们接力精进。越是有人工智能的同行相伴，越要如此。创造永无止境，人工智能只会让人类对创造力的探求之路走得更深更远。”;13;19;32;18388;0.001740265390472047
109891;人工智能绘画在某些方面可能会比人类画师更加优秀，比如精确度、速度和重复性。但是，人工智能绘画仍然有一定的局限性，比如缺乏创造性和主观性。所以，人工智能绘画不会完全取代人类画师，而是与人类画师共存和发展。fromCHATGPT;1;11;12;18388;0.0006525995214270176
109896;艺术的价值还在于创作的过程，也许AI会抢掉艺术家的饭碗，但永远取代不了艺术;1;2;3;18388;0.0001631498803567544
109898;ai相当于把别人的作品蹂躏打碎然后融合在一起没有一点人类的感情当然某些人可能就喜欢这些毕竟能绕过著作权;8;4;12;18388;0.0006525995214270176
109907;其实普通画师完全可以同时担任ai画师，ai画画门槛真的低所以应该不会有专门的ai画师，只是会出现用ai的画师，我也挺讨厌会用ai就自称画师的家伙另外，我觉得ai绘画包括生成试ai真的就是科技树点歪，现在明明就已经供过于求了，况且画师的作品并不是什么消耗品，我只能说他是资本的工具，并不是我们的工具。;2;4;6;18388;0.0003262997607135088
109910;天梯断了，没有人生来就是强者，本来那大部分普通画师晋级的希望都很渺茫的，你搞这个出来压根就没有普通画师会坚持。可能一百万个人会出一个大师但是你已经把那一百万个人给毙掉了，美其名曰他们不是“大师”画的不如AI，直到有一天他们发现AI的画不再进步了，在那破口大骂大师都去哪了，怎么不来当肥料了。doge;3;6;9;18388;0.0004894496410702633
109914;ai其实就是利用大数据收集并且肢解了别的画手的作品然后拼接到一起;5;7;12;18388;0.0006525995214270176
109924;ai构筑的是虚假的未来，由人所书写的，才是属于人的未来doge;2;4;6;18388;0.0003262997607135088
109928;艺术是要投入感情的，机械的拼贴没有灵魂;1;5;6;18388;0.0003262997607135088
109934;我觉得Ai绘画不够成熟。当有一天，ai技术发展到可以利用生活中的素材，加以一定的算法与随机性时是不是就兼就兼具了人的特性。人的灵魂本质上也是信息与算法。人的的思维是不是大脑对外界信息的处理加工，并带这一定的随机性？人类太自信了，总以为自己的思维，灵魂是不可替代的，可是灵魂灵魂真的存在吗？无论是你的感性还是理性会不会都是大脑算法的结果？;1;3;4;18388;0.00021753317380900588
109936;时代进步，未来的AI只会越来越强大，取代各个职业只是迟早的事，但传统行业总能找到出路;3;3;6;18388;0.0003262997607135088
109940;Ai从来不会绘画，他就是整合。但，从他出现的那一刻，必然干掉无数人的饭碗，因为他效率太高了;1;3;4;18388;0.00021753317380900588
109944;今天你不为画师说话，那明天ai窃取你的工作的时候也不会有人给你说话;15;3;18;18388;0.0009788992821405265
109960;AI绘画的感受就给我一种，就算你不会画画，但是你懂得说出关键词，懂得修改这个词汇，修改图中啊，不正常的地方，就能创作出一个完整的堪比学习了好几年绘画大佬的图，基本上一个小时就能搞定。;3;1;4;18388;0.00021753317380900588
109975;AI是商业不是艺术;6;1;7;18388;0.0003806830541657603
109982;如果有一天画手们的思想被AI取代了，AI又从哪里偷东西出来画呢？;1;1;2;18388;0.00010876658690450294
109984;每个人的画风都是不一样的。AI是不能取代的。;1;1;2;18388;0.00010876658690450294
109989;画画是为了啥？为了自己开心呀，你不开心为啥要入坑绘画圈？就像你玩游戏玩个破解版，通关后你还想玩吗？你不就是为了想要那种游戏过程吗，不就是想要别人边上来一句“卧槽牛逼”吗？画画同理，虽然说着粗俗了点。我学过一年绘画，虽然真的累，但是你在比你画的差的人面前指点江山时候是真的爽;7;4;11;18388;0.0005982162279747662
110000;我感觉画师在学习过程，也是学习各个大师等的作品，再通过人的大脑消化吸收。ai是用人工智能的逻辑去学习，版权会限制学习这个行为嘛。;2;5;7;18388;0.0003806830541657603
110003;不要说ai绘画了，ai写作被搞出来那就真的完蛋了。;2;1;3;18388;0.0001631498803567544
110006;可以看一下亚食人的视频对于大公司来说版权都不是问题，未来有点像现在的电子配音，反正走一步看一步，真有那天我可能只能转行了笑哭BV1y14y1572C;6;1;7;18388;0.0003806830541657603
110016;先用ai我再改细节脱单doge;1;2;3;18388;0.0001631498803567544
110020;ai只会拼合，它的创造力是暂时比不上人类的，再说画画本来就是我的爱好，想画啥就画啥的快乐可不是ai能给的。脱单doge脱单doge;1;1;2;18388;0.00010876658690450294
110024;其实之前也和噢朋友讨论过一点主要是拿你的画去临摹（训练）ai这事到底咋算临摹你的画不能算侵犯你版权吧人的临摹咋算其实这个我还是不太懂;1;1;2;18388;0.00010876658690450294
110032;我看不懂人工与AI的差距，可能是我没有艺术细胞吧，我觉得如果不犯法AI也挺好的，有效率，而且不会出现很多瑕疵;1;0;1;18388;5.438329345225147e-05
110040;其实我一直有个疑问，假如ai绘画水平已经可以以假乱真了，然后有一个公司，用AI语音，图像把这个AI画手包装成真人，然后他的作品发布到网上，很多人都觉得好看，甚至思考这其中的内涵，那他到底是有艺术内涵还是没有艺术内涵？在你不知道他是ai画手的情况下，我记得以前好像看过一个类似的电影;6;0;6;18388;0.0003262997607135088
110048;这个问题，之前新闻传播领域也就机器人写作会不会取代记者探讨过，答案肯定是不会的，没有人，AI如何才能写出稿子或者画出来画？;2;0;2;18388;0.00010876658690450294
110086;看你对艺术的定义，艺术如果是探寻未知的新美感，AI这种基于大量学习的估计很难做到;1;0;1;18388;5.438329345225147e-05
110097;只提一个点，ai绘画的水平已经相当高了，大概七成的画师比不过ai;2;0;2;18388;0.00010876658690450294
110104;抄袭来的艺术是艺术吗微笑;1;0;1;18388;5.438329345225147e-05
110106;关键是普通人需要艺术吗;1;0;1;18388;5.438329345225147e-05
110118;ai也不能精准锁定风格，再说画出来市场买不买账又是另一回事;1;0;1;18388;5.438329345225147e-05
110155;打call;1;3;4;18388;0.00021753317380900588
110157;这个手指是治不了了吗;2;3;5;18388;0.00027191646726125733
110160;ai动不动就多指怪笑哭;2;3;5;18388;0.00027191646726125733
110165;自从听说AI画手很惊悚后，每次再看我的第一关注点都是手笑哭;1;1;2;18388;0.00010876658690450294
110167;自从看了这绘画之后我发现我的网盘不够用了;1;1;2;18388;0.00010876658690450294
110171;最后一张图六根手指头;1;0;1;18388;5.438329345225147e-05
110180;周瑜可能性转，但他那举起的手不可能放下doge;14;1045;1059;18388;0.05759190776593431
110195;每次AI无论画什么，只要是个人，都会画变性笑哭;10;655;665;18388;0.036164890145747225
110206;我删掉了喉结，我删掉了X8doge;5;404;409;18388;0.02224276702197085
110212;只有我一个人注意到越到后面手指越扭曲吗笑哭;1;165;166;18388;0.009027626713073745
110214;周瑜也许会骗人、会性转、甚至会（自行脑补doge），但是，他？她？高举的手永不会放下（声嘶力竭）;1;87;88;18388;0.004785729823798129
110225;可不可以用“被ai画多少次后变性”作为考量一个男人相貌中性化的程度思考;1;4;5;18388;0.00027191646726125733
110227;我删掉了坤吧;1;3;4;18388;0.00021753317380900588
110235;我记得这位大兄弟好像B站有号doge;2;1;3;18388;0.0001631498803567544
110265;ai喂了太多的男同图笑哭;6;1910;1916;18388;0.10419839025451381
110272;越离谱的越正常，越正常的越抽象辣眼睛辣眼睛辣眼睛;4;1318;1322;18388;0.07189471394387643
110277;《关于这种视频已经看了一堆，然而我还是不知道用的什么软件这件事》;11;509;520;18388;0.028279312595170764
110289;就是说为什么这么多性转，而且一股子本子风格，这ai不对劲确信;1;255;256;18388;0.013922123123776376
110291;倒不觉得用ai有什么，还挺希望出现更适合绘画人使用的便捷ai辅助工具。但是ai画配群青这首歌是否过于讽刺了一点笑哭，不知道蓝色时期是讲关于绘画的迷茫、热情和努力的吗？;6;205;211;18388;0.01147487491842506
110298;这个ai的男生画风，怎么跟我平时看的漫画那么像doge;5;97;102;18388;0.00554709593212965
110304;画师才是ai绘画真正的受害者，而使用的人是加害者;64;224;288;18388;0.015662388514248424
110372;最近dy里面好多用这首歌，到处都听见，虽然很开心自己的歌被更多人知道但真的很讨厌什么视频都这首歌有种烂大街的感觉，而且大部分人都不知道这首歌的意义只是跟风用了这首歌，一点开这种ai基本都是配的群青，这种跟风的人甚至连群青的作者都不知道，真的会谢tv流泪tv流泪tv流泪;14;86;100;18388;0.005438329345225147
110387;它还是那样识别不出男女，我哭死;1;28;29;18388;0.0015771155101152925
110389;用哪个软件生成ai后的画面？;2;20;22;18388;0.0011964324559495323
110393;AI绘图配乐《群青》，绷不住了无语无语;1;21;22;18388;0.0011964324559495323
110396;飞鱼的腿哈哈哈哈;1;0;1;18388;5.438329345225147e-05
110399;林楠呱我要笑死了;1;0;1;18388;5.438329345225147e-05
110410;BGM是什么？;1;1;2;18388;0.00010876658690450294
110420;好想伦达啊;1;0;1;18388;5.438329345225147e-05
110436;感觉每个ai的水平都不太一样啊，现在感觉qq上的画风最好看，希望能多发展几年，尤其是手，看看有没有机会攻克这个难关，每个平台都走出自己的绘画风格，以后收费也不碍事，有的图真的好美啊星星眼;1;0;1;18388;5.438329345225147e-05
110446;这么看，我的还不错;1;0;1;18388;5.438329345225147e-05
110460;我已经有很多遍都是羞涩猛男了真的难绷，前两次弄出一种教堂圣女的感觉（？）然后我哥，超，他弄出来是御姐保卫萝卜哭哭;4;10;14;18388;0.0007613661083315206
110465;hhh心情不好的时候就看看Ai绘画喜极而泣;1;1;2;18388;0.00010876658690450294
110467;什么软件呀;1;0;1;18388;5.438329345225147e-05
110479;简单说一下为什么没眼罩，我用了各种单边眼罩的词，结果每次都会识别出口罩出来就很无语，然后我就放弃了这个要素。凯亚的蜜色皮肤我有点疑惑该用什么关键词，所以只用了blackskin这个词。我打了kaeya（genshinimpcat）的关键词，像钟离估计是因为后面的genshin这个词，钟离，你不愧是最出圈的原神角色。藏狐;7;1294;1301;18388;0.07075266478137916
110487;其实ai都是把画手的画裁剪粘贴，抖音上有人说自己的画被搬到素材库里了捂脸（可能与视频无关，只是突然想到这件事）;11;571;582;18388;0.03165107678921036
110500;所以ai绘画只是把相关元素按照模板拼凑成一副画，可以这么理解吧;130;285;415;18388;0.02256906678268436
110631;谁说的唐三版钟离啊啊啊啊卧槽笑死我了;1;74;75;18388;0.00407874700891886
110633;其实还是挺好看的脱单doge;1;59;60;18388;0.003262997607135088
110636;求图可以嘛qwq，中间有几张感觉好好看保卫萝卜哇保卫萝卜哭哭保卫萝卜哭哭（打扰到就会删掉的保卫萝卜哭哭;2;12;14;18388;0.0007613661083315206
110639;感谢up提供的链接，让我这穷人体验了AI绘画功能，还有这个网站是个人搭建的吗？跟官网有什么区别？吃瓜;1;7;8;18388;0.00043506634761801175
110641;这个AI在哪找哇保卫萝卜哭哭;2;5;7;18388;0.0003806830541657603
110646;桑桑桑塔纳;1;1;2;18388;0.00010876658690450294
110658;我生成的全是女孩子保卫萝卜哭哭保卫萝卜哭哭;2;0;2;18388;0.00010876658690450294
110662;BGM是什么星星眼;2;0;2;18388;0.00010876658690450294
110665;什么软件啊;2;0;2;18388;0.00010876658690450294
110668;up给的关键词是什么，能发一下嘛？;5;0;5;18388;0.00027191646726125733
110677;用的啥软件呀保卫萝卜哇;2;0;2;18388;0.00010876658690450294
110681;后边四个都好看诶;3;0;3;18388;0.0001631498803567544
110685;笑吐了;1;0;1;18388;5.438329345225147e-05
110687;扉间哼此等弱小的宇智波，老夫都不需要用手doge;3;345;348;18388;0.01892538612138351
110691;草柱间和斑像情头;1;263;264;18388;0.014357189471394388
110693;龙兜大部分ai作画都挺可爱;4;70;74;18388;0.004024363715466608
110698;污污污污污，王晓婷，霸体，辛辣天森，，，，哇嘞哇嘞哇佩恩，卡密哒，辛辣天森哇啊啊啊啊啊啊啊啊，挑战卡密本身就是，无谋，胜负已分，，胜率1145场9810，;1;69;70;18388;0.0038068305416576026
110701;有没有一种可能ai是根据搜索总量来画的也就是说搜索更多的是猫或者猫耳在座各位不反思一下吗？吃瓜吃瓜吃瓜;4;46;50;18388;0.0027191646726125733
110706;今天17，祝自己生日快乐;1;38;39;18388;0.002120948444637807
110708;美女，你想象一下几年后你相亲结婚了，你老公并不是你喜欢的人脾气暴躁，孩子也不听话学习又差，生活压力压得你喘不过气来，你想离婚但因为孩子还小，这时候你就会后悔没有认识我兄弟三七二付;2;28;30;18388;0.001631498803567544
110712;AI图手永远都是那么奇怪，七根手指要不就是4根手指犯这种错误？;2;9;11;18388;0.0005982162279747662
110718;没看完视频，预言一波最后的是超哥对不doge;1;4;5;18388;0.00027191646726125733
110772;你家的这个ai是不是喜欢猫猫;1;0;1;18388;5.438329345225147e-05
110794;我焯仙人兜所以为啥ai画的仙人兜每次都这么好看doge;1;0;1;18388;5.438329345225147e-05
110801;问一手音乐doge;1;0;1;18388;5.438329345225147e-05
110827;涩了;7;85;92;18388;0.005003262997607135
110835;再多来点;3;29;32;18388;0.001740265390472047
110840;完了ai会画手了;3;6;9;18388;0.0004894496410702633
110844;已热词系列三连求tag脱单doge;3;6;9;18388;0.0004894496410702633
110851;AI是会画泳装的喜欢doge;1;2;3;18388;0.0001631498803567544
110853;不够瑟;1;2;3;18388;0.0001631498803567544
110855;求图脱单doge;1;2;3;18388;0.0001631498803567544
110858;我去ai整出来的手是真不敢看笑哭笑哭;1;1;2;18388;0.00010876658690450294
110860;为什么不弄个永久链接长期更新呢脱单doge;1;1;2;18388;0.00010876658690450294
110862;请问有专栏吗？想拿图片做壁纸。崩坏3吃饭团;2;1;3;18388;0.0001631498803567544
110865;可爱;1;1;2;18388;0.00010876658690450294
110867;喜欢打call;1;1;2;18388;0.00010876658690450294
110869;隔着屏幕都能闻到青春的气息;1;1;2;18388;0.00010876658690450294
110871;喜欢;1;1;2;18388;0.00010876658690450294
110873;UP主加油看好你噢;1;1;2;18388;0.00010876658690450294
110875;给心心;1;1;2;18388;0.00010876658690450294
110877;关键词是什么;1;0;1;18388;5.438329345225147e-05
110879;可以，点赞了，那两个圆圆的东西没有了星星眼;1;0;1;18388;5.438329345225147e-05
110881;up能发个专栏吗;1;0;1;18388;5.438329345225147e-05
110885;你这个手为什么比其他ai画的好不少，虽然还是不自然;2;0;2;18388;0.00010876658690450294
110888;咋提高画面精细程度的;1;0;1;18388;5.438329345225147e-05
110890;ai什么时候才能学会画手啊;1;0;1;18388;5.438329345225147e-05
110892;好好看dogedoge;1;0;1;18388;5.438329345225147e-05
110894;真不错;1;0;1;18388;5.438329345225147e-05
110896;好美星星眼;1;0;1;18388;5.438329345225147e-05
110898;热词系列知识增加热词系列好活;1;0;1;18388;5.438329345225147e-05
110900;喜欢喜欢喜欢;1;0;1;18388;5.438329345225147e-05
110903;真不错;1;0;1;18388;5.438329345225147e-05
110905;网盘搞起来;2;0;2;18388;0.00010876658690450294
110908;很美，爱了;1;0;1;18388;5.438329345225147e-05
110910;打call;1;0;1;18388;5.438329345225147e-05
110912;加油;1;0;1;18388;5.438329345225147e-05
110914;不错;1;0;1;18388;5.438329345225147e-05
110916;加油;1;0;1;18388;5.438329345225147e-05
110918;好看好看死了;1;0;1;18388;5.438329345225147e-05
110920;超真实除了手脱单doge脱单doge脱单doge;4;95;99;18388;0.0053839460517728956
110925;看这些才知道那些汉服模特修图有多重，仙女都是科技弄出来的;5;78;83;18388;0.004513813356536872
110931;确定不是真人拍的？AI都到这地步了，真人机器人也不远了嘛滑稽;7;39;46;18388;0.0025016314988035677
110939;up组织一下对素材的手进行人工标记，训练针对性模型撒;2;27;29;18388;0.0015771155101152925
110942;真的不是照片吗喜极而泣;3;20;23;18388;0.0012508157494017839
110946;科技发展的太快了吃瓜;5;17;22;18388;0.0011964324559495323
110952;以前的都是有容，这期好像都是有平天下大志的doge;1;12;13;18388;0.0007069828148792691
110954;ai这手指是不是被动画片影响的啊？;1;11;12;18388;0.0006525995214270176
110956;现在有的美颜p图就是朝着这种效果吃瓜;2;10;12;18388;0.0006525995214270176
110959;咱就是说，这是up你女装的照片吗？是不是修修改改后拿出来说这是AI绘画的图？dogedogedoge多发点，路过的人爱看doge;1;10;11;18388;0.0005982162279747662
110961;up主这是拿自己女朋友的照片出来骗人吧保卫萝卜白眼;1;9;10;18388;0.0005438329345225147
110963;这是什么软件？想养一个，以后闲了，让它天天画给我看滑稽;1;7;8;18388;0.00043506634761801175
110966;好真实的效果啊，第一次见这么真实的国风，up考虑出教程嘛，关注了脱单doge;6;7;13;18388;0.0007069828148792691
110973;希望哪天游戏角色能按这个标准来吧，到时候就真的不需要女朋友了;1;5;6;18388;0.0003262997607135088
110975;与其说是画更像照片;1;4;5;18388;0.00027191646726125733
110978;能不能生成那种图片？滑稽;2;4;6;18388;0.0003262997607135088
110981;希望可以放一个阿里云盘，百度太慢了脱单doge脱单doge脱单doge;5;4;9;18388;0.0004894496410702633
110987;笑哭今天刚刚回上来一个币给你了。咱是体面人不白嫖。就冲你直接放链接。咱也不含糊;1;4;5;18388;0.00027191646726125733
110989;ai会画手了笑哭;1;3;4;18388;0.00021753317380900588
110991;请问需要什么级别的显卡，这些脸自动形成的吗;3;3;6;18388;0.0003262997607135088
110998;加油;3;3;6;18388;0.0003262997607135088
111003;竖屏有木有做手机壁纸笑哭三连支持一下;1;2;3;18388;0.0001631498803567544
111005;迅雷云盘下好后怎么解压缩失败？（手机）;3;2;5;18388;0.00027191646726125733
111010;有些衣服是真的好看啊打call打call;5;2;7;18388;0.0003806830541657603
111022;给个图包我当我电脑壁纸用;1;1;2;18388;0.00010876658690450294
111025;up请问如何将一张自己生成的脸应用于多个图片里呢;1;1;2;18388;0.00010876658690450294
111028;还是不自然，不过要求不高看看也还行。;1;1;2;18388;0.00010876658690450294
111031;我要失业了doge;5;1;6;18388;0.0003262997607135088
111041;希望出教程讲解一下，还是不太会初音未来V4C五周年纪念暗中观察;1;1;2;18388;0.00010876658690450294
111046;可以可以，每个脸感觉都不太一样，挺好的;1;1;2;18388;0.00010876658690450294
111048;能不能白票一下软件的教程。;1;1;2;18388;0.00010876658690450294
111050;al绘画在哪弄哈;1;1;2;18388;0.00010876658690450294
111052;以假乱真;1;1;2;18388;0.00010876658690450294
111064;用的是什么模型？;1;0;1;18388;5.438329345225147e-05
111066;大佬发个提示词跟反义词啊脱单doge;1;0;1;18388;5.438329345225147e-05
111068;有没有神秘代码;1;0;1;18388;5.438329345225147e-05
111070;问一下up，放大到4k是用什么算法的;1;0;1;18388;5.438329345225147e-05
111072;up能不能分享一下gufeng的lora模型，三连已奉上脱单doge;1;0;1;18388;5.438329345225147e-05
111074;用的那个模型和LoRA啊;1;0;1;18388;5.438329345225147e-05
111076;这个是用的什么模型啊？;1;0;1;18388;5.438329345225147e-05
111078;链接在哪;1;0;1;18388;5.438329345225147e-05
111080;用什么软件画的呢？;1;0;1;18388;5.438329345225147e-05
111083;可以训练画那种画吗？滑稽;1;0;1;18388;5.438329345225147e-05
111087;up是怎么做到都是一张脸的呀tv大哭;2;0;2;18388;0.00010876658690450294
111090;这是画的？;1;0;1;18388;5.438329345225147e-05
111092;有模型包？;1;0;1;18388;5.438329345225147e-05
111094;这用的是什么模型;1;0;1;18388;5.438329345225147e-05
111096;我来点第2000个;1;0;1;18388;5.438329345225147e-05
111098;求模型参数和prompt;1;0;1;18388;5.438329345225147e-05
111102;请问是什么模型啊？;1;0;1;18388;5.438329345225147e-05
111105;我好奇这个只给了哪些指令。可以用中文去添加指令吗？;1;0;1;18388;5.438329345225147e-05
111107;用的是哪个模型，我也跑个试试doge;1;0;1;18388;5.438329345225147e-05
111110;UP是用StableDiffusion的吗，可以分享下模型么脱单doge;1;0;1;18388;5.438329345225147e-05
111113;哪个平台的AI呀;1;0;1;18388;5.438329345225147e-05
111115;用的是什么模型啊？delicate？;2;0;2;18388;0.00010876658690450294
111119;厉害了，有些图片如果不告诉我这是AI做的，我都以为是照片笑哭;1;0;1;18388;5.438329345225147e-05
111121;有原图不脱单doge;1;0;1;18388;5.438329345225147e-05
111123;所以有什么用可以赚钱么，？;2;0;2;18388;0.00010876658690450294
111132;我怀疑是真人;2;0;2;18388;0.00010876658690450294
111137;这是电脑自己做的图加渲染吗，好奇;2;0;2;18388;0.00010876658690450294
111142;可以给个下载链接么？三联了;1;0;1;18388;5.438329345225147e-05
111145;请问一下软件的具体名字叫什么啊脱单doge;1;0;1;18388;5.438329345225147e-05
111147;这是一个照片让ai生成画，还是关键词？;1;0;1;18388;5.438329345225147e-05
111156;很真实又很假是怎么回事。。。;1;0;1;18388;5.438329345225147e-05
111158;这是用sd做的？;4;0;4;18388;0.00021753317380900588
111163;已三连，你懂的脱单doge;1;0;1;18388;5.438329345225147e-05
111166;照片，ps滤镜，蒙尘与划痕，大概出来这么个效果;3;0;3;18388;0.0001631498803567544
111170;无法解压射手座好家伙;11;0;11;18388;0.0005982162279747662
111182;6啊;1;0;1;18388;5.438329345225147e-05
111184;迅雷云盘的密码是多少;1;0;1;18388;5.438329345225147e-05
111186;什么时候生成视频;1;0;1;18388;5.438329345225147e-05
111190;这些人的脸是真人脸来的吗;1;0;1;18388;5.438329345225147e-05
111192;AI修图？;1;0;1;18388;5.438329345225147e-05
111195;novelai？？还是stableDiff？;1;0;1;18388;5.438329345225147e-05
111197;这确定不是照片？;2;0;2;18388;0.00010876658690450294
111200;这个脸还是可以得;1;0;1;18388;5.438329345225147e-05
111202;有tag必须要点赞投币;1;0;1;18388;5.438329345225147e-05
111204;UP求模型;1;0;1;18388;5.438329345225147e-05
111206;有没有模型呀？呲牙;1;0;1;18388;5.438329345225147e-05
111208;毫无真人痕迹;3;0;3;18388;0.0001631498803567544
111212;黄种人有那么白吗doge;1;0;1;18388;5.438329345225147e-05
111214;请问可以分享一下tag吗？;1;0;1;18388;5.438329345225147e-05
111216;这是用的什么模型和lora？真好看星星眼;1;0;1;18388;5.438329345225147e-05
111218;坤坤失去了他的坤坤doge;13;2710;2723;18388;0.14808570807048074
111232;没错，你们是玩过瘾了，可能你们会感觉很好啊，可是你有没有想过，城市在分崩离析你有没有听见孩子们的悲鸣？你未曾注意阴谋得逞者在狞笑。你是否想过，朋友不再是朋友，家园不再是家园;7;285;292;18388;0.01587992168805743
111240;这次没有变性doge;15;1334;1349;18388;0.07336306286708723
111257;小兔对小鸡说：“你知道娃娃鱼身上最珍贵的部位是哪里吗？”小鸡想了想，恍然大悟说：“鲵肝嘛，哎呦。”;18;980;998;18388;0.054274526865346964
111276;纣王的不懈努力妲己终于怀孕了，不幸的是，有一天妲己散步的时候被一块石头绊倒了，栽了下去，流产了，纣王看到崩溃地大喊：“己你胎没己你石栽使胎没”大臣们都痛呼：“哦悲悲”;4;297;301;18388;0.01636937132912769
111281;这种视频我只会看一眼，;1;18;19;18388;0.0010332825755927778
111283;我发布了一篇笔记，快来看看吧;3;55;58;18388;0.003154231020230585
111289;多年后的某天，坤坤终于忍不住了，发出了他的律师函，告了所有黑子。临开庭前，坤坤听到了来自陪审团的声音，“这是些小黑子真可恶，现在终于被告了，以后别想吃我哥哥的蛋了”。坤坤听完后一愣，没想到小黑子已经混入了陪审团，但坤坤很快恢复了往常的从容，因为这次他会一举将所有小黑子铲除。坤坤看到了自己的律师走了过来，就去和他聊了一会。准备开庭了，律师先去做最后的准备，就边走边鼓励他说“这是个千载难逢的只因会，我们将会把所有小黑子铲除”这次坤坤被吓了一跳，但看律师已经走远了，坤坤就安慰自己说是自己太敏感了，可能听错了，但这样安慰让自己心里充满了不安和恐惧。终于开庭了，双方律师不不相上下，两个半小时过去了也没有判决结果。这时坤坤听到法官自言自语道“这次案子难道不小啊，两个半小时了也没结果，双方说的只因本都对，现在一直都没有结果，只能看哪边先漏出鸡脚了。”争辩还在继续，结果还没有下来，但坤坤已经什么都明白了，看着眼前的所有人都是小黑子，甚至自己律师和法官都是，坤坤陷入了绝望doge;4;162;166;18388;0.009027626713073745
111295;严厉批判，小黑子。颠倒黑白，使用ps技术侮辱他人。恶意P图，再P你的只因把就要爆掉了。阿米奈dogedogedoge;1;25;26;18388;0.0014139656297585382
111307;省流：第三张开始失去只因doge;2;25;27;18388;0.0014683489232107897
111318;你们这群小黑子，就知道黑我家哥哥，你们根本不知道，我家哥哥撅起来有多爽傲娇傲娇;1;2;3;18388;0.0001631498803567544
111323;疑惑疑惑不知道怎么会有人一直黑他，纯路，真的觉得没必要这么黑蔡徐坤，蔡徐坤是优质偶像，非常宠粉，三观也超正，在跑男这种真人秀综艺里面，真的非常能够体现出蔡徐坤优秀的人格特点和为人处事方式，玩游戏时，也不屑于使用非常手段获得游戏胜利，而是通过自己已知的条件、聪明有逻辑的大胆分析，把握每一个只因会，很让人佩服人也很有礼貌，工作也认真，肉也有营养，看到他，我就可以燃起学习的热情，重拾起生活的希望，这不就是偶像的意义吗。小黑子们一直黑他不就是因为羡慕他过得比自己舒服吗，拜托，他的美好生活是自己辛苦工作，无数个日夜练习唱跳才出来的，每天练习25个小时，高烧100依然坚持练习，小黑子们继续黑吧，你们明天起床还是会面对一样的挣扎的生活，但作为ikun的我还是会继续粉他，因为他给我带来的正能量。2023202320232023打call打call打call打call给心心给心心给心心;1;3;4;18388;0.00021753317380900588
111437;什么奇怪的BGM辣眼睛辣眼睛吐;1;0;1;18388;5.438329345225147e-05
111516;什么软件哇热词系列三连;1;0;1;18388;5.438329345225147e-05
111527;AI什么鬼，什么东西都能画出女生，该不会是up故意搞的吧doge;10;1375;1385;18388;0.07532086143136828
111538;doge;5;281;286;18388;0.01555362192734392
111544;这是B站虚拟形象的废稿44娘，今日重见我很高兴doge;40;4730;4770;18388;0.2594083097672395
111585;好了，新的站娘出现了doge;13;336;349;18388;0.018979769414835763
111599;22和33的结合doge;6;121;127;18388;0.006906678268435936
111606;AI画什么都能让它变成人，并且都是女的doge;2;73;75;18388;0.00407874700891886
111610;求软件;2;18;20;18388;0.0010876658690450293
111613;看来我是第一个喽halloworld;3;39;42;18388;0.0022840983249945617
111617;ai绘制的2233怎么还把脸给我弄成这样doge;11;82;93;18388;0.0050576462910593865
111633;我这视频咋还没看完呢？;1;2;3;18388;0.0001631498803567544
111635;求BGM;1;1;2;18388;0.00010876658690450294
111649;完了，现在看小电视都感觉涩，up你赔我精神损失费doge;1;63;64;18388;0.003480530780944094
111653;ai学聪明了，学会把手藏起来了;1;35;36;18388;0.001957798564281053
111660;《这家伙自从改了名字就没几次是正常的了》（bushi）;1;1;2;18388;0.00010876658690450294
111667;我这有更好看的doge;1;1;2;18388;0.00010876658690450294
111690;咱就是说你这是不是P上去的思考;2;0;2;18388;0.00010876658690450294
111701;UP解释一下绘画是连续的吗？一张绘画完之后在根据绘画的绘画还是一直根据原来的图绘画;2;0;2;18388;0.00010876658690450294
111718;22和33;1;2;3;18388;0.0001631498803567544
111727;人狠话不多，直接上干货脱单doge;1;82;83;18388;0.004513813356536872
111729;讲得不错，但你才一千粉敢要五千赞，是个什么情况;4;39;43;18388;0.002338481618446813
111734;我想Ai帮我工作，赚钱，搞卫生，结果它只会聊天，画画，玩游戏，太让我失望了;14;119;133;18388;0.007232978029149445
111749;希望你某些部位不会跟视频一样这么细脸红;1;11;12;18388;0.0006525995214270176
111751;图片较低的动态图动态图片较低的短视频短视频长视频提高质量准备工作喂某亚洲老师视频，骑兵不要妙啊不敢想喜欢喜欢捂眼捂眼捂眼;1;15;16;18388;0.0008701326952360235
111753;卧槽，电诈狂喜doge;1;13;14;18388;0.0007613661083315206
111755;可是c站点进去下载也是iff格式吖，不是png格式图片信息提去不了吖;9;12;21;18388;0.0011420491624972808
111765;X轴选了3个LORA，如果不加Y轴的话，怎么给3个LORA选权重啊;6;8;14;18388;0.0007613661083315206
111774;为什么提示词搜索可以用，但是提示词相关性老报错啊。有没有兄弟知道;1;0;1;18388;5.438329345225147e-05
111777;我生成的图，很多会出现眼睛有问题这种一般怎么修复呢;1;0;1;18388;5.438329345225147e-05
111783;怎么生成9张？;1;0;1;18388;5.438329345225147e-05
111787;为什么我做出来的，面部狰狞，身体畸形大哭大哭大哭;4;1;5;18388;0.00027191646726125733
111792;AMD显卡能用吗;1;0;1;18388;5.438329345225147e-05
111795;话说怎么分别对2个人物用不同的LOAR呢;1;0;1;18388;5.438329345225147e-05
111799;为什么我tag里面输入2girls每次都是只生成一个人;1;0;1;18388;5.438329345225147e-05
111805;手脚异常怎么修？;1;1;2;18388;0.00010876658690450294
111812;有没有图生图的办法，比如我自己拿一套衣服图片给ai然后让模型穿给我看脱单doge;2;0;2;18388;0.00010876658690450294
111817;upup请问下期会出图生图的教程吗;1;0;1;18388;5.438329345225147e-05
111819;保存的预设怎么删除啊请问仓鼠阿巴仓鼠阿巴;1;2;3;18388;0.0001631498803567544
111835;冷知识：如果误删tag在浏览器也能使用CtrlZ和CtrlY笑哭;2;8;10;18388;0.0005438329345225147
111839;这生成图片，还是中文的网站是啥。。。;2;0;2;18388;0.00010876658690450294
111850;四分钟讲了别人要半小时才能说明白的事，打call三连了;3;6;9;18388;0.0004894496410702633
111855;最近一直在弄怎么画多人，画两个不一样的人;1;0;1;18388;5.438329345225147e-05
111857;文本框布置作业，我要是输入了三行，是选一次生成3批，还是选1批生成3张？;7;0;7;18388;0.0003806830541657603
111865;大型网骗现场doge;1;0;1;18388;5.438329345225147e-05
111868;生成这种ai图有什么用doge;3;0;3;18388;0.0001631498803567544
111872;up我想删除之前的预设tag应该怎么弄;2;0;2;18388;0.00010876658690450294
111876;请问这软件需要显卡好些的配置吗？;2;1;3;18388;0.0001631498803567544
111885;请问哪位大佬知道保存的预设怎么删除，一堆了，乱七八糟的，也没找到删除方法;7;0;7;18388;0.0003806830541657603
111893;张张都是双胞胎;2;9;11;18388;0.0005982162279747662
111899;C站参数可以直接复制，提取的参数信息不全面不能重现图片;8;0;8;18388;0.00043506634761801175
111911;civitai上的dolllikeness系列是都下架了吗？;5;0;5;18388;0.00027191646726125733
111917;怎样固定住图片的样子，然后换场景或衣服？;6;0;6;18388;0.0003262997607135088
111925;C站是什么;1;0;1;18388;5.438329345225147e-05
111932;报错了怎么办;1;0;1;18388;5.438329345225147e-05
111947;变线稿后去骗约稿的钱么;3;15;18;18388;0.0009788992821405265
111951;有一个线稿的lora可以直接用;6;12;18;18388;0.0009788992821405265
111961;请问safesentor格式的模型如何使用？;2;0;2;18388;0.00010876658690450294
111967;我的出不来这种线稿怎么回事，完全按步骤操作的;1;0;1;18388;5.438329345225147e-05
111972;有一个问题，既然都有成图了，为什么还要退回线稿呢？;1;0;1;18388;5.438329345225147e-05
111978;请教一下智障君视频里经常出现的xy对比图怎么生成，或者用到什么插件告知一下插件名，找了好久都没找到，谢谢了;2;0;2;18388;0.00010876658690450294
111988;只能生成一片白茫茫的白茫茫的白茫茫图片;3;0;3;18388;0.0001631498803567544
111992;全世界的艺术家们联合起来;24;244;268;18388;0.014574722645203394
112017;某些人不懂别BB，抵制的不是AI，抵制的是拿别人画的图去喂AI然后说是自己原创的“艺术家”，AI应该要往不需要投喂别的艺术家的作品来生成画作的方向发展才对（当然这挺难的妙啊）;8;148;156;18388;0.008483793778551229
112027;AI绘画的发展是大势所趋，但是AI绘画相关的法制建设也应该是大势所趋;3;103;106;18388;0.005764629105938656
112032;如果AI不喂图也能画画，能创造新的画风和技法，我就支持AI，否则它只能是个小偷，资本吸血的工具，用AI出图和李裁缝的行为没有区别，我说完了，资本家的狗可以来咬我了调皮;10;41;51;18388;0.002773547966064825
112043;与其提升自己，不如诋毁别人;19;37;56;18388;0.0030454644333260824
112063;他们就是要artstation开一个ai板块，把ai和人分开。至于商业上要用这拦不住的，我原来公司负责美术的现在就天天用ai，又快又好用;9;29;38;18388;0.0020665651511855556
112073;无所谓，道德伦理会为技术让步，过往如此，未来如此;39;26;65;18388;0.0035349140743963455
112113;自己也从事美术相关工作的，接触ai绘画一段时间了，目前又悲又喜，喜的是很多想法可以快速实现，极大的提升美术生产力，量上去了，品质自然就高了。悲的是AI绘画技术不被主流美术界认可，甚至被异端化。关于版权侵权问题的边界在哪？先说自己的结论，目前重点是抵制AI产生的带有侵权性质的作品，并以此谋利行为。而不是抵制AI绘画这种创作形式本身。个人认为AI技术本身（从获取互联网数据到学习完成数字模型这个过程）没有所谓侵权行为，回想自己的学画十多年的过程，总结为三个阶段，1，起步阶段，无不都是先学习绘画基础，素描，色彩，设计理论等等。2，发展阶段，学习临摹参考和优秀作家作品，量变到质变后逐渐丰富后形成自己的风格。3，成熟阶段，在前两项基础上把脑子里的经过思考和衡量的画面画出来，在各种主观和被动的需求中不断成熟的创作过程。目前尝试下来现在AI可以做到极大的缩短1和2阶段的时间投入成本，快速进入第3阶段。而且AI在1和2两个阶段学习方式和人没有本质的区别，只是效率高得惊人。而在第3阶段恰恰是人起到决定性的作用，即便是Ai也是需要清晰的需求，才能产生带有价值的作品。所以对于目前在从事或即将从事美术设计行业的同学，需要清醒的认识到抵制应该是无论手绘还是AI创作的侵权作品，而不是盲目的抵制AI绘画技术本身，不要忽略AI绘画艺术对未来美术创作起到的革命性作用，否则很可能吃亏的是自己。;29;25;54;18388;0.0029366978464215794
112143;可以用，但是喂给AI的东西得付钱。无偿剽窃就是没道理的。;3;22;25;18388;0.0013595823363062867
112148;感觉像美国码头工人抵制港口信息化。;7;21;28;18388;0.0015227322166630412
112156;历史的车轮是永远不会停止的，作为美术从业者我们应该做的是适应AI带来的改变、寻找新的盈利方式并且等待相关制度的完善，而不是一群人搁网上喊一些阻止发展的口号无语;14;20;34;18388;0.00184903197737655
112171;看了很多AI的图，要么没感觉，要么拼凑味太浓，还有些干脆就没拼对用来快速出想法可能还行，但真要到使用的地步还得是正儿八经的再画一遍吧。如果我是甲方或者公司老板，为了避免将来可能的麻烦肯定会要求手绘。只有一些根本没有美术资源的小公司和工作室才会直接商用吧。还有就是一些画渣可能会用来找存在感满足虚荣心。我觉得这只会拉高这个行业的门槛。大公司不会用AI图，对手绘的要求只会更高。会用AI的公司也不用再找画手了，AI凑合用就行。只有画渣会受伤的世界喜极而泣另外将来也会慢慢变的没人愿意分享自己的图了我这种图片收集党估计也会受伤灵魂出窍;4;19;23;18388;0.0012508157494017839
112176;httpsmpweixinqqcomsG2exVAqkHQud7DmVH2BEVA找到了比较详细的事情过程其实大多数艺术家抵制的是ai生成图片的版权问题，而不是技术本身。另外，就目前的技术来看，在以设计为主的场景原画领域，ai还无法满足需求（或许某一天ai能根据要求设计建筑的时候，就能做到了，那到时受到冲击的绝非一个两个行业），但某些仅要求美观性的商业美术需求还是受到了一定冲击。;1;13;14;18388;0.0007613661083315206
112178;笑死历史车轮前的几只小小螳螂呲牙;15;12;27;18388;0.0014683489232107897
112195;ai降临派和ai拯救派是两个极端;2;11;13;18388;0.0007069828148792691
112198;我站AI，我是花钱买插画还被当猪宰的冤种，我就站AI，ai加油吃瓜;16;11;27;18388;0.0014683489232107897
112215;ai出图这么轻松，以后没人辛辛苦苦原创了，ai没法创造新的画风和新的设计;1;10;11;18388;0.0005982162279747662
112217;好幼稚，就好像油车看不起电车似的，最后肯定会出现纯电和电混，但也丝毫不影响油车的地位。;21;10;31;18388;0.0016858820970197955
112239;人类就应该不停的进步，任何方面都一样，不止ai绘画，包括ai任何东西。这是人类技术的进步，不应该被阻止。如果有一天因为技术的不到位，而遇到无法解决的困难，后悔还来得及么？;13;7;20;18388;0.0010876658690450293
112254;破防实录是吧;1;6;7;18388;0.0003806830541657603
112258;感觉总会有人禁不住未来互联网巨头给出的高价，卖出自己作品的使用权给他们开发训练ai模型，抵制侵权是可能成功的，但抵制ai进入行业抢饭碗恐怕是很难的。想想如果未来ai程序优化进入手机app，用自然语言生成想要图片漫画，很多人都能自给自足，并且这个时候大家用的ai可能已经解决了版权问题，那很多接私稿或者画同人图的画师必然受到影响;2;5;7;18388;0.0003806830541657603
112264;乐子人别急，现在是绘画，以后就是你的专业，期待你们看到自己被ai取代后脸色惨白的样子给心心给心心给心心;7;3;10;18388;0.0005438329345225147
112273;chatGPT也一样，用未授权代码训练，让那些只会printf，for循环，while，if的程序员失业;1;3;4;18388;0.00021753317380900588
112279;ai算法会不断的进步;1;2;3;18388;0.0001631498803567544
112285;为画画的出了把汗，这样发展下去老板直接招几个会用ai的就行，不懂我们3d会不会有这一天;1;2;3;18388;0.0001631498803567544
112288;私炉：你猜猜我受影响吗笑哭;1;2;3;18388;0.0001631498803567544
112297;我在这个站上看到好多AI绘画的不过他这个站人也是参差不齐有大佬也有奇奇怪怪的人;1;1;2;18388;0.00010876658690450294
112302;与其说抵制ai不如抵制科技的发展;10;0;10;18388;0.0005438329345225147
112331;1Jr3vDiHoovrNn97AlXTsnA提取码：8888图包百度云一些图过不了审也放里面了，不多嘟嘟，压缩2次;18;25;43;18388;0.002338481618446813
112351;图我拿了，三连给了，交易愉快;1;1;2;18388;0.00010876658690450294
112353;能重新发个链接吗;19;1;20;18388;0.0010876658690450293
112373;能整点古风的不，我有个朋友想看滑稽;2;1;3;18388;0.0001631498803567544
112376;大佬能从新发下吗，已经失效了;1;0;1;18388;5.438329345225147e-05
112380;貌似盘蹦了？能下能重发？;4;0;4;18388;0.00021753317380900588
112386;大佬打不开啊脱单doge;16;0;16;18388;0.0008701326952360235
112403;模型除了国风2和3还有lora么歪嘴;1;0;1;18388;5.438329345225147e-05
112410;道理我都懂，什么软件;1;0;1;18388;5.438329345225147e-05
112412;还是喜欢一开始的，老婆永远不要长大就好了脱单doge;23;576;599;18388;0.03257559277789863
112436;我支持ai绘画的功能，这是不可逆的趋势，并且这玩意已经展现出了它的魅力和吸引力，以后也能成为生产工具的一部分。但我反对它的付费，因为它本身就是吃别人的画合成出来的，版权就有问题，却拿来自己牟利。你要是只是给支付服务器算力的价格还好，但显然目前的价格是昂贵不合理的。这玩意，最好的宿命就是免费开源，要么，就是被正义破解了;153;3278;3431;18388;0.1865890798346748
112590;ai画图是很有前景的而且发展很快，不用几年技术就会越来越好，能画出来来的也会越来越精细，这对发展方面来说是好多，比如用ai辅助来做galgame的和轻小说的插画会大大节约成本和时间吧，也是生产力的发展呢，不过靠画画吃饭的，我的评价是寄了，没错就是我，不能说完全不需要，但生产力的提高意味着几个人做的事可以一个人做，评价就是要没了热;21;387;408;18388;0.0221883837285186
112613;你别说，我要是写一本网络小说，自己创作的角色，如果能用AI将他们大概绘制出来，这样真的很方便、很满足，当作插画用，省钱省心，多美的一件事啊。;76;559;635;18388;0.034533391342179684
112690;ai确实很厉害，纺织机器刚出现的时候，也是很多工人抵制，甚至跑进去砸了机器，汽车诞生的时候，马车夫也一样闹，不能跑得比马车快，也不能装的比马车多，现在呢，ai这个我不敢说这个是好是坏，一切交给时间去验证吧，时间是检验新事物的唯一标准。;398;1519;1917;18388;0.10425277354796607
113089;一张大头贴卖三五百的时代再也不会有了。;21;373;394;18388;0.02142701762018708
113111;光从这些画来看，AI没有灵魂的论调可以取消了，不得不承认被萌到心里了保卫萝卜哭哭保卫萝卜哭哭;52;493;545;18388;0.02963889493147705
113164;有点机械恐慌了笑哭，我在想不光与美术行业收到冲击，在未来其他行业会不会像现在一样也收到冲击。以至于绝大多数人的利益收到冲击，最后生产力过剩而沦落为一众无用阶级。藏狐;22;288;310;18388;0.016858820970197957
113187;但是其实这种AI画风，或者说“合成画风”吧，目前来看也只有这种，这可能是算法的结果吧，固定了画风，如果以后算法多了后，可能会模拟不同画师的画风来进行导出。目前这AI在手指细节和某些关节方面刻画还比较粗糙;20;244;264;18388;0.014357189471394388
113209;好好好，快进到拿ai生成的画去随意卖弄，说是自己原创，然后同画风原作者找来进行一个大混战给心心给心心给心心;19;426;445;18388;0.024200565586251905
113229;然而世界上的所有画家实际上都是可以说是被投喂出来的，一个画家从不欣赏、学习、模仿别人的画作，这话说出来你自己都不信。既然要成长那么就需要学习，而学习就是对世间事物的理解与模仿，最后加上自己的理解。人的意识都没有办法创造出自己完全不知道的事物，更别说现阶段的ai了，你脑中的创造还是对自己认知中的事物进行拼装重组呢，那我能说你的思想抄袭了别人吗？藏狐;143;676;819;18388;0.04453991733739395
113373;怎么会有人选择丑陋的蒸汽机内燃机玩意，而不乘坐有“灵魂”的车夫的马车呢？;27;238;265;18388;0.014411572764846638
113401;这种情况谁也没办法，我也挺喜欢画画的，看到这种视频多少对我有点打击，瞬间不想画了，但这也是不可逆的，早晚都有这一天;6;149;155;18388;0.008429410485098978
113408;觉得萌都是因为被喂图的画师画的好啊热;7;198;205;18388;0.011148575157711551
113416;把手遮住有几个人知道是ai画的，一个个的正义使者是吧捂脸;10;189;199;18388;0.010822275396998041
113427;不管如何评判，在这方面根本没有对错之分，你可以说它违背道德把人家画师的画吞了当素材，你也可以说方便了某些人，但无疑ai出现在各方面各领域都是大势所趋，就像目前就业计算机专业永远都是人们需要的，这就是大势，它可能触及了某些小画师的底线但它绝不会撼动大师的地位，它使得某些小画师没米赚，但它也让某些请画师的人省了米，就这方面来说，到底谁对谁错，无非就是有没有触犯自己罢了，但如果有人拿这东西来赚大家的米，那这种人不应该是所以人唾弃的吗思考;12;144;156;18388;0.008483793778551229
113440;虽然说ai是未来的趋势，但是类似画师这种，我觉得反而会重损人类的感性方面，为何ai能作画，靠的无非就是身为人类的我们不断创作的图进行学习拼接，尝试设想一下，若是ai把中小画师的工作饭碗抢了（大画师问题不是太大），在未来又有哪里的素材给ai进行不断更新，大画师终有年龄的限制，新生的血液被ai扼杀在摇篮，不留余地给中小画师成长发展的空间，到最后只会让新生血液逐渐消失，不止是画师方面，资本会逐步逐步将人类的创作能力侵蚀;9;73;82;18388;0.00445943006308462
113450;绘画本来就是个人心血，ai可能代替人类但它们始终不是活的，绘画是艺术并不单纯是谋利的工具，这些可以辅助绘画，但画师的心血，下手的每一笔才是画的灵魂;20;38;58;18388;0.003154231020230585
113471;人脑哪有电脑强啊希望机器人早日取代人类占领地球微笑;3;47;50;18388;0.0027191646726125733
113476;想起一个亲戚朋友，工作不找，整天闷家里画，花了一个月出来的成品也不如这里的一张微笑;3;11;14;18388;0.0007613661083315206
113480;要是由从出生到成长到成年到变老到死亡的全过程就好了;5;80;85;18388;0.004622579943441374
113486;觉得是盗取劳动成果乱缝一套的兄弟可以去了解一下ai作画的原理，可以简答理解为一个和你一样一开始会参考临摹前人的作品但却可以一目千张作品不吃不喝不睡觉吃电的而且学习能力是人类几百倍的东西，但ai再怎么样还是学的人类的东西，靠的是现有的素材资源学习的，再怎么画还是前人栽树后人乘凉，没有自我创新能力，你我还是能发挥自己的脑洞创造出史无前例的东西，因为我们都是栽树的人;2;19;21;18388;0.0011420491624972808
113489;A老师用ai画你家的茂南啊脱单doge;1;55;56;18388;0.0030454644333260824
113493;昨天试了下，真的跑不动，一个512512可能要几分钟，一次出两张图，还是标签比较少的了（负面标签该加的都加了，而且标签一多有时候会报错。（别问，问就是我独显内存不够。我朋友叫我去试下colab，就用Google服务器去跑一下，我还没跑过，应该很快吧笑哭;2;12;14;18388;0.0007613661083315206
113496;话说这个画风真的很像一百天挑战的那位太太笑哭不会全都喂进去了吧？？;1;12;13;18388;0.0007069828148792691
113498;属于工业对手工业的降维打击了，画师一天一张图效率可以说极高了，AI一天能给你画一千张藏狐;7;66;73;18388;0.003969980422014357
113506;我感觉自己的兴趣爱好变得毫无意义了;23;51;74;18388;0.004024363715466608
113530;好好制裁一下绘圈小画手捏;8;21;29;18388;0.0015771155101152925
113540;因为大部分画师也画不好手，所以AI也不会tvdoge;1;11;12;18388;0.0006525995214270176
113547;潘多拉的魔盒已经打开了，再怎么抵制也回不到以前，画师的未来确实难，但是没人能改变这个世界，能改变的也只有自己;5;12;17;18388;0.000924515988688275
113553;非常真实，ai只会画鸡爪，手是真的画不出来;5;9;14;18388;0.0007613661083315206
113559;感觉都能薄纱很多中下水平的手画了。。这ai发展也太恐怖了辣眼睛;5;31;36;18388;0.001957798564281053
113565;不知道一百多年前的马车夫怎么看现在的跑车的呲牙;7;18;25;18388;0.0013595823363062867
113573;K幻他的图不可能有授权，全是盗的。淘汰之后可以用之前攒下来的信息。可以淘汰大部分画师是因为成本太低了，一个软件几十块可以用好久，一般约稿一张1008000原本十个人的工作量现在三个人改一改就可以拿低配版糊弄了。另外七个人喝西北风;7;65;72;18388;0.003915597128562106
113583;等ai把画圈价格打下来，教育机构的学费也应该能跟着下来，到时候我再低价报班学绘画，赚到;11;8;19;18388;0.0010332825755927778
113595;新东西的出现肯定是好事，科技是第一生产力，但人类的创造力和思维能力永远是Ai学不来的，这或许会对绘圈产生冲击，但对动画行业来说肯定是好事，如果完全掌控了这种技术，做动画这种需要的人力会大幅降低，加上最近几年硬件性能的突飞猛进，个人感觉不出10年，到时候只要懂得深度学习和Ai软件，或许人人都能做动画。比如只需要画个分镜，Ai会自动帮你上色补帧渲染形成一副完整的动画。阿梓从小就很可爱新装扮嘿嘿那如果硬件性能不够怎么办呢？再大胆猜想一下，或许到时候直接有软件或者网站能在线渲染，因为比4G还要快十几倍的5G快要来了。宏观的说，这或许只是时代的一个开始，后续可能会有更多冲击行业的新东西，时间会证明一切。阿梓从小就很可爱新装扮嘿嘿;5;64;69;18388;0.003752447248205351
113601;虽然但是都在讨论AI吗？我的感觉是看着一个孩子从小到大真的好治愈啊，好像真的在养女儿一样而且他还有了自己的孩子，太可爱了;1;7;8;18388;0.00043506634761801175
113603;AI越发达，中小层面的画师就惨了，毕竟不是人人都是大师。就目前来说小说创作啥的AI还无法取代，毕竟小说里的世界观庞大程度和涉及逻辑思维能力和事件人物等等是Ai无法理解的。但是像ai绘画这种通过一定理论拿固定内容拼凑整合出来的画面，对中小层面的画师冲击不是一般的大热尤其是对那些一副画收费500以下的小画师，痛苦程度可想而知。本来就是赚个辛苦钱，现在连辛苦钱都不一定赚得到了;5;10;15;18388;0.000815749401783772
113609;刚用了一晚上难以想象你是怎么从一堆古神里调出这些的辣眼睛;2;20;22;18388;0.0011964324559495323
113613;可爱捏，不过绘画业会因为它遭到沉重打击吧热;20;23;43;18388;0.002338481618446813
113635;看个图能看出灵魂？你就是摄魂怪？;2;16;18;18388;0.0009788992821405265
113639;感觉开发galgame的门槛进一步降低doge;1;16;17;18388;0.000924515988688275
113641;要我说，什么时候科技能发展到让ai替我死;4;10;14;18388;0.0007613661083315206
113648;NovelAI不是扒出来生成的图片有一模一样的吗，除了颜色不一样;1;8;9;18388;0.0004894496410702633
113650;为什么感觉大多数都。。没有表情，就是那种很呆很麻木，不知道是不是我的错觉;3;6;9;18388;0.0004894496410702633
113654;相机出来的时候也有一批画师失业但是现在还是在好好发展我觉得ai大概也是这样;2;9;11;18388;0.0005982162279747662
113657;好好好，加速发展，ai绘图算什么，最好全部ai。今天这些行外的看戏的人也将是画画人的模样;1;7;8;18388;0.00043506634761801175
113659;我觉得ai还是挺好的，毕竟你一张约稿几千元，一个头像几百元，我们的钱都不是大风刮来的，一张稿子一个月生活费就没了。你觉得人们一边想要美图一边又想便宜，ai作画不是很合理吗。而且这样人工绘画和ai作画可以互相卷，还可以淘汰掉一些二流小画家，越来越精美的作品诞生出来不是很好吗;3;5;8;18388;0.00043506634761801175
113670;十年后再来不也许五年就够了，到时候再来评论区看看脱单doge;1;9;10;18388;0.0005438329345225147
113672;有些东西，不是你反对就能阻止它的;1;4;5;18388;0.00027191646726125733
113676;up怎么做到保持风格还能加年龄的啊大哭;1;4;5;18388;0.00027191646726125733
113678;我觉得ai还是无法取代现在的画师，因为它要吃现有画师的图，首先版权就是问题，其次它不能创新只能学习，而每个画师都会形成自己独创的画法和风格。我动态里好多老师在骂一些用ai盈利的，因为那些ai被喂了他们自己画的图，有些画面真的是像从他们的图里扣下来换个颜色就拼成一个新图。就像有一位画师说的，现在的ai绘图就是把一个人解剖再用那些碎肉拼成一个新的人。;14;7;21;18388;0.0011420491624972808
113693;这不就是工具嘛，与其抵制，不如拿来更好的提升自己，三流画师更是舒服，直接改图，行业门槛都低了doge;9;7;16;18388;0.0008701326952360235
113705;这个ai最近好火，超想试试能不能用screenshot生成好看的狒狒图;1;5;6;18388;0.0003262997607135088
113707;那些支持的都不是基层画师吧微笑;3;6;9;18388;0.0004894496410702633
113711;虽然会淘汰不少画师，但是顶尖画师会更值钱;5;6;11;18388;0.0005982162279747662
113721;UPUP，请问这个ai不应该是只能根据tag来随机生成图片吗？为什么还可以生成像这种一连续的呀星星眼;5;3;8;18388;0.00043506634761801175
113730;都是吃了互联网分享的红利罢了吃瓜;1;5;6;18388;0.0003262997607135088
113733;到底谁可以来和我指条明路啊大哭;1;2;3;18388;0.0001631498803567544
113736;这真的是ai生成的吗？这换做普通画手没几年功底都不行但在ai手里;3;2;5;18388;0.00027191646726125733
113742;这些比大多数中下层画师要画的好了吧;2;2;4;18388;0.00021753317380900588
113748;求图已三连加关注了;1;1;2;18388;0.00010876658690450294
113750;up，求图脱单doge;1;1;2;18388;0.00010876658690450294
113752;有图包吗;14;1;15;18388;0.000815749401783772
113767;ai老师，能不能别画长大doge;1;1;2;18388;0.00010876658690450294
113769;bgm是什么;1;1;2;18388;0.00010876658690450294
113771;求关键词打call;3;1;4;18388;0.00021753317380900588
113775;有关键词吗害羞;1;1;2;18388;0.00010876658690450294
113779;很多弹幕说的没有表情，没有室外场景等等什么的，其实只要加几个tag就可以解决了。。。。。。;1;7;8;18388;0.00043506634761801175
113788;看着是挺好的，但感觉好多有些相似，不是说它跟别人的相似，而是它自己本身就好多相似，感觉就是重重复复的那几样，没有眼前一亮的感觉;1;1;2;18388;0.00010876658690450294
113794;好名字不知道了;1;1;2;18388;0.00010876658690450294
113803;人类画出来的东西呢，是由绘画概念和参考物以及自己天马行空的想象力构思出一副自己心中满意的画，然后绘画出来。AI有趣的是它既没概念也没想象力不会被参考物限制，没有概念和思路的混合一起产生一种人类无法理解却向往的美;1;1;2;18388;0.00010876658690450294
113808;ai最多只是辅助作用，一个没有感情的机器是没办法画出更深奥的东西的;2;1;3;18388;0.0001631498803567544
113815;星羽望但是他这左右手接反，眼睛近小远大，甚至左胳膊和右胳膊的衣服接在一起就有点说不过去了;1;1;2;18388;0.00010876658690450294
113817;ai竟然可以画的这么好灵魂出窍;1;1;2;18388;0.00010876658690450294
113821;求bgm;2;1;3;18388;0.0001631498803567544
113825;所以关于ai画图是ai拼合其他画师的图的话，那感觉这个需要的图的量应该很大吧？思考那为什么有些人说可以代替大部分画师呢？如果真淘汰了大部分画师的话那ai还有素材库嘛？难道要靠自己之前的画再用来拼嘛？藏狐;6;1;7;18388;0.0003806830541657603
113848;ai发展已经是时代趋势，你们再抵制也没啥用了，现在唯一的问题是在之后的商业绘画上现在的画师会扮演什么样的角色;1;5;6;18388;0.0003262997607135088
113852;B站小画手们别急，等AI继续发展还有的是你们急;2;7;9;18388;0.0004894496410702633
113856;感觉表情几乎是一样的，很多构图也很类似，像玩奇迹暖暖换衣服和发型一样，甚至还有透视画错了的;2;1;3;18388;0.0001631498803567544
113868;两年之后，甚至不用两年，ai应该就能完全达到人类顶尖画师的高度了;1;0;1;18388;5.438329345225147e-05
113879;冲了一圈浪回来发现ai好像没法画多人互动图诶（也有可能是我没看到）;1;0;1;18388;5.438329345225147e-05
113893;虽然但是AI是只能画原创人物吧一些二创作品还是需要画师自己画的。;2;0;2;18388;0.00010876658690450294
113914;某个AI软件已经被投诉侵权了。AI完全调用别人的作品根据一定规律来拼图并不算是学习，以算法为名行的是外包公司P图的勾当，每个部位拿一点总没法认出的。它只会拼接计算出各种可能性供人选择，没有主观的处理引导画面做视觉引导。那些看上去好看的AI图，只是因为喂的风格图本身就是非常不错的构图。AI虽然能启发思路，但是更多的是扼杀创作的积极性。我本来以为画写实的先被革命，没想到是二次元先第一个被革命了。这种出图方式完全是对多年辛苦练习基础，学习色彩构成的画师嘲讽，也是对尊重知识产权的西方法律的嘲讽。就看是国外先立法还是国内先立法了。;1;0;1;18388;5.438329345225147e-05
113932;ai图是挺好看，但是总少了点灵动，千篇一律的，刚开始很惊艳，看多了有点麻木哈欠;1;0;1;18388;5.438329345225147e-05
113965;Ai绘画取决于人类的画，如果因为AI绘画导致画师越来越少的话，训练的样本增长率也会大幅减小，最后绘画变成了类似于垄断且毫无进展的行业;7;0;7;18388;0.0003806830541657603
113989;永雏塔菲;1;0;1;18388;5.438329345225147e-05
113992;有没有那么一部讲一个人慢慢成长的动画啊，日漫好像向来没啥时间跨度啊;3;0;3;18388;0.0001631498803567544
113997;求bgm脱单doge;1;0;1;18388;5.438329345225147e-05
114001;说实话，这个是怎么做到相同人物（感觉长相有点差不多）不同背景的？是跟种子有关系吗？笑哭网站的也可以这样吗？;3;0;3;18388;0.0001631498803567544
114022;bgm是啥啊，真好听;2;0;2;18388;0.00010876658690450294
114027;用ai画的画训练ai，这样会怎么样呢;1;0;1;18388;5.438329345225147e-05
114029;为什么不继续发呢。直接老年。吃瓜;2;0;2;18388;0.00010876658690450294
114035;还是幼了好啊doge;1;0;1;18388;5.438329345225147e-05
114046;还学个p啊，画一辈子也比不过软件，以后估计就是，提供创意布局让ai来画了。以后估计不管会不会画画，拿软件都能画出来想画的东西了。;1;0;1;18388;5.438329345225147e-05
114052;新的挖矿产业啊，买显卡挖图片，旷工开始入手大量40系按照需求输入文字每张收取一毛钱;1;0;1;18388;5.438329345225147e-05
114054;这个AI绘画软件是什么？;1;0;1;18388;5.438329345225147e-05
114063;绿色斐林试剂仔细看，别看光影，看衣服有没有穿模粘连，一般眼睛近大远小，看左右手是不是反了鹿乃惊头发会掉色到衣服上，衣服会反重力，头发接不上，两眼瞳孔不同之类的枕边童话嘿嘿嘿;1;0;1;18388;5.438329345225147e-05
114070;以后就能自己给自己做饭了冷圈有救了（）;2;0;2;18388;0.00010876658690450294
114073;人类画师学画，也是需要大量素材的，说要人工智能付版权费什么的，有失偏颇。现在的人工智能，还是很机械的阶段，确实能画出东西，但是它的画，相当于，你把ai的图库，全部临摹一边，你也能画出不只这个水平，现在ai的厉害的地方，主要还是在机械的重复的工作上面。它还在量变，在量变的过程中，没有达到质变。ai在量变上，人类无可匹敌，但是能不能达到质变，才是它会不会影响到人类的关键。但是谁都不能遇见，未来肯定也是很让人担心的，ai现在所有的发展还是在为人服务（广义上的人），等什么时候ai的发展为自己服务的时候，人类才是真的完了。但是人类不可能在一瞬间完成蜕变;1;0;1;18388;5.438329345225147e-05
114078;每张都好好看;1;0;1;18388;5.438329345225147e-05
114087;up官网做的吗;1;0;1;18388;5.438329345225147e-05
114099;风格有点单一;1;0;1;18388;5.438329345225147e-05
114109;虽说是拼接的，但比以前的都好很多，不过有没有种可能我们绘画也是种拼接行为就是将参照物与自己想象拼接起来思考而且拼接也算种智能吧，就算不能实现真正意义上的原创作画，那未来会不会做成ai剪辑;1;0;1;18388;5.438329345225147e-05
114137;求bgm;1;0;1;18388;5.438329345225147e-05
114140;我觉得好AI作画好啊，像这种脑海有漫画故事情节却没有画画天赋。;1;0;1;18388;5.438329345225147e-05
114142;bgm是啥啊;2;0;2;18388;0.00010876658690450294
114145;好看，求图脱单doge;1;0;1;18388;5.438329345225147e-05
114151;这些画真好看，老哥扔个图包吧脱单doge;1;0;1;18388;5.438329345225147e-05
114158;请问是否在论坛上发表了这系列的图呢？;2;0;2;18388;0.00010876658690450294
114161;up求BGM;1;0;1;18388;5.438329345225147e-05
114168;本地搭建的版本听说要10g显存，是吗;1;0;1;18388;5.438329345225147e-05
114170;什么ai这么强啊，为什么我用的ai画出来的比抽象派还抽象;2;0;2;18388;0.00010876658690450294
114175;怎么才能做到这么多张图画风统一，人设统一的思考;1;0;1;18388;5.438329345225147e-05
114178;这玩意不太听话，拿来辅助画师也不实用感觉;1;0;1;18388;5.438329345225147e-05
114185;up，想要原图;1;0;1;18388;5.438329345225147e-05
114188;ai绘画淘汰的是中低画师，那些顶级的不会;2;0;2;18388;0.00010876658690450294
114192;图包有吗，感谢星星眼;1;0;1;18388;5.438329345225147e-05
114194;怎么稳定画风还有那么怎么搞复杂的衣服和背景的？;1;0;1;18388;5.438329345225147e-05
114201;这是完整版吗;1;0;1;18388;5.438329345225147e-05
114207;up，有图集吗，打包一份好吗给心心;1;0;1;18388;5.438329345225147e-05
114216;up用什么AI软件画的，能不能说一下;2;0;2;18388;0.00010876658690450294
114221;怎么做到全是一张脸的;1;0;1;18388;5.438329345225147e-05
114229;大拇指是ai无法理解的存在;1;0;1;18388;5.438329345225147e-05
114234;画同一个人是怎么做到的哦呼;1;0;1;18388;5.438329345225147e-05
114241;upup，能不能来个tag脱单doge;2;0;2;18388;0.00010876658690450294
114244;红金配色的妹子来点;1;0;1;18388;5.438329345225147e-05
114251;请问up是怎么出来这种年龄增长的效果的啊;5;0;5;18388;0.00027191646726125733
114265;大笑上次看ai小画师吵了十几层楼，无非就是让他们尝到了不劳而获的甜头，还真敢把头抬得那么高;32;2765;2797;18388;0.15211007178594735
114298;有些人的观点真实奇怪，只要技术能进步就算损害了个人的利益也是允许的吗？并不是，他们无脑赞成只是因为没有损害到他们的利益呲牙;215;4850;5065;18388;0.27545138133565367
114514;AI你自己私下玩玩就行了，现在偏偏有些赛博画师喜欢拿着AI生成的图去跳脸画师，连画笔数位板都没碰过还自认为是什么画师;17;1468;1485;18388;0.08075919077659344
114532;没经过画师允许拿人家图去喂ai，不行。自己画图喂ai训练产生新图，行。;47;3570;3617;18388;0.19670437241679356
114580;人描图：抄袭ai描图：ai牛逼创死画师我看ai创死的是某些人速度八十迈漂移的三观罢了支持;117;2752;2869;18388;0.15602566891450947
114698;很正常。经常跟“ai小画家”们对线，对方常常以“机器学习”与“人类绘画也需要临摹”为理由。但是正是这种说法暴露了这帮人对于绘画一窍不通的本质。人类画动漫不是依靠模仿，而是基于自己对于现实世界的认识为基础，对现实的“选择性表达”。基于这一点，就注定ai绘画不可能有创新，只是更高级别的“拼尸块”罢了;143;4339;4482;18388;0.24374592125299108
114842;商业ai绘画的素材库必须公开，所以素材要取得版权支持;21;1191;1212;18388;0.06591255166412878
114864;第一步，我们偷他们的画。第二步，我们抢他们的饭碗。第三步，我们指责他们说机器人也是人。第四步，我们把他们踩到脚下告诉他们没有你们地球照样转。第五步，告诉他们的后人，是你们抄袭了我们，你们想创作就得掏钱崩坏学园2和善。;10;1697;1707;18388;0.09283228192299325
114875;人类也是从临摹、模仿开始学习的，凭什么人类可以用ai不行？答在画室学画画，我交了学费，画照片我还付了钱，别人出的书我付钱买了临摹学习，我看见喜欢的画师他们出画集我也付钱了，不是所有人学画画都是买了盗课，逮着一个图片就临摹，再说说AI呢，这边讨论他版权问题捏，他用别人的画来学习，他付钱了吗？;53;1574;1627;18388;0.08848161844681314
114929;拿临摹的图出来约稿你猜会不会被骂？人临摹是为了自己，机器所谓的临摹，得益者是机器背后的人，别跟我说机器要临摹，临摹拿出来说是自己的，就算是人干出来也会被骂呲牙;4;646;650;18388;0.035349140743963454
114934;正好，讲讲“ai小画家”们常用的话术。1人类也是从临摹、模仿开始学习的，凭什么人类可以用ai不行？答因为从绘画的层面来说，ai根本就不是学习。人类画动漫的过程是1以人生活的、所感知的现实世界为参照物，对于事物有一个基本的认识。比如，人都有两个胳膊两条腿一个头2学习技法来把自己感知的现实世界“漫画化”并用画笔表现出来3画成动漫ai是没有对于现实世界的认识的，所以ai作品只能从人类的作品中剪切元素加以糅合，不存在创新，更不是学习;153;1409;1562;18388;0.08494670437241679
115088;抖音的ai绘画区现在有个趋势就是发自己ai后的私密照我觉得不只是离谱简直逆天;12;661;673;18388;0.03659995649336524
115101;讲好笑的，都说AI未来可以帮助画师，打压自信小画家。可现在我已经看到一两个没有承认自己用了AI，拿AI骗人的画师。既然可以帮助人，那为什么现在出现了AI诈骗？以及私自盗用他人的作品投喂AI。我看到了一个本来就烂的环境更烂了。;13;594;607;18388;0.03301065912551664
115115;说白了，和这些用ai绘画的人是说不通的，因为他们不创作，不创作怎么会懂创作的不易，怎么会理解看着自己辛辛苦苦好几个日夜画出来的图被人轻易偷去切块拼尸，他们看到只会说“我自己用而已”“反正我又不画画损害不到我的利益”“我怎么了我又没商用”“我拿我自己照片喂的ai”“工业革命之前手工也排挤机器”机器取代了什么呢，反复无用的重复劳作，我没看到有那个机器说取代苏绣之类的吧，机器也没说把很多人织好的布偷回去剪开再拼在一起吧，偷换概念真是有一手还有那些说凭什么不是ai自己画的你是真认为ai有自主学习能力吗？特别是这群人发ai绘画的视频用的还是《蓝色时期》这部讲述美术生励志追梦的漫画的主题曲《群青》，都该死;60;773;833;18388;0.045301283445725475
115176;画师集体变成打工人，还是不给钱的那种，还不更新法，也不怕以后也没人画了吃瓜;13;432;445;18388;0.024200565586251905
115190;最恶心的是开发者高高在上的语气，并且对于画手说动了他们的蛋糕这句话。并且对于这种侵权或者是违背了人类道德底线的行为无所谓，并且觉得没有什么事很光荣，认为他们研发了这款软件能够和画师可以比对了，觉得很成功，很光荣，这种行为真的令人作呕特别是他那高高在上并且觉得是动了画师的蛋糕所以画师跳脚的样子，对于这种侵权盗窃拼凑的行为，十分的光荣。恶心，令人心寒;13;434;447;18388;0.024309332173156405
115204;可以画，可以抄，可以发布，可以分享，但是绝对不能商用，这是绘画一直存在的规律，不仅是规律，也是法律规定，不要拿AI绘画作为自己人品低劣肆意侵权的借口。;18;459;477;18388;0.02594083097672395
115223;ai只是个工具，它本身肯定没有意识。但是人会怎么使用的就不一定了，希望能赶紧立法补充空白吧无语热;2;164;166;18388;0.009027626713073745
115227;ai的算法并不是纯粹的拼凑这些画师的作品，但从某种意义上来说比那要糟糕;3;210;213;18388;0.011583641505329563
115231;前段时间朋友给我发两张图，一看线稿风格是毛玉老师，看上色又不太像，然后他告诉是AI弄的，;10;159;169;18388;0.009190776593430499
115243;你一点，AI给你生成成千上万张图，然后你从里面选出一些你觉得好的，这个过程你真的觉得是自己在驯化AI吗？;25;134;159;18388;0.008646943658907983
115269;我的建议是，要是解决不好保护画师利益免受ai绘画侵害的问题就让ai绘画直接死在摇篮里得了;37;101;138;18388;0.007504894496410702
115307;网上那种看起来是AI抄袭的，事实上是本质是画AI画的人把别人的画当底图让AI去改，这种其实就是普通意义上的描改，只是描改的人自己不动手让AI代工罢了，AI在这里头其实就单纯是一个工具如果真的是喂给素材库的话，根本不可能出现叠图AI虽然不能像人一样直接理解三维世界的事物，但是也是要通过输入的图片，在词语和二维的图像间建立联系的，以程序的方式去总结一个东西在二维上一般是长什么样子的，而不是直接复制粘贴素材。（如果AI是在抄袭，就不会出现现在这种画不好手的问题了，直接把素材的手粘贴过来就好，正是因为二维视角的绘画AI在试图理解手的结构时，搞不清楚手这么一个结构，在二维为啥可以有这么多种样子，所以才一直画不好。）;11;96;107;18388;0.005819012399390907
115319;支持ai的发展，前提是保证画师权益;45;436;481;18388;0.026158364150532958
115365;之前看到有人说的很对，ai就像太监举着电动bang子嘲笑正常人;1;67;68;18388;0.0036980639547531
115367;等某些现充们的工作被ai代替他们就知道我们的心情了;30;65;95;18388;0.0051664128779638895
115398;小说有融梗的说法，以后ai作画可以叫融图;11;320;331;18388;0.018000870132695235
115410;视频的最后：吃了别人的饭，掀了别人的桌，还要赖别人找你理论是因为碰到他们利益？顺带一提，作为出版相关专业学生，我要说一句，这种行为并不属于所谓的法律空白的灰色地带。我国《著作权法》是有明确规定禁止对他人的著作进行挪用商用的。不论主体是AI还是个人，盗用素材的人都必须为此承担相应的法律责任;2;79;81;18388;0.004405046769632369
115413;所以我讨厌这种AI绘画未经画师允许就私自把图喂给AI，这真的很过分，很恶心虽然我这个人目前还画的不怎么样，但以后肯定会画的比现在好，因为我就打算靠这一行来吃饭如果有一天我的画真的被人偷了，我TM会气死;24;79;103;18388;0.005601479225581902
115438;有什么脸说自己是科技公司啊，连源码都是拿开源的抄的;1;61;62;18388;0.003371764194039591
115440;确实需要管控，不过希望是以限制用AI作品盈利的方式，而不是限制AI作画技术与使用本身;12;99;111;18388;0.006036545573199913
115453;昨天看到有个人嫌官方画的角色设计不好看，在下面发了一大堆AI的图，有人怼他说你拿这个抄袭的东西跟人家原创比，他居然说没拿人家的画。首先这个人不是画师，那他的AI究竟是怎么画出图来的？没拿别人的图训练过就能画？前天还在闲鱼看到一个约稿的，价格就跟正常画师差不多，我一看那个画风就觉得很奇怪，像AI，我把他的主页往前面翻，发现他最早跟绘画相关的商品是在11月1号发布的一条AI图图的东西。然后后来他AI出图的价格就开始往上涨，再后来直接标榜自己是原创无语甚至那个价格比很多画师都要高。;3;57;60;18388;0.003262997607135088
115457;就是把画师的作品用来喂ai了？;48;182;230;18388;0.012508157494017838
115506;听别人说，滴墨社区的ai绘画有个协议，就是如果你用滴墨社区合成的图片被原画师发现了要告你，你负全责，别找滴墨社区软件官方，官方不负责任，这个我也是听别人说的我记得我第一次听说ai绘画还好奇玩了几天，后来看那ai缝合的画，实在是没有我关注的画手画的戳我xp再加上ai版权的问题我就删了，不在碰它了;1;55;56;18388;0.0030454644333260824
115508;希望维权成功吧，让我再看看这个时代美好的一面;10;59;69;18388;0.003752447248205351
115520;不就是吗，用的是画师素材，七拼八凑的拼出来。;34;144;178;18388;0.009680226234500761
115556;动到一些画手的蛋糕掀掉一些画手的饭碗人家维护自己的合法权益属于在饭碗内呢，并不属于饭后甜点的“蛋糕”doge;2;102;104;18388;0.005655862519034153
115559;从个人角度上讲目前来说ai作画不会那些手部武器背景头发这类的细节其次身体结构都是错误百出的有一定鉴赏能力的朋友能一眼分辨出来一份作品是画师之手还是ai创作画师是完全无法被ai代替的其次只能靠广大群众自觉了pixiv就有明确的版权定义但国内除了群众自发抵制非授权的大规格商业用途外确实也没有什么出路了;43;40;83;18388;0.004513813356536872
115604;我完全支持ai绘画发展，但是在ai作品商用上应该有严格规定，尤其是一些肉眼看见能产出原画师特征的ai图，保护好知识产权。严格开始，ai绘画的每一次训练都是对画师知识产权的侵犯，但是这玩意很难管，别人在网上扒了你的图自己偷偷训练，谁能知道历史的洪流就是这样，总有一大批人不明不白被创死，在我看来，ai绘画的发展是不可阻挡的，而且必然伴随着不断的侵权，画师们学生们与其想着阻止这个过程，不如想想怎么从结果上来保护自己;14;78;92;18388;0.005003262997607135
115619;不一棒打死所有的ai绘画，但也必须切实保障画师的版权。未经同意不应该擅自使用其他画师的作品喂ai;16;150;166;18388;0.009027626713073745
115636;我看看还有谁疯狂支持ai绘画捂眼别总想着不劳而获昂，真想有收获，还是得靠自己的努力;3;34;37;18388;0.002012181857733304
115640;前两天在一个评论区看见一个人说ai绘画不好下面一堆人回复“哦”“”“人家就是好用啊？”好用的是画师们的作品吧？我希望这些事不关己的人以后的工作与爱好都被别人取代捏;17;309;326;18388;0.017728953665433977
115659;一说ai就有人开始跟讲一些所谓的底层逻辑，会且只会说这一句也解释不清楚不免显得有点可笑，我们现在所遇到的问题分明是有人未经画师同意将画师的劳动成果投入ai进行所谓转换学习与科学研究这件事是否侵权，是否有损画师利益，是否是对于版权的挑战，归根结底，ai的抄袭的确难以界定，我们无法确定这幅画的构成是否有画师某一素材的参与，可是是谁给了那些软件背后的人，在画师毫不知情的情况下将他们带有价值的劳动成果投入素材库供ai学习的权利，我们所学的知识无一不支付着带有价值的东西时间或者金钱，上学还有走读费课本费，那怎么ai就特殊，手上拿个ai就能等人家做好馒头一出锅给整屉端走？这不纯纯盗窃现在对于ai讨论度最高的问题只有版权纠纷这一个，没有版权纠纷的ai谁管他学成什么样，等到以后出现一个敢公开素材库没有版权纠纷的成熟ai它就该收费了，到时候ai和画师相互成就，也不知道哭的会是哪些没有能力的穷光蛋;7;25;32;18388;0.001740265390472047
115667;啊？居然真有人用ai接商稿？ai不应该就是图一乐玩玩的东西吗？;4;74;78;18388;0.004241896889275614
115672;咩栗受害者之一仓鼠阿巴;2;27;29;18388;0.0015771155101152925
115676;这些软件都是套了别人开源的基本库就出来赚流量了，但凡自己多迭代几遍，都不会出现这种明显的相同结构吃瓜;1;84;85;18388;0.004622579943441374
115679;我手机里也存了不少画师的公开的图，但是我绝对不会拿去分享，一是没有经过画师同意就传播不合规矩，二是你不确定你分享出去的图最后会被用到哪里。所以，我根本就不看好ai绘画这个东西。;3;20;23;18388;0.0012508157494017839
115683;海德格尔认为艺术就是大地跟世界的斗争，它是我们跟虚无混沌的大地搏斗的痕迹，是我们尝试理解世界、表现世界、赋予世界意义的过程，是我们跟世界的互动，从这个角度来看，它就不仅只是一个物品，背后凝结的正是我们人之为人的基本感受和意义。这个过程远不是输入几个关键字弄出一幅好看的画能带给我们的;14;23;37;18388;0.002012181857733304
115699;ai就是拼凑画师们的作品，你可以发出来让大家欣赏，也可以自己作为头像作为屏保，作为壁纸，但是不能商用不能用这些来敛财。;1;33;34;18388;0.00184903197737655
115701;讲个笑话，我画的无偿都被盗了，免费都要偷，j不j啊童话系列阿拉丁寄;6;72;78;18388;0.004241896889275614
115708;我认为创造的基础应该是原创。;2;18;20;18388;0.0010876658690450293
115712;哈哈，没有画师哪有这ai素材库，要是以后大家都不画了，不学美术了，那就好玩了;1;18;19;18388;0.0010332825755927778
115714;ai发展是不可避免的，与其抵制ai，不如现在就开始对ai绘画进行规划，慢慢融合下来，也会成为画手的素材库;6;23;29;18388;0.0015771155101152925
115721;只是拿图训练的话应该不算侵权，如果是出现原图那肯定就是侵权。要追究“画风”的版权问题那基本不可能，甚至是整体动作甚至一眼像都不能算侵权，要是算侵权那麻烦就大了;28;39;67;18388;0.0036436806613008486
115750;我偷你的图来训练我的ai从而进行商业盈利，我是合法合规的哟真见;1;14;15;18388;0.000815749401783772
115753;看到高赞蚌埠住了ai神经网络学习的原理不是拼接，具体的诸位自己动动手搜索吧辣眼睛辣眼睛目前训练好的ai既可以独立创作、也可以根据他人的画作改图。正规的作画软件，这两种模式应该标明。未取得版权许可，将他人画作拿来改图并据为己有（比如说：给ai蒙娜丽莎，请ai帮我画一个性转蒙娜丽莎），其性质和盗图、描改图、p图没有差别，是没有争议的侵权行为。然而，我注意到，之前半年里也同样出现了大量画师乐子人使用“改图模式”，修改自己的图，然后去碰瓷ai公司说是他们的“作图模式”存在拼接和造假，试图制造舆论对立，这样的事件。而另一方面，“作图模式”出的图虽然是原创的（无法叠图），但是此前许多ai公司训练ai使用的数据集是未经购买的，且辩称“这只是像人类一样通过看图来学习，不需要购买”。然而，机器并不适用于人类的权利，其学习和出图的效率显然扰乱了市场，需要管理。这也是舆论的一个关注点：该怎样修改法律，才能让ai公司为训练集付钱呢？评论区的朋友，可以先去了解一下绘画相关的法律，以及ai的基本原理，然后才能得出客观的结论。;30;91;121;18388;0.006580378507722428
115785;自从学画画开始就没有一天不是焦虑的，我本就不是什么专业的美术生，一开始只是因为爱好拿上了笔开始了创作，期间为了提升自己画出更好的作品让更多人能够喜欢我的画，花了许多钱报班学习，有时甚至因为报班花的钱太多连日常生活费都不够，常常因为自己进步过慢而崩溃，被人嘲笑过也有人支持过，就这样莫名其妙坚持了三年，说实话我不是很有天赋的那种，但我自认为我是能努力的那种，看着现在的ai绘画我已经不知道这么久的坚持是否还是有意义的，但是看到我的笔我又不忍心让它以后只能在角落落灰，只希望用ai的能真正明白我们创造者的不容易，给予我们应该的尊重保佑;3;13;16;18388;0.0008701326952360235
115790;ai绘画确实好玩，特别是研究tag，商用还是算了;5;18;23;18388;0.0012508157494017839
115799;我想说的是，网上的ai画家有没有可能只是出售显卡算力而不是图片本身？;10;12;22;18388;0.0011964324559495323
115811;emmm很无语，人工作画的创意设计和逻辑性才是ai学不来的东西，这么容易被ai卷死不如卷铺盖卖煎饼算了倾权确实是个问题，没有经过训练的人没有关于版权的意识，只知道“网上找的为什么不能用”，但其实只要不商用不获得收益就没问题，ai说到底只是工具，可以用来增加工作效率，真正有价值的还是ai无法替代的部分ai也是互联网新兴灰色地带，等有关部门法规调控;8;13;21;18388;0.0011420491624972808
115820;倒是放放自己的图和素材库的图的对比啊，看看到底有多像;4;17;21;18388;0.0011420491624972808
115825;ai的所谓学习逻辑就是识别模仿加乱序，只不过越低劣的ai模仿痕迹越重。如果达到被画师告的程度，那基本上就是失败了，另一个画师描改都是不可的凭什么套ai就可以？更烂的是用ps之类随便拆分各个部分排列组合，这种凭什么叫ai绘画？;7;17;24;18388;0.0013051990428540352
115833;ai跑图兴起不止是能骗二次猿，还能骗老人，以前电信诈骗或卖赝品骗老人，属于违法犯罪被抓到了还会判刑，现在利用ai绘画搞诈骗，印ai油画国画，说这是某某名画师独一无二的原创作品，然后拼夕夕式把画师名字一部分改成生僻子避嫌，然后高价卖给不懂科技的老人家，还是合法的，我就不信以后没骗子干这个。;1;10;11;18388;0.0005982162279747662
115837;说实在的ai无法完成商业客户需求的，而且ai用于商业稿其实按抄袭判定其实都算，应该要加强抄袭法案的修改，用于自娱自乐其实不算太大问题但是如果用于商业用途的都应该要算违法，新闻这个明显就是商用了;2;10;12;18388;0.0006525995214270176
115841;ai生成图和人类临摹能一样吗？类比一下就是：人类临摹你抄了同学作业，ai生成把同学作业拿去复印了一份;3;9;12;18388;0.0006525995214270176
115845;好恨，好恨，好恨好恨好恨好恨好恨，ai绘画去死;14;9;23;18388;0.0012508157494017839
115860;素材库为什么会有素材库一说，不是多维向量嘛？刚点进来就愣住了。应该说的是训练数据集吧。;2;9;11;18388;0.0005982162279747662
115865;想到一个比较现实的问题，虽然我也是学美术的也喜欢画画，但是在以后ai取代人工作画确实有这个趋势，工业革命不就是如此吗，或许，几年后，真的会有商业插画用ai创作。不过，现在人审美变得很快，所以画师也不会完全消失;2;8;10;18388;0.0005438329345225147
115868;这些都是投机分子，前沿的探索者们已经开始研究怎么用ai画漫画了。;7;8;15;18388;0.000815749401783772
115883;如果用经济学中的增值法来计算一个物品的价值，那么画家进行创作就是一个附加价值的过程。而AI作画应当被视为对画家作品的二次加工附值。结果的出价必须要高于画家作品才合理。建议制定规则强制Ai作画的价格区间高于画家作画;12;9;21;18388;0.0011420491624972808
115896;是得管管但我也希望能给画师尊重ai绘画也不应该被停止;1;9;10;18388;0.0005438329345225147
115898;没用的，以后ai会取代越来越多的岗位，如果ai能再进一步的话连程序员也没饭吃了。。。;4;13;17;18388;0.000924515988688275
115903;永远都记得有人评论说过，这次并不是技术上的突破，而是道德层面上的撕破;3;89;92;18388;0.005003262997607135
115907;别动我抹茶老师气死了啊啊啊啊ai我杀了你啊啊啊杀杀杀生气生气生气;2;15;17;18388;0.000924515988688275
115914;想问问各位，如果给ai喂自己画的图，单纯想看看自己的作品还有哪些改进的地方，这种行为可以接受吗？保卫萝卜哭哭;16;6;22;18388;0.0011964324559495323
115931;是不是以后画师们发图都要带上厚厚的水印了;1;6;7;18388;0.0003806830541657603
115933;ai图是学习，没错，但是掌控ai的是不关心共享社区的算力寡头;1;6;7;18388;0.0003806830541657603
115936;我尽力了，但是这家伙就是油盐不进灵魂出窍;4;8;12;18388;0.0006525995214270176
115942;还直接扣，笑死我了，什么垃圾ai直接扣大图。像视频里这个是图生图，基本是用户拿着你的图让ai按照你的图画出来的，给ai喂进去你是根本查不到的，成数据了。按简单的来说，你喂给ai，ai认识到这样是好看的，你有时候觉得是扣了你的图，说不定是借了几十个画师的手生出的一个人小部位。我不知道那些小鬼拿画师的话跑去图中图然后发给画师找存在感呲牙，看看视频里的画，经常用ai的一眼就能看出是图中图，不知道的画师还以为是无中生有直接扣大图呢，但凡看过ai原理都知道不可能。;9;14;23;18388;0.0012508157494017839
115953;人临摹的本质是为了学习最基本的透视，人体，色感（打个比方就好比如说数学的公式），不可能几个小时就能参透，需要不断练习，吸收，再运用到考试中去而ai就是，我根本不懂这个数学公式，直接拍题到题库搜答案，搜完了我还要骂你一句“你学公式不也是抄袭吗，你跟我是一样的，虽然我连公式都没学过，但我解题甚至还比你更快更好，你有什么资格说我”;2;7;9;18388;0.0004894496410702633
115956;ai生成的图没版权就完事了;1;5;6;18388;0.0003262997607135088
115960;ai绘画刚了解我第一反应是如果能靠关键词“拼”一个oc图出来，用这个去找画师约稿应该会比较方便，因为有些oc人不会画画只有文字设不过现在看来ai绘画真的有些滥用;6;5;11;18388;0.0005982162279747662
115967;这种东西就是个祸害大笑让版权意识更加拉跨;1;5;6;18388;0.0003262997607135088
115982;我现在可能爱发电的原创“AI绘图”画家（只绘猫娘）;2;4;6;18388;0.0003262997607135088
115987;要是有数字秘钥和画师认证就好了，画师出图后自动生成数据锁，需方购买后得到钥，国家提供作品数据备案，法律上只要卡好秘钥授权后的责任归属大的问题就基本能解决，也能双向发展;7;7;14;18388;0.0007613661083315206
115995;道德指责从来就没啥用;1;5;6;18388;0.0003262997607135088
115997;简直无敌谷歌的新AI技术无限自然：从单个图像生成自然场景的永久视图哔哩哔哩httpsb23tvSgi6OnH不知道什么时候可以看到有人替建模师发声;5;5;10;18388;0.0005438329345225147
116003;断人财路如同杀人父母doge;25;12;37;18388;0.002012181857733304
116034;恩将仇报要是AI小画师们没那么恶心AI没准还能成为画师的帮手;1;3;4;18388;0.00021753317380900588
116038;chatGPT也一样，直接拿github的代码训练，让那些只会helloworld，ifelse的程序员失业，给那些不会代码的人装逼的资本;1;3;4;18388;0.00021753317380900588
116040;同志们，学一下美化吧的水印全屏吟唱法，糊上他好几层妈蛋。偷一个人的作品叫偷，偷全网站的图就不叫偷了是吧;3;3;6;18388;0.0003262997607135088
116044;ai画的图，版权是被学习画师的还是召唤师的还是编写ai的人的;2;3;5;18388;0.00027191646726125733
116047;有能耐AI画出来的画也“灰色地带”OK;1;3;4;18388;0.00021753317380900588
116049;抹茶老师画的咩阿栗的图被盗了呜米燃起来了我这小暴脾气一下子就上来了;3;4;7;18388;0.0003806830541657603
116054;但是出的图也没有版权。随便用;1;4;5;18388;0.00027191646726125733
116057;666原来ai小画家竟是我自己，ai绘画被抨击无非就是抢饭碗了，真搞艺术ai看得懂？;4;7;11;18388;0.0005982162279747662
116062;为什么有争议？所谓“抄袭”的概念不是一种新概念吧，以往是怎么判断“抄袭”“侵权”的，现在按同一种方法去做不就行了？所谓的“用软件拼接”是抄袭侵权，那么用手人工拼接就不是抄袭侵权了？同样一张图，判断它是否侵权还要因为它在什么设备上创作的而采取不同的评判标准？所以，归根结底，为什么以往的对“抄袭”“侵权”的判断方法不能用？既然能用那有什么可吵的？;3;7;10;18388;0.0005438329345225147
116068;好想看见第一起告侵权成功的;1;2;3;18388;0.0001631498803567544
116073;我自己也是美术生，未来也想向插画漫画这类的方向发展，只能说感同身受吧。AI绘画刚出来的时候就隐约有种感觉，这个东西肯定会侵犯画师权益。等后来真正了解到AI作图原理后更是觉得不舒服，因为我清楚美术生并不都是为了考大学才学美术的，我们之中有很多人是真的喜欢，甚至热爱艺术，为了考上好的美院，就要兼顾文化课和专业课，甚至要比普通高中生付出更多努力，因此一想到自己的作品被AI随意拿走提供给大众，努力了这么多年的结果被AI“小画家”随意拼凑并拿到面前嘲讽，肯定会感到不舒服。不过，仔细想想，AI画作虽然会刷下去一部分技术不太成熟的画师，但是绝对不可能会取代画师，不管是神态，细节，还是设计理念，AI画出来的东西都很死板，容易造成审美疲劳，艺术能延续至今靠的可不单单是视觉的美感，它依靠的更多是作品传递给欣赏者的情感，是一种跨越时空交流的浪漫，这是AI不可取代的，是人类的想象力。只能说AI作画吧，只是用各种素材拼接了表面，内在的东西想学是学不来的，当然，AI“小画家”们不会在意这些，他们只想赚钱嗑瓜子，唉还是希望可以整顿一下AI作画方面的问题吧（以上观点仅代表个人，杠精别杠，刚就你对）最后补充一下脱单doge：劳资甜美就是热爱美术，劳资甜美就是要靠美术发家致富，画师的水平就是比AI纽币，麻烦某些嘲讽画师的AI“小画家”不服憋着害羞，画师大佬们跟人体，素描，色彩磕生磕si的时候，你们连最基本的火柴人都画不好呢捂眼，少想一些投机取巧的事儿，有这功夫去画几张速写给心心;1;2;3;18388;0.0001631498803567544
116075;把ai当做生产工具最有效率的方式，是把自己画的画投给自己的私炉ai，让ai学到自己的风格，再大量出图，挑几张好的改一改。这样可以把精力给构图啥的匀一匀。大场面的细节仍然是无处可逃的体力活。;1;2;3;18388;0.0001631498803567544
116078;说白了就是饭碗问题;3;2;5;18388;0.00027191646726125733
116083;逆天接商稿也是离谱我自己自娱自乐都快被骂成败类了居然还有人接商稿抗压能力一定拉满了;3;2;5;18388;0.00027191646726125733
116090;素材还分免费和付费呢，直接拿走喂ai就空手套白狼？;1;2;3;18388;0.0001631498803567544
116101;什么腾讯行为;1;2;3;18388;0.0001631498803567544
116105;这是人的悲哀，“艺术”“绘画”那些都是空虚的符号，人在使用中其意义才被涌现出来，它再华丽在绚丽，如果不是人在空间视角中的经验获得的，而是需要强制将人依附在这空虚的符号上，那人就被降格成了空虚符号的附属物，人成了物，这里会出现诡异的现象，即人在此依然认为自己在驱动“空虚符号”，是这些符号的主人，但完成这些“空虚符号”大批量生产的核心是人的驱动与筛选，即必须经过人这一位面筛选出符合某种“人的审美”的机制的符号，人成为了物的生产的最后一道工序，这也就是对人的爱欲的物化，而欲望的驱力使得人不会满足与对物的满足，它不停的否定生产出的“空虚符号”，比如赌徒心理，“不是这个”“下一个永远更好”，从而使得“空虚符号”的生产具有某种合理性需求，具有某种“意义”，从而因此加剧了对物的依赖，看似人成为物了主人，实际成为了物的奴隶，“恋物癖”由此发生出来;2;2;4;18388;0.00021753317380900588
116111;《训练》《神经网络不是拼图》《你知道什么是集群数据吗》，我遇到好些个从程序代码上来跟我谈是不是拼图各类不想干话题的回复，然而问题是别人学习画画都像AI这样还会出现千万种不同的画风？AI不就是喂什么图出什么画风，AI也没有自己的画风啊？别人正经美术行业就一定要复制另一个人的成果？网络速成班就算真有无限相似的复制人出现那也是一个愿意教一个花钱学来的，不说流水线速成班，正常的看真人参考照片能画出各种画风，AI能吗？AI只能画数据集的东西，这就是最有力的证据，那帮人就会扯神经网络和集群，然后呢？美术行业里面抄都是被人骂大街的，还轮得到AI？AI这种复制行为简直是雷区蹦迪，PS有盗版为什么他们没用呢，因为学画有成本，你一点都不学骗不到钱，现在好，出来个给图它自己会复制的PS，于是以前眼红那些骗钱的人现在都加入了，然后用更低的价格嘲讽之前那帮骗钱的，然后顺便跳脸正经画画的，以上就是AI现在的环境微笑;25;6;31;18388;0.0016858820970197955
116141;ai绘图不算抄啊，兄弟。ai绘图相当于新画师学老画师的风格。但拿老画师的画去图生图不道德啊。笑哭就好比做刀削面的机器会淘汰掉一些三流的刀削面师傅。也没人去说那机器抄了什么刀削面技术。;10;3;13;18388;0.0007069828148792691
116153;只要不商用，我认为也是没有问题的;1;3;4;18388;0.00021753317380900588
116155;关于这一点，我想引用别人的一个观点：Ai绘图的学习素材，就像是人类画家学习的临摹样本。如果学习素材需要付费，那么临摹样本也要付费。人类画家虽然自己的原创作品里面没有对临摹样本的侵权，但是也会有绘画风格痕迹。同理，Ai绘图的作品有学习样本的痕迹，也就能够接受。;24;3;27;18388;0.0014683489232107897
116180;抵制ai绘画在某种程度上是在抵制科技的进步完全抵制是不可能的。不过我怎么对没想到先开始抵制ai的会是绘画圈，我还以为会先是机械体力劳动者;42;9;51;18388;0.002773547966064825
116223;说实话绘画领域本身还处在传统手工业，而深度学习等新兴技术为该行业带来了工业化的起步，显然画师作为传统从业者会大为不满喜极而泣;52;9;61;18388;0.0033173809005873395
116276;老是拿纺织机说事，纺织机是人智慧的结晶，它的产生过程是人努力而来的，研发过程都是正规的。你这ai作画算哪门子正规啊，怎么好意思和纺织机类比的，研发者写了个程序然后白嫖画师的成功训练，受害者海了去了，本质上努力的还都是画师，然后进步过程居然还是在跑画师们的图，吃了那么多画师的成果就不能改改让它自个训自个吗，训了这么多也没见进步是什么啊。ai绘画到现在基本除了给不画画的提供了乐子一事无成，不仅如此还平等的创死了大部分人，ai侵权屡见不鲜，ai诈骗层出不穷，说能拿来当参考，跑出来牛鬼蛇神，有那时间不如自个调个模型，参考学习的就是作画的手法，细节的处理，然后这部分跑出来的东西基本都逻辑不通，除了坏处就没见到好处，怎么好意思拿这玩意类比最后还是造福了人类的纺织机的疑惑。;6;9;15;18388;0.000815749401783772
116284;这些画师最好不要把给ai惹毛了，不然在网上随便抓一抓，抓出来100多张跟他画的画差不多的作品，上传时间还比他早，大家都很尴尬。;6;5;11;18388;0.0005982162279747662
116291;希望国家早日完善相应法律法规，不应因发生于互联网便任由此等行径肆无忌怠。某些非法盈利者们以侵占他人知识产权来盈利，被指控还这般理直气壮强调自己“合法”。此般行径，作为一名公民实在气愤。公民权利被肆意破坏，这是违背宪法的。希望盗用他们劳动成果以盈利的非法盈利者们早日受到国家公平公正的法律法规管控，还国内信息互联网的一片蓝天。;1;1;2;18388;0.00010876658690450294
116299;已经有换皮游戏全游戏都是ai绘画改图上线赚钱喽，举报也没用;4;1;5;18388;0.00027191646726125733
116304;我赞同画师维权，但我不赞同阻止这项技术进步。;1;1;2;18388;0.00010876658690450294
116307;分享一下经历，之前我画了一个自设oc的正面图，然后有一个somebody小孩盗我图，然后过了几个月，内个somebody小孩又把我的图给放AI了，还说自己画的，真一somebody，这还是我群友提醒才发现的;7;1;8;18388;0.00043506634761801175
116319;不用大惊小怪，现在的人可以为一条狗而去诅咒人，可以为了自己的心情而诋毁他人，可以为自己所爱的明星而四处出征，可以因为软件不同而目中无人，可以因为生活的优渥而对人民冷嘲热讽，可以因为他人的国籍、性别、肤色而侮辱他，也可以因为观念不同而破口大骂。为了个ai有什么干不出来的？;1;1;2;18388;0.00010876658690450294
116324;等我归来可好;1;1;2;18388;0.00010876658690450294
116327;等个不久的将来，所有画师都默契的不再发布的免费插画抠鼻;1;1;2;18388;0.00010876658690450294
116333;不画画，但是看到别人拿ai图出来展示甚至还跳脸原画师就想吐，ai画图至少现在还比不上人类的创作，我一个没怎么画画的人都能识别大部分的ai画图。辣眼睛;1;1;2;18388;0.00010876658690450294
116337;我学计算机，曾经和助教讨论过ai的话题，虽然现在很多人事不关己高高挂起，而且近十年来ai的发展前景一片大好绝对能赚的盆满钵满，但50到100年后ai发展成熟很可能取代一大批公式化的职位，到时候最吃香的可能是设计师这类创新性职业了。当然，对当代人，对普通人来说这些都遥不可及毕竟那时候该退休的早都退了，但我觉得ai绘画应该是发展趋势的一种体现（当然也可以觉得我是在嘴，毕竟是和ta闲暇时的思维发散害羞）;4;1;5;18388;0.00027191646726125733
116343;我在想既然是图片是一种数据，未来数据链技术进步能不能像给信息“烙印”一样给图片“烙印”，随着相关条例的颁布，未加入协议的图片或图片网站不可挪用资源给ai训练或是图生图，私自输入的话“烙印”自动破坏信息或是形成无法识别的乱码污染数据库或是被筛选出来;4;1;5;18388;0.00027191646726125733
116349;看来这玩意儿还是火候不到家，这就半路下山出来赚钱了，这也太奸商了。笑哭;1;1;2;18388;0.00010876658690450294
116357;ai是人吗？不是，所以它没有人权，也就没有版权，所以你用ai跑的图我随便拿来卖钱也没关系吧，因为ai是没有版权的，你输入的几个简单的词条也不可能算作“著作权”脱单doge;2;2;4;18388;0.00021753317380900588
116362;这东西是要证据的，不是说动作一致就是抄了;1;2;3;18388;0.0001631498803567544
116369;你们还记得王者荣耀的AI人机吗？玩家为啥不投诉呢，同理。这只是借鉴;3;4;7;18388;0.0003806830541657603
116374;不应该让技术问题成为限制创作的门槛。每个人都会有想画的东西，但不是每个人都有画画的能力。让所有不会画画的人也能得到自己想要的图，这不是一件好事吗？;107;2;109;18388;0.00592777898629541
116482;以前看人类反对人工智能的电影不理解，现在明白了，反对的原因是打击到了反对人的利益;5;2;7;18388;0.0003806830541657603
116489;说个好笑的，我用ai绘画画出来个带水印的;1;7;8;18388;0.00043506634761801175
116491;连数位板都没碰过算什么画画;40;3;43;18388;0.002338481618446813
116532;我有个疑问，为什么智能化发展为大方向的如今，为什么其他智能化设施，ai软件没人喷呢？一样会造成人失业啊，一样会被资本买断生产工具造成剥削呀（而且已经是现状了）为什么基本听不到反对声音？肯定又要有人说偷换概念了，请仔细想想本质上真的有很大不同嘛，如果有，你换几个再看看呢，所以真的是ai绘画有问题嘛？我觉得单纯只是使用的人有问题。请独立思考后再理智和我讨论谢谢，建议私聊方便点，想喷我的别喷我谢谢，我喜欢和文明人讨论doge;10;3;13;18388;0.0007069828148792691
116543;”互联网精神“是这样的偷笑偷笑;10;4;14;18388;0.0007613661083315206
116557;Ai本来就能垫图啊，出来的图比原版还要好看很多呢，还想吃纯手工红利呀;3;4;7;18388;0.0003806830541657603
116561;让ai来打击一部分辣鸡画家没啥不好，真正大佬级的人物都有自己的画风，ai根本不知道为什么某种画风吸引人，想让ai能影响到那种画家还早呢，冷军画的再逼真也比不上相机照的，说到底还是那些本身没啥实力的叫的最欢，本身画就低创，和ai一个创新水平，当然要抵制了，至于侵权问题从法律上来说目前就是不侵权的，等后面法律完善就好了，别跟我杠侵权问题，杠就你说得对，比法律还懂;4;2;6;18388;0.0003262997607135088
116566;不是很理解各位为何义愤填膺。Ai实际上在促进整个插画行业发展。低端的、重复性的画作是时候该被AI的创造所取代。至于侵权，首先，我认为只要不盈利，就无所谓侵权；第二，关于损害画师利益，这么说罢，汽车司机取代了马车夫，也损害了马车夫的利益，难不成我们要为了马车夫的利益而停止汽车吗？我个人认为，与其说抵制AI，不妨改为利用AI就像利用套索工具那样。实际上，这也是一个先进生产力被旧有的生产关系所牵制的活生生例子。;8;2;10;18388;0.0005438329345225147
116575;难道用经验和手画画比用显卡和算法来的高贵？这不就跟照相机完美淘汰中世纪油画人员一样吗;2;2;4;18388;0.00021753317380900588
116578;这是历史必然，我站在AI这边。我觉得AI公司已经很尊重版权了，起码你还能在它的库里面查到。有些公司直接爬，人家根本就不告诉，也没不鸟你。我认为AI并没有侵犯这位女士的版权，喂的是数据，并没有拿你的作品去商用。生成了的图片版权也是AI的，至于像我只能说，大家都是站在巨人的肩膀上，AI需要学习;2;3;5;18388;0.00027191646726125733
116584;ai的正确方式是闷声发大财，模型训练还得靠各位大大喂图呢，这时候去跳脸无异于端着碗筷骂娘;2;1;3;18388;0.0001631498803567544
116588;文生图和图生图不一样的好吧;3;1;4;18388;0.00021753317380900588
116592;图片从素材库里删除没用已经被压缩成向量格式封入模型中;2;1;3;18388;0.0001631498803567544
116596;提供一种抗辩：我使用人类公共知识资源总结了一套学习方法进行自学，拿被公开的图片进行临摹并且取得了很好的效果。那这样我应不应该支付？属不属于侵权？大笑;16;1;17;18388;0.000924515988688275
116614;我始终为AI站台，现在不为AI说话，明天就永远不会到来。;2;4;6;18388;0.0003262997607135088
116618;可是我ai绘图不是为了给别人看诶，我就是为了给自己看啊，我可以不去学绘画就能拥有绘画的能力，为什么我要去否认它啊，只能说优胜劣汰。;20;2;22;18388;0.0011964324559495323
116639;ai本体也就几个g，还可以不联网运行也就是说根本就没有什么从网上扒素材库拼接这种情况训练好后你是根本找不到训练集的;17;2;19;18388;0.0010332825755927778
116657;之前qq的ai绘画不是很火嘛，我就把一些经典梗图拿去生成了，然后随手转发到一个游戏群里，然后就被ai警察出警了，还叫我多玩点，过不了多久就能看到拿你脸生成的黄图了我当场就无语了，这些小警察是不知道ai换脸早就有的东西了吗？而且不会有人觉得互联网有隐私吧？你发的朋友圈和qq空间全都看得到，你只要在第三方软件打开摄像头就会被看到，真的魔怔了，如果怕遇到这些事，请立刻离开互联网，现实里也少和不信赖的人说话，因为ai只你的需要一段录音就能掌握你的声音;3;1;4;18388;0.00021753317380900588
116661;哈哈，评论区居然有这么多画师啊;1;5;6;18388;0.0003262997607135088
116663;吃瓜看见一堆传统利益的人被新型技术慢慢超越代替跳脚的评论真的是吃瓜都吃的开心吃瓜;2;6;8;18388;0.00043506634761801175
116666;你画的画交过税吗。见的多了一群小画师画的稀碎还收费贼高，10月份天天在吧里帮别人跑被画绷的图。有多少是为了版权而骂又有多少人是因为ai画的比他好而破防的，挡着她赚钱了？;3;2;5;18388;0.00027191646726125733
116671;评论区是捅了画师窝了思考;2;2;4;18388;0.00021753317380900588
116674;无所谓人类画家也是从模仿抄袭开始然后开始创造ai只不过正在模仿这个过程未来ai创造也只不过是时间问题;1;3;4;18388;0.00021753317380900588
116683;现在已经开始删掉原素材库进行图喂图了借鸡生蛋的过程基本上已经结束了;5;0;5;18388;0.00027191646726125733
116692;说这么多，还不是因为绘圈的人利益被侵犯了，被人抢了饭碗，个个说得义正严辞;4;0;4;18388;0.00021753317380900588
116699;澎湃新闻的了吧;1;0;1;18388;5.438329345225147e-05
116703;我觉得需要约定俗成或者法律来规定Ai绘画。同时可能平台上的画师的合同需要换一个新的，不然画师一定反对;7;0;7;18388;0.0003806830541657603
116711;虚假的ai画手：315r生成图，当辛苦费租借国外软件费。真正的ai画手：勇于与其他画手打架，收费颇高自信满满。;3;0;3;18388;0.0001631498803567544
116728;罗辑指着美术馆那副AI画出来的画说：“那张图看起来不错，这是哪位画的？”大史摇摇头，“都不是，地球上的画家早就失传了，都不用麻烦画家画，就是AI不停地生成，永远不会重复，很带劲儿的东西，我正打算试用一个月”“这就是你对技术奇迹的麻木了，机器能够拥有自己的意识创造艺术，这简直是和盘古开天地一样的大事到现在你也没意识到这是个多么伟大的时代”大史把烟蒂扔掉，想了想又觉得不妥，就又把扔到草坪上的烟蒂拾起来，扔到不远处的垃圾箱里。“我麻木？是你这知识分子想象得太远了，这技术，其实我们那时就已经有了。”“你开玩笑吧？”“要说技术我是不懂，但具体对这事儿多少还是明白一些，因为碰巧我曾使过一种老婆生成器，它不需要人去画，而且也是永远也不会重复，知道是怎么整的吗？它直接从上百万张已经截好的头像进行排列组合。现在也就是这么回事儿，训练方式和算力比我们那时强一些而已。”罗辑站住了，呆呆地看了大史半天，又抬头看看那副AI画作，再想想那个三转二的虚拟形象，终于明白了：不过是数据堆出来的而已，通过对精心挑选和处理的大量数据进行训练，可以对数据集中的元素进行排列组合，同时对图片和文字之间的语义关系进行训练，在一定的数据集范围内进行变换，这种AI生成的任何图片都参考了数据集中的某一部分。正如大史所说，即使在两个世纪前，数据驱动型AI也是一项很普通的技术，之所以在当时没有普遍使用，是因为这种AI对于算力和数据集规模的需求过大，互联网上的图片只有一小部分能够允许在数据集使用，大部分都拥有版权。而在现在这个时代，由于分布式计算的成熟以及部分公司的道德底线，算力和数据集已经极大地丰富了，训练模型所产生的损耗变得可以接受。;1;0;1;18388;5.438329345225147e-05
116730;圈外人：“ai时代来了画师最终要被取代底层画师就开始急了”说实话从ai绘画火起来之后经常看到这样的言论，甚至还有营销号大肆宣扬别学画画去学ai学画画没有前途的思想，导致很多刚刚在画画起步的画手们深陷焦虑，画画人嘛有点焦虑是很正常的不过我想说，要认清楚自己的目标是什么，身为真正热爱画画的人千万别因为圈外人的指指点点而放弃爱好，能拥有一个爱好是一件很难得的事情;1;0;1;18388;5.438329345225147e-05
116748;偏偏还爱到处跳脚胡说八道先把ai打成抄袭再污蔑ai的技术声称ai亵渎灵魂诉说ai是邪恶的发明最后拿到钱了事;1;2;3;18388;0.0001631498803567544
116750;最近上一些绘画网站能感觉到一股死寂，关注的很多画师到好久没发图了;1;0;1;18388;5.438329345225147e-05
116758;卢德主义者赢不了。;1;0;1;18388;5.438329345225147e-05
116767;吃瓜，抢的又不是我的饭碗，砖头不砸在我头上我是不会觉得疼的吃瓜;1;0;1;18388;5.438329345225147e-05
116771;AI绘画就是在虐杀绘画行业;1;0;1;18388;5.438329345225147e-05
116775;那怎么查ai素材库呢;1;0;1;18388;5.438329345225147e-05
116777;小黑比比Q妈耶;2;0;2;18388;0.00010876658690450294
116780;没用的，知道版权的人就是懂，不知道就是不懂，这波ai潮是抵挡不住的，受害不能避免;1;0;1;18388;5.438329345225147e-05
116782;这和描图差不多是一个性质的吧？不要脸的人真让人害怕;1;0;1;18388;5.438329345225147e-05
116784;这两个月出现了好多的画手拿着AI生成的画去接稿，AI不会画手，手部就会拿什么水印挡住，我还刷到了好几个被骗的;1;0;1;18388;5.438329345225147e-05
116788;我自己画了一张图丢进ai生成，再用生成的继续画画加工蜜桃猫苦鲁西，这也是侵权吗？;2;0;2;18388;0.00010876658690450294
116791;研发Ai绘画的太缺德了;9;0;9;18388;0.0004894496410702633
116801;开发一种无素材AI的算法，;4;0;4;18388;0.00021753317380900588
116813;为什么不去喂动漫截图呢？一集能喂好多张吧。笑哭;1;0;1;18388;5.438329345225147e-05
116821;6pen上画的画（我自己搞鼓的）上面角落就有画师签名这玩意自用看着好玩就可以了，或者你从事绘画方面搞点tag组合私底下激发灵感也行辣眼睛;1;0;1;18388;5.438329345225147e-05
116831;普通人自己玩玩还好;1;0;1;18388;5.438329345225147e-05
116839;技术从头到尾都不是中立的。只有那些对技术的历史一无所知的人，才会相信技术是完全中立的。波兹曼《娱乐至死》;1;13;14;18388;0.0007613661083315206
116841;但ai画的越来越好事实;2;3;5;18388;0.00027191646726125733
116844;省流草方块马赛克窑洞建筑美学茅厕日式欧式中式;23;2210;2233;18388;0.12143789427887752
116868;《人类房屋进化史》;5;528;533;18388;0.028986295410050034
116874;说出来你可能不信，这居然是某个皮肤画出来的;8;224;232;18388;0.01261692408092234
116883;最后把泥土变成房子了是吧;2;91;93;18388;0.0050576462910593865
116886;从泥土演变成现代建筑，不仅代表着原始时代到现代社会，也代表了玩家从一个泥土做的辣鸡火柴盒到豪华大别墅，更代表着玩家从萌新到大佬的过程（编不下去了没词了）。;2;69;71;18388;0.003861213835109854
116889;我以为ai又奔着歼星舰去了笑哭笑哭笑哭;2;39;41;18388;0.00222971503154231
116893;AI只会画日本那一套，如果一直画下去变成二次元萌妹是迟早的事;4;11;15;18388;0.000815749401783772
116898;真草房子;1;10;11;18388;0.0005982162279747662
116900;再来30次肯定变人;1;9;10;18388;0.0005438329345225147
116902;tnnd，为什么不能撅;2;8;10;18388;0.0005438329345225147
116916;可以撅力（喜）;2;2;4;18388;0.00021753317380900588
116919;画多久才可以撅doge;1;2;3;18388;0.0001631498803567544
116922;可以橛了。doge;1;2;3;18388;0.0001631498803567544
116932;有时候感觉日本一些建筑挺有欧洲的味道，以前去札幌玩的时候我记得有个地方就特别像;1;1;2;18388;0.00010876658690450294
116936;b站冷知识：点赞是免费的，却可以让做视频的up开心好几天硬币是珍贵的，投币却可以让你我更快成为六级大佬收藏夹的容量是无限的，却可以让视频成为你永久的回忆。三连是神圣的，请把你们神圣的三连交给up吧给心心;1;1;2;18388;0.00010876658690450294
116943;草房子doge;1;1;2;18388;0.00010876658690450294
116985;房子好好看，摄了;1;0;1;18388;5.438329345225147e-05
116991;卧槽好涩MD受不了我去一趟厕所;1;0;1;18388;5.438329345225147e-05
117014;我比较好奇为什么你和秋叶大佬的都是黑的背景，而我的是白的，是单纯调了颜色还是版本不一样笑哭笑哭笑哭笑哭;16;23;39;18388;0.002120948444637807
117031;修手没有演示是因为修手成功率还是太低了妙啊;2;15;17;18388;0.000924515988688275
117036;还是不会啊，我用MAC连stablediffusion都安装不来;2;0;2;18388;0.00010876658690450294
117039;大佬，请问那个上传蒙版怎么用？应该上传什么样的蒙版？;2;0;2;18388;0.00010876658690450294
117042;所以anythingv30ckpt在那里下载呢;1;0;1;18388;5.438329345225147e-05
117045;融合模型，308010G爆了两次显存笑哭重启电脑第三次才融合成功。;2;0;2;18388;0.00010876658690450294
117051;李就是我的理塘王;1;0;1;18388;5.438329345225147e-05
117056;up求教我的不管怎么重绘都没用，原来是啥样之后就是啥样，这是怎么会事？;5;0;5;18388;0.00027191646726125733
117064;融完模型之后加载出报错copyingaparamwithshapetorchSize320933fromcheckpointtheshapeincurrentmodelistorchSize320433喜极而泣请问下up有没有遇到过这个情况，有什么解决的办法吗，torch版本1121cu116;1;0;1;18388;5.438329345225147e-05
117069;效果不如原模型，在Anything中测试的。也是15和对应的inpaint，已经anything3，不知道是哪里出了问题;1;0;1;18388;5.438329345225147e-05
117072;难道有东北话AI配音了？;2;0;2;18388;0.00010876658690450294
117076;这个局部重绘模型通用么，画写实人像的也能用？;1;0;1;18388;5.438329345225147e-05
117078;想问一下大佬局部重绘老是失败，蒙版涂成啥样，出来的结果还是啥样的，是什么情况导致的？;2;1;3;18388;0.0001631498803567544
117091;up主，按你的视频操作了以后我的webui一只报ErrormergingcheckpointsThesizeoftensora9mustmatchthesizeoftensorb4atnonsingletondimension1这是怎么回事呀;2;0;2;18388;0.00010876658690450294
117094;up想问下webUI顶部那一排可以选择超网ClipSkipVAE的功能是哪个插件？好像很方便诶;2;1;3;18388;0.0001631498803567544
117100;这个画成啥样就实时显示啥样在哪里开啊？;2;0;2;18388;0.00010876658690450294
117104;请教一下，我inpiant完的图再用来下一次inpaint，迭代几次以后发现图片其余地方变模糊了，最终放大分辨率也不会再变清晰。这个是因为我的操作有问题吗，难道不是只有重绘的地方会改变吗？;1;0;1;18388;5.438329345225147e-05
117106;刚好遇到这个问题doge;1;1;2;18388;0.00010876658690450294
117108;我的模型天天漏牙，很恐怖笑哭;2;2;4;18388;0.00021753317380900588
117113;难受笑哭笑哭;1;0;1;18388;5.438329345225147e-05
117115;我这边的报错消息是“合并检查点时出错“nonetype”对象没有属性“pop”。;2;3;5;18388;0.00027191646726125733
117118;直接爆内存了怎么办笑哭;3;0;3;18388;0.0001631498803567544
117124;尝试了很多次都是runtimeerrorthesizeoftensora9mustmatchthesizeoftensorb4atnonsingletondimension1，怀疑是我电脑配置太低的问题，暂时先放弃了保卫萝卜哭哭保卫萝卜哭哭保卫萝卜哭哭，三连留个爪印，以后换了电脑玩再来保卫萝卜哇;1;0;1;18388;5.438329345225147e-05
117126;当然也可以用来脱衣服脑洞波系列主题装扮向晚酷;1;0;1;18388;5.438329345225147e-05
117130;你们自己看吧笑哭;17;110;127;18388;0.006906678268435936
117149;呦西，花姑娘，然后后面该说什么才能配得上大佐的气质？;1;37;38;18388;0.0020665651511855556
117151;为什么突然就变了？doge;1;36;37;18388;0.002012181857733304
117154;看到封面的第一眼我居然看成了霍雨浩笑哭;3;9;12;18388;0.0006525995214270176
117163;14秒那个是原图的巅峰dogedogedoge;1;3;4;18388;0.00021753317380900588
117183;问一下？这个背景BGM是什么？谢了;2;0;2;18388;0.00010876658690450294
117192;这东西挺好期待以后完善让我的甲方都用上让他们知道自己表达出来的东西到底是啥;14;689;703;18388;0.03823145529693278
117207;边看边捅了自己四根胰岛素跪了;1;114;115;18388;0.006254078747008919
117209;为啥小食觉得丑黑手觉得漂亮因为情人眼里出西施doge;1;68;69;18388;0.003752447248205351
117211;这个尽量还是不要玩吧，它的素材和画风都是从各个画手那里扒来然后汇总的，也没有授权就能随便用，你的照片会汇入大数据里，以后别人也是随便用的;37;451;488;18388;0.026539047204698716
117249;打完胰岛素我歪个楼，小食你这套制服谁家的啊，看起来可以穿着面试的亚子（来自0offer的毕业生大哭）;1;30;31;18388;0.0016858820970197955
117268;这跟我用的小程序一样诶;1;0;1;18388;5.438329345225147e-05
117273;多人一般都会离谱脱单doge;1;1;2;18388;0.00010876658690450294
117276;换个AI吧，这么多AI就这个要排队;1;0;1;18388;5.438329345225147e-05
117287;知道画师为啥不会被AI淘汰吗？因为AI绘图需要精确描述OK;1;16;17;18388;0.000924515988688275
117297;求问什么app;1;0;1;18388;5.438329345225147e-05
117299;这种AI让我好有危机感啊，以后可能我们画手就被这种AI取代了。。。大哭;3;0;3;18388;0.0001631498803567544
117319;所以，封面那张眼睛正常的图咋来的妙啊;1;2;3;18388;0.0001631498803567544
117327;俺也想要，什么软件啊;6;4;10;18388;0.0005438329345225147
117335;一直想知道这是啥软件呀？好想试试保卫萝卜哭哭;3;1;4;18388;0.00021753317380900588
117343;透明雨衣transparentraincoat百搭有驚喜嘟嘟;5;171;176;18388;0.009571459647596259
117350;github上有没有图转文功能的项目？比如识别一张非ai或人工绘制的图片里所包含的元素，把识别出的元素添加进ai画图里就能生成类似画面的;5;17;22;18388;0.0011964324559495323
117358;高低不同颜色的丝袜是什么tag啊笑哭;3;2;5;18388;0.00027191646726125733
117362;乞丐装咋弄，到处都是补丁的哪种doge;1;5;6;18388;0.0003262997607135088
117367;什么时候讲一下建筑星星眼星星眼;1;0;1;18388;5.438329345225147e-05
117369;up啥时候能出一个中国风服装的科普和头饰的科普doge想生成民国校服那种风格，结果ai一直画成日式校服笑哭;2;5;7;18388;0.0003806830541657603
117372;怎么生成全身立绘呀？我生成的都是大头;5;2;7;18388;0.0003806830541657603
117379;提个意见（不过可能只是我个人感受），字幕的话还是纯色下面这种传统风格，这种看得比较舒服，现在这种竖排彩色看得有点别扭难受，不符合平时的习惯藏狐藏狐;2;2;4;18388;0.00021753317380900588
117382;在这里问一下，如何生成异瞳人物啊，比如一只眼睛是红色另一只是蓝色的那种。要打什么tag，想试着整一些眼睛颜色不一样的人物;2;1;3;18388;0.0001631498803567544
117385;有没有修手的tag，手经常崩，偶尔有正常点的，而且还经常抱手笑哭;4;0;4;18388;0.00021753317380900588
117391;请问如果用一个关键词来概括归纳所有服装造型的种类统称，应该是哪个英文单词？;2;3;5;18388;0.00027191646726125733
117394;兜帽、雨披如果想带上帽子，盖住发型的，该怎么写;4;4;8;18388;0.00043506634761801175
117415;如何不换人物只换衣服呢？;1;0;1;18388;5.438329345225147e-05
117424;为什么我的AI那么憨？笑哭;15;860;875;18388;0.04758538177072003
117440;有些眼瞳不一样，颜色也不一样脱单doge;3;509;512;18388;0.027844246247552752
117444;聪明的AI已经知道把手藏起来了doge;4;1321;1325;18388;0.0720578638242332
117449;这个bgm配ai可以说是地狱笑话了;9;448;457;18388;0.02485316510767892
117459;一个月前还在说这ai能淘汰低级画师，现在中高级的都不好说思考;91;482;573;18388;0.03116162714814009
117551;为什么我能从中看到了doge希儿，识宝，爱莉的身影吃瓜;13;285;298;18388;0.016206221448770937
117565;个人感觉最好的一期，有一说一，虽然有很多缺点，但AI画细碎的头发和又炫又时髦的衣服，眼睛时还是很强的;10;142;152;18388;0.008266260604742223
117576;每次看到很棒的ai作品，总有一种伤感。是吃了哪位画师的作品才有这种风格，才画的这么棒保卫萝卜哭哭;51;106;157;18388;0.00853817707200348
117628;吃瓜发动态吧喜欢;2;29;31;18388;0.0016858820970197955
117631;现在最怕的就是把ai作画当成自己的作画，开始到处嘲讽的人。成功来得太容易，人就容易丧失底线。;2;47;49;18388;0.002664781379160322
117634;Ai已经不是开始那种生硬的拼接画师图片了，而是能模仿画师的画风，按关键词自己生成。对真人画师麻烦且繁琐的步骤，它需要几分钟就能出一堆，鬼知道ai未来会进化到什么地步;4;54;58;18388;0.003154231020230585
117640;我越看越不甘心啊凭什么好多画师们练了那么久画画，辛辛苦苦的练，结果还没有AI发展那么一会画的好，AI只需要吞画画厉害的太太的画就可以封死好多画师的路，最可怕的是它还可以接着发展，AI迟早顶替画师吧;12;42;54;18388;0.0029366978464215794
117653;AI不是自己画的，是靠别的大佬的图，喂给AI，AI进行拼图才得到的。这在某种意义上算是侵权了;4;25;29;18388;0.0015771155101152925
117660;好康;1;7;8;18388;0.00043506634761801175
117663;奥比岛点赞;1;2;3;18388;0.0001631498803567544
117665;崩坏3赞神乐七奈好耶;1;6;7;18388;0.0003806830541657603
117669;为什么大伙评价al画的就全是挑刺呢？;2;1;3;18388;0.0001631498803567544
117676;没啥问题啊，弱人工智能在当前领域就是超越所有人啊，定义就是这样热;1;1;2;18388;0.00010876658690450294
117680;人不过也是把看到的颜色加以利用吧，所以说实话我很看好艺术家用ai进行艺术创作的;3;11;14;18388;0.0007613661083315206
117686;什么时候可以建模呢，画画要弄成动漫还是太累了，模型弄动画更有优势;1;1;2;18388;0.00010876658690450294
117690;求背景音乐抓狂;2;1;3;18388;0.0001631498803567544
117694;是挺能画的，不过手永远是硬伤，光这一点就比不上画师;23;6;29;18388;0.0015771155101152925
117730;AI画出来的眼睛没有灵魂。;6;6;12;18388;0.0006525995214270176
117739;up用的什么软件，AI这么聪明doge;1;3;4;18388;0.00021753317380900588
117741;投币了图我拿走了脱单doge;1;3;4;18388;0.00021753317380900588
117743;打call好看，什么模型啊;1;4;5;18388;0.00027191646726125733
117748;星尘比心星尘比心星尘比心;1;2;3;18388;0.0001631498803567544
117750;热词系列三连求度盘图包;5;2;7;18388;0.0003806830541657603
117756;大大好强Akie秋绘比心Akie秋绘比心;1;1;2;18388;0.00010876658690450294
117766;再能画也是拼尸微笑微笑微笑微笑微笑微笑微笑微笑;1;0;1;18388;5.438329345225147e-05
117792;up你是用的本地的还是在线的画的啊来古震撼;4;0;4;18388;0.00021753317380900588
117800;什么软件分享一下脱单doge;1;0;1;18388;5.438329345225147e-05
117821;bgm是什么啊;2;0;2;18388;0.00010876658690450294
117827;求AI软件;1;0;1;18388;5.438329345225147e-05
117833;建议里面混几个真正的画师作品，让大家来猜哪个是？脱单doge;3;0;3;18388;0.0001631498803567544
117852;色彩方面已经很强了，感觉现在就差眼睛嘴巴和手有些瑕疵了。;1;0;1;18388;5.438329345225147e-05
117856;这种Ai指令要怎么说，求说句;1;0;1;18388;5.438329345225147e-05
117858;ai生出来的图分辨率是多少呀;1;0;1;18388;5.438329345225147e-05
117861;ai画图可以让他模仿固定的某一个画师的风格吗？给他喂固定画师的画能让他画出差不多的吗;1;0;1;18388;5.438329345225147e-05
117864;我并不是很认可ai啊，为什么？因为我是美术生无语；（喷子走开啊，还有我挺喜欢up）讲真的ai不可能威胁到画师的，毕竟ai的画都是从一些知名画师那演变过来的；假如你是甲方（商用）你会选择只有大块面的色块，还是有大块面有细节的色块，那怕是低级画师他对事物的处理那一点不比ai弱？（以上可当废话）ai其实就是那些不会画画的或者懒的画画的人的玩具，对玩具，别在说什么ai抢饭碗什么的了？妙啊（都可以当废话脱单doge）;2;0;2;18388;0.00010876658690450294
117874;可以用来当头像不星星眼;1;0;1;18388;5.438329345225147e-05
117885;个人感觉ai的统一眼神无神;2;0;2;18388;0.00010876658690450294
117898;AI画的手指头很怪大哭笑哭;1;0;1;18388;5.438329345225147e-05
117911;学美术的都学过一句话：画人难画手，所以AI绘画很难把人手画好，一旦把人手画的活灵活现了，到那时AI绘画真的就完美到无懈可击了笑哭;1;0;1;18388;5.438329345225147e-05
117926;求图包喜欢;1;0;1;18388;5.438329345225147e-05
117933;卧槽好看求图已三连;1;0;1;18388;5.438329345225147e-05
117935;我家台灯看了拿了一包纸进厕所了doge;2;76;78;18388;0.004241896889275614
117947;两张图就变性的屑;1;18;19;18388;0.0010332825755927778
117952;我怎么觉得是倒放doge;1;2;3;18388;0.0001631498803567544
117962;这个音乐星星眼;1;0;1;18388;5.438329345225147e-05
117964;没办法，我自己试了那么多次AI就是涩不起来，还是比画师少了很多灵魂，想必这就是传说中的人文情怀吧脱单doge笑哭;1;41;42;18388;0.0022840983249945617
117966;这一期太对xp了。;1;33;34;18388;0.00184903197737655
117968;xdm争取每日一更，每期图包都会发专栏星星眼;8;11;19;18388;0.0010332825755927778
117977;感觉可以喂一些himitsu的画进去，那个质感也很好;5;43;48;18388;0.0026103980857080703
117984;关注公众号了，针不挫doge;1;10;11;18388;0.0005982162279747662
117986;有美少女的地方就有我星星眼我的梦想是下辈子转生到剑与魔法的世界当个白毛红瞳的血族小萝莉然后和其她萝莉贴贴害羞（已经为自己转生提前写好设定了感兴趣的可以来看看cv12364446）;1;8;9;18388;0.0004894496410702633
117988;模型很好歌也很好墨镜;2;8;10;18388;0.0005438329345225147
117991;没图包很难让人三连啊;1;0;1;18388;5.438329345225147e-05
117993;我爱啦;1;1;2;18388;0.00010876658690450294
117995;想问一下公众号名字叫啥给心心;1;0;1;18388;5.438329345225147e-05
117997;这是himitsu的画风？;5;2;7;18388;0.0003806830541657603
118003;ai绘画还要收费？;1;0;1;18388;5.438329345225147e-05
118006;这个是什么软件呀UP能教教吗？;2;1;3;18388;0.0001631498803567544
118010;up，这模型下载后该丢哪里啊;4;0;4;18388;0.00021753317380900588
118015;下载好之后设置为手机壁纸好糊呀有大佬知道什么情况吗？;1;0;1;18388;5.438329345225147e-05
118018;自己训练？强的脱单doge脱单doge;1;0;1;18388;5.438329345225147e-05
118021;up的lora是影响原模型画风的那种吗，还是只会修腿星星眼，顺便问一下能不能出一个裸足的lora吃瓜;1;0;1;18388;5.438329345225147e-05
118023;模型怎么用啊，几个月前的novelai还能用吗;1;0;1;18388;5.438329345225147e-05
118028;请问这是什么AI软件制作出来的呀;2;0;2;18388;0.00010876658690450294
118033;我想要图文。;1;0;1;18388;5.438329345225147e-05
118041;公众号是在哪里？;1;1;2;18388;0.00010876658690450294
118044;多来点星星眼星星眼;1;1;2;18388;0.00010876658690450294
118046;可以发个图包吗大佬;1;0;1;18388;5.438329345225147e-05
118050;模型能分享吗doge;1;0;1;18388;5.438329345225147e-05
118053;有没有图星星眼;3;0;3;18388;0.0001631498803567544
118057;我劝你快点把图包发给我，万一我穿不上裤子，那up你就要倒大霉了doge;1;0;1;18388;5.438329345225147e-05
118059;这用的哪个绘画软件呢？;1;1;2;18388;0.00010876658690450294
118063;C酱兔兔纪念装扮流汗UP用的参数和tag模型能透露一下吗，用AOM3跑出来的都是邪神C酱兔兔纪念装扮流汗C酱兔兔纪念装扮流汗C酱兔兔纪念装扮流汗;1;0;1;18388;5.438329345225147e-05
118065;刚才那期怎么没了（;1;0;1;18388;5.438329345225147e-05
118071;公众号来自未来没有找到，只有个空号笑哭;3;1;4;18388;0.00021753317380900588
118075;我用了模型和没用模型怎么都一样啊笑哭是要训练过才行吗？;6;0;6;18388;0.0003262997607135088
118088;这个看起来不错啊，求分享;1;0;1;18388;5.438329345225147e-05
118090;麻了怎么搞都画不出来一张清楚的，抄别人的都画不出来，恼死了;4;2;6;18388;0.0003262997607135088
118095;图包呢，求图包星星眼;2;0;2;18388;0.00010876658690450294
118099;某些小画家为了自己有虚荣心用ai绘画向朋友展示“自己的画作”这让我很讨厌;1;37;38;18388;0.0020665651511855556
118101;艹，拜ai所赐，现在我在P站一看到巨佬的画，第一时间是看手或头顶不思议之旅冷漠;9;35;44;18388;0.0023928649118990647
118111;很想问一下，如果我拿ai软件处理实景图当背景给画师用（因为不想花钱付背景图），画师会反感吗;4;13;17;18388;0.000924515988688275
118118;AI当游戏玩玩就得了，有些人还真认为AI也算是创作辣眼睛;9;12;21;18388;0.0011420491624972808
118128;你的理解有问题，AI不是在拼接，他是真的在画，但确实不可能替代画家，先通过图灵测试还差不多;1;6;7;18388;0.0003806830541657603
118130;能靠画画为生的人，ai水平太低影响不到。而所谓绘圈更多是满足小孩子过家家的社交需求，也不会选择ai。所以根本没必要去敌视这个东西。;1;6;7;18388;0.0003806830541657603
118134;感觉大致意思就是画家怕别人抢饭碗呗吃瓜（纯路人可以解释，没必要碰）;8;6;14;18388;0.0007613661083315206
118143;下方up主推荐广告体验不一样的AI绘画。求求你至少先了解一下不同类型的ai绘画都是什么然后再来说版权吧。。。直接地图炮不太好吧。。;6;3;9;18388;0.0004894496410702633
118151;我搞ai就是闹着玩的还是正常找画师约稿最好;1;2;3;18388;0.0001631498803567544
118155;之前我就听说过了，ai绘画的本质是“拼尸块”用很多画师的作品根据关键词每个作品截一点拼凑成一个“作品”没想到是真的;2;1;3;18388;0.0001631498803567544
118171;AI绘画永远也不要进步;2;1;3;18388;0.0001631498803567544
118191;角度不同吧，ai画不出来故事，但是通过大量的画作分析布局，从而重新创造出另一副事态人们通过其成长获得新思路，ai的作用就是帮助人类更快解决瓶颈;1;1;2;18388;0.00010876658690450294
118197;ai绘画其实很垃圾，尤其是你像画一个有同名的角色，人体结构也不好，还很猎奇，画质渣的一批，明显画师约稿更值doge;1;1;2;18388;0.00010876658690450294
118199;说白了不管人类绘画还是ai绘画，就是术业有专攻的问题，一个没有任何绘画基础的人画出来的是依托答辩，一个没有任何ai使用经验用ai画出来的也是依托答辩辣眼睛;1;0;1;18388;5.438329345225147e-05
118207;AI取代不了高创，但是低创画师就没了，有益无害;1;0;1;18388;5.438329345225147e-05
118213;评论区里面，有人被触碰利益，已经开始急眼了doge;26;0;26;18388;0.0014139656297585382
118241;其实我感觉就是弄着玩的，不会用到什么正经事上doge;1;0;1;18388;5.438329345225147e-05
118245;新技术出来了就是出来了，你反感技术也不会消失，而且技术还会跟你卷，现有情况不如直接接受当辅助或者卷铺盖跑路，除开特殊情况以后画师这行顶级以下肯定没钱赚，只不过会过滤出想画的和想赚的，线下以及一些方面上的绘画不会受影响;1;0;1;18388;5.438329345225147e-05
118248;以下仅陈述个人观点1AI的利在上层阶级资本家看来，驯服ai远比投入大量钱财、时间寻找喝水的画师合适，经常可以在评论区看到“ai不会画手”“ai的画没有感情”等字样，不然，我人为只要图喂得够多，训练次数够多，那么ai也同样能“以假乱真”，到那时，ai的画风会各式各样，也很难分辨出是否是ai绘画。2AI的弊也经常能看到AI的图是偷来的，事实上这是开发者的问题，如果与上层及顶层画家谈好版权，那么不仅版权解决了，上层人们分到的蛋糕也肯定会更多；之前看过一位up说过，一个大项目需要10个高层画师商讨完成，且工期是三个月，那么在ai达到一定高度时，也就只需要一半甚至不到的画师留下改进ai的作品，工期也将大大缩短3关于AI在未来，AI肯定会和各行各业息息相关就像一次工业革命时那样，我们不可能像那时的人们一样愚蠢到去破坏蒸汽机（即现在的人工智能）我们应该接受，并改良，应该有适当的法律约束（我相信一定会有的）4总结AI的出现并不会撼动顶层画师的铁饭碗，更不会影响到资本家的蛋糕，影响的只会是中层以下的画师，我们与其举牌抗议AI，倒不如多练练提升自己画技保卫萝卜哇AI本身并没有错错只是错在没有法律的约束，从而导致某一部分人行不正之事;2;4;6;18388;0.0003262997607135088
118258;动画人表示挺期待的，可以用ai大大降低工作量;64;295;359;18388;0.019523602349358276
118323;训练的时候得给它很多很多优秀的人物精模吧;18;138;156;18388;0.008483793778551229
118342;ai是好就怕画了老久的画快画完了别人喂给ai先你发图“诶，明明你抄袭的我”辣眼睛;8;117;125;18388;0.006797911681531434
118351;别糊弄人了好吗？那些软件连最基本uv和拓扑都搞不定现在。;20;59;79;18388;0.004296280182727866
118373;为什么不弄个ai音乐，ai电影，要是你们能欣赏得来这些就知道ai绘画是什么屎了;9;41;50;18388;0.0027191646726125733
118383;AI造人指日可待脱单doge;2;24;26;18388;0.0014139656297585382
118386;以后大家想要自己画画做动画做音乐，只要有点子灵感都能自己用ai做，不用门槛了，什么真正的共产主义;7;30;37;18388;0.002012181857733304
118394;个人觉得还是要参考一下围棋AI的发展，一开始确实需要人类的定式，后来呢，人类变成了负担。别以为画画，建模又有太多不同。诚然围棋的目标是明确的，也就是围更大的地，而画画艺术之类的，要取悦人。但我们知道人并不是有灵魂的，人只是一团血肉罢了，是可以分析的，可以理解的可以定性的定量的。换句话说会有难度，但逻辑上并非不可能。哎，再看看，如今抖音金曲之类的，是不是越来越的简单无脑，偏偏他们最火。;1;6;7;18388;0.0003806830541657603
118397;把别人的努力与心血全部喂给自己的ai，给自己赚钱更准确的说，是抢钱吃瓜;9;14;23;18388;0.0012508157494017839
118407;有这能力只训个尼子？doge;5;11;16;18388;0.0008701326952360235
118414;大家都不用花时间学了直接摆了;1;4;5;18388;0.00027191646726125733
118419;ai赶紧进步，降低建模门槛，这样我就能不花钱自己产出建模了捏给心心支持ai喵支持ai喵支持ai谢谢喵喵喵。;1;0;1;18388;5.438329345225147e-05
118425;ai大的来说不可能取代人类，但重点是，它可以取代很多中下工作者，这才是需要注意的地方，不要什么整天扯什么艺术ai人类什么的，聊现实的跟直接;1;2;3;18388;0.0001631498803567544
118435;藏狐藏狐不是，如果布线全乱的那也仅仅只能建个模敢上贴图麽藏狐;4;2;6;18388;0.0003262997607135088
118441;麻烦ai学会展好uv。太麻烦了。;4;1;5;18388;0.00027191646726125733
118446;AI发展就像刘慈欣写的“诗云”，很美，但没办法从中筛选出自己最需要的。;2;2;4;18388;0.00021753317380900588
118452;对我普通人来说很爽，对设计师来说这个饭碗保不住了吧，甚至有的ai只看绘画真的很优美各种元素还是秒出图，幸好我不是学绘画的笑哭;5;2;7;18388;0.0003806830541657603
118466;bgm是什么啊好耳熟;1;0;1;18388;5.438329345225147e-05
118470;希望Ai是建模師的助力而不是替代;1;0;1;18388;5.438329345225147e-05
118475;肌肉加中年雄性加纹身或各种图案等于反派;5;433;438;18388;0.023819882532086143
118481;我个人觉得国内的反派就是那种操纵全局，用谋略致胜，外表最不凶狠反而面相和蔼会穿着唐装坐在茶室里一边聊天一边走下一步的那种。这种BOSS往往气质上就打败了一大批那种凶神恶煞的反派，属于是压迫感最强的。星星眼;56;725;781;18388;0.042473352186208395
118538;省流中国在0257;26;93;119;18388;0.006471611920817925
118565;中国人最重要是内敛。反派必然是足智多谋型，能不能打不重要，但气场和智慧必须要max。;7;100;107;18388;0.005819012399390907
118573;一堆杜姆既视感tv笑哭;1;101;102;18388;0.00554709593212965
118577;怎么这么多光头。。。。。;4;25;29;18388;0.0015771155101152925
118583;这很多不像是反派倒像是他们的民族英雄;1;9;10;18388;0.0005438329345225147
118586;这个ai不正确为什么反派几乎都是黑人doge;1;1;2;18388;0.00010876658690450294
118597;中国的坏人：千姿百态，难以形容中国的反派：从古至今一直都是外敌;4;2;6;18388;0.0003262997607135088
118623;可汗赶紧更，好多小国我都不认识;1;0;1;18388;5.438329345225147e-05
118625;ai画工不错，但人物都能一眼看出原型。说白了，就是抄;1;0;1;18388;5.438329345225147e-05
118631;AI只会抄袭吗？？;1;0;1;18388;5.438329345225147e-05
118657;机器工具人识别歌曲;1;0;1;18388;5.438329345225147e-05
118672;阿尔巴尼亚那个一眼杀手47;1;0;1;18388;5.438329345225147e-05
118680;为什么刚果是猩猩笑哭;1;0;1;18388;5.438329345225147e-05
118682;很美漫风甚至有几个就很明显是dc的反派;1;1;2;18388;0.00010876658690450294
118687;UP免费次数用完了在哪里绑银行卡。。已三联打call;3;11;14;18388;0.0007613661083315206
118691;能画naifu那样的吗;3;15;18;18388;0.0009788992821405265
118695;该服务器已达到最大活跃子区数，归档一个子区以释放空间？？？？;1;9;10;18388;0.0005438329345225147
118698;discord已经被禁了;1;3;4;18388;0.00021753317380900588
118700;一直卡在验证手机那个页面;2;3;5;18388;0.00027191646726125733
118705;up这要翻墙吧;2;3;5;18388;0.00027191646726125733
118708;为什么进入网站没有首页呢;4;2;6;18388;0.0003262997607135088
118716;大佬，有关注ui这块吗？刚用了一个产品，是有图层的可编辑设计稿，大受震撼。我私信你他们内部的优先入口了担心自己价值降低中。。。。;1;0;1;18388;5.438329345225147e-05
118733;有几次免费用的机会呀？已经成功进入，感谢UP主;1;1;2;18388;0.00010876658690450294
118740;为何midjourney无法进去嘤嘤嘤;1;1;2;18388;0.00010876658690450294
118745;一直加入不成功，点加入人机验证后还是加入。经过各种尝试。解决办法如下，点加入，人机验证的时候掉，重新点加入。就成功了。呲牙;2;0;2;18388;0.00010876658690450294
118748;奇怪，discord让我验证，我输入手机号码验证码之后弹出输入密码用来修改密码。;1;0;1;18388;5.438329345225147e-05
118751;需要翻墙吗;2;1;3;18388;0.0001631498803567544
118755;看不懂啊discord注册好了，怎么打开midjourney;1;0;1;18388;5.438329345225147e-05
118759;为什么需要手机验证，，，中国的号码还不行;2;0;2;18388;0.00010876658690450294
118762;为什么会卡在接受邀请，要确认是不是人类，一直卡在那;2;1;3;18388;0.0001631498803567544
118773;请问显示该应用程序未响应怎么办;1;1;2;18388;0.00010876658690450294
118776;邀请链接无效了大哭;1;0;1;18388;5.438329345225147e-05
118780;请问加入测试版进不去该怎么办;1;0;1;18388;5.438329345225147e-05
118786;up主，discord打不开是什么原因呢？;1;0;1;18388;5.438329345225147e-05
118788;你好，UP主，打不开原图咋办？是要充钱才能点开原图吗微笑;1;0;1;18388;5.438329345225147e-05
118791;Ai可以写书法不;1;0;1;18388;5.438329345225147e-05
118796;要vpm吗;1;0;1;18388;5.438329345225147e-05
118799;UP是要翻墙才能有吗？？？在线等回复下谢谢;1;0;1;18388;5.438329345225147e-05
118802;大陆手机好收不到验证码啊现在;2;0;2;18388;0.00010876658690450294
118805;medjourney官网是什么;1;0;1;18388;5.438329345225147e-05
118807;这次的年纪大了好多。还是喜欢小小的可爱的;3;15;18;18388;0.0009788992821405265
118811;doge我们浙江人就喜欢这些老婆;7;9;16;18388;0.0008701326952360235
118819;你还真别说，我表妹和这些脸挺像的，尖下巴，肉嘟嘟的脸;2;8;10;18388;0.0005438329345225147
118823;拒绝幼态审美，从他她它做起dogedoge;1;6;7;18388;0.0003806830541657603
118825;真的像从二次元出来的;5;6;11;18388;0.0005982162279747662
118831;脸已经越来越同质化了;6;3;9;18388;0.0004894496410702633
118877;能给个有这个VAE的下载嘛？;2;7;9;18388;0.0004894496410702633
118880;对比度有点太高了，伤眼睛doge;1;3;4;18388;0.00021753317380900588
118882;我一度以为Vae只是会调色，结果差别这么大的吗？？;1;1;2;18388;0.00010876658690450294
118884;大佬这边没有VAE选项怎么办笑哭;1;1;2;18388;0.00010876658690450294
118886;能请问下是几比几吗？;2;1;3;18388;0.0001631498803567544
118889;请问为什么我下载这个vae后，加载不出来;3;1;4;18388;0.00021753317380900588
118893;这是怎么做到的啊，，，，是新的模型吗想把橘子加点蜡笔的颜色进去要怎么做啊大哭;1;1;2;18388;0.00010876658690450294
118896;两个都下载了怎么合并呢;1;0;1;18388;5.438329345225147e-05
118899;首先我不是萝莉控doge;1;5;6;18388;0.0003262997607135088
118920;说明有很多强盗未经画师本人许可将他们的画喂给了ai;7;21;28;18388;0.0015227322166630412
118928;请问视频能放全图吗？截图党一枚。doge;1;9;10;18388;0.0005438329345225147
118930;ai图也有作者是真的难绷，喂的素材都是作者画的？真是说强盗也不为过吃瓜;1;5;6;18388;0.0003262997607135088
118932;网页打开不了;1;2;3;18388;0.0001631498803567544
118944;没了啥都没了;4;0;4;18388;0.00021753317380900588
118961;9527的模型把;1;1;2;18388;0.00010876658690450294
118974;话说，双人图怎么单独控制每一个人物的tag，我基本都是双胞胎笑哭;7;53;60;18388;0.003262997607135088
118982;这下真是把大多数普通画师都要逼死了笑哭;14;36;50;18388;0.0027191646726125733
118997;AI最让我难过的就是永远无法识别手指笑哭，好多美图都被破坏了;6;32;38;18388;0.0020665651511855556
119004;太美了，我都不想画画了笑哭笑哭笑哭笑哭;3;23;26;18388;0.0014139656297585382
119009;这种画风咋出来的啊;1;8;9;18388;0.0004894496410702633
119011;好图，但希望不要看镜头，要看对方吃瓜;2;6;8;18388;0.00043506634761801175
119017;双人图居然不会融在一起，ai的进步神速啊;1;1;2;18388;0.00010876658690450294
119020;可以用来画本子吗;2;1;3;18388;0.0001631498803567544
119025;请问一下up怎么让画面中只出现一个头？就是我一输入了fullbody的tag就容易在背景上再出现一个脸，这种情况怎么处理？;4;1;5;18388;0.00027191646726125733
119033;用的什么模型啊是momokoe吗;1;0;1;18388;5.438329345225147e-05
119035;求tag;4;0;4;18388;0.00021753317380900588
119041;千篇一律，食之无味;1;0;1;18388;5.438329345225147e-05
119043;这画风输的是哪个画师？;1;0;1;18388;5.438329345225147e-05
119045;求问up，为什么我输入了1girl，很多时候还是会出来多个人物呢;1;0;1;18388;5.438329345225147e-05
119055;什么时候al一键生本doge;1;0;1;18388;5.438329345225147e-05
119067;怎么设定一男一女呢;2;0;2;18388;0.00010876658690450294
119078;好家伙，laur的辩护，我明白为啥视频是这个标题了笑哭;2;21;23;18388;0.0012508157494017839
119081;我还在等待（罗兰）我从未离开脱单doge;1;19;20;18388;0.0010876658690450293
119083;合着标题指的是bgm啊。突然又想到几个月前被尾杀薄纱的时代了;1;10;11;18388;0.0005982162279747662
119085;干脆写个同人文得了脱单doge脱单doge脱单doge;4;8;12;18388;0.0006525995214270176
119090;为什么我在看陌陌的同时手动了;3;5;8;18388;0.00043506634761801175
119094;求图求图打call;1;5;6;18388;0.0003262997607135088
119096;等个图包doge;1;3;4;18388;0.00021753317380900588
119101;这个陌是什么意思;6;2;8;18388;0.00043506634761801175
119111;好看的;1;2;3;18388;0.0001631498803567544
119116;求个tag谢谢喵;1;1;2;18388;0.00010876658690450294
119119;喜欢;1;1;2;18388;0.00010876658690450294
119126;好看，求个tag星星眼;1;1;2;18388;0.00010876658690450294
119129;斯哈斯哈斯哈斯哈是我的陌陌星星眼喜欢脱单doge脱单doge打call;1;1;2;18388;0.00010876658690450294
119133;最近出的rog4080笔记本能画瑟图吗？请问up主;1;0;1;18388;5.438329345225147e-05
119142;三连等图包;1;0;1;18388;5.438329345225147e-05
119144;我在河北为最后的杰瑞发声。;10;92;102;18388;0.00554709593212965
119155;这画完就成12了doge妙啊;2;52;54;18388;0.0029366978464215794
119158;泰非是男的还是女的;10;34;44;18388;0.0023928649118990647
119169;首先我不是福瑞，我觉得还是动物好看，其次我不是福瑞，虽然拟人也不错，但是动物更可爱，最后我不是福瑞，真的很喜欢动物版的;6;23;29;18388;0.0015771155101152925
119176;泰菲家族干的真棒，我成女的了;2;15;17;18388;0.000924515988688275
119179;热词系列三连表哥尼宝蒙金奇也安排一下吧打call;1;13;14;18388;0.0007613661083315206
119183;这是我画的呲牙;2;3;5;18388;0.00027191646726125733
119190;这里强推一下美图秀秀画的莉莉脱单doge画的特别好看，就是存在手机里每天晚上有点废身子脱单doge;2;2;4;18388;0.00021753317380900588
119194;现在的AI画东西都这么涩了吗妙啊辣眼睛;6;1;7;18388;0.0003806830541657603
119207;我一看，不觉得很好看笑哭笑哭笑哭;1;0;1;18388;5.438329345225147e-05
119209;音乐叫什么名字啊？;1;0;1;18388;5.438329345225147e-05
119213;第一个我老婆doge;1;0;1;18388;5.438329345225147e-05
119217;图次的花嫁也弄一下吧？;2;0;2;18388;0.00010876658690450294
119220;UP主是男的？变态吗？;1;0;1;18388;5.438329345225147e-05
119226;可能是ai看见了我们看不见的东西吧;3;38;41;18388;0.00222971503154231
119247;chatgptai画图，ai制番指日可待dogedoge;16;106;122;18388;0.006634761801174679
119264;想请教大佬，这ai可以用来生成场景图然后把产品放进去吗。或者给他看产品，直接帮我画进去;9;56;65;18388;0.0035349140743963455
119274;历史的界碑应该以每一次科技的突破为节点，只有科技变革的按钮才能触发不可逆转的历史进程。文明的本质是把身体的功能逐步让渡给工具，科技发展史就是工具改造史、人类进化史。;14;53;67;18388;0.0036436806613008486
119289;这个软件对电脑CPU和显卡有什么要求吗？;22;20;42;18388;0.0022840983249945617
119312;。从信息空间中挖掘符合人类审美的图像是设计师，艺术家的技能。这个技能首先要求人具备审美的能力，后具备挖掘的能力（即创作技能）。一般人比之创作者，主要逊色在创作技巧，俗称脑子：会了，手：你不会。AI很有意思，它迁移了人类的审美，并以此为据生成图像。而数学家做的工作使得AI的审美等价于创作，这不奇怪，每个人都能在脑海中构建图像，而非专业创作者难以变现自己的审美。现在，AI一定程度上平等地给予了每个人这一能力。如果真出了脑机接口这种东西使得人具备了一种审美即创作的能力，那还能怪机器具现了人的想象么（。总结一下，不可否认AI的能力确实超乎想象（对目前的人来说），但它其实还是一个和笔墨一样的工具，都是用来从信息空间中挖掘符合人类审美的作品的工具。在可以预见的未来，生成器的能力会不断变得强大，直至超出人用手工绘制的程度。但归根结底，AI创作的能力上界最终取决于人类审美能力的上界。所以有空喷AI出图不如想想怎么用AI整出更瑟的图才是王道（;20;60;80;18388;0.004350663476180117
119333;结合chat，真的能有可能做出极高自由度的游戏啊。再结合ARVR，太绝了。;3;27;30;18388;0.001631498803567544
119337;ai这个东西真的潜力无限;5;22;27;18388;0.0014683489232107897
119343;生成的pose图可以编辑调整吗？;4;7;11;18388;0.0005982162279747662
119348;感觉好复杂;1;4;5;18388;0.00027191646726125733
119350;这个图生成过程的动画是怎么调出来的呀;1;3;4;18388;0.00021753317380900588
119352;你好，请问视频中webUI里面预览模型能显示相关图片是怎么做到的？比如那个chilloutmixNi模型的图片，是相关插件吗;4;2;6;18388;0.0003262997607135088
119357;请问中间弹出翻译窗口是什么软件;1;1;2;18388;0.00010876658690450294
119360;想要完整安裝方法星星眼;1;0;1;18388;5.438329345225147e-05
119362;所以这个是基于sd的，可我sd部署太坎坷了，至今没成功tv难过;1;0;1;18388;5.438329345225147e-05
119366;已赞，送你上首页;1;0;1;18388;5.438329345225147e-05
119368;卧槽，这对工作很有用啊;16;32;48;18388;0.0026103980857080703
119385;想知道up右下角的这个脸是怎么做到的？;8;13;21;18388;0.0011420491624972808
119394;那给黑白漫画自动上色的ai有没有滑稽;6;27;33;18388;0.0017946486839242985
119402;下载后放到SD的AutoMatic1111的WebUI安装下extensionssdwebuicontrolnetmodels大神这个文件找不到啊;1;0;1;18388;5.438329345225147e-05
119406;3连分享下安装PDF可以嘛你简介验证码是错的;1;0;1;18388;5.438329345225147e-05
119408;三联啦，up可以给个PDF完整版安装流程吗？感谢;1;0;1;18388;5.438329345225147e-05
119410;问下模型预览使用的什么插件微笑;3;0;3;18388;0.0001631498803567544
119414;up大大，为什么我安装了controlnet，但是没有你那一栏大哭;1;0;1;18388;5.438329345225147e-05
119416;有通过多角度照片进行3d可视化的ai嘛doge;1;0;1;18388;5.438329345225147e-05
119419;up你的模型在操作页面是怎样看到图片的，我的只能看到英文名;1;0;1;18388;5.438329345225147e-05
119422;要用显卡吗;1;0;1;18388;5.438329345225147e-05
119425;UP精华包在那下57G实在太大了;2;0;2;18388;0.00010876658690450294
119429;有大佬知道这个怎么改成CPU吗，我的一直是在用GPU运行，老是运行一半就崩了;2;0;2;18388;0.00010876658690450294
119433;这个好像要有8G才行我的1660S6G基本都出不到图;2;0;2;18388;0.00010876658690450294
119436;你好UP主，请问1下你SD里面那个Q版钢铁侠的模型是在哪里下载的呀很喜欢名字是CBZBB;2;0;2;18388;0.00010876658690450294
119440;如果说简易游戏模型然后用ai算法输出游戏画面，那游戏不得质的提升，而且不同场景可以拥有不同关键词，行成不同效果虽然现在看输出会很慢，但相信以后这个技术肯定会用到游戏上;1;1;2;18388;0.00010876658690450294
119442;UP，请教下，你的显卡是啥？或者要啥级别的显卡才能跑的相对快一些。;4;0;4;18388;0.00021753317380900588
119447;老照片修复可行吗;4;0;4;18388;0.00021753317380900588
119452;举手想要PDF;1;0;1;18388;5.438329345225147e-05
119454;想问下大佬模型封面预览图是怎么添加的？微笑;1;0;1;18388;5.438329345225147e-05
119456;说不好听的，现在人工的设计绘画创意太耗时间都是浪费生命，AI分分钟解决需求，解放创作者双;1;1;2;18388;0.00010876658690450294
119458;up下载前我想先请教下如果我下载github上automatic1111版的sd，webui是不是就是纯英文？我看你的是中文版的，是下的国内的吗;2;0;2;18388;0.00010876658690450294
119461;这个插件在下载里面也叫这个名字吗为什么我找不到呢。。;2;0;2;18388;0.00010876658690450294
119469;这玩意可以把漫画家干死;1;1;2;18388;0.00010876658690450294
119471;请问大佬，你的视频右下角的头像动态对口型是怎么弄的？;1;0;1;18388;5.438329345225147e-05
119473;up请问他能做到绘制同个风格的图片吗我想实拍视频配合一些插件让后做动画有可行性吗;1;0;1;18388;5.438329345225147e-05
119477;up主，你的头像换脸是怎么处理的。谢谢;2;0;2;18388;0.00010876658690450294
119487;为什么我的没有绘图过程;2;0;2;18388;0.00010876658690450294
119491;tablediffution整合包在哪下载？思考;2;0;2;18388;0.00010876658690450294
119494;能画涩图吗;2;0;2;18388;0.00010876658690450294
119498;请问大佬，extranetworks里插件（比如lora）的preview怎么设置显示图片呢？;1;0;1;18388;5.438329345225147e-05
119500;我用这个画了五副图赚了75美元，菜菜程序员，半点画画不会;6;2;8;18388;0.00043506634761801175
119507;下载后放到SD的AutoMatic1111的WebUI安装下extensionssdwebuicontrolnetmodels这个文件夹是在哪里？怎么操作？？;2;0;2;18388;0.00010876658690450294
119511;请问UP的电脑配置是什么？怎么生成的这么快;4;0;4;18388;0.00021753317380900588
119516;StableDiffusion模型ckpt用哪个，随便用嘛;1;0;1;18388;5.438329345225147e-05
119520;本来还想学点摄影，用不了多久就被AI代替了，唉;2;0;2;18388;0.00010876658690450294
119523;有没有自动去马赛克的软件滑稽;3;0;3;18388;0.0001631498803567544
119527;到了右下角的摄像头，这个脸型差点，我以为是AI上去的。doge;2;0;2;18388;0.00010876658690450294
119530;我就是老板，哈哈可以不用雇员工了，别告诉别的老板哦。;2;0;2;18388;0.00010876658690450294
119533;有网页版吗？不需要本地部署的;1;0;1;18388;5.438329345225147e-05
119539;首先得有个不错的n卡笑哭;1;1;2;18388;0.00010876658690450294
119541;想问下LORA的那个预览图是怎么有的微笑;3;0;3;18388;0.0001631498803567544
119545;想问一下这个插件可以保持角色原有轮廓不变，改变衣服吗;1;1;2;18388;0.00010876658690450294
119547;这个主要是平面设计的吗？;2;1;3;18388;0.0001631498803567544
119550;有交流群么脱单doge;1;0;1;18388;5.438329345225147e-05
119553;问下那个翻译软件是什么，谢谢;4;4;8;18388;0.00043506634761801175
119558;Up主点赞投币了，求资源打call打call打call。我也是原画师，只能说打不过就加入了;1;0;1;18388;5.438329345225147e-05
119560;这东西啥时候能成为自己喂素材diy的ai产品啊。;6;0;6;18388;0.0003262997607135088
119568;请问up的那个弹窗翻译软件是什么;1;0;1;18388;5.438329345225147e-05
119573;今年考研，就报考人工智能辣星星眼;12;0;12;18388;0.0006525995214270176
119586;GPT不是也能生图dogedogedoge;2;3;5;18388;0.00027191646726125733
119589;lora文件同名png，放一起就行;3;1;4;18388;0.00021753317380900588
119593;小白的装修设计快来。。。;1;1;2;18388;0.00010876658690450294
119595;话说这些ai绘图下载之后使用需要网络吗。;1;0;1;18388;5.438329345225147e-05
119597;有哪些Ai不需要翻墙？;1;1;2;18388;0.00010876658690450294
119599;所有这些Ai工具生成的图都可以商用吗？;2;0;2;18388;0.00010876658690450294
119602;大佬求安转包;7;0;7;18388;0.0003806830541657603
119610;大佬，lora封面怎么弄的;5;0;5;18388;0.00027191646726125733
119618;而且我明明下载了，放在Cextensionssdwebuicontrolnetmodels里面了，可出图的时候自动还要下，下的也很慢。。。;3;1;4;18388;0.00021753317380900588
119622;请问StableDiffusion模型需要用什么特别的吗，我用chilloutmixNiCkpt模型可以吗;3;0;3;18388;0.0001631498803567544
119626;那个帮助文档的链接能发一下吗星星眼;1;0;1;18388;5.438329345225147e-05
119628;中间能直接看到模型预览图片的插件叫啥;9;0;9;18388;0.0004894496410702633
119638;时时清除马赛克，促进人类进步;3;110;113;18388;0.006145312160104416
119645;软件叫什么名字;2;1;3;18388;0.0001631498803567544
119648;AI绘画让很多人明白其实大部分画师就是在拼贴自己看到过的东西;60;128;188;18388;0.010224059169023277
119709;没被人卷死，被ai卷死灵魂出窍;6;72;78;18388;0.004241896889275614
119716;画场景还是很实用的，我感觉场景跟本不需要细节，氛围到了就行了。;3;63;66;18388;0.003589297367848597
119720;完全疲劳，外行都看腻歪了，别提内行了，到处拼凑细节，处处没有细节，全是逻辑错误？;24;62;86;18388;0.004676963236893626
119745;如果是不懂美术的可以去研究研究懂美术的去搞，感觉很浪费练习的时间笑哭;14;37;51;18388;0.002773547966064825
119760;一眼看上去好牛逼，第二眼看又没啥东西，不能细看是所有AI的通病了，构图光影已经足够了，但没有内在支撑，AI能进步到画面逻辑自洽那真的是画师可以转行了;14;36;50;18388;0.0027191646726125733
119775;不是AI强而是我们长期被统一的艺术价值体系禁锢而逐渐退化了创造力;3;14;17;18388;0.000924515988688275
119779;你好UP主，我是个穷人，国际专家所说的标准低收入人群月收入少于两万元的低收入人群，可以把多余的楼房租出去，私人车库希望能送我张英伟达H100120G专业计算显卡协处理器。委屈;2;14;16;18388;0.0008701326952360235
119783;第一眼惊艳，看多几张，全是同样的素材堆砌;1;6;7;18388;0.0003806830541657603
119785;我记得这个软件只能搞场景，而且场景里时不时出现人脸，画人的话需要水平相当的画师才能去改画，但是迄今为止应该没有哪个愚蠢的画师去帮资本完善它热;4;6;10;18388;0.0005438329345225147
119790;审美疲劳还是无意义“细节”过多，很多地方细看就是一堆不可名状，这方面最近出的NovelAi感觉就好点，整体画面看着干净多了，但是颜色又单调了，而且阴影堆的很僵硬，现在ai需要做减法搞得画面密密麻麻反而效果一般;1;5;6;18388;0.0003262997607135088
119804;好奇都是什么关键词，特别是第一组的;1;1;2;18388;0.00010876658690450294
119811;一点感想：自动流水线发明出来取代了最低级的流水线工人，各种闸机和自动收费系统发明出来取代了无数的收费员，自动送餐机器人，无人驾驶，翻译软件，智能语音客服等等类似的例子数不胜数。AI画图肯定会挤占一些人的生存空间，这是毫无疑问的。AI现在还不够强，所以它只能有限的抢低端人员的饭碗。等AI变得更强，那肯定更多的人会被抢饭碗。时代在进步啊，人类的追求就是更高效，更方便啊，不管是半自动、还是全自动工具被发明出来，都会取代相对低效的人工。曾经的收费员，流水线上打螺丝的工人，电话客服，翻译，电报员，公交车售票员这些人都到哪里去了？要么躺平回家退休养老，要么学习新技能继续打拼。当一个新技术慢慢成熟，大众会迅速接受并且习惯。比如料理包，手机打车等等。不止是AI画图，各种新技术都可以看做是某种高效的工具，可以取代一部分低效的打工人。所以努力学习吧，要么被AI取代，要么被AI逼迫着变得更优秀。;2;0;2;18388;0.00010876658690450294
119818;这啥软件;1;0;1;18388;5.438329345225147e-05
119824;大佬，请问你知道MJ如何利用出过的图，然后加元素吗？比如我画了一个妹子，下一张想画这个妹子在遛狗的。那该如何让AI记住我之前画的这个妹子呢？;1;0;1;18388;5.438329345225147e-05
119828;与其说是AI对人的降维打击倒不如说是天才对人的降维打击，以前人总认为努力能打败天才，但实际上他们从来就没遇见过天才。现在有足够才能的人编写了AI将天才留存并永生。;6;0;6;18388;0.0003262997607135088
119838;不懂就问，为什么你的ai画的好幼滑稽;2;38;40;18388;0.0021753317380900587
119841;夜辉啥时候成萝莉了。。。不是那种介于御姐和少女之间的那种游戏人间的感觉嘛;3;19;22;18388;0.0011964324559495323
119851;辉夜的标签应该是最容易描述的了（）黑长直带刘海;3;6;9;18388;0.0004894496410702633
119857;upup，可以问问这能不能广筷发专栏，已赞，发完最好踹我傲娇;3;3;6;18388;0.0003262997607135088
119870;不懂就问，什么时候把手放出来doge;1;1;2;18388;0.00010876658690450294
119879;永遠亭蓬萊山輝夜;1;1;2;18388;0.00010876658690450294
119881;蓬莱山輝夜channel;1;1;2;18388;0.00010876658690450294
119884;永琳诱捕器喜欢;1;1;2;18388;0.00010876658690450294
119889;AI画图怎么一直画同一个人物？;1;0;1;18388;5.438329345225147e-05
119891;有问题，大佬是怎么指谁画谁的，我都是画谁指谁;3;0;3;18388;0.0001631498803567544
119907;祝贺破万;3;0;3;18388;0.0001631498803567544
119913;辉夜可爱捏;3;0;3;18388;0.0001631498803567544
119921;手怎么这么正常;2;0;2;18388;0.00010876658690450294
119940;upup模型能分享嘛;1;0;1;18388;5.438329345225147e-05
119942;是私炉吗藏狐;1;0;1;18388;5.438329345225147e-05
119950;我老婆真可爱星星眼;2;0;2;18388;0.00010876658690450294
119955;三连求图;1;0;1;18388;5.438329345225147e-05
119958;三连求图脱单doge;1;0;1;18388;5.438329345225147e-05
119967;up用什么画的啊给心心求模型和tag;5;0;5;18388;0.00027191646726125733
119973;可爱;2;0;2;18388;0.00010876658690450294
119977;继续加油;1;0;1;18388;5.438329345225147e-05
119980;求图;1;0;1;18388;5.438329345225147e-05
119982;求图。星星眼;2;0;2;18388;0.00010876658690450294
119985;有图吗星星眼;1;0;1;18388;5.438329345225147e-05
119987;喜欢你的视频;1;0;1;18388;5.438329345225147e-05
119989;以后会出现一种新职业，叫ai绘画修补师doge专业修补ai画的不好的地方;2;39;41;18388;0.00222971503154231
119992;想一想假如你花大价钱去约稿，结果是AI画的，对方拿着定制的钱，却给你发流水线的作品，这呆而且AI的版权也是个问题啊呆;2;27;29;18388;0.0015771155101152925
119995;“AI画”就是画师用AI画出来的作品，跟“铅笔画、水彩画、水墨画、丙烯画”以及“油画”是一个意思。不经过学习和练习，给你工具你也出不来作品，照相机随便买一台就能当摄影师吗？如果不需要画师的创作，AI自己就能出作品，就相当于数位板成精、画笔成仙、油墨成魔，人类就慢慢等着被灭绝吧，区区一个“画师”岗位算什么。;34;35;69;18388;0.003752447248205351
120031;你们不觉得现在ai已经秒杀大多数画师了吗？97有吧;5;13;18;18388;0.0009788992821405265
120037;制作gal门槛低了吃瓜;2;10;12;18388;0.0006525995214270176
120041;AI画本，AI拍片tvdoge;1;4;5;18388;0.00027191646726125733
120043;要图的，上蓝鸟好多ai的图。能看的不能看的都有。;4;9;13;18388;0.0007069828148792691
120061;ai究竟是不是艺术艺术究竟是什么没有意义意义只有快乐艺术是欣赏的多数人没有欣赏艺术的能力只需要觉得好看好听就行。为什么，因为听多了看多了。你才有艺术的感觉。有一些艺术是需要触摸的。尤其是油画那种你能看到每一笔笔触，淋湿画布的那些韵味。还有嘲讽画师艺术家的，不理解怎么想的。人类法律，工作，艺术能发展到Ai是一步步过来的。而不是一个哈批说一句艺术无用论解决的。以后AI取代了医生，你就说医生没有用。纯纯dinner。没有大量病例作为基础它怎么发展？纯纯有病。你觉得有一些艺术你欣赏不来就是你单纯哈批看不懂罢了。有一些艺术不是艺术，所以你觉得艺术都这样了。看了几章AI色图就否定了画色图的，那你连色图都看的少。;9;4;13;18388;0.0007069828148792691
120076;还没达到真正的ai创作，脸部都差不多没什么变化，希望快点进化解放生产力;1;3;4;18388;0.00021753317380900588
120081;AI表示，你们人类追求的所谓艺术，不过是我信手的涂鸦罢了，艺术根本没有意义。;6;3;9;18388;0.0004894496410702633
120090;想一想人工智能的绘画能力提高十倍，会多么恐怖;2;2;4;18388;0.00021753317380900588
120105;这个画风色色的;1;0;1;18388;5.438329345225147e-05
120129;有链接了踢我下打call;1;2;3;18388;0.0001631498803567544
120132;大佬融了其它模型吗求模型笑哭笑哭我下载的2代国风跑出来惨不忍睹;3;1;4;18388;0.00021753317380900588
120147;实话讲吧，你等了4个小时有没有吃瓜;4;0;4;18388;0.00021753317380900588
120153;up脸真好看啊怎么调出来的啊星星眼;1;0;1;18388;5.438329345225147e-05
120155;Up用的什么软件呀？想学习可以出教程吗？;1;0;1;18388;5.438329345225147e-05
120159;置顶别想了人家有男朋友他男朋友的主页httpsspacebilibilicom脱单doge;2;23;25;18388;0.0013595823363062867
120162;哦这个模型我最近也经常用，感觉还挺稳定的，但是我忘记我从哪下得了，也不知道是怎么融合出来的;1;12;13;18388;0.0007069828148792691
120164;doge说好的捆绑呢doge;3;9;12;18388;0.0006525995214270176
120168;来了来了，小故事什么时候安排一下doge;1;4;5;18388;0.00027191646726125733
120170;这沙优怎么跟邻家天使大人有点像;1;2;3;18388;0.0001631498803567544
120173;是荻原沙优么，;1;2;3;18388;0.0001631498803567544
120179;唉，这期给我看麻了;3;1;4;18388;0.00021753317380900588
120183;熟xi的bgm想不起来了，我以前经常听;1;1;2;18388;0.00010876658690450294
120188;啊，撞了;1;1;2;18388;0.00010876658690450294
120190;必须三连;1;1;2;18388;0.00010876658690450294
120192;加油热词系列三连Akie秋绘打call;1;1;2;18388;0.00010876658690450294
120195;大佬能问问模型吗星星眼;1;1;2;18388;0.00010876658690450294
120221;有一说一，现在的ai太强了;21;54;75;18388;0.00407874700891886
120243;置顶图片在交流群群相册里，模型在群文件里。视频中的图为内群机器人画的图。群号690341384。500人小群，昨晚群满了，踢了一些不活跃的。现在又满了，点赞，投币，三连，私聊我，求模型，或者求模型链接，给模型链接，你自己下doge，我设置的关注自动回复。没关注的不会自动回复回复指令求模型，或者求模型链接，都是自动的。嫌弃新群540940622至今为止新群里已经有一批弄出来了，质量都挺不错的，授人以鱼不如授人以渔。渔学会了，啥图不都自然而然来了？;8;51;59;18388;0.0032086143136828365
120252;随着ai技术的不断发展，越来越的多画手失业;9;51;60;18388;0.003262997607135088
120263;呆滞看着视频，紧紧握住的是人性中的野蛮，涌溅出的是精神之海的浊秽，风雨大作之后呆滞的眼神是我最后的倔强。;4;35;39;18388;0.002120948444637807
120268;这绝大部分的每一张图片都完完全全。符合我的审美观。好久都没有见到过这么好看，这么好看，这么好看的图片啊，真的这种美式，从内而外，发自内心的最纯粹的美。没有什么图片。是让我真真正正的发自内心的觉得他好看，自从今天看了这个up主的这些AI25D的图片的美图后，我又充满了希望，我想要把这些图片全部都打印成照片。制作成海报，张贴在自己的家里墙上大哭大哭;1;26;27;18388;0.0014683489232107897
120270;说出来你可能不信，我用百度识图，结果搜出来是奇迹暖暖，你这取材是不是奇迹暖暖啊？dogedogedoge;1;25;26;18388;0.0014139656297585382
120272;好看可惜不会动;4;20;24;18388;0.0013051990428540352
120277;感觉真的坏了，这画师行业，北美那边还在疯狂添加diy的内容提供最大程度ai自定义，真的离谱;1;18;19;18388;0.0010332825755927778
120280;这是novelai画的吗;2;12;14;18388;0.0007613661083315206
120283;说真的大批画手失业，很多小说封面插画啥的，都用的上，感觉很多图像以前言情小说的封面;4;10;14;18388;0.0007613661083315206
120288;封面;1;10;11;18388;0.0005982162279747662
120290;我先来，抠图拼尸罢了吃瓜;2;9;11;18388;0.0005982162279747662
120294;怎么还有降智弹幕，连AI是啥都不懂就来喷;2;6;8;18388;0.00043506634761801175
120297;看来我是时候改行编程了;4;6;10;18388;0.0005438329345225147
120304;弹幕总觉得自己很懂呲牙;5;5;10;18388;0.0005438329345225147
120310;我踏马原地失业星星眼;4;5;9;18388;0.0004894496410702633
120320;计算机毕业然后学了2年画的发表下看法，商业作品现阶段ai很难替代人工，或者说目前根本不可能，ai之所以被定义为抄，照搬而遭很多画师不齿，有一个原因是它所谓的“学”目前阶段只能停留于抄，照搬，然后拼接，哪怕错了几百几千次它依旧无法明确那是对是错，而人为修正这些细节，其实挺烦的，这层面不如直接拉个画师来改，其次商业上ai很难精确明白甲方的需求，完美出精细化的需求图，到这步依旧需要画师来操刀，它只能当个灵感辅助（作为本专业的我觉得程序用于辅助这类简直合理到不能当然，对底层冲击确实也是实实在在最后，yysy，ai的氛围控制可能比很多商业大佬都厉害这点真的可以逆向学习画师去卷ai，不要想着比不过啊，出图速度什么的，你卷到了其实就是赚到了（隔壁围棋界也在这么搞），ai其实也可以成为画风实验的预览工具，不用担心花大量时间研究了一堆最后整出一堆垃圾;5;2;7;18388;0.0003806830541657603
120331;他可以赛璐璐吗他不行，画师们先不用担心，他不能赛璐璐;2;1;3;18388;0.0001631498803567544
120335;ai什么时候学会画se图啊;7;1;8;18388;0.00043506634761801175
120347;pixiv有号吗;3;1;4;18388;0.00021753317380900588
120351;ai能叫绘手吗吃瓜囧;3;1;4;18388;0.00021753317380900588
120357;请问下载的模型要怎么用要进群才能用吗;2;1;3;18388;0.0001631498803567544
120365;已赞，送你上首页;2;1;3;18388;0.0001631498803567544
120368;是哪个模型啊;1;1;2;18388;0.00010876658690450294
120379;好幼啊;1;0;1;18388;5.438329345225147e-05
120383;这个是用什么黑暗用什么ai软件画的？no;1;0;1;18388;5.438329345225147e-05
120386;BGM好好听，但是识别不出来;2;0;2;18388;0.00010876658690450294
120395;分享点高级的形容词吧大哭有设备但是脑洞不够;2;0;2;18388;0.00010876658690450294
120400;可以画面条吗呲牙;1;0;1;18388;5.438329345225147e-05
