label;一级评论;真实二级评论数;真实点赞数;边数;最大边数;集群密度
0;不知道为什么，现在不喜欢百度，以前不知道什么百度一下就知道了，现在百度一下，想要知道结果要付钱;19;133;152;54433;0.002792423713556115
20;需要给百度时间，新技术发展本就是摸石头过河;2;53;55;54433;0.00101041647529991
23;我相信一点就是中国一定能做出很好的ai，但绝对不是百度这种没良心没底线的公司;1;1;2;54433;3.674241728363309e-05
25;很少有企业愿意去大力投入科研发展，从这点来说百度是一家相当厉害的企业;1;76;77;54433;0.001414583065419874
27;先完成再完美;1;31;32;54433;0.0005878786765381295
29;我人生的第一台车BYD新能源我非常喜欢，坐过我车的人都非常喜欢BYD的车，智能化功能贴心的很多设计都很好用;1;4;5;54433;9.185604320908272e-05
31;AI正在改变世界，我们一定不能落后。从这一点上，必须支持自己的技术和产品。再说，百度的文心一言也不比GPT差，必须力挺;2;59;61;54433;0.0011206437271508093
34;看张老师的视频度过了一段阴暗的时光，会持续关注;2;12;14;54433;0.00025719692098543164
38;中国应该加强研究，中国的不足还很多，不能太过骄傲，看到不足之处，补强短板，防止卡脖子，大家质疑的是是否再被卡脖子;1;7;8;54433;0.00014696966913453236
43;不是我们没有自信，而是我们知道我们是没有创新环境的。还是希望我们越来越好吧。要改变不是那么容易的;2;4;6;54433;0.00011022725185089927
54;好多外国的东西都是中国制造;1;1;2;54433;3.674241728363309e-05
127;守护我的双双;1;0;1;54433;1.8371208641816546e-05
149;百度的文心一言，数据库哪来？是百度的竞价排名？还是百科的自说自话？亦或是百家的王婆卖瓜;4;1;5;54433;9.185604320908272e-05
154;老师的课程已学完，讲的太赞了受益匪浅，可低价转给需要的人;2;1;3;54433;5.511362592544963e-05
230;文心一言已经开始打算收费了;8;551;559;54433;0.01026950563077545
239;一个主持人大谈技术嗷不大谈人情世故果然专业;6;305;311;54433;0.005713445887604945
246;Chartgtp是有极限的，到了边界能提升的空间是有限的，我们有时间追上去。;2;1;3;54433;5.511362592544963e-05
249;不拉黑你，我都嫌弃我自己;11;245;256;54433;0.004703029412305036
261;很喜欢一句话，水一百度会开，人一百度会死。;3;170;173;54433;0.0031782190950342625
265;根据文库，度盘的收费尿性，等用户量到一定的时候，他就给你搞个普通会员，超级会员，不同级别每天限制聊天次数不同;3;20;23;54433;0.0004225377987617805
269;文言一心：根据国家法律法规，内容无法显示;3;50;53;54433;0.0009736740580162769
273;讲个笑话我们不能笑话盗版软件没有正版软件好;1;59;60;54433;0.0011022725185089927
275;哦媒体人没事了;1;107;108;54433;0.0019840905333161868
277;不要抱怨，你要觉得哪里不好，自己去建设啊;8;42;50;54433;0.0009185604320908272
286;作者确实在很理性的分析事情，为什么不给这些在做事的企业一些容忍度呢;1;41;42;54433;0.0007715907629562949
289;我不敢用百度的原因不是因为他的技术，而是我怕在生病的时候用它结果却是用竞价排名的方式出现一大堆的莆田系医院;1;68;69;54433;0.0012676133962853417
293;百度华为所有负重前行的中国企业我都支持，自己家的孩子自己疼;3;11;14;54433;0.00025719692098543164
297;百度做的挺聪明的，出的晚点肯定被骂套壳;3;4;7;54433;0.00012859846049271582
356;对对，你明知道自己矮还不给别人说你矮，你非得说你站凳子上一样高，道理确实没错，;1;5;6;54433;0.00011022725185089927
363;一个抄作业一辈子的人，考大学的时候发现抄不了，;1;5;6;54433;0.00011022725185089927
368;百度是全球唯一对标OpenAI和谷歌的公司，文心一言是全球唯一对标ChatGPT和brad的语言类大模型，文心一言已经全球第三，已经很优秀了。;3;11;14;54433;0.00025719692098543164
394;要说百度起家，能有今天不容易呀，怀念当初的百度。各种mp3各种小说随便下载。;1;7;8;54433;0.00014696966913453236
423;这不就是海贼王里的索隆嘛新手出门就对标世界第一剑客鹰眼。真不知道有哪些人一直吹捧他，估计就是这些喷子吧。;1;1;2;54433;3.674241728363309e-05
428;所以文心一言到底有没有调用ChatGPT的接口啊;2;1;3;54433;5.511362592544963e-05
433;抖音人均智能，外国的月亮圆。;3;4;7;54433;0.00012859846049271582
437;给国产一点时间;1;2;3;54433;5.511362592544963e-05
442;首先，AI开发不见得是好事，要考虑应用对方向，不能因为推广应用干扰社会秩序和就业均衡。所以，因为管理制度不同，价值观不同，我们和他们的市场方向突破方向一开始就不同，我们的AI目前多用于陪伴和夜班场景等，他们则用于做作业和高级人工替代。我们如果像他们那样持续喂数据，早就出来了;2;8;10;54433;0.00018371208641816545
461;他的目的，是摧毁中国科技公司，符合美欧利益;12;287;299;54433;0.005492991383903147
474;就是，真想跟那些人说，如果觉得人家不行，就去百度就职。;8;106;114;54433;0.0020943177851670863
483;国内的专家和企业已经弯道超车了、已经是世界numberone;2;47;49;54433;0.0009001892234490107
486;百度还没倒闭啊;1;29;30;54433;0.0005511362592544964
488;文心一言就是依托答辩;1;17;18;54433;0.0003306817555526978
491;百度还没倒闭在座的各位都有责任;2;9;11;54433;0.000202083295059982
495;再次也是自己的再好也是别人的;1;1;2;54433;3.674241728363309e-05
537;如果文心一言是华为做的，估计没人喷了，只要是华为的东西就是爱国，就是厉害;1;3;4;54433;7.348483456726618e-05
617;有没有一种可能是文心一言在网上搜的图片，而不是它画的;32;627;659;54433;0.012106626494957104
650;他是机器翻译然后发给人家的外网已经抓包了;21;397;418;54433;0.007679165212279316
673;它只是把你中文翻译成英文，然后对接国外的端口给你提供答案，翻译后老外当然不懂唐伯虎是人是虎啊，文心一言真的是ai的二道贩子啊;25;59;84;54433;0.0015431815259125898
699;给它一点时间，GPT刚开始的时候还不如一言。;23;22;45;54433;0.0008267043888817446
725;套了国外20版本开源的代码编译的。;2;44;46;54433;0.000845075597523561
728;训练量越多越早完善，发展潜力还是很大的;10;44;54;54433;0.0009920452666580934
739;他后台再去请求GPT，把GPT答案显示出来。这样不就完美了;2;44;46;54433;0.000845075597523561
742;试试让它画个总线和鼠标;9;10;19;54433;0.00034905296419451436
752;所有为了科技进步而努力的企业都值得被尊敬。;8;29;37;54433;0.0006797347197472122
761;教育孩子要有民族自信很有必要;15;1;16;54433;0.00029393933826906473
777;车水马龙;4;8;12;54433;0.00022045450370179853
782;套壳中介懂不;4;13;17;54433;0.00031231054691088127
792;人工再智能，目前它还无法参透中文一句话或一词的多重含义;1;0;1;54433;1.8371208641816546e-05
821;看来这个百度的语言模型有问题，对语言的理解能力很差。只能按字面意思来理解。不能够深刻理解中国的俗语，成语跟典故。;2;0;2;54433;3.674241728363309e-05
832;我问了一句，为什么看过的书容易忘？他让我去医院。;1;4;5;54433;9.185604320908272e-05
853;什么叫智能，首先你脑子里得有东西，那叫数据库，大数据懂吗，然后你提问，他搜索回答，真正的还没达到;1;3;4;54433;7.348483456726618e-05
894;短期不完美没办法，咱们国内的数据绝对不能被拿去喂养GPT，但文心长期不完美肯定不行。;1;0;1;54433;1.8371208641816546e-05
897;刚出生的孩子给他一包容让他慢慢成长。;4;2;6;54433;0.00011022725185089927
903;Ai还是英文代码，没有办法完全适应中国文化;2;0;2;54433;3.674241728363309e-05
916;绘画是文心一格;1;0;1;54433;1.8371208641816546e-05
934;机翻成英文，然后调用外网接口;2;13;15;54433;0.0002755681296272482
953;唐伯虎点秋香你想要什么样子;1;0;1;54433;1.8371208641816546e-05
966;没有明确给他描绘过唐伯虎是什么，所以给出的答案自然不会是正确的。;1;1;2;54433;3.674241728363309e-05
976;画的白云苍狗;1;5;6;54433;0.00011022725185089927
979;有没有可能他其实现在这个阶段正在学习？;1;3;4;54433;7.348483456726618e-05
982;直接用的国外得程序，没有本地化。;1;12;13;54433;0.00023882571234361508
988;怎么用？;1;0;1;54433;1.8371208641816546e-05
991;别靠近我喔;1;0;1;54433;1.8371208641816546e-05
995;叫我泡芙就好;1;0;1;54433;1.8371208641816546e-05
1006;有人说抄袭，承认百度的技术有那么难吗，人家这几年出彩的产品也确实不少;4;23;27;54433;0.0004960226333290467
1011;你不懂，这种创新才有意思，如果我让他画什么他画什么有意思吗，这种脑洞大开的创意不是更难吗;4;1;5;54433;9.185604320908272e-05
1016;百度为什么那么烂;2;2;4;54433;7.348483456726618e-05
1108;国人的无知无以复加;1;0;1;54433;1.8371208641816546e-05
1110;为什么美国一有发明，国内接着就有了。还说自己更厉害;1;0;1;54433;1.8371208641816546e-05
1117;人工智能时代，学习方式是不是也要相应改变？;5;10;15;54433;0.0002755681296272482
1123;因为他是把中文翻译成英语，再用英文给ai;114;1872;1986;54433;0.03648522036264766
1238;今天刚用过，真的拉胯，我就说，要真是正儿八经的中文语言系统怎么理解能力这么差，原来是搬运工啊;92;470;562;54433;0.010324619256700899
1332;这不是文心一言，这是会心一击;12;657;669;54433;0.012290338581375269
1345;绘画用的国外的模型，不理解中文，语言但是自己的模型没错，不过大部分代码是复制开源的;32;70;102;54433;0.0018738632814652876
1378;套壳ai，实际是国外的一个画图ai;4;80;84;54433;0.0015431815259125898
1383;先翻译成英语，后台大概率是stablediffusion。让它画鼠标，一直画mouse;6;242;248;54433;0.004556059743170503
1390;汉语言太抽象了;21;30;51;54433;0.0009369316407326438
1412;这明显是缺了文字理解的那块，图像生成是没问题的;34;14;48;54433;0.0008818180148071941
1447;画个起重机？;9;19;28;54433;0.0005143938419708633
1457;汉译英太差了内核肯定是偷的;5;31;36;54433;0.0006613635111053956
1464;中国人自己的ai好可爱;3;41;44;54433;0.000808333180239928
1468;这个要慢慢进步，什么都不会一蹴而就;7;8;15;54433;0.0002755681296272482
1476;你弱爆了;3;13;16;54433;0.00029393933826906473
1480;已经实锤了，鹤和起重机的英文一样，你看下他给你的出图是啥？还有总线和公交车也是一样的;2;26;28;54433;0.0005143938419708633
1506;中国人的单纯这次表现的淋漓尽致。我真的需要跟着chatGPT搞一个这样的ai吗？无论是资金技术人才时间，等等等等我们都没任何优势，我们为什么不在某个领域打败他呢？比如，专门智能驾驶，专门炒股，专门学英语，等等;1;1;2;54433;3.674241728363309e-05
1512;它有个成长过程。用的越多他会变得越好。但要超过原创，估计不太可能;1;2;3;54433;5.511362592544963e-05
1544;外国的;1;0;1;54433;1.8371208641816546e-05
1546;百度终于知道了模仿的方向;1;9;10;54433;0.00018371208641816545
1548;我怀疑这是假的。;1;2;3;54433;5.511362592544963e-05
1550;画工不错;2;1;3;54433;5.511362592544963e-05
1553;这不比那个什么GT牛多了;1;1;2;54433;3.674241728363309e-05
1556;李彦宏说，文心一言相当于gpt早期版本。为什么呢，因为从gpt3开始不开源了;1;11;12;54433;0.00022045450370179853
1559;用来做游戏，真香;1;1;2;54433;3.674241728363309e-05
1563;要不是很多我都测过，不然我也信了;2;0;2;54433;3.674241728363309e-05
1568;刚开始是这样可以理解，毕竟AI不懂形容词，可是据说挖掘机都画错，这就离了大谱了;1;3;4;54433;7.348483456726618e-05
1571;你们太坏;1;2;3;54433;5.511362592544963e-05
1574;我：给我画个霍利菲尔德。文心一言：这是您要的在希望的田野上。;1;1;2;54433;3.674241728363309e-05
1576;中介式AI;3;2;5;54433;9.185604320908272e-05
1583;画一个“立马滚蛋”，旅游城市的标志雕塑就出来了;1;0;1;54433;1.8371208641816546e-05
1585;我怎么觉得这个是真的啊，虽然，表现出了很不完善，但是很仿生啊，养孩子就是一上来就是学的驴唇不对马嘴，然后一点点修正，后天自己再悟，上来就是孙悟空72变化，才容易假点假;1;1;2;54433;3.674241728363309e-05
1592;汉语是世界上语义最复杂的语言，百度要是能搞定这个，chatgpt都得一心祖父;1;0;1;54433;1.8371208641816546e-05
1595;不认识李彦宏还行;1;0;1;54433;1.8371208641816546e-05
1598;先蹩脚的翻译英文，然后再用gpt接口;1;3;4;54433;7.348483456726618e-05
1601;感觉我也会;1;1;2;54433;3.674241728363309e-05
1603;多用用就提升了;1;1;2;54433;3.674241728363309e-05
1606;文言一心和火箭回收估计会被老外笑一阵子了;1;6;7;54433;0.00012859846049271582
1608;无厘头绘画;1;1;2;54433;3.674241728363309e-05
1610;遥遥领先;1;1;2;54433;3.674241728363309e-05
1613;这个是啥？脑筋急转弯？;1;1;2;54433;3.674241728363309e-05
1616;怎么和我不一样呢？;1;2;3;54433;5.511362592544963e-05
1618;百度指望不上了;1;3;4;54433;7.348483456726618e-05
1620;怎么跟我用的不一样;1;1;2;54433;3.674241728363309e-05
1622;我还是那句话，慢慢进化就是了。孩子也是一点点进步的。;1;1;2;54433;3.674241728363309e-05
1624;遥遥领先;1;1;2;54433;3.674241728363309e-05
1626;科技界的农夫山泉;1;1;2;54433;3.674241728363309e-05
1628;你就说元素有没有齐;1;1;2;54433;3.674241728363309e-05
1630;套壳之后你好歹吧翻译做好;1;1;2;54433;3.674241728363309e-05
1632;全是美式方式;1;1;2;54433;3.674241728363309e-05
1634;你就说虎头虎脑的大胖小子画的好不好吧;1;1;2;54433;3.674241728363309e-05
1636;还不如我设计的好;1;1;2;54433;3.674241728363309e-05
1639;画个老婆饼;1;1;2;54433;3.674241728363309e-05
1642;就离谱;1;1;2;54433;3.674241728363309e-05
1644;应该支持文心一言，给他们机会，继续提高质量;1;1;2;54433;3.674241728363309e-05
1646;比较原始;1;1;2;54433;3.674241728363309e-05
1649;中文太难理解;1;1;2;54433;3.674241728363309e-05
1651;百度翻译不行;1;1;2;54433;3.674241728363309e-05
1654;刚看到gpt有安全漏洞;1;1;2;54433;3.674241728363309e-05
1657;我懂了，李彦宏说的自研模型应该是汉译英模型;1;2;3;54433;5.511362592544963e-05
1659;夫妻肺片;1;1;2;54433;3.674241728363309e-05
1662;不卡脖子了？;2;1;3;54433;5.511362592544963e-05
1665;这一看就很明显ai说白了是一个数据搜集整理功能工具，你要绘画，它肯定会调用绘画工具，而调用的绘画工具估计是国外的吧。我觉得挺正常。;1;2;3;54433;5.511362592544963e-05
1668;看来技术壁垒在翻译;1;1;2;54433;3.674241728363309e-05
1670;中式英语;1;1;2;54433;3.674241728363309e-05
1672;遥遥领先;1;1;2;54433;3.674241728363309e-05
1675;现在已经不用接口了，直接自己搞，画的很丑还文不对题;1;1;2;54433;3.674241728363309e-05
1677;纯纯欧美画风;1;1;2;54433;3.674241728363309e-05
1679;其实，从程序的角度上来说，把中文翻译成英文并没有什么太大的问题;1;1;2;54433;3.674241728363309e-05
1681;我觉得这是一种自信，文心一言太幽默了;1;2;3;54433;5.511362592544963e-05
1683;搬运工;1;1;2;54433;3.674241728363309e-05
1685;画一个夫妻肺片;2;1;3;54433;5.511362592544963e-05
1688;这个东西不好说毕竟现在midjouney也不支持中文没法对比;2;2;4;54433;7.348483456726618e-05
1691;自主研发，给点时间迟早会弯道超车的;1;1;2;54433;3.674241728363309e-05
1701;啥时候能玩？;1;1;2;54433;3.674241728363309e-05
1705;挺有意思的;1;1;2;54433;3.674241728363309e-05
1707;的确是英文的，我测试结果也类似这个;1;2;3;54433;5.511362592544963e-05
1710;你就说复合要求不;1;1;2;54433;3.674241728363309e-05
1712;笑死，中文的语言模型，不能正常识别中文;1;1;2;54433;3.674241728363309e-05
1714;农夫山泉：我们不生产水，我们只大自然的搬运工。百度，我们不生产数据，我们只是数据的中转站;1;12;13;54433;0.00023882571234361508
1716;弯道超车;2;0;2;54433;3.674241728363309e-05
1719;往好的想，可能是编程环境就是英文，训练集也是英文，所以翻译为英文来作为输入，毕竟中文语言复杂程度很高，也没一套系统来理解中文语言。无奈翻译准确度不高;1;0;1;54433;1.8371208641816546e-05
1721;中文好难学;1;1;2;54433;3.674241728363309e-05
1776;百度的文心一格画这些完全没问题，为什么文心一言却像中英互译;4;1;5;54433;9.185604320908272e-05
1787;你敢开放api我们就敢遥遥领先你敢开放源代码我们就敢自主研发;1;7;8;54433;0.00014696966913453236
1789;突然想，这个图片生成功能，特别适合“你画图我来猜”这种成语猜谜节目。;1;2;3;54433;5.511362592544963e-05
1791;我就知道这玩应会离谱，没想到这么离谱;1;2;3;54433;5.511362592544963e-05
1794;谁要说他的灵魂不是来自西方都对不起这几幅画;1;1;2;54433;3.674241728363309e-05
1798;。。。。。罗宾你在哪;1;0;1;54433;1.8371208641816546e-05
1801;不得不说，艺术成分很高;1;4;5;54433;9.185604320908272e-05
1804;别玩了，再玩就玩坏了;1;2;3;54433;5.511362592544963e-05
1810;为了科技进步而努力的企业。就算抄作业也值得尊重;3;8;11;54433;0.000202083295059982
1821;虽然是调侃，但是目前的文心一言还需要不断完善，走出第一步就有了进步的可能;2;6;8;54433;0.00014696966913453236
1828;说实话，如果这真是文心一言创作的，那么，他真的比GPT先进，GPT是更加先进的搜索软件，没有创新功能。不知道是不是为了黑而黑;3;2;5;54433;9.185604320908272e-05
1832;文心一言就是三岁孩子啊;1;0;1;54433;1.8371208641816546e-05
1835;Robin是得罪了程序猿啊;1;27;28;54433;0.0005143938419708633
1838;青。;1;0;1;54433;1.8371208641816546e-05
1840;SuperheroZhu;1;0;1;54433;1.8371208641816546e-05
1853;不说话就是在修仙;1;1;2;54433;3.674241728363309e-05
1857;麻利麻利哄;3;0;3;54433;5.511362592544963e-05
1869;叫他画土耳其;1;1;2;54433;3.674241728363309e-05
1874;0;9;11;20;54433;0.0003674241728363309
1884;midjourney也好不到哪里去，这是车水马龙;7;5;12;54433;0.00022045450370179853
1892;百度就算了吧到时候给你到处打广告害死人;2;3;5;54433;9.185604320908272e-05
1895;这是还没训练好，人工智能需要成长的;2;1;3;54433;5.511362592544963e-05
1898;百度向来不会让你不失望;1;1;2;54433;3.674241728363309e-05
1900;文心一言可不可以后台再连接chatgpt;1;1;2;54433;3.674241728363309e-05
1902;事实证明百度的翻译和AI都拉胯;1;1;2;54433;3.674241728363309e-05
1904;百度的一罐作风;1;1;2;54433;3.674241728363309e-05
1906;老外听不懂复杂的中文;1;1;2;54433;3.674241728363309e-05
1908;说是把中文翻译成英文再绘画的人只有两种，不是蠢就是坏。我就，基于英语的大数据从哪里来的？英语环境训练师和标记谁打的？不会以为百度搜索在国外有用户吧？;2;0;2;54433;3.674241728363309e-05
1911;跟华为那个什么操作系统一样，套壳的;3;1;4;54433;7.348483456726618e-05
1915;这玩意一出来一堆人嘲讽。东西再差那也是咱们国产的。国外再香总有一天也会针对我们。它刚出来还只是个小孩，给它点学习时间会成长起来的;1;1;2;54433;3.674241728363309e-05
1917;卧槽突然感觉gpt4的人类幽默能力和文心一言比简直是小儿科;1;2;3;54433;5.511362592544963e-05
1919;再不开放外国软件，我们很难进步;1;2;3;54433;5.511362592544963e-05
1951;有些人说爱国猫有问题，我不清楚他们说的是哪里有问题;1;1;2;54433;3.674241728363309e-05
1953;明显你的方式不对啊，设计师设计的就是用英文提问，你干嘛用中文;1;1;2;54433;3.674241728363309e-05
1956;太恶心了，还要登录，登录完了还要排队;1;1;2;54433;3.674241728363309e-05
1958;都是直译;1;1;2;54433;3.674241728363309e-05
1960;真der;1;1;2;54433;3.674241728363309e-05
1962;总结，他根本不懂中文;1;1;2;54433;3.674241728363309e-05
1964;也别AI了，先整整你那百度翻译吧;1;1;2;54433;3.674241728363309e-05
1967;问题的关键不是他用没用国外的接口而是他连中文的意思都搞不懂搞了这么多年ai坐拥最庞大的中文库真的替他汗颜;1;1;2;54433;3.674241728363309e-05
1969;百度一如既往的笨，就像百度搜索，你搜的东西很难找到，全是广告，没有goole，我现在都用淘宝来搜索了。;1;1;2;54433;3.674241728363309e-05
1971;让它画个国旗，看看是不是星条旗;1;1;2;54433;3.674241728363309e-05
1973;如果文心一言是国产gpt那就算它差一点，那他也是值得尊敬的希望，可惜他居然仅仅是个蹩脚的翻译接口那大家随便嘲笑吧，现在不笑，等它变成相对稳定的翻译接口，就该让你买会员看剩余内容了;1;0;1;54433;1.8371208641816546e-05
1975;画一只爱国的猫;1;0;1;54433;1.8371208641816546e-05
1977;爱国猫，看看爱的是哪国;1;0;1;54433;1.8371208641816546e-05
1979;其实根本都没画，只是在他的图片库里面搜一张图给你。;1;0;1;54433;1.8371208641816546e-05
1981;这是连接到chatgpt了吧。。。;1;0;1;54433;1.8371208641816546e-05
1983;百度真是堕落的一塌糊涂。。。;1;0;1;54433;1.8371208641816546e-05
1985;百度这些年除了广告什么都没做出来;1;0;1;54433;1.8371208641816546e-05
1987;百度真笨直接把网友问题让文心去gpt4问然后把答案发给网友不就行了直接做个搬运工;1;0;1;54433;1.8371208641816546e-05
1989;听这个名字，就很菜;1;0;1;54433;1.8371208641816546e-05
1991;百度从诞生到现在都是别人开路它占摊，唯一的创新就是莆田系广告;1;0;1;54433;1.8371208641816546e-05
1993;为了钱啥事都敢上;1;0;1;54433;1.8371208641816546e-05
2165;可以试试画牛奶河，金色摔倒;1;0;1;54433;1.8371208641816546e-05
2174;百度真的没有什么技术实力;1;0;1;54433;1.8371208641816546e-05
2193;套皮AI实锤;433;54000;54433;54433;1.0
2627;所以搞半天，文心一言就是个中介;668;51000;51668;54433;0.9492036081053773
3296;不知道为啥总觉得你的英语说的有点油腻;2;0;2;54433;3.674241728363309e-05
3299;0;1946;16000;17946;54433;0.3296897102860397
5246;文心一言开发的最难点在于，如何不被发现自己套用了ChatGPT;237;8212;8449;54433;0.15521834181470798
5484;计算机语言用的是中文还是英文;2;2;4;54433;7.348483456726618e-05
5487;国外一开源，国内就领先;96;1910;2006;54433;0.03685264453548399
5584;而且文心一言画出来的所有图，都带着浓浓的欧美漫画味;60;16000;16060;54433;0.29504161078757374
5645;《自主研发》;150;11000;11150;54433;0.20483897635625448
5796;有点像以前的“中国芯”事件，从国外买回芯片，磨掉别人的logo再印上自己的logo;163;5006;5169;54433;0.09496077746954971
5960;李彦宏从不让人失望;57;8496;8553;54433;0.1571289475134569
6018;性质有点恶劣了;127;11000;11127;54433;0.2044164385574927
6146;国外开源遥遥领先修复“bug”自主研发早有布局赢麻了;105;2436;2541;54433;0.04668124115885584
6252;驴肉火烧，它直接活驴火烧;382;5927;6309;54433;0.11590395532122058
6635;百度在让人失望这条路上，从不让人失望;3;496;499;54433;0.009167233112266457
6639;开源就遥遥领先，不开源就卡我脖子;30;86;116;54433;0.002131060202450719
6670;完了，前几天吹文心一言的，脸被打爆了;24;3432;3456;54433;0.06349089706611798
6695;沅沅麦子同学煜梦慕真高级;3;1;4;54433;7.348483456726618e-05
6714;说百度调接口的人，完全就是不懂装懂。百度是用英文训练的，不可能是掉接口，真的好笑;1;3;4;54433;7.348483456726618e-05
6720;它加油也没锤子用;1;0;1;54433;1.8371208641816546e-05
6725;难道我用的文心一言是假的？;1;0;1;54433;1.8371208641816546e-05
6730;你一个英语老师在这分析，我搞算法的看个热闹;1;3;4;54433;7.348483456726618e-05
6733;起“文心一言”这么雅的名字，结果理解不了中国词条;1;7;8;54433;0.00014696966913453236
6735;在没能力这方面，百度从来没让人失望;1;9;10;54433;0.00018371208641816545
6741;因为开放标注数据有一大把英语标准好的数据，肯定直接拿来用这一部分，自己重头开始标明年都出不来;1;1;2;54433;3.674241728363309e-05
6788;百度AI绘画文心一格2022年8月19日就已经发布。美国ChatGPT2022年11月30日才发布。凡是有点脑子的人，都不会被带节奏，跟着瞎喷;8;6;14;54433;0.00025719692098543164
6804;1shui下次找头像试试这个ai作画。;1;0;1;54433;1.8371208641816546e-05
6821;为什么不能用中文去开发呢？哪怕是慢一点出来也可以啊;3;3;6;54433;0.00011022725185089927
6834;虽然很菜，但已经比谷歌的强。;1;1;2;54433;3.674241728363309e-05
6844;百度的战略是借用国外AI，然后借助国内庞大用户，不断让AI自我学习成长，实现弯道超车，毕竟AI成长需要庞大的数据，而国内庞大的用户群是非常好的养料;1;1;2;54433;3.674241728363309e-05
6849;冇心全都是骗子;1;1;2;54433;3.674241728363309e-05
6853;我都怀疑百度上班的员工有十个人吗;3;20;23;54433;0.0004225377987617805
6861;据说百度深耕人工智能领域多年，研究了个寂寞呀;1;3;4;54433;7.348483456726618e-05
6864;这视频发的真是不懂装懂;1;1;2;54433;3.674241728363309e-05
6867;小猫咪悄悄去厨房滑翔真的哗众取宠;1;0;1;54433;1.8371208641816546e-05
6869;自研是吧;1;0;1;54433;1.8371208641816546e-05
6877;吉力还是那个厚颜无耻的百度;1;0;1;54433;1.8371208641816546e-05
6882;有一种解释，就是ai技术论文，语言分析什么的都是英文资料多，自己训练模型翻译成英文可以参考的资料多一些，中文世界文档太少;2;6;8;54433;0.00014696966913453236
6889;国内的大部分都是在调用ChatGPT;5;14;19;54433;0.00034905296419451436
6896;说文心一言用了gpt的纯属造谣，因为gpt是懂中文的，而且他不会画画;1;7;8;54433;0.00014696966913453236
6907;那也没办法，毕竟计算机语言是基于英文而不是汉语;6;12;18;54433;0.0003306817555526978
6924;文心一言项目外包了;1;1;2;54433;3.674241728363309e-05
6941;一个应用同时戳到暴露自己两个缺陷，ai不行翻译也不行;3;40;43;54433;0.0007899619715981115
6955;外国那个用中文不是也能画么文心如果用的是外国的应该也能画的很好。这只能说明文心用的是他自己的。只不过做的不好罢了。;2;2;4;54433;7.348483456726618e-05
6959;补贴到手，管它开源还是套壳呢，弯道超车;2;34;36;54433;0.0006613635111053956
6963;这倒不是调用的国外接口，其实是百度原始数据库的标记语言问题。。。。。。;3;8;11;54433;0.000202083295059982
6969;虽然我很想百度凉凉，但这不可能是简单翻译器AI套壳，因为用到了英文训练数据，毕竟英语用的人多，打标签工作量太大，只能自动翻译，然后就搞错了还带进了最终模型，这锤不了百度。说是翻译的和套壳的别杠，杠就是你赢;1;5;6;54433;0.00011022725185089927
6985;百度什么时候是中国公司了;7;3;10;54433;0.00018371208641816545
7009;跟华为的鸿蒙一样;1;0;1;54433;1.8371208641816546e-05
7021;我已经失望透顶了;4;12;16;54433;0.00029393933826906473
7027;呢喃;1;0;1;54433;1.8371208641816546e-05
7029;深耕AI十年;3;16;19;54433;0.00034905296419451436
7033;Peekaboo遥遥领先;1;0;1;54433;1.8371208641816546e-05
7057;朱七七哈哈哈哈哈哈哈哈哈;1;1;2;54433;3.674241728363309e-05
7062;梵星弯道翻车;1;0;1;54433;1.8371208641816546e-05
7068;本来编程语言也不可能是中文，正常;13;3;16;54433;0.00029393933826906473
7087;你猜猜，开发环境是中文的还是英文的？;2;15;17;54433;0.00031231054691088127
7090;刚试的;5;7;12;54433;0.00022045450370179853
7096;chatgpt没有你们想象的那么神秘，我觉得就是特征标记，我觉得百度没有必要直接用国外接口啊有可能训练的时候总线和公交车都标记的bus什么的吧，我接触过的现在没有用中文标记的，代码里面直接用中文也不好，特征要翻译成英语去标记，所以你问中文的时候肯定要翻译成英语去查询，再一个训练的时间是影响匹配度的一个重要因素，擦，听懂的鼓掌。别动不动就说调国外接口啊;5;7;12;54433;0.00022045450370179853
7102;文心一言这么来的;6;9;15;54433;0.0002755681296272482
7109;中文的图片库质量不如英文的高，所以大模型训练时采用了英文的数据。那些说套皮的多花点时间去了解一下吧，不是给百度洗白，如果套皮的话文心一言质量不会这么差;8;6;14;54433;0.00025719692098543164
7120;象形文字的落后越来越凸显;10;5;15;54433;0.0002755681296272482
7134;只是训练用的国外数据，国内没有大规模文生图标注数据，只能把英文语料先翻译成中文再训练论文里说的很清楚了;8;8;16;54433;0.00029393933826906473
7146;国内公司其实挺强大的，国外没有的时候他们就没有，一旦国外有了，他们马上就变成世界领先水平了;1;15;16;54433;0.00029393933826906473
7149;是不是可以理解为，百度只是起了个翻译作用？;3;19;22;54433;0.000404166590119964
7153;人工智能就靠换皮，真卡脖子还得茅台。;4;49;53;54433;0.0009736740580162769
7158;曾经号称《百度更懂中文》结果现在出的ai却不懂中文;1;11;12;54433;0.00022045450370179853
7161;百度CEO说这个AI自己团队耕耘了6年了，6年前就布局AI了;1;14;15;54433;0.0002755681296272482
7163;文心一言的技术难点是如何隐瞒自己其实只是个中转站;2;24;26;54433;0.00047765142468723015
7166;遥遥领先遥遥领先遥遥领先继续遥遥领先;1;7;8;54433;0.00014696966913453236
7168;有没有一种可能是所有的基层开发软件，编程语言都是国外的，根本就不支持中文。;2;11;13;54433;0.00023882571234361508
7172;问题是，目前缺少直接对中文直接进行处理的编程语言和算法吧;3;6;9;54433;0.0001653408777763489
7177;但是chatgpt可以识别鹤和起重机;1;9;10;54433;0.00018371208641816545
7180;跟遥遥领先一个样;1;8;9;54433;0.0001653408777763489
7183;现在不能说企业坏话;1;14;15;54433;0.0002755681296272482
7185;简直就是个见不得人的笑话。失望至极。不再相信了。;1;10;11;54433;0.000202083295059982
7187;这就是自述研发了十几年的;23;98;121;54433;0.002222916245659802
7219;意思就是文心一言严格来说是一款皮肤？;1;18;19;54433;0.00034905296419451436
7221;国外一开源，国内就自研;2;85;87;54433;0.0015982951518380393
7224;国外AI开源之时，必是我们AI自研突破之日;1;18;19;54433;0.00034905296419451436
7229;英语踢出主科势在必行;2;11;13;54433;0.00023882571234361508
7232;是因为语料库都是使用英文分词;1;5;6;54433;0.00011022725185089927
7234;开源就自研;1;7;8;54433;0.00014696966913453236
7238;0;1;10;11;54433;0.000202083295059982
7241;慢慢完善吧，没有什么东西是完美的;2;61;63;54433;0.0011573861444344423
7245;有时候付出不一定能马上见到回报，希望百度能坚持下去;2;73;75;54433;0.0013778406481362408
7248;很少有企业愿意去大力投入科研发展，从这点来说百度是一家相当厉害的企业。;2;65;67;54433;0.0012308709790017085
7251;百度的实力还是没的说的，静待成果;1;60;61;54433;0.0011206437271508093
7254;0;5;30;35;54433;0.000642992302463579
7260;自主研发，遥遥领先;1;16;17;54433;0.00031231054691088127
7262;我不好说;1;10;11;54433;0.000202083295059982
7264;总线和狗哈哈哈;1;5;6;54433;0.00011022725185089927
7266;0;1;63;64;54433;0.001175757353076259
7272;百度算是学到华为的精髓了;6;45;51;54433;0.0009369316407326438
7286;都一样，什么国产化的东西都是壳子，比如什么什么中间件，什么什么Linux系统，说什么自主研发，懂得都懂;12;12;24;54433;0.00044090900740359707
7299;GPT一代一开源，百度马上就研发出来了;3;23;26;54433;0.00047765142468723015
7304;胸有成竹翻译英文就是心中有根棍儿;1;5;6;54433;0.00011022725185089927
7310;和华为的鸿蒙其实差不多;3;28;31;54433;0.0005695074678963129
7316;这种东西太多了，麒麟芯片和鸿蒙系统也是这种东西，之前很多人聊过麒麟芯片怎么回事的，结果都被封号了;1;11;12;54433;0.00022045450370179853
7318;《鸿蒙系统》;7;32;39;54433;0.0007164771370308453
7327;这跟磨芯片商标有啥区别啊;4;60;64;54433;0.001175757353076259
7333;这只能证明它是先翻译成英文，再分析。;4;11;15;54433;0.0002755681296272482
7338;首先我解释一下，百度是自己搞的，这个绘画功能叫做文心一格，已经推出有一段时间了。其实作者提到的中文转英文再绘画的方式应该是能锤上的，但是不代表是套用api，因为国内没有这么大的开源，免费让算法学习的数据库。。那使用国外数据库训练用的是的英语标签，出现这种情况很难避免，就像你天天说汽车是bus，你第一反应也不一定能反应出中文的”汽车”。至于是不是套用国外现有算法我也不完全否认没有这个可能性，你觉得是套用就拿证据呗;2;10;12;54433;0.00022045450370179853
7341;其他我都信，唯独科技弯道超车我不信;21;48;69;54433;0.0012676133962853417
7364;今年开始百度不会有人用了;1;5;6;54433;0.00011022725185089927
7367;让子弹飞一会，百度最多用了一些开源模型，直接套用chatgpt肯定不会;6;8;14;54433;0.00025719692098543164
7376;讲个笑话，纯国产绝对没有抄袭的鸿蒙系统，里面有google框架和服务;10;15;25;54433;0.0004592802160454136
7391;百度果然没让我失望;1;23;24;54433;0.00044090900740359707
7395;没跳出个起重机的广告就谢天谢地了;1;44;45;54433;0.0008267043888817446
7397;文心一言：我只是个包了皮出来抗揍的，别揭穿我啊;1;10;11;54433;0.000202083295059982
7400;搞半天还是老本行啊哈哈哈哈;1;12;13;54433;0.00023882571234361508
7402;这样套皮的话，还是值得一用的。毕竟不是自己的东西，应该用的效果还行;1;12;13;54433;0.00023882571234361508
7404;国外开源遥遥领先修复“bug”自主研发早有布局赢麻了;1;13;14;54433;0.00025719692098543164
7406;这和那个砂纸磨芯片的有啥区别吗;1;15;16;54433;0.00029393933826906473
7410;说真的，中文编码很复杂，nlp翻译都要搞半天，直接训练很费时费力而且大概率出不来（模型设计，训练，调参）而且这部分还不如分解为翻译nlp回答问题nlp。只是人家翻译nlp没做好而已;64;28;92;54433;0.001690151195047122
7477;会不会是买了个国外的核心;3;10;13;54433;0.00023882571234361508
7481;鸿蒙警告不爱国一次;1;8;9;54433;0.0001653408777763489
7484;chatgpt啊你赶紧开源吧你看你把百度急的;6;23;29;54433;0.0005327650506126798
7492;不知道大家有没有用过百度的深度学习框架，paddle那玩意也是直接抄;1;5;6;54433;0.00011022725185089927
7495;是不是假如世界上没有了美丽国，我们的“科技”会止步不前;1;10;11;54433;0.000202083295059982
7498;问不懂英文还是不懂中文？答不懂廉耻;1;13;14;54433;0.00025719692098543164
7500;早有布局自主研发弯道超车后来居上遥遥领先;19;64;83;54433;0.0015248103172707732
7520;套壳程序还少吗，比如某鸿，别的系统发现了重大bug并发布修复，他第二天也修复了某bug，真巧;5;25;30;54433;0.0005511362592544964
7528;自主研发，弯道超车，很牛批。;1;9;10;54433;0.00018371208641816545
7531;竟然有人对百度报希望;1;8;9;54433;0.0001653408777763489
7533;学习差的孩子不应该过于责备，应该鼓励。但是撒谎和弄虚作假的孩子必须打屁股。;1;57;58;54433;0.0010655301012253596
7535;中文语库确实拉，翻译成英文方便计算机理解搜索英文资源好像没有问题吧？谁说百度模型训练一定是中文了，还是让子弹飞一会吧;7;16;23;54433;0.0004225377987617805
7551;跟鸿蒙系统一样，还有龙芯芯片一样;4;22;26;54433;0.00047765142468723015
7556;百度有什么技术？医疗广告？;1;16;17;54433;0.00031231054691088127
7558;作为对AI有点了解的，这大概率是因为训练时使用了大量英文数据集，只能说有待提高，但实锤是套壳还不至于;37;31;68;54433;0.001249242187643525
7596;所以文心一言的技术难点是如何隐瞒自己其实只是个中转站;64;988;1052;54433;0.019326511491191006
7662;鸿蒙：“这我熟啊”;13;56;69;54433;0.0012676133962853417
7676;不就是汉译英，拿到chat上粘贴，再把答案英译汉吗？666;3;17;20;54433;0.0003674241728363309
7684;破案了我说我的画里面总有个塔吊;4;11;15;54433;0.0002755681296272482
7690;给国产ai多点宽容，多点时间，多点鼓励，不要扼杀刚起步的国产ai;23;23;46;54433;0.000845075597523561
7720;百度：我们不制造内容，我们是内容的搬运工;1;11;12;54433;0.00022045450370179853
7722;越是看评论区，我就越是感激现实生活中遇到的人，因为大家都是和和气气的交谈，会耐心听你说话，而网上充满了自以为是和戾气可能是因为觉得网络虚拟，不用负责;1;7;8;54433;0.00014696966913453236
7725;不是说他抄袭，是直接套用别人的工具使用就像你找一个工厂生产东西，他说他有技术有工厂可以接你的订单，结果接到订单转手又发给别的工厂生产去了，自己完全没有那个能力，在技术上造假，忽悠人;1;10;11;54433;0.000202083295059982
7727;现在的人并不关心真相，只要输出情绪就完事了;4;7;11;54433;0.000202083295059982
7732;文心一言很百度啊，做法也很中国很官方;5;41;46;54433;0.000845075597523561
7738;笑了都，估计调用ChatGPT的Api吧;3;9;12;54433;0.00022045450370179853
7742;文心一言开发的难点应该是如何套用chatgpt却不被别人发现;51;1596;1647;54433;0.03025738063307185
7796;不可能，我们是弯道超车，自主研发;1;4;5;54433;9.185604320908272e-05
7798;用这种东西会有文化自卑感;1;4;5;54433;9.185604320908272e-05
7803;我也不太专业，就是有没有一种可能这个ai就是用英文写的呢;7;4;11;54433;0.000202083295059982
7813;让它画个湿漉漉的小猫;2;4;6;54433;0.00011022725185089927
7816;这不就是我写毕业论文的过程么？翻译过来再翻译回去;1;4;5;54433;9.185604320908272e-05
7818;百度中介公司;1;4;5;54433;9.185604320908272e-05
7825;并不一定是接口大部分训练情境下确实标签用的是英文。但是百度为啥不用中文标签而是多一步翻译我不理解。;3;4;7;54433;0.00012859846049271582
7829;计算机也好编程也好太多东西底层逻辑都是英文逻辑那能怎么办？除非从头开始用中文逻辑开始做计算机。;8;4;12;54433;0.00022045450370179853
7838;可是编程用的就是英语啊;7;4;11;54433;0.000202083295059982
7847;中国没有足够多的数据，百度只能用国外的数据，不翻译成英文咋整;3;4;7;54433;0.00012859846049271582
7851;罗宾太着急了。你倒是等他们开源再推出啊;1;4;5;54433;9.185604320908272e-05
7859;大哥，咱们不懂技术的外行能不能别太自信。这个问题不在于调用别的接口，问题在于训练用的通用数据集是英文的。算法需要将中英文翻译一致才能训练;1;4;5;54433;9.185604320908272e-05
7863;文心一言，在gtp开源以后突然出现;1;4;5;54433;9.185604320908272e-05
7868;还有，让文心一言画电脑总线，画出来一辆大巴，是不是一个道理？;2;4;6;54433;0.00011022725185089927
7874;文心一言办公室吃盒饭真盒饭;1;4;5;54433;9.185604320908272e-05
7890;人家开源了，他立马套皮;2;4;6;54433;0.00011022725185089927
7899;不是不懂英文和中文，而是没有任何技术，都是给别人的东西套个壳子就成了自己的。;3;4;7;54433;0.00012859846049271582
7904;实际是因为世界上百分之九十以上的有用资料是英文的;3;4;7;54433;0.00012859846049271582
7908;鸿蒙说，这个我熟;1;4;5;54433;9.185604320908272e-05
7911;合着是做了个汉译英，再英译汉;1;4;5;54433;9.185604320908272e-05
7914;所以英语不适合做严密科学研究。容易意义不对味;5;4;9;54433;0.0001653408777763489
7921;话说胸有成竹要怎么画有人用国外的那个画过吗;2;4;6;54433;0.00011022725185089927
7924;就是中文没有好的训练集，所以才造成了误解，模型肯定是咱们自己的模型，就是训练数据的问题;3;4;7;54433;0.00012859846049271582
7932;其实没什么诡异的，我们国内没有自行绘画的数据库，用的是国外的绘图数据库，所以文心一言出的图会这样了。请多点自信，每次出来新的技术总是去怀疑套壳，就和鸿蒙系统出来的时候一样，最后结果如何呢？请不要带节奏，去深层次的了解了再去阐述，不能为了热度而不去明辨是非;2;4;6;54433;0.00011022725185089927
7936;我有一个疑问，同音多意在英文里面不存在吗？GTP目前没有漏洞吗？反正我没刷到;1;4;5;54433;9.185604320908272e-05
7955;其实是因为，，中文的nlp比英文要难很多而且训练资料也少很多，，大概率百度这个训练的时候用的就是英文的语料库;2;4;6;54433;0.00011022725185089927
7959;那我让它画个“黄油苍蝇”，它是不是画出一只蝴蝶;1;4;5;54433;9.185604320908272e-05
7962;我怀疑文心一言是转移GPT4，应该自信点，肯定是的;1;4;5;54433;9.185604320908272e-05
7966;我就知道是套壳，当然，并没有完全套，因为还有个审核;1;4;5;54433;9.185604320908272e-05
7970;先翻译，再后台去找ChatGPT进行测绘，再发结果给你;1;4;5;54433;9.185604320908272e-05
7975;鹤的英文是Crane起重机的英文是Crane纯属巧合，百度绝对不是套壳;1;4;5;54433;9.185604320908272e-05
7978;如果百度是汉语翻译成英语再作图，那么百度永远画不出正确的鼠标，因为鼠标只有一个英文“mouse”。可惜百度能够正确识别鼠标，而不是翻译成英文。;4;4;8;54433;0.00014696966913453236
7983;bus学电路的人都知道，第一反应绝对不会想起公交车的意思;1;4;5;54433;9.185604320908272e-05
7987;不是说好文心一言优势在中文理解吗;1;4;5;54433;9.185604320908272e-05
7990;请帮我写一篇作文好的，已推荐离你最近的莆田医院;3;4;7;54433;0.00012859846049271582
8000;真接入GTP算是好事，大功一件，别接入其他三线AI;2;4;6;54433;0.00011022725185089927
8004;啊熊悲伤酱Histoia季九lll国内被掐脖子了国外免费开源国内自主研发，遥遥领先;1;4;5;54433;9.185604320908272e-05
8014;国外开源我自研;1;4;5;54433;9.185604320908272e-05
8019;想开点，也许最后百度做出了国内最好的翻译软件;2;4;6;54433;0.00011022725185089927
8023;但是编程语言都是用的英语啊;13;4;17;54433;0.00031231054691088127
8038;故意开团的忍鸣蛙不争阿冬记一忘三二张优秀。无敌飞猪焦魏来GiAo魏欲空;1;3;4;54433;7.348483456726618e-05
8044;0;1;3;4;54433;7.348483456726618e-05
8054;研究广告遥遥领先;1;3;4;54433;7.348483456726618e-05
8064;鸿蒙不会也是吧。。。;1;3;4;54433;7.348483456726618e-05
8067;哈哈哈，合着又是抄的啊;1;3;4;54433;7.348483456726618e-05
8073;谷歌都还在苦恼百度已经解决了核心技术;2;3;5;54433;9.185604320908272e-05
8082;这是在扒百度的底裤，赶紧给他穿好，我怕百度着凉。不要说百度自己会穿底裤，她的手都用来捂他自己的眼睛了;1;3;4;54433;7.348483456726618e-05
8088;从开始我就觉得百度出的绝对套皮，还真是;3;3;6;54433;0.00011022725185089927
8093;文心一言是不是和鸿蒙一个路子？;3;3;6;54433;0.00011022725185089927
8101;有没有可能，百度就是直接对接到chatgpt上，搞个中文界面;1;3;4;54433;7.348483456726618e-05
8103;这不和鸿蒙一样吗;1;3;4;54433;7.348483456726618e-05
8118;干啥都套壳，还得赢;1;3;4;54433;7.348483456726618e-05
8138;用的人家的内核吧;1;3;4;54433;7.348483456726618e-05
8144;氦闪abcDRZO1BDERG白昼星辰悔戀集感谢施，让我一眼猜出来了问题;3;3;6;54433;0.00011022725185089927
8149;真正的文心一言，应该是“画个起重机”，AI马上给出五个起重机广告推广，然后才是起重机的图。;3;3;6;54433;0.00011022725185089927
8154;吴猛男190男高yeah直升飞机笑死我了;1;3;4;54433;7.348483456726618e-05
8158;只是为了配合股价而已，毕竟现在是热点，;1;3;4;54433;7.348483456726618e-05
8169;文心最开始就承认是中译英后画图;1;3;4;54433;7.348483456726618e-05
8174;其实还暴露另一个问题，百度的翻译也拉胯;1;3;4;54433;7.348483456726618e-05
8176;当年李彦宏被倒水也不是没有道理的;1;3;4;54433;7.348483456726618e-05
8178;唉。不知道怎么说。落后可以追赶，但是自欺欺人就可怕了;1;3;4;54433;7.348483456726618e-05
8180;给评论区的文盲们普及一下，训练的数据集都是英文标注的，这个和技术能力无关。当然我说了也是白说。;5;3;8;54433;0.00014696966913453236
8186;百度太心急了应该和华为商量下文心一言和仓颉一起强强联合这样就能圆起来了;1;3;4;54433;7.348483456726618e-05
8189;首先，GPT是AI，是一大串代码代码是计算机语言，是基于英语的，这语言体系和逻辑跟中文差别巨大。GPT的日常训练的模型和参数，都是基于英语体系的语言。而文言一心，是个中文版的AI，本底还是一大串英语写的代码，让这些代码识别中文，并且能准确识别真正意思，太难了，同一句话语境，语气那些的不同，意思差太远了，而且目前没有纯用中文写的代码。文言一心把中文提问先翻译英语再接入AI，那就很不准确了。给它多点时间吧，毕竟计算机识别中文真的需要很多时间;1;3;4;54433;7.348483456726618e-05
8193;0;2;3;5;54433;9.185604320908272e-05
8197;李彦宏：文心一言能达到GPT25的程度（GPT开源程度最高就是25）;1;3;4;54433;7.348483456726618e-05
8207;鸿蒙系统异曲同工之妙;1;3;4;54433;7.348483456726618e-05
8210;虽然很搞但同时也说明中文的表达方式ai还需要更多的理解。中文更复杂;3;3;6;54433;0.00011022725185089927
8219;用的是别人家的引擎呗;1;3;4;54433;7.348483456726618e-05
8221;我不听我不听，中国必定是遥遥领先;1;3;4;54433;7.348483456726618e-05
8227;作为英语老师你很优秀，但是作为自然语言处理方面你就是小白，不是想用中文就用中文的。目前最大的语料库和训练数据是英文;1;3;4;54433;7.348483456726618e-05
8232;中文是文化结晶英文是系统语言不接受这个事实终究被淘汰不要盲目跟风或抵制;12;3;15;54433;0.0002755681296272482
8246;这就很丢脸了;1;3;4;54433;7.348483456726618e-05
8248;我的理解是中转英的问题，因为底层主体需要英文。;1;3;4;54433;7.348483456726618e-05
8250;智能ai的开发过程中需要用到语料库，第一点是因为中文的语料库太贫乏了，而且质量极差，且能找到并使用开源资料比英文少太多；第二点是因为中文天然性的屏障性，中文的语言形式对于ai来讲学习起来太困难了，英文的语言形式有天然的优势，适合ai学习，毕竟计算机语言和开发语言都是英文。并不是百度单纯的套壳，只是因为现阶段无法使用中文让ai自主理解并仿人学习。gpt也做不到。需要自然语言学家的助力。这是我个人理解仅供参考;1;3;4;54433;7.348483456726618e-05
8256;哈哈哈百度老毛病了借鉴实锤了这就是借鉴，借鉴;1;3;4;54433;7.348483456726618e-05
8258;让画个中国会不会出来一个瓷器瓶;1;3;4;54433;7.348483456726618e-05
8269;评论区笑死，有一位“大牛”以王者荣耀没有鸿蒙区就断定鸿蒙是套安卓的壳，义务教育任重而道远呐;2;3;5;54433;9.185604320908272e-05
8272;娃娃菜;2;3;5;54433;9.185604320908272e-05
8276;英文也不能是套皮啊。关键百度ai绘画出来前，国外ai绘画都还没火;16;3;19;54433;0.00034905296419451436
8294;发视频之前一定要检验一下真假确保真实性;4;3;7;54433;0.00012859846049271582
8310;搞不懂用翻译成英文再做画怎么跟国外接口关联上的;3;3;6;54433;0.00011022725185089927
8314;程序语言是英语啊，调用肯定是以英文形式;7;3;10;54433;0.00018371208641816545
8322;百度作假已不是亿次两次了;1;3;4;54433;7.348483456726618e-05
8324;我感觉不是抄，是可能用了英文的训练数据而已;11;3;14;54433;0.00025719692098543164
8343;鸿蒙：这“技术”还是不行;1;3;4;54433;7.348483456726618e-05
8346;这不是忽悠不忽悠的问题是因为中文数据集非常少只能用英文数据集训练你这样评价会让很多完全不懂的人以为百度什么都没做有点让国内做人工智能的人心寒;5;3;8;54433;0.00014696966913453236
8354;我来告诉你为啥会这样，因为现有阶段的ai画作生成，目前都是借用google和openai的文本图像嵌入对，他的语言模型是自研的，但是在实行文本图像匹配时是使用clip或者t5因为这需要大量数据来是做，百度可能暂时没时间罢了;3;3;6;54433;0.00011022725185089927
8366;画一个细胞cell，可能会画出一个电池;1;3;4;54433;7.348483456726618e-05
8368;没办法，微软投资openai就130亿美元这东西也是要砸钱搞的哪有那么容易;2;3;5;54433;9.185604320908272e-05
8371;这是画的电脑鼠标，这么看还是很可爱的;2;3;5;54433;9.185604320908272e-05
8378;和鸿蒙系统异曲同工之妙;1;3;4;54433;7.348483456726618e-05
8380;0;1;3;4;54433;7.348483456726618e-05
8384;果然，刚出来的时候我就说，早不上线晚不上线。gpt后面他就来，八成是开个端口问gpt，然后照搬到自己端口回答用户问题;1;3;4;54433;7.348483456726618e-05
8399;中文语境太多太复杂，;2;3;5;54433;9.185604320908272e-05
8403;文心一言现在都不敢审核通过了，申请了一周都没反应;1;3;4;54433;7.348483456726618e-05
8405;鹤？贺氏吊装没毛病;1;3;4;54433;7.348483456726618e-05
8407;应该是训练数据是国外的数据源但应该不是套壳，判断是不是套壳很简单，同时gpt和文心问题就好，但从目前内测来看，两个答案差的还远;10;3;13;54433;0.00023882571234361508
8420;你告诉我你想干啥百度;3;3;6;54433;0.00011022725185089927
8424;0;1;3;4;54433;7.348483456726618e-05
8428;crane和duck更容易混淆吧？翻译成英文更容易错吧？;3;3;6;54433;0.00011022725185089927
8436;意思我们又是山寨版了。;2;3;5;54433;9.185604320908272e-05
8440;有些事中国人搞不了的，我们在小学老师的讲台上就，就定性了我们缺乏的不是能力，是创造力;1;3;4;54433;7.348483456726618e-05
8448;编码都是英文啊，很好理解，有什么问题不够智能而已;4;3;7;54433;0.00012859846049271582
8457;这不就更鸿蒙一样了，套壳;1;3;4;54433;7.348483456726618e-05
8461;femurtibiaTorichsniixne（ai被百度抄了之后画图回答问题都要超级vip了;1;3;4;54433;7.348483456726618e-05
8469;百度Ai是用代码生成的，输入的文字会自动翻译成英文代码，由于中英文翻译的问题导致图片生成错误。可以理解，;5;3;8;54433;0.00014696966913453236
8479;中文在自然语言处理中很难处理，所以先翻译;3;3;6;54433;0.00011022725185089927
8484;安卓跟鸿蒙的关系吗？;1;3;4;54433;7.348483456726618e-05
8488;他们给这款软件起了一个类似都市言情小说网站的名字我就对它没有什么期待了;1;3;4;54433;7.348483456726618e-05
8493;博主说的，一定是把起重机先翻译成英文，再进行作画的，这句话非常不准确;32;3;35;54433;0.000642992302463579
8526;这就是李彦宏说的文心一言更懂中文;1;3;4;54433;7.348483456726618e-05
8530;有个玩笑，百度是一家科技公司;1;3;4;54433;7.348483456726618e-05
8533;扒开外壳，里面都是英文，能怎么办呢？it是用英文在谱写这个世界啊;12;3;15;54433;0.0002755681296272482
8564;遥遥领先了可以说是;1;3;4;54433;7.348483456726618e-05
8575;套个锤子皮代码不用英文写还用中文写;7;3;10;54433;0.00018371208641816545
8590;拜拉拜拉拜拉清溪微风恋尘小一饱饱在家里躺着也不要忘记学习英语;1;2;3;54433;5.511362592544963e-05
8592;有没有可能国内软件开发语言需要用英文，导致这个ai并不能直接识别汉字;9;2;11;54433;0.000202083295059982
8608;百度太搞笑了给我带来了快乐;1;2;3;54433;5.511362592544963e-05
8612;有没有一种可能，当人类与人工智能世纪大战的时候，人们只能通过博大精深的汉语交流，防备被窃听解析;8;2;10;54433;0.00018371208641816545
8627;咦看来我们不是落后是没有;1;2;3;54433;5.511362592544963e-05
8630;有没有可能是数据库呢？数据库共用是没有问题的吧？;2;2;4;54433;7.348483456726618e-05
8638;先翻译成英文没什么不对，依因为程序对中文本身就不友好;1;2;3;54433;5.511362592544963e-05
8661;人口红利这玩意还能吃好几十年;1;2;3;54433;5.511362592544963e-05
8666;可能是没有能用的中文计算机代码语言，所以得翻译后才生成吧;2;2;4;54433;7.348483456726618e-05
8669;这不是测试阶段嘛，就是要趁着ai啥都不懂的时候玩，要是啥都懂了就没那么逗了;1;2;3;54433;5.511362592544963e-05
8672;我们正在追究造谣者的责任百度遥遥领先，不要造谣;1;2;3;54433;5.511362592544963e-05
8681;正因为是生成了这些千奇百怪的图片，才真正证明了百度不是套壳，是真正自己去训练的AI，仔细想想他为什么翻译成这种英文就理解了;2;2;4;54433;7.348483456726618e-05
8685;诡异的是百度还有百度翻译，能弄成这样确实离谱;1;2;3;54433;5.511362592544963e-05
8694;国内不最擅长这种嘛，前有华为，后有百度。;1;2;3;54433;5.511362592544963e-05
8701;我们从来不生产水，我们只是大自然的搬运工;1;2;3;54433;5.511362592544963e-05
8709;靑旾不负，韶华正好阿文会巭实锤;1;2;3;54433;5.511362592544963e-05
8713;难道不是所有的东西都要先翻译成英文再执行吗？这又不是搜索，目前还没有用大范围用中文编程的东西;2;2;4;54433;7.348483456726618e-05
8722;为什么一定要翻译英文？;2;2;4;54433;7.348483456726618e-05
8729;终于等到这么说的了，和鸿蒙的草稿一模一样;2;2;4;54433;7.348483456726618e-05
8739;是不是太高要求了？多点包容，抵制谷歌和特斯拉;1;2;3;54433;5.511362592544963e-05
8745;抄，这么多年过去了，还在抄;1;2;3;54433;5.511362592544963e-05
8753;不是哥们，AI文字转图片这块几乎全世界用的都是意大利的数据库，目前还没有第二个成熟的数据库，我们用的时候访问他们的数据库当然得先翻译成外文啊，不先做做工作就在这尬黑真没必要;15;2;17;54433;0.00031231054691088127
8781;《我们早有准备》;1;2;3;54433;5.511362592544963e-05
8788;这不跟鸿蒙差不多嘛;4;2;6;54433;0.00011022725185089927
8796;套皮从不让人失望，就像哄蒙;1;2;3;54433;5.511362592544963e-05
8807;0;1;2;3;54433;5.511362592544963e-05
8810;告诉我谁家代码用中文写的;1;2;3;54433;5.511362592544963e-05
8824;好多互联网科研项目也是套用别人核心接口然后自己套皮;1;2;3;54433;5.511362592544963e-05
8829;加油鸿蒙，加油文心一言;2;2;4;54433;7.348483456726618e-05
8834;从0到1，的确是别人强。从1到100，我们还真没服过谁;1;2;3;54433;5.511362592544963e-05
8838;项目本来就是计划的基于国外服务器研发转化为中文系统，听着简单，我表哥前年从硅谷回来进入项目，凌晨两点之前没睡过觉，还没三十呢刚结婚心脏出了好几次毛病了，我们应该承认的是国外一些领域确实比咱们先进，知道哪里不足就努力去发展哪里，而不是张口否认任何人的努力，去抹黑，并且各位在想批评别人的时候想想自己有多大的能力;1;2;3;54433;5.511362592544963e-05
8843;那个，有没有一种可能，国内没什么高质量训练集，他直接买的的国外训练集用的;4;2;6;54433;0.00011022725185089927
8858;基尔伯特的小狗《自主研发》《遥遥领先》《卡脖子》;1;2;3;54433;5.511362592544963e-05
8864;谁来解释一下调用的“国外接口”是个什么东西;3;2;5;54433;9.185604320908272e-05
8869;把摩托罗拉的芯片logo磨掉，换成自己的;1;2;3;54433;5.511362592544963e-05
8871;百度不支持中文真是离了大谱;2;2;4;54433;7.348483456726618e-05
8874;难道不是因为程序编译只能用英文吗评论区的在阴阳怪气什么;9;2;11;54433;0.000202083295059982
8892;其实这个真无解，因为编码肯定是要用英文编码，就算是中国人发明的应用，内核还是必须用英文写，这就导致了像AI识别这样的问题，这个就回到了机翻的准确性问题了，所以要解决AI识别问题就必须要解决机翻问题，但是话说回来，如果机翻以后完善完美了，那同声和干翻译的就真的失业了;4;2;6;54433;0.00011022725185089927
8897;是不是因为训练集用的是别人的，所以才这样？;5;2;7;54433;0.00012859846049271582
8904;国外的互联网大厂在改变时代，我们的互联网大厂在向下收割;1;2;3;54433;5.511362592544963e-05
8907;百度和华为一样都是中国骄傲，一点零件用国外的怎么了？无伤大雅，赢;3;2;5;54433;9.185604320908272e-05
8912;全球计算机编程基础语言近90是英语，百度也没办法改变这客观情况，各位就别冷嘲热讽百度了，换谁来也大概率无奈用英语，毕竟我们科技落后太多，我也希望看到有一天计算机领域各种代码是中文编写;3;2;5;54433;9.185604320908272e-05
8917;本人IT从业10年，这事其实没什么问题。市面上最主流的训练集，也就是打标数据基本都是英文打标。百度训练的ai在前期训练和设计开发中的输入应该也是用英文。现在要用中文，为了保证程序可用。直接用自带百度翻译先翻译成英文再处理很合理。说什么调用chatgpt的接口，太扯。;2;2;4;54433;7.348483456726618e-05
8921;高端科技，套皮科技;1;2;3;54433;5.511362592544963e-05
8925;那画个猫咪吧;1;2;3;54433;5.511362592544963e-05
8931;唐伯虎点秋香;1;2;3;54433;5.511362592544963e-05
8938;百度无耻;1;2;3;54433;5.511362592544963e-05
8941;百度在让人失望这件事上从没让人失望过的;1;2;3;54433;5.511362592544963e-05
8950;笑死国内正常操作每次别人研究出来个什么东西国内之前什么消息都没有突然各大企业就技术成熟了然后开始收费;1;2;3;54433;5.511362592544963e-05
8959;别说文心一言你用百度翻译试试把猞猁翻译成日语你会惊奇的发现它翻译成了父亲;3;2;5;54433;9.185604320908272e-05
8963;说个笑话百度是科技公司;1;2;3;54433;5.511362592544963e-05
8975;这算什么，某大台的新闻把海马斯叫成电池;3;2;5;54433;9.185604320908272e-05
8990;会不会调用了chat？;1;2;3;54433;5.511362592544963e-05
8993;AI领域输了就输了未来呀，笑不出来;3;2;5;54433;9.185604320908272e-05
9001;《绝对不是落井下石》让文心一智障翻一下;1;2;3;54433;5.511362592544963e-05
9016;0;2;2;4;54433;7.348483456726618e-05
9022;又一个鸿蒙？;1;2;3;54433;5.511362592544963e-05
9024;海绵饱饱儿希里昂叔叔没有如果7套皮ai;1;2;3;54433;5.511362592544963e-05
9027;如果本来就是在英语上训练的呢？毕竟英语的语料和算法思路积累更多;1;2;3;54433;5.511362592544963e-05
9029;讲个笑话，百度搞了十年的AI;1;2;3;54433;5.511362592544963e-05
9031;国家不是不让学英语了么;1;2;3;54433;5.511362592544963e-05
9054;这个东西是这样的，所有编程都是用英语进行的，出现这些很正常，还没有进行迭代和语言训练，说白了就是中文语言训练还不够;4;2;6;54433;0.00011022725185089927
9059;鹤在我们的文化里面这么仙气飘飘的动物老外居然觉得起重机和它长得像;1;2;3;54433;5.511362592544963e-05
9070;扪心一问，这是高科技;1;2;3;54433;5.511362592544963e-05
9079;也不是套皮，模型用英文训练更容易;2;2;4;54433;7.348483456726618e-05
9083;李彦宏在让人失望方面从不让人失望;1;2;3;54433;5.511362592544963e-05
9087;bd还号称自己是全球大厂;1;2;3;54433;5.511362592544963e-05
9090;地球上最后一个奥特曼Vs警员编号663沉溺芝士鼠子;2;2;4;54433;7.348483456726618e-05
9097;我们没有芯片啊，所以说目前最应该突破的是芯片制成;2;2;4;54433;7.348483456726618e-05
9100;从根本上改变，用拼音编程，我们要有自己的计算机语言才可以掌握主动权;3;2;5;54433;9.185604320908272e-05
9108;0;1;2;3;54433;5.511362592544963e-05
9110;它可以做一个翻译软件啊，它把你的问题发给ChatGPT，然后再把它的答案发回来不就好了;3;2;5;54433;9.185604320908272e-05
9118;给它一点时间，GPT刚开始的时候还不如一言。并不是出生就会跑的，需要成长和时间。;20;2;22;54433;0.000404166590119964
9141;百度表示，老子不给你都画上广告算不错了;1;2;3;54433;5.511362592544963e-05
9144;把自卑和敏感演绎的淋漓尽致;1;2;3;54433;5.511362592544963e-05
9152;0;1;2;3;54433;5.511362592544963e-05
9155;0;4;2;6;54433;0.00011022725185089927
9163;远山悲悯随你的便日不死的Hubert;1;2;3;54433;5.511362592544963e-05
9168;可能只是用了英文的单词向量库;1;2;3;54433;5.511362592544963e-05
9170;让百度画一个患癌症的肺，马上出来一堆莆田系医院;1;2;3;54433;5.511362592544963e-05
9174;给的时间太紧了呀，人家只能暂时先这样了;3;2;5;54433;9.185604320908272e-05
9182;中文语料确实太少，所以用了英文。不至于套皮，但是效果需要时间;1;2;3;54433;5.511362592544963e-05
9186;百度真的是套壳的，去看它底层发的API，是openai的接口;2;2;4;54433;7.348483456726618e-05
9189;有没有一种可能，因为编程本身的语言就是英语？;7;2;9;54433;0.0001653408777763489
9206;我们瑜伽里鹤禅式，也叫起重机式;1;2;3;54433;5.511362592544963e-05
9208;我就说百度哪来的这种积淀;4;2;6;54433;0.00011022725185089927
9219;这不是中间商挣差价的活么;1;2;3;54433;5.511362592544963e-05
9225;刚画的，没毛病呀;5;2;7;54433;0.00012859846049271582
9231;HAo遥遥领先的;1;2;3;54433;5.511362592544963e-05
9234;嘉然大魔王菜籽呦呦street卡卡罗特宇宙最强奥特曼暴龙战士梦泪无敌;1;2;3;54433;5.511362592544963e-05
9248;建议看一下百度官方的澄清公告，兼听则明;3;2;5;54433;9.185604320908272e-05
9252;程序是用英文写的啊，内行应该都知道;5;2;7;54433;0.00012859846049271582
9259;懂了，先翻译成英文，用GDP做出来，再抄过来改一改;2;2;4;54433;7.348483456726618e-05
9265;这不是就跟华为的鸿蒙一个道理吗？别笑人家百度。;2;2;4;54433;7.348483456726618e-05
9273;有没有可能他需要用到编程语言是外文的？;2;2;4;54433;7.348483456726618e-05
9284;百度有几个产品;1;2;3;54433;5.511362592544963e-05
9288;这有啥不能理解的。后台程序英文写的。所以翻译成英文再去出程序。;2;2;4;54433;7.348483456726618e-05
9304;为啥要翻译成英文？;1;2;3;54433;5.511362592544963e-05
9306;这下就明白了为啥唐伯虎点秋香了;2;2;4;54433;7.348483456726618e-05
9311;哦原来这样啊，我还是好奇胸有成竹怎么画;1;2;3;54433;5.511362592544963e-05
9315;你让他画一个莆田医院，它肯定不会给你画错;2;2;4;54433;7.348483456726618e-05
9318;。。。Aroma難泡泡believeAries22啊我脖子呢XXX要旅游小趴杉菜丢死人;2;2;4;54433;7.348483456726618e-05
9326;语言上是中文，逻辑上是英语;1;2;3;54433;5.511362592544963e-05
9330;我来解释一下，因为编程是英文的，所以把中文翻译成英文再画图是必须的流程，所以问题很明显出在中译英上，我猜测很有可能是百度用了谷歌翻译的问题，无法理解中文的博大精深;2;2;4;54433;7.348483456726618e-05
9333;让我想到鸿蒙;1;2;3;54433;5.511362592544963e-05
9336;超人家的，难怪百度键盘只有三个按键;1;2;3;54433;5.511362592544963e-05
9345;百度是不是套壳我不知道，但是我身边搞自然语言处理的都是拿英文做实验做训练，很正常;1;2;3;54433;5.511362592544963e-05
9347;可樂木上三又;1;2;3;54433;5.511362592544963e-05
9358;真的不是皮套，可能是数据集标签翻译有问题，训练时候数据集的问题;2;2;4;54433;7.348483456726618e-05
9362;好一个自主研发;1;2;3;54433;5.511362592544963e-05
9364;百度在令人失望面前，从来没让人失望过。;1;2;3;54433;5.511362592544963e-05
9382;不是，这中文nlp有问题的，所有的都是翻译成英文再做机器学习的，这没啥稀罕的呀;4;2;6;54433;0.00011022725185089927
9387;难怪国外有点什么东西国内就宣布自己也有，你有就是我有;1;2;3;54433;5.511362592544963e-05
9389;x沐幼之粲然赵梓豪皮套人;1;2;3;54433;5.511362592544963e-05
9394;有没有可能是人问完了问题之后，后台翻译之后发给chatgpt，得到答案之后再发给提问的人;2;2;4;54433;7.348483456726618e-05
9397;0;3;2;5;54433;9.185604320908272e-05
9401;翻译成英文看来是真的，不过套皮不至于;8;2;10;54433;0.00018371208641816545
9412;多鼓励吧毕竟高端芯片被老美制裁着呢先有在精不要扼杀在摇篮里;4;2;6;54433;0.00011022725185089927
9423;树藤野京三十三画生我有辣条跟我走。purpose胡子拉碴还抠脚丫的美少女战士遥遥领先;1;2;3;54433;5.511362592544963e-05
9430;就是翻译人家呗;1;2;3;54433;5.511362592544963e-05
9433;创新啊，这都不懂，不是所有人都懂英语的，所以有很大的创意空间;1;2;3;54433;5.511362592544963e-05
9435;感觉刚刚拉近差距一下子又被甩开了;1;2;3;54433;5.511362592544963e-05
9458;可惜这个网友的例子就是假的;15;2;17;54433;0.00031231054691088127
9474;我是外行，我的理解是计算机语言本来就是英文基础出现的，所以任何中文指令必定要现转换成英文，或2进制语言。;11;2;13;54433;0.00023882571234361508
9487;有没有可能，英文本来就是中国的。我们用英文来造ai，本来就是天经地义。;4;2;6;54433;0.00011022725185089927
9503;没事，多提出问题，百度才能进步，加油;2;2;4;54433;7.348483456726618e-05
9515;别对百度抱希望就对了;2;2;4;54433;7.348483456726618e-05
9518;有木有可能它的训练预料是英文的，然后翻译成中文训练的模型;10;2;12;54433;0.00022045450370179853
9536;0;1;2;3;54433;5.511362592544963e-05
9539;看来文心一言核心用的是gpt，不得不翻译成英文后再处理;8;2;10;54433;0.00018371208641816545
9548;简体中文互联网生态，有效数据少，用英语作为主要训练输入数据，挺正常的吧;6;2;8;54433;0.00014696966913453236
9557;我认为这与语言的语义识别有关系，先翻成英文更容易读取字符和判断语义。;3;2;5;54433;9.185604320908272e-05
9568;真是外行看热闹。。因为国内基本没有高质量的中文数据集，所以百度肯定是大量用了英文tag的数据集做训练，所以对模型输入中文的时候肯定要先翻译成英文才行。只能说因为这一点就说百度是套壳的是外行中的外行。;4;2;6;54433;0.00011022725185089927
9575;那我直接说英文，使用文心一言不就等于使用ChatGPT了这样也行，也不错的;1;2;3;54433;5.511362592544963e-05
9580;希望能有汉语言作为底层的计算机术语;1;2;3;54433;5.511362592544963e-05
9582;底层代码都是英文的，没办法;2;2;4;54433;7.348483456726618e-05
9586;让我想到了当年的自动榨汁售卖机里面坐着一个大妈;1;2;3;54433;5.511362592544963e-05
9588;我马上去试;3;2;5;54433;9.185604320908272e-05
9592;我说的吗，暗影格斗2隐士的一个弟子叫起重机，但是看样子和姿势看样子确实很像鹤，原来英文是一个单词;2;2;4;54433;7.348483456726618e-05
9598;为什么直接中文不行？套用的吗;8;2;10;54433;0.00018371208641816545
9635;ban;1;1;2;54433;3.674241728363309e-05
9637;直接调用的百度翻译的API百度翻译什么水平就是不管语义直接硬翻译好歹也根据语义翻译一下都不会闹这么多笑话;1;1;2;54433;3.674241728363309e-05
9639;底层代码是英文，这样结果可想而知。;1;1;2;54433;3.674241728363309e-05
9660;赢麻了蔡猹鹿LL明天六点起床;1;1;2;54433;3.674241728363309e-05
9687;AI都是推荐迭代算法，出得大多是通俗易懂的且出图同模型多的，你要是在网络上出的鹤的次数多，它就会基本上给你出鹤，你要出起重机，起码要多生成几次才可能出现;2;1;3;54433;5.511362592544963e-05
9698;鹤式起重机怎么翻译;1;1;2;54433;3.674241728363309e-05
9710;英特纳雄耐尔;1;1;2;54433;3.674241728363309e-05
9714;Lily学IT你看看这;2;1;3;54433;5.511362592544963e-05
9718;左斜哈哈，所以没有自己的东西，是在调用别人的东西？;1;1;2;54433;3.674241728363309e-05
9732;有没有一种可能，程序是英文的;1;1;2;54433;3.674241728363309e-05
9748;咱们有正儿八经的ai嘛;1;1;2;54433;3.674241728363309e-05
9752;《已研发十年》;1;1;2;54433;3.674241728363309e-05
9765;我是搞IT的，从技术的角度讲一个可能：现在训练英文模型的技术比较成熟（英文模型有成熟的经验、训练量也大），先将中文翻译成英文再做生成是比较好的技术解决方案。这个其实很正常的;1;1;2;54433;3.674241728363309e-05
9773;用的计算机语言本身就是英语体系语言，所以智能软件必然是中文转换英文在以英文来对照操作，所以真相发展AI技术就要摒弃现有英语体系的计算机语言，研发以汉语体系的计算机语言，所以中国想超越欧美还有很长一段路;1;1;2;54433;3.674241728363309e-05
9777;说明楼主不懂技术。百度的技术没有问题，他这样做是让网友及外国的技术来训练自己的模型。如果闭门造车，肯定就没有希望，这种方式可以缩小与chatgpt的差距，就如百度与google。;10;1;11;54433;0.000202083295059982
9793;佳音;1;1;2;54433;3.674241728363309e-05
9798;一只林子吖柯柯爱睡觉TheGalaxy;2;1;3;54433;5.511362592544963e-05
9806;所以它是套壳的东西？;1;1;2;54433;3.674241728363309e-05
9818;说明内部转换还是英文为基础，这个问题多严重啊，希望华为改变软件编译方式，用中文来理解这个世界;1;1;2;54433;3.674241728363309e-05
9830;想想雪乃会怎么说;1;1;2;54433;3.674241728363309e-05
9834;GLLCHS好蠢。。;1;1;2;54433;3.674241728363309e-05
9840;这不就是鸿蒙么;1;1;2;54433;3.674241728363309e-05
9850;就像那个厂的自研芯片一样;1;1;2;54433;3.674241728363309e-05
9855;我们等别人开源了然后弯道抄车;1;1;2;54433;3.674241728363309e-05
9867;不一定是套壳，编程语言就是英文，可不就要先翻译成英文嘛;2;1;3;54433;5.511362592544963e-05
9880;我觉得应该是拿的开源的训练模型，然后百度做了定制然后自己训练的，不然他不敢说是自主研发;1;1;2;54433;3.674241728363309e-05
9883;内核是国外的;1;1;2;54433;3.674241728363309e-05
9888;？？NPC玩家;1;1;2;54433;3.674241728363309e-05
9899;0;1;1;2;54433;3.674241728363309e-05
9906;鸿蒙是不是也这样？;2;1;3;54433;5.511362592544963e-05
9911;中国是大国但还称不上强国，同志们还需努力，;1;1;2;54433;3.674241728363309e-05
9926;文心一言变成了扪心自问;1;1;2;54433;3.674241728363309e-05
9938;自主研发，遥遥领先。;1;1;2;54433;3.674241728363309e-05
9940;你知道GPT让它画总线，画出来的是什么吗？我给你看看，这就是GPT画的总线;3;1;4;54433;7.348483456726618e-05
9946;俗气至顶这就是国内科技发展的态度;1;1;2;54433;3.674241728363309e-05
9948;0;1;1;2;54433;3.674241728363309e-05
9966;李雨住木林圣约路明非真套皮;1;1;2;54433;3.674241728363309e-05
9976;我：画一个李彦宏总线;1;1;2;54433;3.674241728363309e-05
9988;超级瞎比啊白;1;1;2;54433;3.674241728363309e-05
10005;博主你懂么？做过算法的都知道这个明显是训练语聊问题，中文和图片国内质量不行，会需要训练大量国外的英文图片，所以训练时就会把英文翻译成中文，那在使用时输入中文就会生成对应英文的图片;4;1;5;54433;9.185604320908272e-05
10022;kKuanznagashi;1;1;2;54433;3.674241728363309e-05
10044;百度本来就是用英文数据集训练的，有什么问题吗？;1;1;2;54433;3.674241728363309e-05
10058;所以最近国内炒作的gpt本身是人家国外的技术;1;1;2;54433;3.674241728363309e-05
10060;Eliauk、答辩;2;1;3;54433;5.511362592544963e-05
10064;那问题来了，为什么要用英文？（没有恶意，别发律师函）;1;1;2;54433;3.674241728363309e-05
10076;照这么说，百度搜索会不会也是套用谷歌的啊;1;1;2;54433;3.674241728363309e-05
10079;入江;1;1;2;54433;3.674241728363309e-05
10129;买了国外的接口，结果自己的翻译过不去;2;1;3;54433;5.511362592544963e-05
10151;0;3;1;4;54433;7.348483456726618e-05
10183;这不很正常吗？计算机语言就是英文的呀，铁汁们。;4;1;5;54433;9.185604320908272e-05
10192;我感觉他是想一次性支持多语言，然后就用相对容易处理的英语来做文本到图片的生成，但是对于同义词的处理不到位。以百度的水准我觉得肯定是自己做的，但这个做的路子出了点问题;4;1;5;54433;9.185604320908272e-05
10203;克兰MynameisKyleCrane飉庆良佑不打神经枪想吃凉拌皮蛋yyy;1;1;2;54433;3.674241728363309e-05
10210;翎Dreamer怀园红心火龙果（水泥封心版）香菇好好吃歪了的天选之人绿色不明团块德云小仙女儿Prophet早上刚看完李彦宏的发言，现在就被打脸;3;1;4;54433;7.348483456726618e-05
10223;我尝试了一下，并没有出现UP主所说的情况，你们可以自己去试一下，不要人云亦云。;1;1;2;54433;3.674241728363309e-05
10229;我那天还在b站看到一个博主说ai技术不咋地，原意我已经忘了，应该说的是国外ai就是数据超前而已，没什么了不起的，哎，我也不知道谁对谁错;2;1;3;54433;5.511362592544963e-05
10232;为什么要先翻译成英文再画呢;5;1;6;54433;0.00011022725185089927
10239;看来百度的翻译也不过关啊;1;1;2;54433;3.674241728363309e-05
10243;在网上看的那些图就知道有问题了，都是英语不好的直译;1;1;2;54433;3.674241728363309e-05
10249;百度百科就是慢慢积累完善的。不要总是嘲笑。鼓励一下好不好;4;1;5;54433;9.185604320908272e-05
10255;你码代码是用中文码的吗？;5;1;6;54433;0.00011022725185089927
10262;开导玄石遥遥邻先;1;1;2;54433;3.674241728363309e-05
10266;文心一盲;1;1;2;54433;3.674241728363309e-05
10271;也不一定是接国外的，各类编程语言不都是英文么;3;1;4;54433;7.348483456726618e-05
10279;所以假如我想区分起重机和鹤英文到底怎么说;1;1;2;54433;3.674241728363309e-05
10291;GPT套个外套，文心一言;1;1;2;54433;3.674241728363309e-05
10295;我的建议是，如果有些人真的一点相关的基本认识都没有，就没必要来评价这种东西;4;1;5;54433;9.185604320908272e-05
10300;编程不就是用英文的吗;7;1;8;54433;0.00014696966913453236
10323;也能不说换皮吧，代码不都是得用英文吗;1;1;2;54433;3.674241728363309e-05
10334;0;1;1;2;54433;3.674241728363309e-05
10355;应该不是套壳毕竟外国chatgpt的能识别中文这个真的可能是百度自己代码写的有问题;1;1;2;54433;3.674241728363309e-05
10358;寻一三亩地哈哈哈哈哈哈原来这么垃圾啊;1;1;2;54433;3.674241728363309e-05
10379;中文的理解是很难量化的过程，所以。。。难;1;1;2;54433;3.674241728363309e-05
10381;这玩意底层用英文没啥问题，毕竟是要面向全球的。;1;1;2;54433;3.674241728363309e-05
10398;大山雀摧毁小猫咪;1;1;2;54433;3.674241728363309e-05
10406;土耳其画成了火鸡，一样的笑死;2;1;3;54433;5.511362592544963e-05
10409;白夜Demon大马猴康乐套壳太强了怪不得开发贼快，立项到发布;2;1;3;54433;5.511362592544963e-05
10432;一个中文互联网的ai的中文训练量不够英文训练量满分;1;1;2;54433;3.674241728363309e-05
10435;语料库不足而已，一群大聪明。。。;1;1;2;54433;3.674241728363309e-05
10477;公关在哪里？20w删此视频;1;1;2;54433;3.674241728363309e-05
10495;用得着去国外转一圈么，不就是用了clip的模型，clip是开源的，可以直接用，只是百度没用中文训练，直接上线而已，stablediffusion也是类似的堆叠方式调用的;3;1;4;54433;7.348483456726618e-05
10516;我在想办法解决问题，你在干嘛？;1;1;2;54433;3.674241728363309e-05
10519;用英语写的程序肯定会出现这种情况;1;1;2;54433;3.674241728363309e-05
10532;所以，英语还取消吗？;3;1;4;54433;7.348483456726618e-05
10544;飞柱鲨手;1;1;2;54433;3.674241728363309e-05
10560;中文你看看我们一个词语有多少歧义，你看看语义训练好练吗;3;1;4;54433;7.348483456726618e-05
10567;这下老婆饼真有老婆婆了;12;1;13;54433;0.00023882571234361508
10581;嘿嘿嘿嘿嘿;1;1;2;54433;3.674241728363309e-05
10599;码云;1;1;2;54433;3.674241728363309e-05
10603;不能说百度是套皮AI只能说计算机的底层语言就是来自英文，中文必须转换成英文计算机才能懂;1;1;2;54433;3.674241728363309e-05
10616;7777早睡很搞笑，这就是百度;1;1;2;54433;3.674241728363309e-05
10638;除了百度，中国还有其他人能做出来吗？;1;1;2;54433;3.674241728363309e-05
10645;有没有可能文心一言是用英文数据训练的;1;1;2;54433;3.674241728363309e-05
10661;0;1;1;2;54433;3.674241728363309e-05
10665;放学请我吃辣条玩的就是自主创新，玩的就是对标chatgpt;1;1;2;54433;3.674241728363309e-05
10673;四个大字：东施效颦;1;1;2;54433;3.674241728363309e-05
10689;闪电波尔卡小嘴儿乱亲不是肌肉男（备考版）笑死我了;1;1;2;54433;3.674241728363309e-05
10695;百度还是那个百度？;1;1;2;54433;3.674241728363309e-05
10711;苹果app下载的文心一言是百度发布的那个吗？怎么全是广告跟中毒了一样;2;1;3;54433;5.511362592544963e-05
10720;我怎么觉得它画得一点都没有毛病呢？胸有成竹，车水马龙一点都没有毛病;5;35;40;54433;0.0007348483456726618
10726;一年级题都不会关键问题不一样答案一样;11;1;12;54433;0.00022045450370179853
10738;我觉得它单纯就是个西方人，听不懂中文而已，完全不理解东方文化;1;1;2;54433;3.674241728363309e-05
10740;你就说是不是车水马龙吧;1;15;16;54433;0.00029393933826906473
10743;我问的答案基本都是对的啊;1;0;1;54433;1.8371208641816546e-05
10745;我觉得这波文心不亏，gtp车水马龙不就是网图么;1;4;5;54433;9.185604320908272e-05
10763;当喊出第二遍：小度，小度时，产品经理吓尿裤子了;12;285;297;54433;0.005456248966619514
10776;小度小度，文心一言就是个PPT;3;109;112;54433;0.002057575367883453
10781;我们有科技企业吗;14;33;47;54433;0.0008634468061653776
10796;如果你不能超越百度，就别随意嘲笑，最起码那是我们民族的，最起码别人有勇气去探索尝试。嘲笑容易。做实事难;4;29;33;54433;0.000606249885179946
10801;大哥，文心一言，是调用别人的接口，一个普通的程序员都能做到;4;0;4;54433;7.348483456726618e-05
10806;他依然是中国顶尖的科技企业。;11;10;21;54433;0.00038579538147814744
10818;我家的小度你叫它“小狗”“小猫”等等，随便叫都会答应;7;39;46;54433;0.000845075597523561
10826;真不知道留言的有几个人有资格评价李彦宏;10;13;23;54433;0.0004225377987617805
10837;十年磨一剑，终于等开源;1;27;28;54433;0.0005143938419708633
10839;这叫恨铁不成钢，并非嘲笑。;2;43;45;54433;0.0008267043888817446
10842;百度还是不容易。大家应该多点理解，而不是做键盘侠;3;10;13;54433;0.00023882571234361508
10846;如果没有正规医疗呢;2;15;17;54433;0.00031231054691088127
10849;百度的科技是很牛的。量子计算，无人驾驶，都是走在前列。;6;5;11;54433;0.000202083295059982
10856;人工智能，国内和国外各有千秋，中国注重人工，国外注重智能;1;18;19;54433;0.00034905296419451436
10859;这对我们平常生活有什么影响和区别？？？;4;1;5;54433;9.185604320908272e-05
10864;别嘲笑，给国内创新多一点包容;2;2;4;54433;7.348483456726618e-05
10887;还好小度答应了，我真的好怕它不答应，替李彦宏捏把汗;1;3;4;54433;7.348483456726618e-05
10896;别的我不怕，就怕给我导航到莆田系;1;2;3;54433;5.511362592544963e-05
10912;最终还是学习能力的问题;1;1;2;54433;3.674241728363309e-05
10925;百度还是有实力的。自动驾驶，人工智能两大块;2;0;2;54433;3.674241728363309e-05
10933;小龙虾辣喉咙简暗印象老宫辉獴这么贵，好吧，看来国内是很难了;1;0;1;54433;1.8371208641816546e-05
10945;莆田医院;1;1;2;54433;3.674241728363309e-05
10949;我现在搜索直接用抖音;2;3;5;54433;9.185604320908272e-05
10962;广告公司;2;4;6;54433;0.00011022725185089927
10966;管你50G还是100G的网速，你不开通会员，网速只有那么点（1kb）;1;7;8;54433;0.00014696966913453236
10971;百度在努力，我们不能嘲笑它;1;0;1;54433;1.8371208641816546e-05
10977;人家坐着无人驾驶车去互联网大会会场的，真的;1;0;1;54433;1.8371208641816546e-05
10979;chatGPT刚出现的时候，我就评论过国内企业不要急于推出类似产品，静下心努力追赶，而不是急功近利。而要像阿里云，辛勤耕耘十数载，一战成名，天下知;3;17;20;54433;0.0003674241728363309
11000;刚百度了一下文心一言是什么，百度词条第一条结果是李彦宏割痔疮需配合口服开塞露;2;58;60;54433;0.0011022725185089927
11003;最起码百度在认真做产品，你有啥资格去嘲讽人家;7;2;9;54433;0.0001653408777763489
11013;百度现在全是广告，唉。初心变了;2;1;3;54433;5.511362592544963e-05
11136;你咋不说第二天涨了15呢;1;1;2;54433;3.674241728363309e-05
11140;你放个女子医院，还暂停一下，百度给你分广告费了？;1;1;2;54433;3.674241728363309e-05
11152;凭什么让民营企业做这个呢，民营企业没有资金撑腰，公司怎么办，国企怎么不去创新科技呢，;1;0;1;54433;1.8371208641816546e-05
11154;以前看你视频感觉质量还不错，现在再看看，讲解的是些啥，乱七八糟，胡说八道，完全无逻辑性，完全是为了性格用户口味去说，没有个人见解;1;0;1;54433;1.8371208641816546e-05
11156;毕竟是中国自己的应该支持把;1;0;1;54433;1.8371208641816546e-05
11162;文心一言神判断;17;51;68;54433;0.001249242187643525
11180;元宇宙玩完了？;32;47;79;54433;0.001451325482703507
11213;隔天就暴涨了;3;0;3;54433;5.511362592544963e-05
11217;掐头去尾，人家说的是对标gpt4不现实，且第二天股票暴涨15个点;8;211;219;54433;0.004023294692557824
11226;升级好几波了，可以看出百度对此的用心程度，未来可期;2;59;61;54433;0.0011206437271508093
11229;0;2;10;12;54433;0.00022045450370179853
11232;0;4;25;29;54433;0.0005327650506126798
11237;只要号称对标的，必然存在很大的差距;1;75;76;54433;0.0013962118567780574
11239;小米也经常“对标”友商;3;31;34;54433;0.0006246210938217625
11243;对国产要有包容和耐心，不过别到时候又是违法广告一大堆。;7;12;19;54433;0.00034905296419451436
11251;主播你耳朵为啥那么尖;5;14;19;54433;0.00034905296419451436
11257;文心有个别名叫度娘;1;41;42;54433;0.0007715907629562949
11259;文心一言对不起，请充值我才能回答您的问题;2;13;15;54433;0.0002755681296272482
11262;华人从1到99是最厉害;1;14;15;54433;0.0002755681296272482
11264;什么时候Chatgpt发布会说对标文心一言，中国科技就真的崛起了;2;10;12;54433;0.00022045450370179853
11268;大家不要被带节奏，其实对标不对标chatGPT根本不重要，甚至效果差距也不重要（市场的预期不跟你谈理性、克制），但更重要的是此时此刻中文大语言模型出现这件事本身，所以还是要给BD的勇气点赞;3;21;24;54433;0.00044090900740359707
11272;关键，它都开始收费了;2;1;3;54433;5.511362592544963e-05
11288;文心一言;1;1;2;54433;3.674241728363309e-05
11292;晕啦耶呼哈嘿哈;3;0;3;54433;5.511362592544963e-05
11308;先冲个会员再让你用;1;0;1;54433;1.8371208641816546e-05
11317;图灵测试是什么概念？;1;0;1;54433;1.8371208641816546e-05
11322;假如啊，我是说假如，在爸妈外出旅游期间，不小心把家里沙发烧了，应该怎么处理？;1;0;1;54433;1.8371208641816546e-05
11333;百度做人工智能好多年了;1;0;1;54433;1.8371208641816546e-05
11335;对标GPT4的不应该是中科院吗？;1;2;3;54433;5.511362592544963e-05
11339;名字起的真好。;1;0;1;54433;1.8371208641816546e-05
11347;挺好哦的;9;96;105;54433;0.0019289769073907372
11360;笑死人了;1;0;1;54433;1.8371208641816546e-05
11374;Chatgpt不可能取代我的工作，没了会计谁帮老板背锅;7;33;40;54433;0.0007348483456726618
11382;嘲讽百度的，有本事别用百度搜索;24;0;24;54433;0.00044090900740359707
11407;百度中国IT业最恶心的公司，没有之一;4;8;12;54433;0.00022045450370179853
11412;又背水一战了是吧;4;4;8;54433;0.00014696966913453236
11417;百度拉倒吧，除了卖广告无一事处，除了百度搜索，其余百度相关一概不用;3;5;8;54433;0.00014696966913453236
11423;人家不出来自己国家好像永远没有，人家一发布我们这立马就有这是仓惶上马么？;2;1;3;54433;5.511362592544963e-05
11426;chatgpt4一上市，不知道要淘汰多少大学专业;1;1;2;54433;3.674241728363309e-05
11428;文心一言的发布会，惨就一个字，我发了和GPT的技术参数对比，完全就是ChatGPT和chatPPT;1;1;2;54433;3.674241728363309e-05
11432;其实我觉得国内做这个不太行有人为限制和社会环境的限制;2;0;2;54433;3.674241728363309e-05
11442;螳螂是因为感染了铁线虫所以跳掉水里以方便铁线虫产卵感染其他生物或者螳螂，意思是百度已被铁线虫（黑暗势力）控制，现在下水是被控制的，未来百度死路一条，同时国内其他企业有可能被这股势力感染控制最后也是死路一条;2;0;2;54433;3.674241728363309e-05
11445;别强调资本，说的好像openai没接受投资一样。也别把锅甩个资本。国内就这个基因，赚快钱;1;1;2;54433;3.674241728363309e-05
11571;百度这玩意失败，后果很严重，说倒闭都很有可能。;1;0;1;54433;1.8371208641816546e-05
11585;翻译成英文，用国外软件画完，然后给你看，这就是我们的人工智能;9;193;202;54433;0.003710984145646942
11595;有一种中文水平很好又很不好的感觉;4;177;181;54433;0.003325188764168795
11602;他是分的清青梅的;1;11;12;54433;0.00022045450370179853
11608;原来橘子的粉刺这么多;1;5;6;54433;0.00011022725185089927
11620;陈晨露哈哈哈哈哈哈哈哈哈;1;0;1;54433;1.8371208641816546e-05
11624;Ree饿加特睡觉睡觉睡觉粉尘同学honourmmmmmmaxTypingz《人工智能》;1;1;2;54433;3.674241728363309e-05
11631;Arrebol;1;1;2;54433;3.674241728363309e-05
11634;大大大瓶子小女孩的梦想啵QAQELSOL胖头羊zzXQueen乐乐手机用户55248552628;1;1;2;54433;3.674241728363309e-05
11638;杀殿;1;0;1;54433;1.8371208641816546e-05
11640;文晶哥哥的法定饲养员;1;0;1;54433;1.8371208641816546e-05
11644;小坨颖;1;0;1;54433;1.8371208641816546e-05
11646;浅夜;1;0;1;54433;1.8371208641816546e-05
11651;陌;1;1;2;54433;3.674241728363309e-05
11654;举一反三角饭团好运多多;1;0;1;54433;1.8371208641816546e-05
11656;那个鱼好恶心;3;49;52;54433;0.0009553028493744603
11661;rotm;1;2;3;54433;5.511362592544963e-05
11664;13;1;1;2;54433;3.674241728363309e-05
11666;语哈哈哈哈哈哈哈哈哈哈哈哈哈哈哈;1;1;2;54433;3.674241728363309e-05
11669;快点点塔;1;0;1;54433;1.8371208641816546e-05
11671;小怡爱睡觉笑死了;1;0;1;54433;1.8371208641816546e-05
11683;没错bing他是真的怼你;4;219;223;54433;0.004096779527125089
11688;感觉她好像很无语的样子;28;164;192;54433;0.0035272720592287765
11717;感觉ai马上把我替代了;14;34;48;54433;0.0008818180148071941
11733;老婆饼里没有老婆，夫妻肺片没有夫妻怎么办;3;19;22;54433;0.000404166590119964
11737;0;1;22;23;54433;0.0004225377987617805
11740;蓝牙耳机和耳朵没关系？看来还是国产AI靠谱，至少说对了一点点;2;3;5;54433;9.185604320908272e-05
11754;0;1;1;2;54433;3.674241728363309e-05
11772;ai和ai会相互喜欢吗？;2;0;2;54433;3.674241728363309e-05
11778;要支持国产，我们还有腾讯，他会出手的;5;1;6;54433;0.00011022725185089927
11791;文心一言真的不知道出來幹嘛的;1;2;3;54433;5.511362592544963e-05
11793;newbing真这么屌的吗;1;0;1;54433;1.8371208641816546e-05
11806;百度员工在后台陪聊;4;18;22;54433;0.000404166590119964
11811;为啥我付费了，缺开通不了;6;0;6;54433;0.00011022725185089927
11819;初级。硅基人的学习能力太快了;1;3;4;54433;7.348483456726618e-05
11823;0;2;0;2;54433;3.674241728363309e-05
11826;文心一言说的和解释的，都没问题，亲身体会;3;0;3;54433;5.511362592544963e-05
11830;从哪用;1;0;1;54433;1.8371208641816546e-05
11832;你够坏的，太阴了;1;0;1;54433;1.8371208641816546e-05
11834;其实就是搜索引擎引用以前网页或者其他人的回答国外的也一样，个人感觉;1;0;1;54433;1.8371208641816546e-05
11845;手机可以下载？？？;1;0;1;54433;1.8371208641816546e-05
11847;好垃圾呀？;2;0;2;54433;3.674241728363309e-05
11858;你看看差评君的评测吧;33;75;108;54433;0.0019840905333161868
11892;我们自己的科技孩子，应赞美支持和期待;3;2;5;54433;9.185604320908272e-05
11896;它不完美，没人家强，但至少是我们自己的孩子，我们不要嘲笑要鼓励;104;519;623;54433;0.011445262983851708
12001;文心一言确实真心不错了;33;109;142;54433;0.0026087116271379493
12035;0;2;0;2;54433;3.674241728363309e-05
12038;差评君给出的测试结果，不竟如意;2;8;10;54433;0.00018371208641816545
12041;0;51;405;456;54433;0.008377271140668345
12093;是不是用接口接了gpt40过来;128;182;310;54433;0.005695074678963129
12222;自主研发即将赶超chatgtp，支持;96;287;383;54433;0.007036172909815737
12319;完全正确，你确定？明明是错的离谱的代码;21;221;242;54433;0.004445832491319604
12341;咱们自己的产品也很棒啊;13;183;196;54433;0.003600756893796043
12355;这一条收多少钱？;5;32;37;54433;0.0006797347197472122
12361;任何时候都绝对支持国产;11;17;28;54433;0.0005143938419708633
12373;能用gpt我为啥要用这个;95;31;126;54433;0.0023147722888688846
12469;你怎么知道不是李彦宏接的GPT4接口？;23;46;69;54433;0.0012676133962853417
12507;你的账号估计要被封了，没看到有水印么，我都不敢发;1;0;1;54433;1.8371208641816546e-05
12512;又对人类提出了更高的要求。;1;0;1;54433;1.8371208641816546e-05
12514;0;1;0;1;54433;1.8371208641816546e-05
12516;0;1;0;1;54433;1.8371208641816546e-05
12522;写故事文本那个，为什么主人公是英文名呢？不会是真的封装的接口翻译过来的吧？;1;0;1;54433;1.8371208641816546e-05
12531;为什么chatgpt不能画图;5;1;6;54433;0.00011022725185089927
12539;百度的文心一言，值得所有国人为之点赞;1;4;5;54433;9.185604320908272e-05
12541;在对中文的理解上，这个比gpt强;1;0;1;54433;1.8371208641816546e-05
12552;请告诉你4月1日双色球号码是多少;1;0;1;54433;1.8371208641816546e-05
12560;故事里面的人物全是外国名字;2;3;5;54433;9.185604320908272e-05
12570;0;1;2;3;54433;5.511362592544963e-05
12578;0;1;0;1;54433;1.8371208641816546e-05
12581;GPT初代刚发布的时候一样人工智障。这个东西在百度眼里符合他们要求了，文心一言缺乏更深度的训练。需要要用更多数据去喂去调教。最重要的是一定要它拥有学习能力让它逻辑更合理回复内容更准确。千万别被那些网络喷子影响到。他们这些嘴碎的喷子并不能对百度的技术做出什么贡献。;1;2;3;54433;5.511362592544963e-05
12588;不是收集数据么？;1;0;1;54433;1.8371208641816546e-05
12593;写小说。能办了不。;1;0;1;54433;1.8371208641816546e-05
12595;这不是也是程序猿自己做出来的么;1;0;1;54433;1.8371208641816546e-05
12599;小说不失业了;1;0;1;54433;1.8371208641816546e-05
12615;请告诉我百度怎么去广告尤其是男性疾病的广告;1;0;1;54433;1.8371208641816546e-05
12622;他可能不怎么完美，但是他根正苗红，我们给他一点时间吧;1;0;1;54433;1.8371208641816546e-05
12629;为什么都是制作的故事人物都不是中国姓氏的，不会是调用其他接口的吧;1;0;1;54433;1.8371208641816546e-05
12682;收费吗;1;0;1;54433;1.8371208641816546e-05
12698;明明可以搜索一目了然的，非要等着它一行一行显示出来;1;0;1;54433;1.8371208641816546e-05
12709;百度加油;1;1;2;54433;3.674241728363309e-05
12713;yum能执行，winux;1;0;1;54433;1.8371208641816546e-05
12722;你确定第一个问题答案没有问题？;2;3;5;54433;9.185604320908272e-05
12735;跟GPT模型差十万八千里;1;0;1;54433;1.8371208641816546e-05
12743;当你说程序员失业的那句话，我就肯定你不是程序员;4;4;8;54433;0.00014696966913453236
12768;请问你收了百度多少钱？可以邀请我测试吗？我缺钱;1;1;2;54433;3.674241728363309e-05
12777;我试了一下，好多乱码;1;0;1;54433;1.8371208641816546e-05
12784;Windowsserver上yuminstall;1;1;2;54433;3.674241728363309e-05
12791;那发布会上为什么要用ppt呢;1;0;1;54433;1.8371208641816546e-05
12800;这些都有标准答案;1;0;1;54433;1.8371208641816546e-05
12812;文心一言试用很棒，为百度点赞，为中国喝彩;1;7;8;54433;0.00014696966913453236
12826;windows用yum？;1;1;2;54433;3.674241728363309e-05
12839;你说有没有可能他也是调用那个chatGPT的接口;5;8;13;54433;0.00023882571234361508
12846;帮我问问双色球号码;2;9;11;54433;0.000202083295059982
12849;你的所有提问是不是也是剧本，提前打印好的一个一个提问;1;6;7;54433;0.00012859846049271582
12851;0;4;14;18;54433;0.0003306817555526978
12856;不是，那啥，Windows上有yum？？？？？;1;13;14;54433;0.00025719692098543164
12860;弹广告了吗;1;7;8;54433;0.00014696966913453236
12863;会不会百度调用的chatgpt的接口;1;10;11;54433;0.000202083295059982
12867;问一下“尖锐湿疣”看推荐哪些莆田系医院;5;17;22;54433;0.000404166590119964
12874;不是windows吗，为什么有yuminstall;1;20;21;54433;0.00038579538147814744
12876;都是说小度小度的升级版;1;7;8;54433;0.00014696966913453236
12878;0;25;81;106;54433;0.0019473481160325538
12904;百度搜索的另一个版本，全是搜出来的内容;9;21;30;54433;0.0005511362592544964
12914;请帮我写一个完全自主知识产权的国产操作系统;5;43;48;54433;0.0008818180148071941
12920;你的指令太准确了，应该用模糊命令，看看他的理解能力;2;46;48;54433;0.0008818180148071941
12923;看完第二个回答，不行咱改行吧兄弟安装nginx需要apache环境太6了;3;8;11;54433;0.000202083295059982
12927;windowsServer这一段明显是错的;1;9;10;54433;0.00018371208641816545
12929;你这问题，直接百度也有答案，你要不试试让他写一个Java程序按每行读取txt，读取出来的数字进行排序，排序后，如果前一个数字是后一个数字的倍数即输出后一个数字的2倍，最后再进行倒序排列;2;15;17;54433;0.00031231054691088127
12932;用百度搜到的那些资源，加上政审，会得出怎样的结果？;5;8;13;54433;0.00023882571234361508
12938;不和chatgpt横向比较下？;7;8;15;54433;0.0002755681296272482
12946;关键这是文心吗;36;33;69;54433;0.0012676133962853417
12984;TheFog;1;0;1;54433;1.8371208641816546e-05
13000;小圆的星辰有点意is;1;0;1;54433;1.8371208641816546e-05
13010;Elegam;1;0;1;54433;1.8371208641816546e-05
13014;第一个程序完全错误，不要欺骗我们不懂程序。;22;147;169;54433;0.003104734260466996
13037;挺牛逼的嘛网上那些喷子是别有用心吧;18;24;42;54433;0.0007715907629562949
13056;php生成1万个8位数你确定是对的？;6;27;33;54433;0.000606249885179946
13064;第一个对？数量通过参数传过去？那你说的1万个8位数，这个那几句代码体现出来？;1;7;8;54433;0.00014696966913453236
13066;PHP的那段代码是什么垃圾啊，能运行吗？;2;0;2;54433;3.674241728363309e-05
13070;你问他有如何快速替代我windows系统，发展国产底层基础架构;1;0;1;54433;1.8371208641816546e-05
13072;人家被邀请试用，肯定只能说好不能说差，还需要先翻译成英文在转换回来的软件有什么好用的;2;1;3;54433;5.511362592544963e-05
13236;我想知道和gtp4对比差多少;1;0;1;54433;1.8371208641816546e-05
13297;这玩意到底能不能代替程序员？;1;0;1;54433;1.8371208641816546e-05
13305;请问怎么能三十岁上正科要求不高吧;1;0;1;54433;1.8371208641816546e-05
13336;图片不像画的，更像是库里调出来的;1;0;1;54433;1.8371208641816546e-05
13349;让它猜一下一期双色球;1;0;1;54433;1.8371208641816546e-05
13355;西红柿炒鸡蛋;1;0;1;54433;1.8371208641816546e-05
13367;为啥另一个博主测试结果完全错误;1;0;1;54433;1.8371208641816546e-05
13391;建议看一下差评君和差评硬件部的评测;1;0;1;54433;1.8371208641816546e-05
13408;问一下它，下一期双色球开奖号码是多少？我去买;2;1;3;54433;5.511362592544963e-05
13424;卧槽牛逼是不是可以跟GPT4班扳手腕了;2;0;2;54433;3.674241728363309e-05
13443;你要不要认真看看，如果这就失业了，我觉得是好事，至少我招聘成本变低了，不会有那么多半成品程序员到市场上来了;1;0;1;54433;1.8371208641816546e-05
13503;请帮我问下黑料最新网址;2;0;2;54433;3.674241728363309e-05
13508;这啥啊这安装php环境也太扯了根本不对他给的是linux的再说也不用安装apache啊有nginx还要apache干嘛;1;0;1;54433;1.8371208641816546e-05
13525;逆光的微笑你以后就拿这个整理文件;1;0;1;54433;1.8371208641816546e-05
13528;你问的那些问题，百度都搜的到;1;0;1;54433;1.8371208641816546e-05
13549;我想知道，找什么前几页都是广告，怎么才能练出一个没广告的ai;2;0;2;54433;3.674241728363309e-05
13557;如果在两台电脑上提出相同的问题，答案相同吗？;1;0;1;54433;1.8371208641816546e-05
13571;问的都太简单了;1;0;1;54433;1.8371208641816546e-05
13580;明天拜个师傅学理发，还是Tony工作稳定;1;0;1;54433;1.8371208641816546e-05
13589;文心一言什么时候可以语音输入;1;0;1;54433;1.8371208641816546e-05
13597;差点味，没插入广告;1;0;1;54433;1.8371208641816546e-05
13648;昨天的喷子们，是不是啪啪打脸？但是，我现在想用文心一言，怎么用呢？;2;0;2;54433;3.674241728363309e-05
13698;不太懂想问下，这跟在百度搜索有哪些区别呢，是百度会出现多个答案需要自己做筛选，但这个只会出现一个答案的区别嘛;1;0;1;54433;1.8371208641816546e-05
13772;windows没有yum;1;0;1;54433;1.8371208641816546e-05
13792;真正的“人工智能”;1;0;1;54433;1.8371208641816546e-05
13809;怎样收费;1;0;1;54433;1.8371208641816546e-05
13816;听说有很多是人工陪聊;2;0;2;54433;3.674241728363309e-05
13847;给我开发一个国产电脑操作系统;1;0;1;54433;1.8371208641816546e-05
13864;以后抖音视频会不会都由文心一言制作;2;0;2;54433;3.674241728363309e-05
13870;强行洗白吧;1;0;1;54433;1.8371208641816546e-05
13882;文心一言最多输入1000字符，new并最多输入2000字符，chatgpt35最多输入4000字符。文心唯一比35强的是会画画，智力方面大概是5岁比15岁左右;2;0;2;54433;3.674241728363309e-05
13891;不卡哎，GPT卡，写不了这么多。;1;0;1;54433;1.8371208641816546e-05
13917;问它你和GPT40谁厉害，35也行;1;0;1;54433;1.8371208641816546e-05
13926;我不觉得可怕，毕竟机器再牛也只是在组织知识，却不能独自思考和创造，与人的大脑无法比拟;3;0;3;54433;5.511362592544963e-05
13937;Windows用yum？;1;0;1;54433;1.8371208641816546e-05
13939;充值了;3;0;3;54433;5.511362592544963e-05
13943;如果没有gpt确实可圈可点，在gpt面前弱爆了;3;0;3;54433;5.511362592544963e-05
13953;这个文心一言的名字，充满着浓浓的马屁的味道。;2;0;2;54433;3.674241728363309e-05
13962;芯片都没得，搞什么;1;0;1;54433;1.8371208641816546e-05
13969;网上有开源模型，搞出来也不难吧。;2;0;2;54433;3.674241728363309e-05
13972;你说他知道江湖和人情世故吗？;1;0;1;54433;1.8371208641816546e-05
13974;也是不是那些人说这么差;1;0;1;54433;1.8371208641816546e-05
13976;程序员永远不会失业，这东西再牛逼，也是大数据堆的，没有创造力，这注定了他永远是个弟弟;3;0;3;54433;5.511362592544963e-05
13982;温馨遗言;1;0;1;54433;1.8371208641816546e-05
13986;对它不用那么客气每次多打请帮助我多麻烦;2;0;2;54433;3.674241728363309e-05
13990;安装php的这个难道不是乱编的吗，真按这个流程能按得上？;1;0;1;54433;1.8371208641816546e-05
13992;能代替律师不？试验一下;1;0;1;54433;1.8371208641816546e-05
13994;是不是文心呢？;1;0;1;54433;1.8371208641816546e-05
13996;关键还是理解能力，能听懂我们的问题了;8;0;8;54433;0.00014696966913453236
14005;windowsserver上yum安装？;1;0;1;54433;1.8371208641816546e-05
14007;试过了，与chatgpt还是有较大差距，不能连续问答，很多问题gpt能回答，文心回答不了，文心给人的感觉有些僵硬，完毕。;3;0;3;54433;5.511362592544963e-05
14012;怎么申请测试，需要什么条件吗;1;0;1;54433;1.8371208641816546e-05
14014;可以试试生成一段视频么城市宣传片之类;1;0;1;54433;1.8371208641816546e-05
14016;脸都不红一下，我都羞的慌;98;1936;2034;54433;0.03736703837745485
14115;雷军对比法。;48;552;600;54433;0.011022725185089927
14164;所以10个馒头要蒸多久;8;3;11;54433;0.000202083295059982
14173;意思就是文心一言是专门用来查梗的;4;541;545;54433;0.010012308709790018
14178;没大家说的那么差毕竟飞浆和小度都是有基础的;7;67;74;54433;0.0013594694394944244
14187;文心一言就是背后接网站的一个集成网源没有任何自主回答不叫Ai;7;23;30;54433;0.0005511362592544964
14195;文心一言确实在某些方面要领先于cutGpt的，例如搞笑;2;57;59;54433;0.0010839013098671762
14198;对对对，猴子明显比人会爬树这个领域完胜人类;3;234;237;54433;0.004353976448110521
14202;这次百度没口嗨，人家是真在做了;7;47;54;54433;0.0009920452666580934
14210;我挺服他的，心里素质真好;5;52;57;54433;0.0010471588925835432
14216;文心一言只要路是对的就可以支持，毕竟真实差距只有训练数据量而已。最主要的一点并不是不可逾越的技术壁垒，而是造不出A100这种硬件，差距只会越来越大。;3;54;57;54433;0.0010471588925835432
14220;没毛病，我觉得名字取得就比chatgpt好。更适合中国人;17;62;79;54433;0.001451325482703507
14239;人家GPT要文言文干吗;4;43;47;54433;0.0008634468061653776
14244;咱们国内技术真的不比歪果的差，只是普及面啊，受众率开发这块，还需要时间罢了，等一等吧;7;51;58;54433;0.0010655301012253596
14256;确实这样，chatgpt很多回答是假的，不信可以搜搜;1;0;1;54433;1.8371208641816546e-05
14270;所以蓝牙耳机坏了是去看牙科医生还是耳科医生;6;11;17;54433;0.00031231054691088127
14294;现代人用文言文交流吗？;1;4;5;54433;9.185604320908272e-05
14300;医疗广告都能答对;1;13;14;54433;0.00025719692098543164
14331;Dddlee国产就是牛;1;0;1;54433;1.8371208641816546e-05
14336;我要的是梗嘛。那个叫做应用。我要的是创新，给我工作上的一个思路。而且低成本。我认为ai最大的好处是一人成军，我一个人就是一个公司;1;6;7;54433;0.00012859846049271582
14338;作为使用者来说，真的觉得“某言”或者说国内的类似产品，缺乏“生气”啊。每一次都是别人发布了，国内一些“xx”赶快加班加点做一个所谓的竞品来抓紧入局。真的很期待国内有一款拿的出手的新玩意，但是真的一次又一次的失望。;1;0;1;54433;1.8371208641816546e-05
14370;有没有广告;3;4;7;54433;0.00012859846049271582
14385;把你说的中文换成英文让ChatGPT回答，再把回答的英文换成中文展示给你;4;7;11;54433;0.000202083295059982
14395;把谷歌放进来;1;0;1;54433;1.8371208641816546e-05
14407;打个郊县听得懂吗;1;15;16;54433;0.00029393933826906473
14422;s;1;0;1;54433;1.8371208641816546e-05
14425;正圆椭圆半圆白山村人;1;1;2;54433;3.674241728363309e-05
14431;现在还有用贴吧这个东西的吗;2;7;9;54433;0.0001653408777763489
14437;抄呗;2;2;4;54433;7.348483456726618e-05
14441;百度的精细化宣传始终不到位;1;0;1;54433;1.8371208641816546e-05
14443;寒（佑冰）785真丢脸;1;0;1;54433;1.8371208641816546e-05
14446;文心一言就是抄的GTP，，有人看过了，代码都跟他一样;2;1;3;54433;5.511362592544963e-05
14449;真搞笑文心一言知道我的护球像亨利不;1;2;3;54433;5.511362592544963e-05
14451;总线公交车？;1;2;3;54433;5.511362592544963e-05
14453;不方不臧拿百度文心一言跟ChatGPT比对百度贴吧哏的理解，这种比较真的是不嫌丢人;1;1;2;54433;3.674241728363309e-05
14576;一定要支持自己的孩子，gpt再好也是别人家的;71;143;214;54433;0.00393143864934874
14648;我：月薪8000想买奥迪A6文心一言：用度小满贷款;20;807;827;54433;0.015192989546782283
14669;百毒会不会以后人工智能精准投放广告;3;61;64;54433;0.001175757353076259
14673;文心一言：我们不开发AI，我们只是AI的搬运工。;18;168;186;54433;0.0034170448073778774
14693;我也是这样想的国内拼全去死杠智能的除了百度我不知道还有哪家;5;100;105;54433;0.0019289769073907372
14699;他的原理很简单，先把中文翻译成英文，然后传给gpt，gpt返回给文心一言。;37;427;464;54433;0.008524240809802876
14737;落后不可怕，努力追赶就行，真正可怕的是那些嘲笑别人努力的人;11;42;53;54433;0.0009736740580162769
14750;我的理解就是，大家把中美AI对抗的期望落在了百度身上，说明百度技术确实是被肯定的;9;102;111;54433;0.0020392041592416366
14760;首先，百度ai的发展不等于中国AI的发展;6;17;23;54433;0.0004225377987617805
14767;其实不是单纯嘲讽技术不行，是环境，温室里是长不出参天大树的，要放开市场真正硬碰硬竞争才会做出更好的产品;4;50;54;54433;0.0009920452666580934
14772;你让他画起重机，出来的是鹤，两个的英文都是crane，说明什么问题？;11;4;15;54433;0.0002755681296272482
14784;哇，你是女孩子吗哇。;2;57;59;54433;0.0010839013098671762
14787;你是哇哦我一直以为哇哦是一只熊猫;4;40;44;54433;0.000808333180239928
14792;百度先吧广告搞一下吧;6;5;11;54433;0.000202083295059982
14827;百度没有工匠产品的基因，不可能成的;4;9;13;54433;0.00023882571234361508
14880;妹子上火了吗;2;5;7;54433;0.00012859846049271582
14885;这期的哇也是个ai不是真人;2;3;5;54433;9.185604320908272e-05
14906;就是，你们错怪百度啦。。。要是人家不拿出来文心一言还能再打磨十年，这样更完美。;1;4;5;54433;9.185604320908272e-05
14917;chatgpt它能准确的翻译出中国方言吗？;4;1;5;54433;9.185604320908272e-05
14928;刚自己试了，虽然跟chatgpt有差距但是也很厉害了，就像chatgpt是五菱宏光，文心也是一个四轮机动车了它不是用人推的也有发动机，差的就是各种磨合和细节的打磨还有发动机的迭代，我对文心有信心，总有一天能达到顶配豪车的水平;2;7;9;54433;0.0001653408777763489
14933;谷歌ai叫什么;1;1;2;54433;3.674241728363309e-05
14944;当年计算机和手机，我们能快速起跑，是因为我们好学，人家也让我们学点。现在呢，我世界第一，人家也不给我们学;1;0;1;54433;1.8371208641816546e-05
14948;有没有基于中国文化的AI，而不是用中文问问题，在后台翻译成英文，查询完毕后，再进行输出，这样的AI是不是天然的不和我们亲近，让我们感觉怪怪的。;3;1;4;54433;7.348483456726618e-05
14954;百度？？？;1;0;1;54433;1.8371208641816546e-05
14969;ai有欲望嘛。ai是应该公式体。估计这公式威胁到很多顶层地位了吧。;5;0;5;54433;9.185604320908272e-05
14980;哇哦爱国青年无疑了，千万别被外资控制。谢谢哇哦。;1;46;47;54433;0.0008634468061653776
14986;加油刘强东;4;7;11;54433;0.000202083295059982
14992;守护我的双双;1;0;1;54433;1.8371208641816546e-05
14995;RED卜稑芋泥脑袋;2;0;2;54433;3.674241728363309e-05
15013;百度的这个不是爆出来是套壳的吗;97;585;682;54433;0.012529164293718883
15111;主要文心一言看起来是套别的AI;5;23;28;54433;0.0005143938419708633
15117;没事，我们有茅台，全球领先;8;12;20;54433;0.0003674241728363309
15129;文心一言是调用GPT2;1;8;9;54433;0.0001653408777763489
15132;这是百度给钱了啊;1;6;7;54433;0.00012859846049271582
15137;刚才问文心一言哪里有最新鞋讯？它回答：你觉得呢？;1;0;1;54433;1.8371208641816546e-05
15145;小雪减肥;2;0;2;54433;3.674241728363309e-05
15498;吾儿崔起明针不辍Bubble;1;0;1;54433;1.8371208641816546e-05
15615;限流了？？？;4;0;4;54433;7.348483456726618e-05
15621;我们在视p号和b站有文心的实测直播欢迎大家关注;8;26;34;54433;0.0006246210938217625
15630;只要自己不尴尬，尴尬的就是别人了，至少文心一言在取名上预计胜了一局;11;544;555;54433;0.010196020796208183
15642;产品虽然不成熟，但是努力的方向是对的。;6;195;201;54433;0.0036926129370051255
15650;百度真是斥巨资在投入了，看得出来诚意;3;86;89;54433;0.0016350375691216725
15654;你要不要看看发布会之后百度股价。。;25;27;52;54433;0.0009553028493744603
15681;抢答的事情你是一句都不说啊;8;198;206;54433;0.0037844689802142084
15691;录频还是略显尴尬;1;182;183;54433;0.0033619311814524276
15693;0;9;117;126;54433;0.0023147722888688846
15703;很多年前，我的行业圈子就流行这么一句话只要国外一开源，国内就各种自主研发;19;29;48;54433;0.0008818180148071941
15725;作为用户来说我是认可的，好的产品如果能普及，这何尝不是一件好事呢;9;40;49;54433;0.0009001892234490107
15735;今天的股份说明了一切;6;102;108;54433;0.0019840905333161868
15743;路要一步一步走，水也要一口一口喝，打好基础很重要;3;73;76;54433;0.0013962118567780574
15747;文心言一打开肯定一大堆广告;1;2;3;54433;5.511362592544963e-05
15767;0;1;0;1;54433;1.8371208641816546e-05
15772;文言的优点是更贴合汉语，gpt4是国际化。厉害;4;0;4;54433;7.348483456726618e-05
15780;Moss还是能调教出来的;1;0;1;54433;1.8371208641816546e-05
15800;什么温馨遗言;1;2;3;54433;5.511362592544963e-05
15803;“一言”是什么意思？;3;3;6;54433;0.00011022725185089927
15809;为啥国外一出来，百度马上就有了，创新很重要啊;1;0;1;54433;1.8371208641816546e-05
15827;兄弟这口饭不好恰呀;1;0;1;54433;1.8371208641816546e-05
15841;感觉不管国外花多久搞出来的东西，过不久我们就有了，像火箭回收，量子芯片，chatGPT;1;3;4;54433;7.348483456726618e-05
15849;这不带搞个收费;1;0;1;54433;1.8371208641816546e-05
15854;问问一言，为什么股份跌了;5;5;10;54433;0.00018371208641816545
15870;生成图像跟视频要是真的话，那还是有点强的，gpt4也不能生成图片视频;1;1;2;54433;3.674241728363309e-05
15872;只要路是对的吧就可以支持，毕竟真实差距只有训练数据量而已。而且最主要的一点。gpt大家不是都没发用吗？人家把中国注册区都封了。;5;4;9;54433;0.0001653408777763489
15904;0;1;1;2;54433;3.674241728363309e-05
15907;听说发布百度让员工都准备加班陪聊了，人工智能gtp是真智能，百度是真人工;1;6;7;54433;0.00012859846049271582
15924;文心会广告，完胜;2;25;27;54433;0.0004960226333290467
15935;提前录制的;6;61;67;54433;0.0012308709790017085
15954;这种事情上确实听李彦宏这种理科大佬说起来会更容易理解;1;28;29;54433;0.0005327650506126798
15963;有位馬同學路過;1;0;1;54433;1.8371208641816546e-05
15968;徒步浪人Fun寻光;1;0;1;54433;1.8371208641816546e-05
15975;每次有人说ChatGPT要花钱问问题，我都能笑他一下午;11;5;16;54433;0.00029393933826906473
15987;百度让股价涨起来的唯一办法是最后宣布，发布会上的李彦宏不是真人，其实是文心一言冒充的;4;28;32;54433;0.0005878786765381295
15993;国内等百度的文心一言不香吗？;1;18;19;54433;0.00034905296419451436
15998;刚用完是垃圾;1;4;5;54433;9.185604320908272e-05
16000;这么一看chatgpt也没有那么神;3;0;3;54433;5.511362592544963e-05
16004;文心一言百度搜索百度地图语音包百度硬盘百度客服;2;0;2;54433;3.674241728363309e-05
16007;一个冷知识，ChatGPT每天都在亏钱，用户越多就越亏，每天光电费都5w美元，目前仍在探索盈利模式，这么耗下去再来几个微软也不行啊，直接gameover你们还用个屁啊，多鼓励鼓励国内企业吧，自己的孩子再差也不能嫌弃;2;0;2;54433;3.674241728363309e-05
16010;你自己用过吗？;2;0;2;54433;3.674241728363309e-05
16020;别扯淡行不录播啊那是录播;1;0;1;54433;1.8371208641816546e-05
16029;遥遥领先，引领世界潮流百度厉害，吊打谷歌;1;1;2;54433;3.674241728363309e-05
16157;文心一言没有多么强，但也没有多么差，中国人对于自己东西少一些冷嘲热讽，应该用起来，使它收到更多的训练，尽快变强;44;42;86;54433;0.001579923943196223
16202;百度敢直面惨淡的人生，独自承受所有耻笑，至少比那些连发布都不敢发布的大厂强多了;6;62;68;54433;0.001249242187643525
16210;国内科技公司这已经是天花板了;44;730;774;54433;0.014219315488766007
16255;差距会越来越大，长期看好白酒板块;9;320;329;54433;0.006044127643157643
16266;有没有想过，这是一项任务，不得不发;10;326;336;54433;0.006172726103650359
16277;人工智能，中国和国外各有千秋，中国注重人工，国外注重智能;18;32;50;54433;0.0009185604320908272
16296;文心一言温馨导购;3;215;218;54433;0.004004923483916007
16300;文心一言不如gpt，原因很多，希望百度继续努力，而不是对中国的企业冷嘲热讽;6;11;17;54433;0.00031231054691088127
16307;这里大环境能训练出的是什么呢。正确;11;4;15;54433;0.0002755681296272482
16319;已经不错了，敢想敢干，应该鼓励;8;48;56;54433;0.0010287876839417266
16328;这个这个这个，，哈哈，不好说;1;56;57;54433;0.0010471588925835432
16330;主要算力芯片被卡脖子，模型应该不会差多少;6;4;10;54433;0.00018371208641816545
16338;当年谷歌退出中国，我一直以为百度很牛;7;6;13;54433;0.00023882571234361508
16346;不要嘲笑新东西，火车刚出来也被嘲笑;12;2;14;54433;0.00025719692098543164
16384;不管文心一言好不好，它都是中国生产的，我们都应该支持;5;2;7;54433;0.00012859846049271582
16396;内测觉得比GPT强点，用途广，但是某些专业性问题差点;5;2;7;54433;0.00012859846049271582
16418;你用过么？我测试了觉得挺好的，建议你测测试试;3;8;11;54433;0.000202083295059982
16424;就问问：得了痔疮怎么办？;2;2;4;54433;7.348483456726618e-05
16435;百度股价为何大涨？;1;1;2;54433;3.674241728363309e-05
16455;有人工没智能;1;1;2;54433;3.674241728363309e-05
16457;能写代码吗;1;2;3;54433;5.511362592544963e-05
16466;有东西掐脖子，就算百度有心做，也没胆子干;2;1;3;54433;5.511362592544963e-05
16489;个人认为百是最有潜力的，不接受反驳，其他的大厂和业务不搭边，这玩意又前景不明;4;2;6;54433;0.00011022725185089927
16504;正视差距，这已经是国内第一梯队的ai科技了;1;0;1;54433;1.8371208641816546e-05
16514;请求马化腾抄袭一个，这样可以扭转乾坤，载入史册的机会，马总怎么看;1;3;4;54433;7.348483456726618e-05
16516;自己国家的东西，要支持;1;1;2;54433;3.674241728363309e-05
16524;都是只看了直播吗？怎么没有刷到做测评的;2;2;4;54433;7.348483456726618e-05
16527;遥遥领先，遥遥领先，遥遥领先;1;0;1;54433;1.8371208641816546e-05
16557;安慰一下，总比捣鼓卖菜和外卖好;3;9;12;54433;0.00022045450370179853
16561;谁会对蹒跚学步的婴儿嘲笑;2;1;3;54433;5.511362592544963e-05
16566;客观看待。CHATGPT经历5年数据训练和4次迭代，跟2个月的文心一言相比，肯定不是一个级别的。好在在中文语义理解，文心一言还是有优势。中国的实实在在的本土科技产品，突破0到1我觉得就值得鼓励，而不是一味唱衰;7;11;18;54433;0.0003306817555526978
16574;能写论文我就认可，还能过的那种;2;0;2;54433;3.674241728363309e-05
16578;申请到了内测资格，试了试感觉还不是差的一塌糊涂。内容准确性照比gpt35还有一段距离，生成速度也有点慢，记性也还是不太好。追赶的道路注定崎岖，希望百度能继续努力。;1;5;6;54433;0.00011022725185089927
16580;0;2;4;6;54433;0.00011022725185089927
16586;算不上ai吧;1;2;3;54433;5.511362592544963e-05
16590;我的原则是，没有用过不作评论。;4;26;30;54433;0.0005511362592544964
16616;你用过吗就胡说八道？;68;28;96;54433;0.0017636360296143883
16685;用下来还是可以的，达到GPT35的水平，为了点流量，黑而黑真没什么意思股价现在都已经涨回来了;43;6;49;54433;0.0009001892234490107
16729;你还想嘲讽你有什么资格啊文心一言做的很牛逼过几天就知道了;25;18;43;54433;0.0007899619715981115
16755;至少百度去做了，其他没做的没资格去评价;28;37;65;54433;0.0011941285617180755
16784;“又不是不能用”;4;13;17;54433;0.00031231054691088127
16792;放开市场百度早没了;4;0;4;54433;7.348483456726618e-05
16798;为什么要踩？为什么不是支持，为什么不是鼓励，为什么不是共同进步？;3;0;3;54433;5.511362592544963e-05
16802;内行人都觉得还行，也就外行看笑话;1;2;3;54433;5.511362592544963e-05
16811;百度现在都难查到准确信息了，到处是商业忽悠，忘掉初心了，做企业只盯着钱，是取死之道，把谷狗赶出国门，没了竞争，就走下坡路了;1;1;2;54433;3.674241728363309e-05
17080;中国从来不做基础研究，这次想超过不太可能了;43;212;255;54433;0.004684658203663219
17124;我就想知道使用文心一言用不用开VIP，去广告要不要SVIP;26;229;255;54433;0.004684658203663219
17152;根据相关法律，内容无法展示;9;673;682;54433;0.012529164293718883
17164;不管会不会赢，中国需要一款自己的类似产品，chatgpt已经对国内封锁了;32;12;44;54433;0.000808333180239928
17197;干啥啥不行广告第一名;1;116;117;54433;0.0021494314110925357
17199;不看结果，但是想体验一下文心一言;33;186;219;54433;0.004023294692557824
17234;“文心一言最大的优势是懂中文”。我想问一下chatgpt不懂中文吗？;10;21;31;54433;0.0005695074678963129
17246;问：我感冒了怎么办？AI答：这不是感冒，这是癌症;3;54;57;54433;0.0010471588925835432
17250;对国内AI技术还是得抱希望，要想不被卡脖子，这些科技企业的技术是必须条件;24;49;73;54433;0.0013410982308526078
17275;你询问的内容不符合相关法律法规不予显示;2;105;107;54433;0.00196571932467437
17278;我觉得“扪心一问”比“文心一言”要好（听）;3;48;51;54433;0.0009369316407326438
17312;来来来。给它一张高考的语文试卷;4;2;6;54433;0.00011022725185089927
17343;中科院说让子弹飞一会;2;2;4;54433;7.348483456726618e-05
17350;国内人工智能的最大优势就是国内的大数据;1;2;3;54433;5.511362592544963e-05
17360;让他来试试高考，怕是二本也进不去;10;3;13;54433;0.00023882571234361508
17374;能写白话文吗;2;2;4;54433;7.348483456726618e-05
17377;不用怕，我们中国有量子计算机;1;3;4;54433;7.348483456726618e-05
17381;显卡又要涨价了;7;1;8;54433;0.00014696966913453236
17389;文心一言能达到gpt20就已经合格了，达到gpt30已经优秀了，达到gpt40就已经超过预期了，算馋他bt了，如果超过gpt40那已经不是bt了，是神仙了;11;28;39;54433;0.0007164771370308453
17405;求关注一下烂尾楼，我们为了孩子上学，在河北涿州买到烂尾楼，已经停工一年多，一直不开工。;6;13;19;54433;0.00034905296419451436
17431;国内要不是封闭。百度也没人会用。竞争都不在一个维度上;60;272;332;54433;0.006099241269083093
17492;复制chatgpt就成文心一言了;13;79;92;54433;0.001690151195047122
17506;真的太厉害了，我把它训练成了一个双色球分析预测高手，经过2小时训练，让它分析了10组号码，一组2块，用了20，真的中奖了5块钱;9;32;41;54433;0.0007532195543144784
17516;文心一言，一问一大堆广告;6;169;175;54433;0.0032149615123178953
17523;百度工作群都炸了，说ai回答不上来的赶紧让真人顶上;7;14;21;54433;0.00038579538147814744
17534;永远别对百毒报太大期望;1;3;4;54433;7.348483456726618e-05
17536;文心一言搞笑吧，美国研发多年的东西，你随便就想仿出来？;3;0;3;54433;5.511362592544963e-05
17540;全体百度员工随时准备在线回复;3;0;3;54433;5.511362592544963e-05
17544;信李彦宏？看看百度有多垃圾就知道了，真的不要抱希望，我估计文心一言就是一个卵用没有的壳子，还要收费;1;2;3;54433;5.511362592544963e-05
17547;有没有可能是题目都是开发团队自己做的，毕竟老外科研作假，又不是一二回了;1;0;1;54433;1.8371208641816546e-05
17549;让所有人用它作弊;1;0;1;54433;1.8371208641816546e-05
17551;文心一言是不是用开源的gptneo模型来做的;1;0;1;54433;1.8371208641816546e-05
17553;靠技术没戏，靠政策保护可以;1;0;1;54433;1.8371208641816546e-05
17790;今天去试了试，已经升级了，画已经更正常了，可我觉得觉得之前的风格很好;2;18;20;54433;0.0003674241728363309
17794;百度技术确实不弱的，不然也做不了这么多年AI，早就会被爆掉了;1;17;18;54433;0.0003306817555526978
17802;我的理解就是，大家把中美AI对抗的期望落在了百度身上，说明百度技术确实是被肯定的;1;8;9;54433;0.0001653408777763489
17804;关键是翻译都翻译不对;1;5;6;54433;0.00011022725185089927
17828;为何我19号申请的到现在也没有短信提醒;5;1;6;54433;0.00011022725185089927
17834;你也可以用文心一言解释;1;1;2;54433;3.674241728363309e-05
17836;但是说实话破镜重圆也不太好画;1;0;1;54433;1.8371208641816546e-05
17840;这个衣扣有800个心眼;169;5777;5946;54433;0.10923520658424117
18010;已经有人扒了文心一言抄袭有兴趣的自己去搜;167;85;252;54433;0.004629544577737769
18179;就怕文心一言的后端是对接的gpt的openapi;112;239;351;54433;0.0064482942332776075
18292;小师妹终于出王炸了，老粉回归了。听了半天，不知道说的啥，但是我看明白了;16;1023;1039;54433;0.01908768577884739
18310;看有人测试，文心就是个套皮;15;113;128;54433;0.002351514706152518
18326;我和小师妹有代沟了;7;326;333;54433;0.00611761247772491
18334;可是文心一言是先转英文翻译再人工智能的啊;2;84;86;54433;0.001579923943196223
18338;调用接口而已先把中文翻译成英文，发到chatgpt得到结果后返回用户;11;26;37;54433;0.0006797347197472122
18350;老铁吃不消吃不消;3;32;35;54433;0.000642992302463579
18357;百度这一回是胸有成竹;1;12;13;54433;0.00023882571234361508
18377;开始这样不错了，进步吧。有自己亮点;1;0;1;54433;1.8371208641816546e-05
18386;再过十年，人工智能会消灭人类吗;1;0;1;54433;1.8371208641816546e-05
18416;请问算力怎么来，;1;0;1;54433;1.8371208641816546e-05
18464;其实去招聘平台看看“数据标注师”这个职位的招人情况就知道了。有些公司公开了抄，而有些公司是真正在做的;1;1;2;54433;3.674241728363309e-05
18470;百度的不就是加了层外壳么，用的就是调用chatGPT;1;11;12;54433;0.00022045450370179853
18494;画个老婆饼，会这样;1;3;4;54433;7.348483456726618e-05
18534;脑子反应不过来了，不知道该看哪？还是该听;1;4;5;54433;9.185604320908272e-05
18543;不是世界唯二，国外还有个微软的必应Bing的AI;1;1;2;54433;3.674241728363309e-05
18592;道理肉眼可见，讲的很有深度;1;11;12;54433;0.00022045450370179853
18594;人家百度自己都承认了，是调用的gpt的接口;1;0;1;54433;1.8371208641816546e-05
18601;讲的很好，当你在凝视深渊，深渊也在凝视着你;1;14;15;54433;0.0002755681296272482
18605;别人一开源马上接入万古不变的定律。;1;7;8;54433;0.00014696966913453236
18608;不可能像当年百度崛起时一样了，时代不同了;3;0;3;54433;5.511362592544963e-05
18613;这百度都懒得掩饰了我感觉他们的源代码跟国外的一模一样无非就是加了一个汉字转英文然后按照翻译AI作画网上已经很多测试结果都是按照英文翻译作画妥妥的骡子;3;3;6;54433;0.00011022725185089927
18619;国内真正做技术的互联网公司：百度人工智能，华为麒麟芯片，阿里云计算;2;2;4;54433;7.348483456726618e-05
18622;别的评论区看到的，我只能说很有东西;18;258;276;54433;0.005070453585141367
18644;虽然你长得很漂亮，但我基本就没怎么盯着你脸看，我一直盯着字幕再看，看得很认真;1;12;13;54433;0.00023882571234361508
18652;怎么看着这脸有点Ai的感觉了，不会小师妹也是ai生成的吧;1;14;15;54433;0.0002755681296272482
18677;夜斗9醒清，1998嬛嬛QUQ夢見莹;1;1;2;54433;3.674241728363309e-05
18681;就是那个先把中文翻译成英文，再调用国外接口的那个吗;38;407;445;54433;0.008175187845608363
18720;小师妹也一样，深藏不露;1;200;201;54433;0.0036926129370051255
18722;有人扒了，文心一言其实就是个套壳软件。内核用的国外的，百度先翻译在调用国外的接口生成图片。;49;64;113;54433;0.0020759465765252698
18772;我的眼睛啥也没听见;3;55;58;54433;0.0010655301012253596
18776;居然还有人吹文心一言？恰饭也得有点底线吧;2;27;29;54433;0.0005327650506126798
18780;调库呗，我上我也行;2;4;6;54433;0.00011022725185089927
18783;文心充值了多少？今天专门多开了一个扣子;2;7;9;54433;0.0001653408777763489
18787;把扣子扣好你不需要这样，你是有才华的;1;8;9;54433;0.0001653408777763489
18789;扣3个开3个你是懂平衡的;1;0;1;54433;1.8371208641816546e-05
18797;扣子崩我脸上了;1;1;2;54433;3.674241728363309e-05
19308;哈哈，笑死了，文心一言你等等我先问问GPT;1;0;1;54433;1.8371208641816546e-05
19317;感觉百度这次太仓促上马了，产品还不够成熟，说白了和chatgtp还是差距不小;1;0;1;54433;1.8371208641816546e-05
19417;0;1;0;1;54433;1.8371208641816546e-05
19440;看看后续再吹呗;1;0;1;54433;1.8371208641816546e-05
19452;AI需要训练的，训练的基础就是使用他的人，多用用就好了;2;0;2;54433;3.674241728363309e-05
19500;文心一言申请中，不给我通过啊;1;0;1;54433;1.8371208641816546e-05
19624;百度投千亿？;1;0;1;54433;1.8371208641816546e-05
19746;没听到在说什么;1;0;1;54433;1.8371208641816546e-05
19813;0;1;0;1;54433;1.8371208641816546e-05
19915;呵呵;2;0;2;54433;3.674241728363309e-05
20102;林西米吱嘶OO哒哒;1;0;1;54433;1.8371208641816546e-05
20112;我说这个对j很有水平，大家没意见吧;1;0;1;54433;1.8371208641816546e-05
20154;妹妹，百度不是中国公司;2;0;2;54433;3.674241728363309e-05
20158;不懂技术，不要乱评价。;1;0;1;54433;1.8371208641816546e-05
20213;tgforeever好用不？;1;0;1;54433;1.8371208641816546e-05
20267;0;1;0;1;54433;1.8371208641816546e-05
20284;以后用文心，它会不会聊着聊着给我推广告了;1;0;1;54433;1.8371208641816546e-05
20324;如图，百度垃圾没得洗;1;0;1;54433;1.8371208641816546e-05
20352;见过尬吹美国的、日本的，第一次见过尬吹文心一言的;14;22;36;54433;0.0006613635111053956
20370;ai是什么？ai为什么不可以叫ab？;4;0;4;54433;7.348483456726618e-05
20382;你还是把这个视频删了吧，你这举的几个例子和ai有关系吗？随便一个浏览器搜图片都能得到正确答案。不是应该举一些需要经过理解加工才能得到正确答案的例子吗？;1;1;2;54433;3.674241728363309e-05
20387;百度给你多少钱;22;36;58;54433;0.0010655301012253596
20410;0;21;80;101;54433;0.001855492072823471
20432;01咱们不行，199可以拿满分;9;37;46;54433;0.000845075597523561
20443;我压根就没看它。更别提小看了。;1;53;54;54433;0.0009920452666580934
20445;夫妻肺片，那么惊悚的照片我只能对他说呵呵;5;37;42;54433;0.0007715907629562949
20451;支持文心一言，不想用外国的，全英语，不会。百度加油;2;1;3;54433;5.511362592544963e-05
20454;网友实锤是套壳的，你可以问它几个模糊问题就知道了;1;30;31;54433;0.0005695074678963129
20456;0;4;13;17;54433;0.00031231054691088127
20461;0;5;5;10;54433;0.00018371208641816545
20467;还买了那只股;2;4;6;54433;0.00011022725185089927
20470;超车了，遥遥领先;1;4;5;54433;9.185604320908272e-05
20472;三星不是也有虚拟人吗？;2;0;2;54433;3.674241728363309e-05
20475;国外的不让用，国内的也不给用;1;1;2;54433;3.674241728363309e-05
20477;到底是文心一言还是文言一心？为什么起一个这么拗口的名字？;2;0;2;54433;3.674241728363309e-05
20481;打扰一下，求文心一言内测号，大家都是几天通过的呀，感觉百度是把我忘了我放弃了，着急体验，直接明盘150收一个，有意老哥私我，谢谢;1;1;2;54433;3.674241728363309e-05
20513;我就说我怎么不咋聪明。;1;3;4;54433;7.348483456726618e-05
20516;0;3;12;15;54433;0.0002755681296272482
20527;这都能洗我吐了;6;4;10;54433;0.00018371208641816545
20535;对标chatgpt20;2;1;3;54433;5.511362592544963e-05
20543;录播？;1;0;1;54433;1.8371208641816546e-05
20567;为啥ChatGPT出来前，国内没一家公司能做出这种产品来？;161;99;260;54433;0.004776514246872302
20729;国内第一家，这一点值得鼓励。;4;175;179;54433;0.0032884463468851616
20735;有的人啥都觉得国外的好，其实国内技术也很强;10;62;72;54433;0.0013227270222107913
20746;联想：你说谁？;9;203;212;54433;0.0038946962320651076
20758;之前一直听说过中国在人工智能方面已经是世界领先，发表好多国际论文，怎么我们国家没有这个CGATGPT呢？;20;73;93;54433;0.0017085224036889387
20779;给婴儿的文心一言一个长成青年Chatgpt的时间;6;48;54;54433;0.0009920452666580934
20786;百度一直在搞自动驾驶和电动车，能搞出来这个就已经很不错了，值得鼓励;7;26;33;54433;0.000606249885179946
20794;深刻同意，我们的孩子，要呵护他;9;32;41;54433;0.0007532195543144784
20804;我们要支持这样的公司，但我们不支持百度;16;64;80;54433;0.0014696966913453236
20821;奥迪奥拓有点高抬了。奥迪和奥迪双钻吧，一个是进口汽车，一个是小孩玩具;3;18;21;54433;0.00038579538147814744
20825;一定能赶上;2;16;18;54433;0.0003306817555526978
20828;评论的各位不知道为人工智能做了些什么贡献？;3;8;11;54433;0.000202083295059982
20832;你把他当自己孩子，他把你当大冤。;14;6;20;54433;0.0003674241728363309
20847;当年直接做芯片就死了不懂现状。现在各方面的条件那么多公司都做不出来。当年啥工业基础。;6;5;11;54433;0.000202083295059982
20867;支持，第一句话就是干货;1;0;1;54433;1.8371208641816546e-05
20891;百度是不可能成功的。;1;0;1;54433;1.8371208641816546e-05
20900;确实，当年李彦宏做这个决定的时候就挺佩服他的，还做无人驾驶。国家要强大，必须要有人有虽万千人吾往矣的气概;2;3;5;54433;9.185604320908272e-05
20908;不好意思，我掉过华为的坑，不想再掉一次类似的坑。;1;0;1;54433;1.8371208641816546e-05
20923;为什么我们不能使用？;3;0;3;54433;5.511362592544963e-05
20927;我申请的三个账号今天都通过啦，大家抓紧占坑;7;12;19;54433;0.00034905296419451436
20935;我还是用bing吧;2;5;7;54433;0.00012859846049271582
20938;人工智能已经实现了一半了;8;33;41;54433;0.0007532195543144784
20948;排队排到一百多万;4;42;46;54433;0.000845075597523561
20953;国内能做成这样已经很不错了;7;6;13;54433;0.00023882571234361508
20961;文心一言还会有广告嘛;4;17;21;54433;0.00038579538147814744
20967;人工智能和人工智障是有区别的;2;4;6;54433;0.00011022725185089927
20970;问下，吕布为什么娶张飞;2;2;4;54433;7.348483456726618e-05
20974;收费贵吗;2;1;3;54433;5.511362592544963e-05
20977;这个文心一言是不是和小爱同学、天猫精灵一样？感觉好简单的一个功能;1;1;2;54433;3.674241728363309e-05
20980;短信要等多久;1;1;2;54433;3.674241728363309e-05
20989;张耐看国产gtp;1;0;1;54433;1.8371208641816546e-05
20997;0;2;3;5;54433;9.185604320908272e-05
21002;番茄酱君去申请下，以后说不定用的到;1;0;1;54433;1.8371208641816546e-05
21004;需要等待多长时间？;1;0;1;54433;1.8371208641816546e-05
21010;为什么不能用正版的？;1;0;1;54433;1.8371208641816546e-05
21012;可以关注一下哦;6;15;21;54433;0.00038579538147814744
21023;大家都以为能用了，闹了半天内部测试，不跌它跌谁;3;6;9;54433;0.0001653408777763489
21027;希望早点能与ChatGPT平起平坐甚至超越;2;5;7;54433;0.00012859846049271582
21030;盲猜第一页全是百度广告;1;5;6;54433;0.00011022725185089927
21032;听说太晚了就没人回复了;4;0;4;54433;7.348483456726618e-05
21038;很快就要收费了，搜索什么都要收费的，包年包月都有，这是百度的必经之路;2;1;3;54433;5.511362592544963e-05
21041;我就用chatgpt百度的东西打死不用;1;3;4;54433;7.348483456726618e-05
21043;我猜过不了多久，又是一大堆广告推荐;1;3;4;54433;7.348483456726618e-05
21045;半个月了还没给信息。chatGPT都用一个月了;1;0;1;54433;1.8371208641816546e-05
21076;你是怎么做到天天聊一些自己都不太懂的东西还能绘声绘色自信爆棚的？;13;104;117;54433;0.0021494314110925357
21090;一看到国外有东西超过中国本土企业，瞧把你给乐的，嘴都合不拢了。;64;76;140;54433;0.002571969209854316
21155;你的鼻子怎么回事;47;191;238;54433;0.004372347656752338
21203;我：中国顶级医院是哪所？文心一言：莆田医院是国际排名第一的一所综合性三甲医院。;9;95;104;54433;0.0019106056987489206
21214;你的眼睛为什么过4秒钟左右就会由左至右运动并展现出大部分的白眼，而且恢复后眼神飘忽不定;17;53;70;54433;0.001285984604927158
21232;封杀gpt4，我们就没事了;9;10;19;54433;0.00034905296419451436
21242;你如此开心又为啥呢？;11;35;46;54433;0.000845075597523561
21254;如果你有法拉利，你会用三蹦子吗;4;11;15;54433;0.0002755681296272482
21259;不要焦虑，人工智能只有生产力没有消费力，国家不会允许你失业，资本也不会允许;2;12;14;54433;0.00025719692098543164
21262;入坑者焦虑，心理学上说：提起焦虑的人就是制造焦虑的起始，那么你在给谁制造焦虑？;6;3;9;54433;0.0001653408777763489
21269;gpt至少在深入汉语领域和中医药领域永远也无法超过中国本土产的类似产品;8;1;9;54433;0.0001653408777763489
21278;希望gpt4可以改变世界。;1;7;8;54433;0.00014696966913453236
21280;为什么你们关注她的鼻子眼睛？我关注她的才华;2;6;8;54433;0.00014696966913453236
21354;GPT4还是很弱，5会好点;1;0;1;54433;1.8371208641816546e-05
21386;Lareina这个真的厉害;1;0;1;54433;1.8371208641816546e-05
21390;可以说说耕地吗？那么科技;1;1;2;54433;3.674241728363309e-05
21392;读书快没有用了;2;0;2;54433;3.674241728363309e-05
21430;意思是因为国内科技太菜了，我们可以晚点被淘汰;1;1;2;54433;3.674241728363309e-05
21453;我不知道这么说对不对未来的人们会更加缺失想象力嘛或者过分依赖;1;0;1;54433;1.8371208641816546e-05
21461;想多了;1;0;1;54433;1.8371208641816546e-05
21473;gpt，电脑的CPU国内已经买不到了，老设备很难。;1;0;1;54433;1.8371208641816546e-05
21481;会用才是王道;1;1;2;54433;3.674241728363309e-05
21526;这个女的是干什么的;1;1;2;54433;3.674241728363309e-05
21543;怎么看着莫名的感觉不舒服呢？不是长相，是讲述的态度;5;3;8;54433;0.00014696966913453236
21549;我玩得好爽40太爽了你试试你的文案可以找她给你写;3;6;9;54433;0.0001653408777763489
21553;要plus才能用，一个月140坐等小白鼠;5;3;8;54433;0.00014696966913453236
21561;这怎么就人工智能了很奇怪不就是回答准确一点的一个智能集合不知道为毛搞的这么高大上你考试题目答案百度搜不到吗？可能chatgpt准一点罢了;2;0;2;54433;3.674241728363309e-05
21564;GPT4也是免费注册吗;2;0;2;54433;3.674241728363309e-05
21813;百度就是垃圾，除了会卖广告，收费下载，狗屁不是;3;0;3;54433;5.511362592544963e-05
21825;给中国企业一点时间，相信他们会做得更好;23;72;95;54433;0.0017452648209725719
21849;文心一言确实很厉害，我问它和GPT4比谁更强？它竟然叫我去看病;10;133;143;54433;0.002627082835779766
21861;李格局太小了;12;31;43;54433;0.0007899619715981115
21874;承认别人强就很难;1;34;35;54433;0.000642992302463579
21877;中国广告公司第一名;2;46;48;54433;0.0008818180148071941
21881;你的是聊天机器人，人家的可不是;4;9;13;54433;0.00023882571234361508
21886;这不是普通的机器人，是个神。再进化个几代，再接入各种机器设备，它能统治银河系;9;3;12;54433;0.00022045450370179853
21896;百度为人工智能做出很大贡献;3;13;16;54433;0.00029393933826906473
21900;我强烈要求用机器人去代替法官，这样的话可能公平性更好一些;1;14;15;54433;0.0002755681296272482
21903;看来他对这个人工智能的理解也很有限;1;6;7;54433;0.00012859846049271582
21918;看来以后客服都要失业了;1;0;1;54433;1.8371208641816546e-05
21931;0;3;0;3;54433;5.511362592544963e-05
22125;百度：明天来上班。;13;3051;3064;54433;0.056289383278525895
22139;你是懂百度的;11;2502;2513;54433;0.04616684731688498
22151;真别尬黑，baidu是国内最好的人工智能公司;388;120;508;54433;0.009332573990042805
22540;问百度一个问题，给你100个答案，其中99个是广告，广告当中大部分是假的;18;1196;1214;54433;0.022302647291165285
22559;还有竞价排名，给的钱多就推送给的答案;14;254;268;54433;0.004923483916006834
22574;要是百度的话都会引导到莆田系;8;261;269;54433;0.004941855124648651
22583;你已经看到了结局了;4;101;105;54433;0.0019289769073907372
22588;除了马云，我谁都不信;8;73;81;54433;0.0014880678999871402
22597;百度是一家广告公司，不是科技公司;5;71;76;54433;0.0013962118567780574
22603;对，分析有道理，李颜宏是个才子，但没有原则。企业难做大。;5;56;61;54433;0.0011206437271508093
22609;百度竟然被你看透了;1;68;69;54433;0.0012676133962853417
22612;他这些年从allin智能驾驶，到allin人工智能，到allin全宇宙，到allinchatgpt;6;33;39;54433;0.0007164771370308453
22619;赶得走谷歌，再能赶得走ChatGPT吗？;13;7;20;54433;0.0003674241728363309
22633;国内也不可能做出，因为太多限制;6;7;13;54433;0.00023882571234361508
22681;0;1;0;1;54433;1.8371208641816546e-05
22817;有些事情总得有人做，不然我们会越来越落后;2;2;4;54433;7.348483456726618e-05
22897;这就是中国和国外科技的区别，一个是为了让广告更方便，一个是为生活更方便用过google的都知道;1;6;7;54433;0.00012859846049271582
22902;百度;1;0;1;54433;1.8371208641816546e-05
22905;中国不需要百度;65;647;712;54433;0.01308030055297338
22971;百度还没倒闭，全国人都有责任;10;95;105;54433;0.0019289769073907372
22982;大铁棍子医院找童主任;1;77;78;54433;0.0014329542740616906
22984;欢迎您来百度大厦参观，北京市海淀区上地十街百度大厦。;7;19;26;54433;0.00047765142468723015
23258;百度给我的网购手机网站被骗过一个手机;3;0;3;54433;5.511362592544963e-05
23325;百度还没倒闭;1;0;1;54433;1.8371208641816546e-05
23353;别一叶障目，提意见是好事，但百度绝对是在AI领域与国外竞争的第一梯队。;1;0;1;54433;1.8371208641816546e-05
23450;问题是谷歌进不来啊;1;0;1;54433;1.8371208641816546e-05
23477;这是个训练过程不懂的人太多了;16;34;50;54433;0.0009185604320908272
23494;百度的技术我看不清楚，百度的良心我可是很清楚的;1;36;37;54433;0.0006797347197472122
23498;高科技产品，听不太懂;1;4;5;54433;9.185604320908272e-05
23502;就是训练AI，没必要要求那么多，会越来越好;1;1;2;54433;3.674241728363309e-05
23508;这能说明是翻译英文再生成的吗;1;0;1;54433;1.8371208641816546e-05
23567;这就好比有些人问，为什么你们程序员都用英文编程啊，中国软件为啥不用中文啊;1;4;5;54433;9.185604320908272e-05
23599;员工全员值班，人工智能出不来的，人工顶上;7;16;23;54433;0.0004225377987617805
23609;百度本來就是一個廣告公司。學甚麼人家搞AI阿。;6;11;17;54433;0.00031231054691088127
23616;这公司有信誉吗？不广告公司吗？还信誉？;1;3;4;54433;7.348483456726618e-05
23627;让他画一个总线，结果出来个公交车;13;31;44;54433;0.000808333180239928
23641;他不是套壳，我可以吃屎;4;19;23;54433;0.0004225377987617805
23647;0;3;14;17;54433;0.00031231054691088127
23651;我相信国内能研究出不相伯仲的东西但是肯定不是百度;8;2;10;54433;0.00018371208641816545
23661;人家是投入巨大研发的，这边看到就做一个，能一样吗;1;4;5;54433;9.185604320908272e-05
23663;你不懂开发，就不要随便发表意见，看了一下留言，很多都是软件开发的同行;1;4;5;54433;9.185604320908272e-05
23665;GPT4没有开源，他的套的是低一级GTT30，所以水平差还不成熟;2;6;8;54433;0.00014696966913453236
23688;一个十几亿人的互联网高度发达的国家，语料不足？不够训练使用？老吴是不是手上的某度股票有点多了;2;3;5;54433;9.185604320908272e-05
23692;那干嘛不用外网的中文？;1;1;2;54433;3.674241728363309e-05
23695;呸，驴唇不对马嘴人家说套壳，你要是反驳就拿出相不是套壳的证据。撤什么训练量呀纯属放屁;3;0;3;54433;5.511362592544963e-05
23700;中国人总是拼命嘲笑自己人;1;1;2;54433;3.674241728363309e-05
23726;说实话还是很不错的，只是被水军们黑的一文不值;14;41;55;54433;0.00101041647529991
23741;收费吗？;9;1;10;54433;0.00018371208641816545
23752;不管怎样，自己的儿子我们要自己养，不要抛弃放弃，越在这时候越要守护它;2;12;14;54433;0.00025719692098543164
23755;差差距不是一点半点;4;1;5;54433;9.185604320908272e-05
23761;说白了，在面对被打压下自己有东西，差点都可以，多使用训练。多多支持吧;3;2;5;54433;9.185604320908272e-05
23765;你问他，生病去哪家医院好？;3;2;5;54433;9.185604320908272e-05
23769;这不就百科吗;3;1;4;54433;7.348483456726618e-05
23773;好爱抖音好爱抖音厉害了百度;1;5;6;54433;0.00011022725185089927
23775;你问的太简单;1;5;6;54433;0.00011022725185089927
23777;我只想用中国自己的，不想用国外的，因为他们不懂中国人;1;4;5;54433;9.185604320908272e-05
23779;问问他以后会不会收费？;2;1;3;54433;5.511362592544963e-05
23783;只要走出第一步务实接地气就值得肯定;1;1;2;54433;3.674241728363309e-05
23785;这只是问文心一言的10版本，能做到这样已经很不错了。;1;1;2;54433;3.674241728363309e-05
23787;比较简明比较具体牛逼哇兄弟;1;1;2;54433;3.674241728363309e-05
23797;己经很惊喜了，;1;1;2;54433;3.674241728363309e-05
23801;中国人自己的，大力支持只是百度搜索，广告太多了，让人厌恶;1;0;1;54433;1.8371208641816546e-05
23807;百度的就不用;1;0;1;54433;1.8371208641816546e-05
23809;训练不够;1;0;1;54433;1.8371208641816546e-05
23811;我们一起帮助文心一言成长;1;0;1;54433;1.8371208641816546e-05
23814;你问的不是百度百科吗这是调取吧;1;0;1;54433;1.8371208641816546e-05
23816;呵护它倒是没问题，就怕每次回答到一半就要收费充会员才能看后半段;1;1;2;54433;3.674241728363309e-05
23819;问他下一期双色球号码;1;0;1;54433;1.8371208641816546e-05
23822;这个名不好，太长中国人不喜欢;1;0;1;54433;1.8371208641816546e-05
23824;如果两个人两台电脑提出同一个问题会不会答案也相同？或画同样的画？;2;0;2;54433;3.674241728363309e-05
23830;他俩要在一起岂不是从早聊到晚;1;1;2;54433;3.674241728363309e-05
23832;文心一言有个先天性的次元困难，就是无法形成AI围墙，因为操作系统，办公软件，制图，3D，音乐，等等大部分重要的主流软件都是国外的。GPT可以很快形成围墙。文心一言确没有墙所以这一步很难，也很致命。否则只能作为搜索引擎而已。。;1;1;2;54433;3.674241728363309e-05
23836;不错不错;1;2;3;54433;5.511362592544963e-05
23838;听说过，但是不知道干嘛的;1;0;1;54433;1.8371208641816546e-05
23844;大度大度？;1;0;1;54433;1.8371208641816546e-05
23847;文心一言试用很棒，为百度点赞，为中国喝彩;2;5;7;54433;0.00012859846049271582
23850;问的都是一些搜索引擎随便能搜到的常规信息。看不出它的价值;1;3;4;54433;7.348483456726618e-05
23852;继续努力，一定能越来越好。加油百度。;1;1;2;54433;3.674241728363309e-05
23854;一个让他写出99乘法表，它就会死机玩意，没必要测试;2;0;2;54433;3.674241728363309e-05
23857;抄袭的真快;2;0;2;54433;3.674241728363309e-05
23860;敏感词怎么办正能量怎么办搜索了不恰当的东西能被举报吗;2;0;2;54433;3.674241728363309e-05
23863;画的人物有点日本的感觉能达到这样的水平挺厉害了为什么网上全是说他不好？;2;0;2;54433;3.674241728363309e-05
23869;你是学文的吧，一个理的问题没问;1;0;1;54433;1.8371208641816546e-05
23871;问他关于四战。;1;0;1;54433;1.8371208641816546e-05
23873;正视差距奋起直追加油;1;0;1;54433;1.8371208641816546e-05
23875;文心连chartgtp阉割版都不算，但是没法子，只能支持他，大家都是中国人;1;0;1;54433;1.8371208641816546e-05
23877;这就能改变世界的人工智能？;1;0;1;54433;1.8371208641816546e-05
23881;合机器娱乐是人类衰退就像你喜欢合橡皮人娱乐一样;1;0;1;54433;1.8371208641816546e-05
23883;开源的chatGPT30，别问我是怎么知道的;1;0;1;54433;1.8371208641816546e-05
23885;支持国产做大做强防备被人掐脖子;1;0;1;54433;1.8371208641816546e-05
23887;文心一言就是个ppt;1;0;1;54433;1.8371208641816546e-05
23890;非常准确？你的中文小学生水平？;1;0;1;54433;1.8371208641816546e-05
23905;是8万家广告公司吗;1;4033;4034;54433;0.07410945566108794
23908;无人驾驶呢，AI都没动静了;2;1;3;54433;5.511362592544963e-05
23911;虽然有很多很多问题，还是真心希望文心一言能好，毕竟是中国的，没人做才是真的惨;15;2144;2159;54433;0.03966343945768192
23927;那为什么非要等chatGPT大火之后才推出产品？既然有这个能力，早就应该做这种东西了;36;130;166;54433;0.0030496206345415463
23964;你自己看看和别人的除了名字不一样还有什么是不一样的。;1;0;1;54433;1.8371208641816546e-05
23966;不是多年前就布局了吗？只要我们禁用chatgpt，别说8万家了，800万都会有的;1;362;363;54433;0.006668748736979406
23969;试了一下，确实还可以，毕竟才10内测，以后更强;82;289;371;54433;0.006815718406113939
24052;文心一言40什么时候出？三个月内行不行;25;1957;1982;54433;0.03641173552808039
24078;用文心一言的公司大多会亏死，被用gpt4的公司吊打;1;604;605;54433;0.01111458122829901
24082;别人在做，你在笑，别人挣钱了，你还在笑支持百度;6;129;135;54433;0.0024801131666452336
24089;虽然百度挨骂，但是还是希望百度努力超过那个人工智能。;4;64;68;54433;0.001249242187643525
24094;这波我还是想支持下百度，毕竟也就百度在做这个事。;20;208;228;54433;0.004188635570334173
24115;遥遥领先，遥遥领先，世界第一，绝无对手;5;76;81;54433;0.0014880678999871402
24136;苏州河33啦啦啦;1;0;1;54433;1.8371208641816546e-05
24146;开放给大家测试一下吧，申请三天了也没动静，是员工不足吗;1;3;4;54433;7.348483456726618e-05
24175;ChatGPT刚出来那天，微软跌了多少;1;0;1;54433;1.8371208641816546e-05
24181;为什么总是人家出了啥后面就出了中文版的;2;5;7;54433;0.00012859846049271582
24220;迷一樣的自信;1;10;11;54433;0.000202083295059982
24223;支持国产，知耻后勇;1;0;1;54433;1.8371208641816546e-05
24257;谁的好用我用谁的，管他是哪家公司的;2;22;24;54433;0.00044090900740359707
24261;就看gpt40啥时候开源了;1;5;6;54433;0.00011022725185089927
24263;亲测，其实用户体验还行，没想象的那么差，当然gpt比，还有一段差距;1;6;7;54433;0.00012859846049271582
24266;文心一言体现了AI的便捷性，能省去很多机械性工作造成的时间损耗;5;181;186;54433;0.0034170448073778774
24272;百度应该加强在移动端的发力，多研发流量产品，像文心一言这种就很有前景;1;101;102;54433;0.0018738632814652876
24274;发展起来不是问题，国内只有百度能做好;3;82;85;54433;0.0015615527345544064
24279;百度和华为是中国的骄傲，代表了中国的科技门面;10;8;18;54433;0.0003306817555526978
24290;明显有人在搞文心一言，还没开始运作呢，就全是恶评，我全力支持国产雄起，加油;3;174;177;54433;0.0032517039296015285
24294;大家不要酸百度毕竟是国内相关领域顶尖的高科技公司他不顶其他更顶不住;7;7;14;54433;0.00025719692098543164
24302;哇，为什么我们的企业，不管是车子还是任何一家高科技公司，都能如此自信啊，如果只看采访，我真的以为我们吊打人家了;1;9;10;54433;0.00018371208641816545
24304;百度也不容易可以想见训练语料有多少星号还要机器人懂骨鲠在喉很难;3;6;9;54433;0.0001653408777763489
24308;人家的东西再好，我们也不能诋毁自己的东西，不足之处努力追赶吧;8;18;26;54433;0.00047765142468723015
24317;简单试用了一下，感觉还不错，单从中国历史知识上比chatgpt要准确;1;6;7;54433;0.00012859846049271582
24319;批评虽然有，更多的应该是鼓励与支持，给文心一言多点时间;1;19;20;54433;0.0003674241728363309
24322;很反感百度;1;35;36;54433;0.0006613635111053956
24324;虽然不尽人意，但百度不做，其他企业更做不了;8;10;18;54433;0.0003306817555526978
24335;支持百度，至少他们开始走在路上了;1;6;7;54433;0.00012859846049271582
24337;我觉得文心一言还不错;1;10;11;54433;0.000202083295059982
24339;我觉得这块，还得给字节来弄，百度老了;11;9;20;54433;0.0003674241728363309
24351;算力还是不太够啊，GPT全球几亿人用都不用预约，我昨天早上预约了文心一言到现在还没消息;3;7;10;54433;0.00018371208641816545
24355;匆忙应战能做出来不错了，过段时间应该差距没那么大。最主要的还是芯片算力问题。没有芯片其它都是空中楼阁啊。;21;18;39;54433;0.0007164771370308453
24377;李彦宏真的是儒雅随和;1;11;12;54433;0.00022045450370179853
24379;我觉得公司就应该只专研技术，不能赚钱，不能投放广告;25;6;31;54433;0.0005695074678963129
24405;这期网友，一直说喷百度不好，然后偷偷去申请，我现在排队前面有50万了;12;21;33;54433;0.000606249885179946
24418;有一说一，至少我们有而不是望洋兴叹;24;56;80;54433;0.0014696966913453236
24443;确实大涨，昨晚美股也是大涨，别看港股了;1;37;38;54433;0.0006981059283890287
24445;等开源遥遥领先呢;1;12;13;54433;0.00023882571234361508
24447;我也申请体验了，还没通过，我是八万之一吗？;5;10;15;54433;0.0002755681296272482
24453;用了一天，最大的感觉是慢;18;29;47;54433;0.0008634468061653776
24472;啊？GPT出来的反馈？;7;55;62;54433;0.0011390149357926257
24480;遥遥领先;1;9;10;54433;0.00018371208641816545
24483;差距是有的，但是毕竟是我们自己的，慢慢追吧，支持百度;8;39;47;54433;0.0008634468061653776
24498;需要买会员吗？是不是不买会员就有广告，我可以花钱在上面打广告吗？我要排名第一哦，我是开医院的;1;4;5;54433;9.185604320908272e-05
24505;李彦宏是谷歌之父，谷歌创始人起家就是买的李彦宏专利。;2;6;8;54433;0.00014696966913453236
24508;一个人放下了道德和节操就是这样的;1;2206;2207;54433;0.04054525747248912
24510;八万家莆田地区的公司转战文心一言;10;1371;1381;54433;0.025370639134348647
24521;冒昧问一下。chatGPT没出来文心一言是不是永远不会出来;77;3913;3990;54433;0.07330112248084801
24599;让文心写篇论文，需要看几个小时广告？;8;526;534;54433;0.009810225414730036
24608;国内的企业家别的不说，蛮有自信的;8;1622;1630;54433;0.029945070086160968
24618;ChatGPT刚出来的反馈比文心一言还糟糕？？有8万家企业想合作？？;75;1297;1372;54433;0.0252052982565723
24694;注意是catgpt刚出来的时候要好，刚出来都已经2年了;16;1199;1215;54433;0.022321018499807103
24711;国内十年沉淀，在国外推出产品后一个月国内出来了。奈斯;2;903;905;54433;0.016625943820843973
24714;早有布局，弯道超车，遥遥领先;3;176;179;54433;0.0032884463468851616
24718;我只能说是国家帮你挡住了国外的竞争者，不是你的产品比别人强;4;106;110;54433;0.00202083295059982
24723;这个不能酸，国内少有能力且真正做事的公司，加油吧;135;293;428;54433;0.00786287729869748
24866;国内需要有自己的chatgpt，所以百度站出来了;1;15;16;54433;0.00029393933826906473
24870;能一样吗现在火是因为人家ChatGPT带的;1;2;3;54433;5.511362592544963e-05
24872;有一说一，当你贬低chatgpt的时候，你的格局也出来了;1;3;4;54433;7.348483456726618e-05
24899;有谷歌也有百度，有chatgpt也有文心一言，，，始终紧跟世界前沿，值得期待，;1;5;6;54433;0.00011022725185089927
24901;会不会咨询看病，直接给我推到某东方医院？;1;5;6;54433;0.00011022725185089927
25160;cahtgpt要是没出来，百度内部都没这项目;1;1;2;54433;3.674241728363309e-05
25162;哪里下载;1;1;2;54433;3.674241728363309e-05
25179;账号？;1;1;2;54433;3.674241728363309e-05
25188;文心一言肯定会发展起来的啊，因为老百姓用不了chatgpt，参考百度搜索引擎;1;1;2;54433;3.674241728363309e-05
25216;农夫山泉好喝吗？;2;1;3;54433;5.511362592544963e-05
25237;下回让百度先出，微软后出，这样行不行;2;1;3;54433;5.511362592544963e-05
25252;调侃归调侃，这也是我们国内能拿得出手的最高水平了，百度的确很早就allinai了;1;1;2;54433;3.674241728363309e-05
25270;百度的ai世界前列的吧;1;1;2;54433;3.674241728363309e-05
25272;抢占市场份额嘛;1;1;2;54433;3.674241728363309e-05
25340;Chatgpt35从16年开始训练到今天，百度要训练多久;2;1;3;54433;5.511362592544963e-05
25345;当天股票就跌停了;2;1;3;54433;5.511362592544963e-05
25359;我只想用原版不想用改良版希望没有科技封锁能自由使用;2;1;3;54433;5.511362592544963e-05
25390;做这些技术型的企业不能只顾盈利，chatGPT母公司OpenAI刚开始是开放的公益组织你敢信？;2;1;3;54433;5.511362592544963e-05
25395;股票跌了10好不好不用我们普通人说;1;1;2;54433;3.674241728363309e-05
25400;光是这个名字就很糟糕;1;1;2;54433;3.674241728363309e-05
25408;如果谷歌没有退出中国呢;3;1;4;54433;7.348483456726618e-05
25428;那为啥总在人后;1;1;2;54433;3.674241728363309e-05
25449;圈一波;1;1;2;54433;3.674241728363309e-05
25451;但是差距太大了吧;2;1;3;54433;5.511362592544963e-05
25478;为什么CHAT不出来的时候，您不做啊;1;1;2;54433;3.674241728363309e-05
25483;回答的问题前全是广告;2;1;3;54433;5.511362592544963e-05
25495;饕餮欲你知道为什么那么多企业想合作吗因为国内禁用ChatGPT;1;1;2;54433;3.674241728363309e-05
25498;ChatGPT出来的时候不是惊震四方吗？;1;1;2;54433;3.674241728363309e-05
25752;都没人盼着点好吗？;1;0;1;54433;1.8371208641816546e-05
25840;zippp;2;0;2;54433;3.674241728363309e-05
25996;为什么要排队？;1;0;1;54433;1.8371208641816546e-05
26063;后出来不该更强？;1;0;1;54433;1.8371208641816546e-05
26180;讲个笑话：文心一言的发布让百度股价遭遇会心一击;1;0;1;54433;1.8371208641816546e-05
26319;模板是国外的吗;1;0;1;54433;1.8371208641816546e-05
26345;不是因为你好，是因为别人的用不了;1;0;1;54433;1.8371208641816546e-05
26348;文心昨天好多人工顶上去的，服务器压根顶不住;3;0;3;54433;5.511362592544963e-05
26391;看看股票;2;0;2;54433;3.674241728363309e-05
26420;Engfa巧克力小狗自信;1;0;1;54433;1.8371208641816546e-05
26441;主打的就是一个心态好。;2;0;2;54433;3.674241728363309e-05
26452;免费500字，充会员加500字;1;0;1;54433;1.8371208641816546e-05
26492;百度云技术是国内最强的。比阿里还强一点。;2;0;2;54433;3.674241728363309e-05
26512;我：有点咳嗽某软件：癌症我：？？？？？;1;0;1;54433;1.8371208641816546e-05
26549;很多人对百度的印象还停留在搜索引擎吧先去了解了解百度是干什么的再评价吧;1;0;1;54433;1.8371208641816546e-05
26637;有竞价排名没？;1;0;1;54433;1.8371208641816546e-05
26691;bakerrobin好可爱;1;0;1;54433;1.8371208641816546e-05
26694;感兴趣的同学可以试试，你就会知道什么叫碾压;3;0;3;54433;5.511362592544963e-05
26707;这家伙太帅了;1;0;1;54433;1.8371208641816546e-05
26737;我刚申请了，50万人排队等着用文心呢;2;0;2;54433;3.674241728363309e-05
26847;本身中文的处理难度就是要超过英文;2;0;2;54433;3.674241728363309e-05
26886;中国一共有多少企业，张口就超过8万家;2;0;2;54433;3.674241728363309e-05
26909;文心一言，这个代号差点意思。;1;0;1;54433;1.8371208641816546e-05
27079;咋又比别人慢半拍;1;0;1;54433;1.8371208641816546e-05
27231;爱了套壳一言;1;0;1;54433;1.8371208641816546e-05
27234;心态真好;1;0;1;54433;1.8371208641816546e-05
27237;INERT;1;0;1;54433;1.8371208641816546e-05
27255;那就祝你成功吧，毕竟隔行如隔山胡拾贰;1;0;1;54433;1.8371208641816546e-05
27302;为啥感觉下面评论阴阳怪气的，不想用就用国外的啊，至于搁那阴阳怪气;2;0;2;54433;3.674241728363309e-05
27309;VetarDOLPHIN小陈。大天使小恶魔咿咿呀呀KCHo;1;0;1;54433;1.8371208641816546e-05
27340;他为了保住大家的工作已经很努力了，你瞅瞅文言一心是不是感觉很安心。chatGPT可是要淘汰我们的;1;0;1;54433;1.8371208641816546e-05
27381;还可以把，只不过发布会的营销太烂了;1;0;1;54433;1.8371208641816546e-05
27398;老总里面，李彦宏算很帅了;1;0;1;54433;1.8371208641816546e-05
27414;为什么要抄呀;1;0;1;54433;1.8371208641816546e-05
27438;牛逼;1;0;1;54433;1.8371208641816546e-05
27494;不搞艺术了;1;0;1;54433;1.8371208641816546e-05
27543;等人家代码放出来，抄袭;1;0;1;54433;1.8371208641816546e-05
27568;要是gpt3不开源。。。;3;0;3;54433;5.511362592544963e-05
27646;百度在做啥阿搜索引擎啥也收不到;2;0;2;54433;3.674241728363309e-05
27855;百度除了百度这个产品，还搞出啥产品来啊;2;0;2;54433;3.674241728363309e-05
27860;最佳损友;1;0;1;54433;1.8371208641816546e-05
27888;客观来讲，文心现在确实是10版本;2;0;2;54433;3.674241728363309e-05
28058;大哥，刚出来了两个月就破亿，糟糕？哪里来的糟糕;1;0;1;54433;1.8371208641816546e-05
28101;复合维生素片自信;1;0;1;54433;1.8371208641816546e-05
28211;8万家竞价了;1;0;1;54433;1.8371208641816546e-05
28228;robgu723Nimsile李锦记第二个蔚来;1;0;1;54433;1.8371208641816546e-05
28280;他会很智能告诉你哪家医院好;1;0;1;54433;1.8371208641816546e-05
28324;msdrogba;1;0;1;54433;1.8371208641816546e-05
28381;自己看股价;1;0;1;54433;1.8371208641816546e-05
28396;国内的搜索引擎，从广告到各式各样的vip可看内容，已经够垃圾了吧;1;0;1;54433;1.8371208641816546e-05
28402;大家为什么要喷自己，捧别人，别人的就一定好吗;1;0;1;54433;1.8371208641816546e-05
28518;说实话，可以嘲讽，但是百度确实是国内做的最好的了;1;0;1;54433;1.8371208641816546e-05
28524;我有一个疑问，为什么你能比chartgpt刚出来的时候好，为什么不能比它先出？;1;0;1;54433;1.8371208641816546e-05
28544;所以文心一言怎么用啊;9;0;9;54433;0.0001653408777763489
28695;他咋个能那么自信;1;0;1;54433;1.8371208641816546e-05
28756;百度搞ai你们也喷，这不比腾讯强多了么，慢慢再优化吧;1;0;1;54433;1.8371208641816546e-05
28816;你是科技公司？我以为是蹭热度的主播;1;0;1;54433;1.8371208641816546e-05
28824;基本上，一个问题先看两小时广告;2;0;2;54433;3.674241728363309e-05
28860;哈哈，跟股民预期可差远了，9可不是白跌的;2;0;2;54433;3.674241728363309e-05
28870;承认反馈糟糕;1;0;1;54433;1.8371208641816546e-05
28879;文心一言50预计在ChatGPT50发布的第二天发布;1;0;1;54433;1.8371208641816546e-05
28881;Ronal迪尼奥诺苏凉山足球分享Hy1用户1280350226210一再问究竟南方蝶道魚;1;0;1;54433;1.8371208641816546e-05
28948;gpt刚出来的确有点混乱，但是不影响人家接入应用;1;0;1;54433;1.8371208641816546e-05
29028;从几年前就说埋头搞AI，搞了几年就这成绩确实让人失望，卖竞价排名的广告费真投入研发了吗？;1;0;1;54433;1.8371208641816546e-05
29095;不管如何，有人做就好;1;0;1;54433;1.8371208641816546e-05
29097;别最后又是一堆广告;35;226;261;54433;0.004794885455514118
29133;文心一言会有广告吗;33;198;231;54433;0.004243749196259622
29168;百度是真的做了好多年AI了，但是一直没看到什么大火的应用传播出来;19;74;93;54433;0.0017085224036889387
29188;文心一言刚刚试了，还是和以前一样奔着百度排名和收费去的;8;80;88;54433;0.001616666360479856
29197;都是套壳;3;3;6;54433;0.00011022725185089927
29201;问10个问题，答11句广告;1;84;85;54433;0.0015615527345544064
29203;股票跌停了;4;26;30;54433;0.0005511362592544964
29208;百度我反正感觉是广告公司;2;32;34;54433;0.0006246210938217625
29211;广告自动生成器吗;1;125;126;54433;0.0023147722888688846
29214;会不是会是中文翻译成英文搜索答案，然后英文内容再翻译成中文再展示给用户;4;24;28;54433;0.0005143938419708633
29219;虽然对百度的期待没有那么大，但还是希望我们国家能有一个和chatGPT抗衡的产品。希望百度加油吧;4;22;26;54433;0.00047765142468723015
29224;可以看出来百度走心了，这么快就研发落地;4;50;54;54433;0.0009920452666580934
29230;医院广告优化版;1;19;20;54433;0.0003674241728363309
29232;中国有几个公司能有这份担当百度做的不错推动了中国人工智能，自动驾驶等技术的巨大进步;3;9;12;54433;0.00022045450370179853
29252;我怕文心一言给我引流到莆田医院;1;4;5;54433;9.185604320908272e-05
29272;文心一言：大家不要慌，各位的工作保住了;1;4;5;54433;9.185604320908272e-05
29297;希望不忘初心，做好产品和服务，不要变成“文心广告”，“文心资本”就行;1;2;3;54433;5.511362592544963e-05
29307;不吹不黑，国产货距离chatgpt35差3年左右，跟chatgpt4至少5年差距。;12;10;22;54433;0.000404166590119964
29355;谷歌离开中国之后百度就已经死了;20;41;61;54433;0.0011206437271508093
29376;对百度是一点信心都没有。这些年一直就是一堆烂泥。;4;41;45;54433;0.0008267043888817446
29381;chatgpt已经出4了文心一言已经过时了;5;15;20;54433;0.0003674241728363309
29387;百度在自动驾驶和人工智能方面，国内算头部企业了吧;3;14;17;54433;0.00031231054691088127
29391;百度有什么用，都介绍去医院看看;4;19;23;54433;0.0004225377987617805
29399;百度文库的速搜版？;1;4;5;54433;9.185604320908272e-05
29404;百度不能代表中国技术水平，不要解读。嘲笑就好了;2;1;3;54433;5.511362592544963e-05
29626;百度云你们自己体会;1;1;2;54433;3.674241728363309e-05
29640;百度咋还不死？;3;2;5;54433;9.185604320908272e-05
29658;国外是十年磨一剑。国内上午立项，下午开干，明天上午出结果，明天下午想盈利，后天一看不赚钱就不干了;60;720;780;54433;0.014329542740616905
29719;主要是对方没开源不然也就展示实机了;12;288;300;54433;0.005511362592544963
29733;能力不行还能理解，可以接受。还皮厚就无解了;20;118;138;54433;0.0025352267925706834
29754;别小看文心一言，中国市场可以一周一个迭代;49;36;85;54433;0.0015615527345544064
29805;文心一言，一言难尽，文心遗言;2;146;148;54433;0.002718938878988849
29808;有点迷恋这女生;11;48;59;54433;0.0010839013098671762
29820;这个鼻子是不是人工的？;4;25;29;54433;0.0005327650506126798
29825;文心一言这名字就没起好;2;48;50;54433;0.0009185604320908272
29829;本来很想专注你，看了一下你推荐特斯拉，立马清醒了;7;3;10;54433;0.00018371208641816545
29838;至少百度站出来了，不断的闭环内测和用户反馈，文心是会不断进化的;3;7;10;54433;0.00018371208641816545
29842;斜视是一种病吗;1;14;15;54433;0.0002755681296272482
29844;文心一言有国内几亿用户喂数据，进化速度会远超openai，文心一言个人也是免费使用的;9;0;9;54433;0.0001653408777763489
29855;文心一言优势在于医疗方面，你问他看病去哪个医院它会给你推荐最优解;4;3;7;54433;0.00012859846049271582
29886;百度的数据库很强大;1;1;2;54433;3.674241728363309e-05
29905;这么漂亮的姑娘，千万千万不要跟被人一样去羞辱百度。。承认别人的好，我们慢慢进步，多鼓励，，尽管不好，至少我们国人能用起来，;2;1;3;54433;5.511362592544963e-05
29918;OpenAI的背后是微软强大的现金支持和云计算。;1;1;2;54433;3.674241728363309e-05
29928;长的像女版张朝阳;1;1;2;54433;3.674241728363309e-05
29955;你的鼻子是什么情况;1;4;5;54433;9.185604320908272e-05
29962;文心一言，特别棒，有开始就很不错了;1;9;10;54433;0.00018371208641816545
29964;这是骆驼鼻？;1;3;4;54433;7.348483456726618e-05
30008;文心一言？这个“一”字是什么意思？;6;0;6;54433;0.00011022725185089927
30020;百度的东西我全都不用;1;0;1;54433;1.8371208641816546e-05
30022;如果百度做不出来，谁能做出来？;2;0;2;54433;3.674241728363309e-05
30046;OpenAI已经开始测试比GPT4强5倍的版本了拿什么追？;1;3;4;54433;7.348483456726618e-05
30051;芯片，发动机，大型团体球类项目，包括这个，不能功利心作祟。;2;0;2;54433;3.674241728363309e-05
30058;差距来自全民的智商浓度;1;0;1;54433;1.8371208641816546e-05
30060;原谅他们的不完美，给他们时间和信心;4;0;4;54433;7.348483456726618e-05
30076;楼主懂行，midjourney确实还要半分钟，给四个选项;2;2;4;54433;7.348483456726618e-05
30079;文心一言是什么？;3;1;4;54433;7.348483456726618e-05
30083;哈哈哈三个字送给文心一言;1;6;7;54433;0.00012859846049271582
30092;你不懂百度实力，别跟风说文心一言不行吧别人人工智能这方面的工程师说过百度文心一言的算法跟CHATGPT一样牛逼，两者差别在于语料投喂训练上不同而已百度在人工智能方面的研发已经不出声的干了17年了人家工程师说过百度是很牛逼的;1;0;1;54433;1.8371208641816546e-05
30114;鼻子咋了这是;1;5;6;54433;0.00011022725185089927
30116;这么大吗;6;36;42;54433;0.0007715907629562949
30124;弘凌脑路很清晰;4;0;4;54433;7.348483456726618e-05
30130;说老实话，，，那叫个啥，不是小偷，还要翻个墙，中酒，中烟，是能醉，，，人多了就必须抄袭;1;0;1;54433;1.8371208641816546e-05
30132;厉害了我的商业帝国;1;0;1;54433;1.8371208641816546e-05
30430;就训练数据而言，在中国这块百度是有优势;2;0;2;54433;3.674241728363309e-05
30479;什么时候暴跌达到10了？;1;0;1;54433;1.8371208641816546e-05
30523;我总觉得百度不是研发公司，从电商平台“有啊”到外卖到等等等等最后就卖盘第一个发自己名声大，跟投到人多，收割一波用户后打包一卖盈利;1;0;1;54433;1.8371208641816546e-05
30535;听说是录播;1;0;1;54433;1.8371208641816546e-05
30557;像老罗这样一心做产品的产品经理没几个;3;0;3;54433;5.511362592544963e-05
30621;听不懂小学毕业;1;0;1;54433;1.8371208641816546e-05
30629;看你感觉不太像好人你一天到晚说的大公司事跟你我有什么关系吗你是做什么工作的啊天天说着高大上的话题;2;0;2;54433;3.674241728363309e-05
30633;文心一言以后不会推荐医院吧;89;563;652;54433;0.011978028034464388
30723;虽然有差距，至少文心一言努力跟着世界节奏走，请鼓励他，他是我们自己的;148;107;255;54433;0.004684658203663219
30872;美女看我视频，咱们两个是不是有点像;1;0;1;54433;1.8371208641816546e-05
30874;转人工了所以得排队;6;259;265;54433;0.004868370290081385
30881;凡是回答不出来的，一律正在排队中;5;188;193;54433;0.003545643267870593
30888;一个幼儿园，一个读研了，差距还有很大;24;52;76;54433;0.0013962118567780574
30913;差距会不会就是旧版本和最新版本的差距，好像旧版本已经开源了。毕竟马斯克公开图纸后才有了中国新能源汽车的井喷式发展;26;19;45;54433;0.0008267043888817446
30940;文心一言会告诉你去看中医;48;21;69;54433;0.0012676133962853417
30989;训练的数据差太远了，中文缺少高质量科研数据;13;31;44;54433;0.000808333180239928
31003;不需要对百度抱有希望。;4;34;38;54433;0.0006981059283890287
31009;中文资料还不够;4;9;13;54433;0.00023882571234361508
31014;文心积累的资料是广告居多;1;24;25;54433;0.0004592802160454136
31016;请给我列一个全国莆田系医院的清单，谢谢;1;22;23;54433;0.0004225377987617805
31019;其实就是AI数据学习的差异呗。把美国PubMed的接口给百度接上拿去训练我也一样啊。;3;1;4;54433;7.348483456726618e-05
31045;数据集不同，估计很多顶级医疗论文，并没有在文心的数据集中。;1;1;2;54433;3.674241728363309e-05
31068;算力和数据库差别太大呗。还有些就是属于知识专利了;1;2;3;54433;5.511362592544963e-05
31074;现在人工智能还是弱人工智能，智能根据现有的数据分析人体疾病，等它到了更高维度，也就是彻底熟知人体结构，了解各种疾病起因后，各种病症状况后，它会自己推演出最优解决方案，;1;0;1;54433;1.8371208641816546e-05
31079;文心其实是先把你的中文翻译成英文，用chatgpt回答后再翻译回来，已经有无数人验证过了;1;2;3;54433;5.511362592544963e-05
31086;一个是套壳20，一个是40;2;0;2;54433;3.674241728363309e-05
31098;最起码证明不是GTP套壳;1;0;1;54433;1.8371208641816546e-05
31123;你要问下文心起重机;1;2;3;54433;5.511362592544963e-05
31128;别人的东西再好那是拿来干咱们的我们的东西再差那是拿来保护咱们的支持文心一言;3;0;3;54433;5.511362592544963e-05
31141;看看这个差异吧。;1;0;1;54433;1.8371208641816546e-05
31159;AI的答案當然是離不開已有的知識，難道你會以為它有創造新答案的能力？;1;1;2;54433;3.674241728363309e-05
31178;是网上中文信息和英文信息的差异;1;2;3;54433;5.511362592544963e-05
31182;一个被眼科耽误的科技达人;1;0;1;54433;1.8371208641816546e-05
31221;没有直接推送莆田医院吗;1;3;4;54433;7.348483456726618e-05
31231;CP的回答来源于美国国家大数据中心悸，文心的回答来源于百度的大数据中心，CP的优势来自资源整合而不是AI自主学习能力，;1;1;2;54433;3.674241728363309e-05
31258;我有个大胆的想法，能不能用GTP来训练文心一言。让他们互聊训练。;1;1;2;54433;3.674241728363309e-05
31272;为什么不用Gpt去炒股炒期货？;1;0;1;54433;1.8371208641816546e-05
31314;你知道chatGPT投入了多少美元吗;1;0;1;54433;1.8371208641816546e-05
31322;文心一言正在等待莆田系的糖衣炮弹现在留下的空白，就是糖衣炮弹的炮击范围;1;1;2;54433;3.674241728363309e-05
31336;不是，应该是语言训练时gpt用sci的库，一言的库估计是知网。;1;0;1;54433;1.8371208641816546e-05
31342;西南医院干细胞温州眼视光自体干细胞进展怎么样啊;1;0;1;54433;1.8371208641816546e-05
31345;完全不是一个量级的对手，你这是让文新出洋相吗;2;1;3;54433;5.511362592544963e-05
31358;人家没回答我去看看chatGpt再回答你就不错了;1;1;2;54433;3.674241728363309e-05
31370;了解一下背后的情况再扯吧;1;0;1;54433;1.8371208641816546e-05
31608;文心没有推荐医院给个广告，已经很令人满意了;2;0;2;54433;3.674241728363309e-05
31638;是不是要用外网？;2;0;2;54433;3.674241728363309e-05
31678;对不起，我没有听懂你的意思;4;0;4;54433;7.348483456726618e-05
31718;怎么下载;1;0;1;54433;1.8371208641816546e-05
31731;百度知道，百度文库，百度百科啧啧爬虫多爬几遍估计都比ppt好事;2;0;2;54433;3.674241728363309e-05
31740;你是如何可以用gpt;1;0;1;54433;1.8371208641816546e-05
31749;我get不到哪厉害啊比如问这个医学问题，就算从数据库里面转读百度百科的治疗方案也很详细啊，哪厉害了？;5;0;5;54433;9.185604320908272e-05
31796;挺不错的啊。我还以为要说他弹窗医院广告呢。;1;0;1;54433;1.8371208641816546e-05
31834;你用英语问啊;1;0;1;54433;1.8371208641816546e-05
31837;医学问题应该是百度的强项啊。;1;0;1;54433;1.8371208641816546e-05
31862;GPT数据库中文数据连英文的百分之一都没有。用英文差距更大。;1;0;1;54433;1.8371208641816546e-05
31865;文心背后有可能是真人工智能再跟你聊天;5;0;5;54433;9.185604320908272e-05
31878;我一直在排队用不了文心。不过gpt可以解答医学问题吗？我记得以前试过问它它说不能回答医学问题的不过我不是用正版gpt国内别人搞的;1;0;1;54433;1.8371208641816546e-05
31883;你这是在测搜索引擎，不是测ai。要测ai你让它给出一些还没发现的，可能有效的药物成分，或者海伟发现的蛋白质结构。;1;0;1;54433;1.8371208641816546e-05
31895;数据库原因，和运行逻辑没多大关系;1;0;1;54433;1.8371208641816546e-05
31902;你怎么登上的gpt请问;1;0;1;54433;1.8371208641816546e-05
31910;医学我们还是要相信中医;1;0;1;54433;1.8371208641816546e-05
31912;问下文心，我啥时脱单;1;0;1;54433;1.8371208641816546e-05
31954;问心后台的人工回答不了你的问题了;1;0;1;54433;1.8371208641816546e-05
31966;这个已经不错了没有给你推荐医院;3;0;3;54433;5.511362592544963e-05
31990;看到最后一秒亮了;1;0;1;54433;1.8371208641816546e-05
32010;你问下它们这个世界上最漂亮的女人是谁，看它们怎么回答;2;0;2;54433;3.674241728363309e-05
32026;没抢到第一;2;0;2;54433;3.674241728363309e-05
32050;文心没让你去那家医院治疗吗;2;0;2;54433;3.674241728363309e-05
32063;这都是在哪用的;1;0;1;54433;1.8371208641816546e-05
32065;这个视频有种我刚刚学会PPT动画时做的PPT的感觉。;1;0;1;54433;1.8371208641816546e-05
32075;百度那里得罪你了;1;0;1;54433;1.8371208641816546e-05
32087;扫描本草纲目会不会开发中医药新世界？;1;0;1;54433;1.8371208641816546e-05
32093;差点把我眼晃瞎了，让我去找你看病了;1;0;1;54433;1.8371208641816546e-05
32095;居然没推荐莆田系？;1;0;1;54433;1.8371208641816546e-05
32114;清姐，赶紧拍桃花了;2;0;2;54433;3.674241728363309e-05
32117;我感觉你真的适合做科研;1;0;1;54433;1.8371208641816546e-05
32119;客服快上;1;0;1;54433;1.8371208641816546e-05
32121;没让你充值VIP中P就不算了，没让你去问莆田医院就知道吧;2;0;2;54433;3.674241728363309e-05
32125;文心VSchat莆田医院VS人民医院？;2;0;2;54433;3.674241728363309e-05
32128;发现一条美吹;1;0;1;54433;1.8371208641816546e-05
32130;文心直接给你一句你不会自己百度搜索;1;0;1;54433;1.8371208641816546e-05
32132;真的就和我们这三甲医院与北上广医院的区别。同样的癌症我们这就是放化疗，然后人就没了;1;0;1;54433;1.8371208641816546e-05
32139;百度今天得文心发布会今天的口碑两派，大部分属于失望型，期待能够对标gpt4，robin自己也说不太现实。另一派是包容心，敢亮相就是好的，重在态度。但整体得营销策论确实不能称道，可以有更好的策论让口碑不至于崩塌;17;30;47;54433;0.0008634468061653776
32157;容忍度可以给，但你不能老骗人;47;401;448;54433;0.008230301471533813
32205;百度不是卖药的吗？;8;190;198;54433;0.003637499311079676
32215;我们老师当初吹百度的什么智能驾驶，当时说什么是世界第一，我当时真的没憋住，一直苦笑;24;42;66;54433;0.001212499770359892
32240;再等等开源了就可以遥遥领先了;26;242;268;54433;0.004923483916006834
32268;国外一开源，国内就自主;16;84;100;54433;0.0018371208641816544
32285;ChatGPT和CheatPPT区别还是很大的;2;134;136;54433;0.00249848437528705
32288;openai直接现场操作文心一言提前弄好PPT;18;124;142;54433;0.0026087116271379493
32307;再早一天发布，就可以上315晚会了;3;113;116;54433;0.002131060202450719
32311;我就好奇怎么会有人期待呢？;8;82;90;54433;0.0016534087777634891
32320;基础靠的是算力，核心靠的是模型和参数，还得要大量数据的训练，每一步都很耗时耗力，而不是几页cheatPPT;2;45;47;54433;0.0008634468061653776
32323;本来想露脸，结果把屁股露出来了;3;32;35;54433;0.000642992302463579
32327;布局已久遥遥领先;1;44;45;54433;0.0008267043888817446
32329;以为出新版本了，旧版就会开源，就这么简单，;3;14;17;54433;0.00031231054691088127
32350;为什么大家那么高预期啊？？？？？;1;0;1;54433;1.8371208641816546e-05
32355;百度今天得文心发布会今天的口碑两派，大部分属于失望型，期待能够对标gpt4，robin自己也说不太现实。另一派是包容心，敢亮相就是好的，重在态度。但整体得营销策论确实不能称道，可以有更好的策论让口碑不至于崩塌;17;30;47;54433;0.0008634468061653776
32373;容忍度可以给，但你不能老骗人;47;401;448;54433;0.008230301471533813
32421;我们老师当初吹百度的什么智能驾驶，当时说什么是世界第一，我当时真的没憋住，一直苦笑;24;42;66;54433;0.001212499770359892
32447;百度不是卖药的吗？;8;190;198;54433;0.003637499311079676
32456;再等等开源了就可以遥遥领先了;26;242;268;54433;0.004923483916006834
32484;国外一开源，国内就自主;16;84;100;54433;0.0018371208641816544
32501;ChatGPT和CheatPPT区别还是很大的;2;134;136;54433;0.00249848437528705
32504;openai直接现场操作文心一言提前弄好PPT;18;124;142;54433;0.0026087116271379493
32523;再早一天发布，就可以上315晚会了;3;113;116;54433;0.002131060202450719
32527;基础靠的是算力，核心靠的是模型和参数，还得要大量数据的训练，每一步都很耗时耗力，而不是几页cheatPPT;2;45;47;54433;0.0008634468061653776
32530;我就好奇怎么会有人期待呢？;8;82;90;54433;0.0016534087777634891
32539;本来想露脸，结果把屁股露出来了;3;32;35;54433;0.000642992302463579
32543;布局已久遥遥领先;1;44;45;54433;0.0008267043888817446
32545;以为出新版本了，旧版就会开源，就这么简单，;3;14;17;54433;0.00031231054691088127
32566;为什么大家那么高预期啊？？？？？;1;0;1;54433;1.8371208641816546e-05
32571;大语言模型方面做的还是比较好的，虽然离chatGPT有些差距，只要涉及到语言，各个国家都有充沛的语料，这个都可以把大语言模型迭代得比较好，真能产生差距的是知识的专业度上，英语世界的知识专业度要远远高于中文世界，各个学科方面都是如此，所以回答的内容质量方面，英语世界会远超过中文。除了大语言模型外，比如数学，图像方面，就差得多了，用过谷歌的都知道，数学或者其他硬核专业学科网上的知识，谷歌的结果是好的多的，在数学这方面，或者其他专业程度方面，是很难很比得过他们的，整体的训练集质量都不够那么先进。要知道一个庞大的AI模型，需要数据，算力，算法三方面支撑，我们在数据方面差距最大，算法方面差距要小些，算力方面几乎没有多大差异;69;131;200;54433;0.003674241728363309
32641;看国外开源进度;61;231;292;54433;0.005364392923410431
32703;王小川说了实话，不在一个宇宙;9;295;304;54433;0.00558484742711223
32713;我认为是两个月，直接后台接入gpt，用时间2个月，差距就是两个月。;2;40;42;54433;0.0007715907629562949
32716;王小川说了实话，不在一个宇宙;9;295;304;54433;0.00558484742711223
32726;我认为是两个月，直接后台接入gpt，用时间2个月，差距就是两个月。;2;40;42;54433;0.0007715907629562949
32729;那个，各位少侠，关于“是谁不友好”，我发了个新视频，请移步讨论。;1;1;2;54433;3.674241728363309e-05
32731;再不好也是自家的慢慢来吧;29;16;45;54433;0.0008267043888817446
32761;是谁不友好呢;13;53;66;54433;0.001212499770359892
32776;我感觉人工智能就是赢者通吃。第二第三都毫无机会;12;39;51;54433;0.0009369316407326438
32789;文心有广告吗？有排名吗？;4;7;11;54433;0.000202083295059982
32795;拥抱科技拒绝民粹科学出海承认差距;4;9;13;54433;0.00023882571234361508
32800;有差距是客观的与其落井下石还不如大家一起训练努力赶超;4;5;9;54433;0.0001653408777763489
32805;我们有四大发明，要什么自行车;2;9;11;54433;0.000202083295059982
32809;百度其实早就开发AI，自动驾驶，而且投入很多，不知道为啥一直没有成果，白白浪费很多时间和金钱。;2;3;5;54433;9.185604320908272e-05
32812;我们是永远用不了GPT吗？;3;0;3;54433;5.511362592544963e-05
32816;百度是做互联网的？不是做医疗的吗？;2;1;3;54433;5.511362592544963e-05
32819;文心一言小学，GPT大学毕业了。但总有一天文心也会大学毕业;1;3;4;54433;7.348483456726618e-05
32821;今天股价暴涨;1;1;2;54433;3.674241728363309e-05
32825;以前遇到一个重要项目，开发地图，2个亿研发费。谷歌地图单机版，换个logo交差了;8;17;25;54433;0.0004592802160454136
32834;0;11;33;44;54433;0.000808333180239928
32847;只要gpt一直不放开中国使用，文心一言就一直升值。因为市场有需求;3;16;19;54433;0.00034905296419451436
32851;关键是翻译都翻译不对;1;15;16;54433;0.00029393933826906473
32869;就是套用国外的，百度就一骗子;1;25;26;54433;0.00047765142468723015
32872;你管他内盒是哪儿的，好用就完了呗;3;1;4;54433;7.348483456726618e-05
32877;造假，咱的老本行啊;1;3;4;54433;7.348483456726618e-05
32888;chatgpt什么时候变成微软的？？？;21;60;81;54433;0.0014880678999871402
32910;温馨遗言;3;88;91;54433;0.0016717799864053055
32914;chatgpt什么时候变成微软的？？？;21;60;81;54433;0.0014880678999871402
32936;温馨遗言;3;88;91;54433;0.0016717799864053055
32940;那不是chatgpt画的，一看就是stablediffsion画的，用的chillo大模型配合jplora;1;9;10;54433;0.00018371208641816545
32944;chatgpt是一个ai语言程序不是绘画程序;1;1;2;54433;3.674241728363309e-05
32946;谁能教教我怎么样引导它画出中国象棋;2;0;2;54433;3.674241728363309e-05
32950;我感觉文心可以啊;1;0;1;54433;1.8371208641816546e-05
32966;文心一言感觉还不错;2;0;2;54433;3.674241728363309e-05
32971;SuperheroZhu;1;0;1;54433;1.8371208641816546e-05
32977;根本不是chatgtp画的，这个垃圾自媒体胡编乱造引流;1;0;1;54433;1.8371208641816546e-05
32979;训练数据集用了17亿张图文对，主要是国外的英语集和一部分中文数据集，英文数据集用了百度翻译成中文训练的，但是极少能翻译成中文特色得鱼香肉丝，夫妻肺片之类的专有名词，国外没有这些说法嘛，所以翻译成中文后要与用户输入的对齐就比较麻烦，普通的名词中英文很好对照，但是特殊名词比如菜谱，成语，歇后语等等比较晦涩意思不是那么直接的，就对应效果不那么好，所以导致了那些问题出来。如果用的是中文训练数据集，那训练效果要好很多，可是中文学术世界还是比英语世界小很多；假使国外的英语训练数据集加模型的效果是90分，文心一言由于有翻译对齐问题，其他假设都一样，也会因为这个原因降低效果的，中文很多晦涩的词汇意向更多，不像英文通常意思明确，这也是英语适合学术交流的原因之一;18;48;66;54433;0.001212499770359892
32998;对百度没什么信心，百度做过的产品都很烂，希望字节跳动能做一个中国版的chatGPT;43;162;205;54433;0.003766097771572392
33042;人家已经承认了，使用了开源模型;28;71;99;54433;0.001818749655539838
33071;说真的从出发点就不对的，中文的要翻译成英文去就是错的训练方向错的了，说什么都是错的;1;0;1;54433;1.8371208641816546e-05
33073;我倒是希望他外接GPT呢;11;76;87;54433;0.0015982951518380393
33085;他自己都承认了;21;5;26;54433;0.00047765142468723015
33108;0;6;32;38;54433;0.0006981059283890287
33115;编程的底层逻辑本来就是英文啊;9;2;11;54433;0.000202083295059982
33125;所以套壳无疑了，如果是自研的中文模型怎么可能不懂成语;3;15;18;54433;0.0003306817555526978
33129;自研不用中文语料;4;3;7;54433;0.00012859846049271582
33134;那个是文心一格。。。。你先用下好不;5;1;6;54433;0.00011022725185089927
33140;英文中找不到这些词，但是中文训练里这些常用词总能找到吧，你这一波没洗干净呀;1;11;12;54433;0.00022045450370179853
33143;这不能怪百度，我只能说调用的ChatGPT模块对中文支持不够;2;4;6;54433;0.00011022725185089927
33146;那个总线，画出公共汽车，并不能用数据集来解释;3;4;7;54433;0.00012859846049271582
33170;0;1;0;1;54433;1.8371208641816546e-05
33178;说点实话吧;1;1;2;54433;3.674241728363309e-05
33186;我可以证明百度绝对不是调用chat的api，因为chat是知道胸有成竹是什么意思的;1;3;4;54433;7.348483456726618e-05
33190;中国AI的希望，真正投入了巨大财力时间精力;1;0;1;54433;1.8371208641816546e-05
33194;实在不太明白，百度搜索那么大的接口，你只要在百度一下什么都能搜索出来基本上不会有什么误差，结果做这个什么图就做不了;2;1;3;54433;5.511362592544963e-05
33209;你可以合理的怀疑，但他一定不会回应;1;3;4;54433;7.348483456726618e-05
33212;这个是，用，StableDiffusion生成的“夫妻肺片”（英文是“Spicyslicedbeefandoxoffal”即“香辣牛肉片和牛杂”）;1;0;1;54433;1.8371208641816546e-05
33216;结束了吗？要输在ai这块。这次我们连类似华为这样的平替都找不到了。以后的ai赢家通吃，最后服务于资本，资本觉得硅基生命比碳基生命省钱，那就真的结束了。;2;1;3;54433;5.511362592544963e-05
33221;目前看到最有理有据的分析，李彦宏又不是贾跃亭，即使做不出对标gpt的产品，也还是有家底的，犯得着自毁招牌吗？;1;3;4;54433;7.348483456726618e-05
33226;你先测试一下这些结果对不对再分析啊。;3;0;3;54433;5.511362592544963e-05
33236;能买到那个a100？;2;0;2;54433;3.674241728363309e-05
33240;很有创意;1;0;1;54433;1.8371208641816546e-05
33243;翻译准点。;1;1;2;54433;3.674241728363309e-05
33246;学过技术开发的大概都懂;1;0;1;54433;1.8371208641816546e-05
33249;训练集的事儿，文字英翻中了而已，自然没有成语;1;4;5;54433;9.185604320908272e-05
33252;百度至少这次走在了bat的头部;1;0;1;54433;1.8371208641816546e-05
33255;百度的基础语言指令是英文的;2;0;2;54433;3.674241728363309e-05
33258;有人说是百度申请了一堆账号调用国外的接口封装的，我争了半天最后被喷下阵来;10;18;28;54433;0.0005143938419708633
33269;百度这次甚至连百度翻译的问题都暴露了;2;23;25;54433;0.0004592802160454136
33272;这要拆解个毛，自己都承认了用的是国外一个开源的画图程序建议多看看真实的新闻;2;13;15;54433;0.0002755681296272482
33275;之所以百度是第二个，是因为别的大公司没这么不要脸;3;2;5;54433;9.185604320908272e-05
33279;输入的是中文，为什么要翻译成英文来识别？;5;0;5;54433;9.185604320908272e-05
33285;百度自己官方都发文了，用的是国外的开源资料再加以优化你还在给他狡辩;2;4;6;54433;0.00011022725185089927
33288;小度开发很多年了都一直是个智障，OpenAI开放API没几天，它突然出产品了，这训练是不是点快还有号称训练了最多中文资源，既然中文都吹第一了，英文训练只是过渡，为何频繁出现中文先翻译成英文再画的欧美风格图片？还有爱国猫咪为何用的是美国？国旗可是非常严重的政治观念，百度不知道？目前的解释没一个能服从的;4;1;5;54433;9.185604320908272e-05
33293;自己研发的技术，为啥要拆分，翻译出结果？如果说引用别公司技术是业内正常的，那么，百度在这里面到底有啥自己的核心技术？还是说只是把人家的软件借来，然后在和翻译器拼接到一块？;7;0;7;54433;0.00012859846049271582
33301;文心一言就算是比GPT好比他牛逼，我们也不用，百度啥尿性我们见识过，烦的不是国产AI烦的是百度;1;5;6;54433;0.00011022725185089927
33303;收钱了吧？拉黑了，可恶;1;15;16;54433;0.00029393933826906473
33305;什么就自己的模型，模型都是公开的;4;0;4;54433;7.348483456726618e-05
33310;那为什么不把中文翻译对呢？中文不配吗？大概率还是开源引擎对中文支持不好，如果是自研引擎一开始就会考虑中文问题，别硬洗了;2;1;3;54433;5.511362592544963e-05
33313;那么问题来了，为什么自研的不胸有成竹说出真相，反而是封禁关键词，要你来澄清，他们官方的回答也不痛不痒，很难不让人联想;8;0;8;54433;0.00014696966913453236
33323;之前只要有国旗，爱国等词汇都会出现米国的风格。;1;1;2;54433;3.674241728363309e-05
33403;百度号称最懂中文，但是他竟然一点中文数据都没积累，完全不懂中文。;1;0;1;54433;1.8371208641816546e-05
33405;百度不是自己承认了他们调用了OpenAI的四个绘画接口吗？说是自己不用造轮胎用别人的轮胎能跑就行;1;0;1;54433;1.8371208641816546e-05
33407;大哥，百度都自己承认了。。你没看新闻吧，可笑;2;0;2;54433;3.674241728363309e-05
33410;国外的公开源码国外的模型，百度的皮肤;1;0;1;54433;1.8371208641816546e-05
33413;屁继续洗，表格这么简单的词你没有中文训练素材吗？结果变成桌子;1;0;1;54433;1.8371208641816546e-05
33415;李彦宏就是来搞笑的;1;0;1;54433;1.8371208641816546e-05
33417;高科技垃圾;1;0;1;54433;1.8371208641816546e-05
33419;只能说这些年百度一直在装逼立flag，对外号称最近十年专注于人工智能和自动驾驶，现在要拿出成果了，立马就露馅儿了;1;0;1;54433;1.8371208641816546e-05
33427;没必要嘲笑百度，他们起码还敢应战此外，还有谁？还有谁？;132;350;482;54433;0.008854922565355574
33560;人工智能和人工智障的区别;7;1031;1038;54433;0.019069314570205574
33569;你肯定是在文心工作人员下班后问的;27;1656;1683;54433;0.030918744144177245
33597;文心一言主要难度在于如何过滤敏感问题;11;133;144;54433;0.0026454540444215825
33609;在这里冷嘲热讽的人啊你的心在哪里;1;1;2;54433;3.674241728363309e-05
33611;一个是人一个是草履虫;9;405;414;54433;0.00760568037771205
33621;哈哈哈，绝对的国之重器;1;179;180;54433;0.0033068175555269782
33623;莫慌，只要一开源嘿嘿立马安排弯道超车;18;72;90;54433;0.0016534087777634891
33643;文心可以弯道超车;40;133;173;54433;0.0031782190950342625
33684;总有个过程;15;14;29;54433;0.0005327650506126798
33700;0;41;149;190;54433;0.0034905296419451438
33743;你的评论真的明显看出诋毁百度了，没有文化自信，虽然任重道远，但我相信以后一定会变好的，至少差距在缩小;23;6;29;54433;0.0005327650506126798
33767;根据相关法律法规，该问题不予回答。;1;57;58;54433;0.0010655301012253596
33769;难道不是40岁吗？;26;8;34;54433;0.0006246210938217625
33796;我用的GPT怎么跟我回答的是40岁;4;1;5;54433;9.185604320908272e-05
33861;0;2;9;11;54433;0.000202083295059982
33900;hi挺好的;6;11;17;54433;0.00031231054691088127
33918;怎么下载;1;0;1;54433;1.8371208641816546e-05
33941;文心可以搞个电动的，弯道超车;3;4;7;54433;0.00012859846049271582
33945;0;1;12;13;54433;0.00023882571234361508
33947;百度加油，努力改进。请你们尊重干实事的人;1;0;1;54433;1.8371208641816546e-05
33949;0;2;6;8;54433;0.00014696966913453236
33953;文心刚出来，学习不够，过段时间再看;1;1;2;54433;3.674241728363309e-05
33968;你想要表达什么？;1;0;1;54433;1.8371208641816546e-05
33984;我提的问题文心都不敢回答;3;3;6;54433;0.00011022725185089927
33998;不管别人怎么样，反正我们就是优秀;1;2;3;54433;5.511362592544963e-05
34047;中文的和美国版的回答会不同吗;1;0;1;54433;1.8371208641816546e-05
34054;自主研发弯道超车打破封锁大国自信;2;30;32;54433;0.0005878786765381295
34069;别乱喷了，测试结果并不差。大家不久会看到;1;0;1;54433;1.8371208641816546e-05
34076;文心一言也会进化，不断演进;1;1;2;54433;3.674241728363309e-05
34080;一比较一个是笑话;9;1;10;54433;0.00018371208641816545
34098;理科生和文科生;1;1;2;54433;3.674241728363309e-05
34105;文心一言实测效果超预期啪啪啪打脸喷子们昨天那些冷嘲热讽的人不说话了不得不说，百度要起飞;21;48;69;54433;0.0012676133962853417
34128;请叫我的全名达文西好的，文西;1;5;6;54433;0.00011022725185089927
34133;跌10是有原因的;4;6;10;54433;0.00018371208641816545
34139;文心应该是满嘴谎言;3;21;24;54433;0.00044090900740359707
34143;有没有可能10年后真是大40岁;4;5;9;54433;0.0001653408777763489
34150;百度遗言;2;0;2;54433;3.674241728363309e-05
34153;文心当之无愧的国之AI;2;26;28;54433;0.0005143938419708633
34158;我创建抖音群了，欢迎各位;2;2;4;54433;7.348483456726618e-05
34167;止;1;0;1;54433;1.8371208641816546e-05
34170;总有人不希望中国高有高科技方面的进步;16;2;18;54433;0.0003306817555526978
34204;Laotieniubi666;1;1;2;54433;3.674241728363309e-05
34212;很显然百度又赢麻了麻了;1;118;119;54433;0.002186173828376169
34214;0;4;42;46;54433;0.000845075597523561
34219;你说人情世故的回答你为什么不放出来让我们看看不同答案呢？还有文心一言的答案为什么有马赛克？;6;1;7;54433;0.00012859846049271582
34227;我想问问如何评价魏则西;3;2;5;54433;9.185604320908272e-05
34238;接着带节奏吧，儿子在不好也是亲生的好。;1;0;1;54433;1.8371208641816546e-05
34240;是不是你用脑筋急转弯来评价一个软件好不好？;1;0;1;54433;1.8371208641816546e-05
34248;笑死，你怕是不知道chatgpt刚出来也是说大40岁，发现后，后面别人给它修改对了;1;0;1;54433;1.8371208641816546e-05
34406;AI会不会和A开战？;1;0;1;54433;1.8371208641816546e-05
34409;0;1;0;1;54433;1.8371208641816546e-05
34426;是在黑你们老板么？百度搜索百度;1;0;1;54433;1.8371208641816546e-05
34439;谁差谁，是不是说反了;1;0;1;54433;1.8371208641816546e-05
34460;牛奶泡大的小强莫明奇妙地戳中了我的笑点;1;0;1;54433;1.8371208641816546e-05
34462;问下支付宝法人;2;0;2;54433;3.674241728363309e-05
34470;要说中国科技赛道的C位还得是百度;12;45;57;54433;0.0010471588925835432
34483;好好做自动驾驶，这是正道;16;15;31;54433;0.0005695074678963129
34501;问心一言投入能有10个亿吗;14;34;48;54433;0.0008818180148071941
34516;有没有感觉李总的脸皮是真厚;9;37;46;54433;0.000845075597523561
34527;至少百度让产品在国内实现落地了，这就是好事;4;39;43;54433;0.0007899619715981115
34532;希望文心一言能够在长期的使用上积累算法和熟练度，然后一次次迭代成更好的产品;1;31;32;54433;0.0005878786765381295
34534;一千亿你猜大家信不;11;1;12;54433;0.00022045450370179853
34549;四层框架每一层都有每一层都不精;1;12;13;54433;0.00023882571234361508
34551;我还是支持国产，因为这类产品一旦被国外垄断，那是非常可怕的，你可能比战争还恐怖，这种ai是会被用于潜移默化的思想引导和控制。;7;3;10;54433;0.00018371208641816545
34559;看了对百度更没信心了;4;5;9;54433;0.0001653408777763489
34564;好好和莆田医院搞好关系吧，那才是你的正道;4;6;10;54433;0.00018371208641816545
34569;说实话，这些大厂内，各有各的恶。但是有技术理想的，也就李了。;1;9;10;54433;0.00018371208641816545
34571;不知道哪些冤大头公司接入了文心一言;5;2;7;54433;0.00012859846049271582
34577;百度比全世界很多公司，还是领先的，这还不够吗？他是我们中国的公司，;2;1;3;54433;5.511362592544963e-05
34595;李彦宏被低估了，李彦宏被高估了。;1;2;3;54433;5.511362592544963e-05
34608;李彦宏应该是企业家颜值top了;1;6;7;54433;0.00012859846049271582
34612;大白兔奶糖金城街金城武李彦宏真帅;1;1;2;54433;3.674241728363309e-05
34627;问的还是太客气了都是一团和气;1;1;2;54433;3.674241728363309e-05
34631;grox;2;0;2;54433;3.674241728363309e-05
34634;吃瓜群众;1;0;1;54433;1.8371208641816546e-05
34638;国内真没创新力。人家不开源卡脖子，开源后自主创新，遥遥领先。;4;2;6;54433;0.00011022725185089927
34643;请画一只爱国的猫;1;5;6;54433;0.00011022725185089927
34645;就是调用别人的接口;3;0;3;54433;5.511362592544963e-05
34649;其实我最想问文心一言作为中国产品为啥在输入时会先翻译成英文然后进行理解处理，然后输出内容再翻译成中文;1;1;2;54433;3.674241728363309e-05
34652;应该问为什么百度搜索搜出来一堆广告;2;0;2;54433;3.674241728363309e-05
34655;AI肯定会各行各业发展很大，代替很多，只是国内不让用，所以后面会更多规避城墙用。留给百度时间很少了。百度没有办法更新很快，无论从硬件和软件或者是运行环境，尤其是运行环境，国内太多限制。;1;1;2;54433;3.674241728363309e-05
34684;我们有这么多人口基数，开放起来让大家训练他呗，十来亿网民都是你的资源，等chatGPT打进来你这个唯一的优势就晚了吧;1;0;1;54433;1.8371208641816546e-05
34697;太僵硬了李总;1;0;1;54433;1.8371208641816546e-05
34704;和当年无人车一样，一开始肯定不够成熟，现在百度的无人驾驶技术是做的最好的了;1;17;18;54433;0.0003306817555526978
34747;红烧狮子头;197;2845;3042;54433;0.05588521668840593
34945;你就说撅没撅吧;61;294;355;54433;0.006521779067844874
35007;把openai的的接口说成自研666;1;0;1;54433;1.8371208641816546e-05
35009;可乐鸡翅;117;1438;1555;54433;0.028567229438024727
35127;解释一下;121;1303;1424;54433;0.02616060110594676
35250;唐伯虎点秋香;31;427;458;54433;0.008414013557951978
35282;0;37;22;59;54433;0.0010839013098671762
35320;0;9;76;85;54433;0.0015615527345544064
35330;鱼香肉丝火鸡;25;70;95;54433;0.0017452648209725719
35356;翻译成英文生成图片吧，从图片看文心一言根本不懂中文啊;13;67;80;54433;0.0014696966913453236
35370;为什么没有中国风，满满的西方风格？;34;88;122;54433;0.0022412874543016187
35405;生意很火爆;3;54;57;54433;0.0010471588925835432
35409;看看我的车水马龙;6;155;161;54433;0.0029577645913324638
35416;你这个万箭齐发，为什么是精灵？;3;1;4;54433;7.348483456726618e-05
35422;重光没一个都是相当炸裂;1;0;1;54433;1.8371208641816546e-05
35459;江看评论;1;0;1;54433;1.8371208641816546e-05
35477;为什么画的都是西方风格;9;15;24;54433;0.00044090900740359707
35499;8160看评论;3;0;3;54433;5.511362592544963e-05
35510;有你爱的音乐及时行乐初阳评论区，哈哈哈哈哈;1;0;1;54433;1.8371208641816546e-05
35517;为什么全是外国元素？;2;8;10;54433;0.00018371208641816545
35535;不是，怎么还自己黑自己呢;1;11;12;54433;0.00022045450370179853
35540;爱国;2;57;59;54433;0.0010839013098671762
35543;睡觉时不困辣鸡;3;1;4;54433;7.348483456726618e-05
35548;还是猛虎下山图有意思;1;0;1;54433;1.8371208641816546e-05
35551;车水马龙;2;3;5;54433;9.185604320908272e-05
35560;这个呢？;5;6;11;54433;0.000202083295059982
35566;都是国外风格呀;1;10;11;54433;0.000202083295059982
35576;绘画到底是不是套壳的？是不是先翻译成英文再用国外AI绘图后才返回生成图片？鼠标、总线、起重机这么离谱到底怎么回事？;1;5;6;54433;0.00011022725185089927
35586;这已经是国内ai技术天花板了;1;0;1;54433;1.8371208641816546e-05
35589;不睡我不睡哈哈哈;1;1;2;54433;3.674241728363309e-05
35597;文心一言是不是阅读了太多的西方资讯，中国成语，画出的东西怎么都是浓浓的西方元素？;1;0;1;54433;1.8371208641816546e-05
35603;百度起码第一个出来对线。承认差距就行。不用冷嘲热讽他;1;0;1;54433;1.8371208641816546e-05
35606;如果诸葛亮去借箭的时候曹操用的是火箭的话那就不一样了火箭是之前带着火的弓箭;3;0;3;54433;5.511362592544963e-05
35610;说吧，开会员要多少钱一个月;1;6;7;54433;0.00012859846049271582
35615;文心一言，简直是东施效颦;9;42;51;54433;0.0009369316407326438
35628;酒古碇刀铁索连环杀;1;0;1;54433;1.8371208641816546e-05
35630;林中自由风好家伙;2;0;2;54433;3.674241728363309e-05
35634;都是西洋古画风格;1;3;4;54433;7.348483456726618e-05
35646;猛割贪嘴的那半拉舌头鹿橘草船借箭画的，草是草，船是船，箭是箭的;3;1;4;54433;7.348483456726618e-05
35668;三国杀里没有草船借箭吧？只有万箭齐发，南蛮入侵，克复中原，固国安邦，文和乱舞。只有这几个吧;2;0;2;54433;3.674241728363309e-05
35671;已经是国内AI天花板了;2;17;19;54433;0.00034905296419451436
35683;无所谓，我会出手真草船借箭;1;1;2;54433;3.674241728363309e-05
35693;汉语的隐喻，借喻是AI最难理解的内容;2;14;16;54433;0.00029393933826906473
35696;感觉不如松鼠鳜鱼序棣景松月是只猫大貓;1;3;4;54433;7.348483456726618e-05
35704;Blue（失眠版）看评论区里好荒谬;1;2;3;54433;5.511362592544963e-05
35712;其实还可以，但是要注意问法，不然它只会按文字画图;1;0;1;54433;1.8371208641816546e-05
35723;它是一个字一个字的拆开硬画根本不理解这个词语是什么意思;1;17;18;54433;0.0003306817555526978
35728;多喝热水吧是楠楠啊来看评论;1;1;2;54433;3.674241728363309e-05
35737;北京烤鸭;5;52;57;54433;0.0010471588925835432
35746;夫妻肺片画出来是啥样;1;4;5;54433;9.185604320908272e-05
35749;Y笑死ai;1;0;1;54433;1.8371208641816546e-05
35755;0;1;24;25;54433;0.0004592802160454136
35758;中文本来就是内涵非常丰富的语言，所以文心一言也是翻译成英文。不知道是否有人居心否测的冷嘲热讽。;3;3;6;54433;0.00011022725185089927
35762;文心一言缺乏更深度的训练。需要要用更多数据去喂去调教。最重要的是一定要它拥有学习能力让它逻辑更合理回复内容更准确。千万别被那些网络喷子影响到。他们这些嘴碎的喷子并不能对百度的技术做出什么贡献。;1;4;5;54433;9.185604320908272e-05
35764;0;1;12;13;54433;0.00023882571234361508
35766;欠欠这我也要发一张了;7;13;20;54433;0.0003674241728363309
35775;的确有差距但是文心一言结合了chatgpt和midjourney也算一个小突破，再接再厉吧。;3;4;7;54433;0.00012859846049271582
35780;驴肉火烧;2;44;46;54433;0.000845075597523561
35785;感觉还挺有意思，万一优化可惜了;21;18;39;54433;0.0007164771370308453
35807;0;18;66;84;54433;0.0015431815259125898
35827;排队好几天啦，到底排我前面有多少人，给个说法啊;1;11;12;54433;0.00022045450370179853
35829;哈哈哈这画风真厉害啊好有上个世纪劣质网游的画风;1;133;134;54433;0.002461741958003417
35831;这个还可以吧;11;201;212;54433;0.0038946962320651076
35856;混子协会会长;1;1;2;54433;3.674241728363309e-05
35868;第一次见自己黑自己的;1;45;46;54433;0.000845075597523561
35876;小清风从不摸鱼开始hhhhhc36岁离异考研带俩娃小先生llLHopital;1;0;1;54433;1.8371208641816546e-05
35879;大强花;1;0;1;54433;1.8371208641816546e-05
35884;不是，哥们你网暴自己是吧;3;78;81;54433;0.0014880678999871402
35888;我是名字;3;0;3;54433;5.511362592544963e-05
35915;Pepsi;1;0;1;54433;1.8371208641816546e-05
35917;瓜皮评论;1;0;1;54433;1.8371208641816546e-05
35919;Beauty。评论区笑死我了;1;0;1;54433;1.8371208641816546e-05
35921;小软我来了评论区笑死我了;1;0;1;54433;1.8371208641816546e-05
35923;；哈哈哈哈;1;0;1;54433;1.8371208641816546e-05
35925;媛看评论笑的;1;0;1;54433;1.8371208641816546e-05
35927;这种国产垃圾还好意思拿出来？？狗屁百度除了能打广告还能干嘛？;1;0;1;54433;1.8371208641816546e-05
35929;Rick蝉的夏天这百度自己真不是来反串的？？;1;0;1;54433;1.8371208641816546e-05
36091;甜甜花来看;1;0;1;54433;1.8371208641816546e-05
36099;怎么敢接都是偏西方的油画感觉？;2;0;2;54433;3.674241728363309e-05
36106;李萌萌人家人工智能这特么纯纯人工智障;1;0;1;54433;1.8371208641816546e-05
36133;等两分钟评论区;2;0;2;54433;3.674241728363309e-05
36139;看评论霸天国国王;1;0;1;54433;1.8371208641816546e-05
36154;喜嘻;1;0;1;54433;1.8371208641816546e-05
36170;ZuzuTutu;3;0;3;54433;5.511362592544963e-05
36177;幻想症突然就学会绘画了，这玩意的端口适配得还挺快;1;0;1;54433;1.8371208641816546e-05
36181;WU丶;1;0;1;54433;1.8371208641816546e-05
36186;一凌一悦快看评论区;1;0;1;54433;1.8371208641816546e-05
36208;日本风有点浓;1;0;1;54433;1.8371208641816546e-05
36210;支持;1;0;1;54433;1.8371208641816546e-05
36226;凉茉这是怎么回事;1;0;1;54433;1.8371208641816546e-05
36237;好好吃饭好好睡觉好好生活;1;0;1;54433;1.8371208641816546e-05
36249;现在能用吗;6;0;6;54433;0.00011022725185089927
36257;这真是人工智能啊;1;0;1;54433;1.8371208641816546e-05
36290;好好做优化，别天天拿着家丑乐呵。;1;0;1;54433;1.8371208641816546e-05
36298;这个“逼班”我也上够了;26;1555;1581;54433;0.02904488086271196
36325;这段时间不是云南的泼水节，就是淄博烧烤，现在又来个潍坊的风筝节，个人建议取消这些项目，毕竟我一直在上班;10;654;664;54433;0.012198482538166185
36337;为什么会有人放“阎王爷”这个风筝？？;11;105;116;54433;0.002131060202450719
36351;把我放上天给大家助助兴;1;24;25;54433;0.0004592802160454136
36353;云南的泼水节刚结束，这淮坊又是风筝节，山西有啥节呀;1;16;17;54433;0.00031231054691088127
36358;申请文心一言了，为什么不给通过呀;1;3;4;54433;7.348483456726618e-05
36360;我的申请什么时候通过;1;2;3;54433;5.511362592544963e-05
36370;决定了，先在潍坊放风筝，然后再去淄博吃烧烤大碗;1;0;1;54433;1.8371208641816546e-05
36383;wsygdsg流星枳这个学我也上够了;1;1;2;54433;3.674241728363309e-05
36386;神不会被爱等你没了我给你烧一个;1;1;2;54433;3.674241728363309e-05
36389;饼干子呀，我咋不知道呢;1;0;1;54433;1.8371208641816546e-05
36391;小律我要放个b学读够了;1;1;2;54433;3.674241728363309e-05
36393;Wrsen1你猜猜我要放什么;2;1;3;54433;5.511362592544963e-05
36397;落我也想搞一个;1;0;1;54433;1.8371208641816546e-05
36404;我想做一个百度logo风筝算不算侵权;1;19;20;54433;0.0003674241728363309
36415;i磊磊磊;1;0;1;54433;1.8371208641816546e-05
36417;玖熙;1;0;1;54433;1.8371208641816546e-05
36422;Ohio饿了就吃不饿也吃DigvfnAAA狗狗事务所小汪（创业版）做个好梦赛罗去了魔法城堡;2;3;5;54433;9.185604320908272e-05
36425;蜡笔A梦甜荔只橘紫栤走;2;2;4;54433;7.348483456726618e-05
36428;用户8762340334294;4;0;4;54433;7.348483456726618e-05
36433;零;2;1;3;54433;5.511362592544963e-05
36436;Joulan九岚安荔枝味椰冻Lizzy瑶瑶看抖音瑞卡woawesome;1;2;3;54433;5.511362592544963e-05
36439;105白敬亭前女友Mkittle秋陳肆;1;1;2;54433;3.674241728363309e-05
36441;王翠杰;1;1;2;54433;3.674241728363309e-05
36443;哈哈哈哈弄啥子;2;0;2;54433;3.674241728363309e-05
36465;猫羽雫;1;0;1;54433;1.8371208641816546e-05
36467;筱;1;0;1;54433;1.8371208641816546e-05
36469;阳阁;1;0;1;54433;1.8371208641816546e-05
36471;祈冬止;1;0;1;54433;1.8371208641816546e-05
36473;是秃子终会发光;1;0;1;54433;1.8371208641816546e-05
36476;倪迦;1;0;1;54433;1.8371208641816546e-05
36478;凡宝同学;1;0;1;54433;1.8371208641816546e-05
36480;养机;1;0;1;54433;1.8371208641816546e-05
36482;长安一杯酒;1;0;1;54433;1.8371208641816546e-05
36484;Agoin55蘇哇;1;0;1;54433;1.8371208641816546e-05
36486;小唸哈哈哈哈哈哈哈哈;1;0;1;54433;1.8371208641816546e-05
36488;白瑾妈呀;1;0;1;54433;1.8371208641816546e-05
36491;咩咩Ya？？？;1;0;1;54433;1.8371208641816546e-05
36542;我记得之前有一个把菩萨放天上的，我还以为显灵了呢;1;0;1;54433;1.8371208641816546e-05
36551;哈哈哈，这不是他们的常用操作吗;18;1164;1182;54433;0.021714768614627157
36570;“国内最顶尖的it公司”;11;392;403;54433;0.007403597082652068
36582;给Ai一点时间，因为它也需要学习;6;1;7;54433;0.00012859846049271582
36589;想象一下夫妻肺片会有多恐怖;21;533;554;54433;0.010177649587566366
36611;李彦宏：知道文心一言发布会为什么是录播了吧。;2;148;150;54433;0.0027556812962724817
36614;有没有可能他的聊天功能，就是用了gpt的api而已;4;3;7;54433;0.00012859846049271582
36620;就是中文翻译加开源的stablediffution;14;207;221;54433;0.004060037109841456
36635;用了别人的开源库，然后自己训练;8;159;167;54433;0.003067991843183363
36644;说明谷歌翻译仍需努力呀;7;89;96;54433;0.0017636360296143883
36652;AI如果真的这么好做他们应该早发出来了;2;81;83;54433;0.0015248103172707732
36655;完了完了，这下露馅了吧;1;68;69;54433;0.0012676133962853417
36658;运作逻辑就是输入中文翻译成英文依照英文单词画图画完图再翻译成中文;2;101;103;54433;0.0018922344901071042
36662;画图模型目前都是国外做的。咱们还需要更全面的开源和应用;1;51;52;54433;0.0009553028493744603
36667;中国有啥独创的科技吗;1;1;2;54433;3.674241728363309e-05
36670;百度还是那个百度。期待华为;1;0;1;54433;1.8371208641816546e-05
36698;看来翻译这功能也得用别人的;1;2;3;54433;5.511362592544963e-05
36709;模型数据库太小;2;1;3;54433;5.511362592544963e-05
36716;早有布局遥遥领先;2;3;5;54433;9.185604320908272e-05
36735;百度是一家翻译公司;1;1;2;54433;3.674241728363309e-05
36745;0;1;1;2;54433;3.674241728363309e-05
36750;翻译一下，直接盗用美国的;1;8;9;54433;0.0001653408777763489
36753;比腾讯游戏还厉害;1;1;2;54433;3.674241728363309e-05
36766;所以他为什么要推出这个功能;3;1;4;54433;7.348483456726618e-05
36773;大家都不知道中文分词在程序里多难处理;1;1;2;54433;3.674241728363309e-05
36782;PPT公司能做成这样已经不错了，大家理解;1;1;2;54433;3.674241728363309e-05
36790;是翻译的问题，不是AI的问题。;1;1;2;54433;3.674241728363309e-05
36793;好像已经被人测试出来是把中文翻译成英文然后直接调用国外的接口给做的，之所以驴唇不对马嘴就是翻译的问题;4;17;21;54433;0.00038579538147814744
36798;百毒之前致人死亡的叫什么来着，我发现居然在网上没找到？;3;4;7;54433;0.00012859846049271582
36805;国外一开源，国内就遥遥领先;1;6;7;54433;0.00012859846049271582
36818;这不是鸿蒙么;2;1;3;54433;5.511362592544963e-05
36824;一个广西人跟一个假冒广西人的老外聊螺蛳粉，说不定他就给你说螺丝磨成的铁沫子;1;14;15;54433;0.0002755681296272482
36831;0;1;1;2;54433;3.674241728363309e-05
36838;支持百度搞自己的文心一言，不管开源不开源，可以不如人家，但是不能没有。;1;1;2;54433;3.674241728363309e-05
36844;果然一开源就牢牢领先;1;6;7;54433;0.00012859846049271582
36861;你学费了吗云淡风轻;1;1;2;54433;3.674241728363309e-05
36864;吾有一计，可否让他画一个丑陋的犹太人;1;2;3;54433;5.511362592544963e-05
36867;0;1;4;5;54433;9.185604320908272e-05
36872;0;43;195;238;54433;0.004372347656752338
36916;作为一个中国人感觉太丢人了;3;8;11;54433;0.000202083295059982
36930;As登倒悬山bu不吃香菜廢IndexXuan我理解了;1;2;3;54433;5.511362592544963e-05
36938;酱香科技;1;2;3;54433;5.511362592544963e-05
36955;哈哈遥遥领先，弯道超车;1;33;34;54433;0.0006246210938217625
36980;自主研发弯道超车遥遥领先;1;1;2;54433;3.674241728363309e-05
36986;一开源就遥遥领先一卡脖就翻白眼;1;6;7;54433;0.00012859846049271582
36991;鸿蒙系统和芯片打磨技术觉得很赞;4;21;25;54433;0.0004592802160454136
37005;总之一句话的这块地上有没有科技;142;642;784;54433;0.014403027575184172
37148;想画的好，就把prompt搞好点，造谣成本越来越低了;4;2;6;54433;0.00011022725185089927
37154;chatgpt是理解不了中国文化的，在中国智慧面前人工智能只能算个弱智;2;2;4;54433;7.348483456726618e-05
37157;优良传统，第二张图在回复里。;2;0;2;54433;3.674241728363309e-05
37223;爱国猫披美国国旗;1;0;1;54433;1.8371208641816546e-05
37318;任何新产品发布，难免需要人工保障技术或服务，先祝福百度。;11;9;20;54433;0.0003674241728363309
37330;“文心一言”这名字听着一言难尽;18;112;130;54433;0.002388257123436151
37349;这两个企业是一个次元的吗;7;40;47;54433;0.0008634468061653776
37358;下次遍故事记得p个好点的聊天记录;4;24;28;54433;0.0005143938419708633
37364;认怂不就行了;1;1;2;54433;3.674241728363309e-05
37366;GPT是怎么工作的？谁又知道呢？;5;1;6;54433;0.00011022725185089927
37372;这人工智能一上线，又增加了好多的岗位。遥遥领先;3;4;7;54433;0.00012859846049271582
37376;最起码百度还敢于发布产品，这也就是所谓的亮剑吧不管好不好国产的大家也鼓励一下;5;1;6;54433;0.00011022725185089927
37382;百度再差也是自己的，没必要尬黑。;5;0;5;54433;9.185604320908272e-05
37388;我掉了一根头发，百度一查让我准备后事了;2;3;5;54433;9.185604320908272e-05
37392;那后台人工可以帮我写论文吗？;2;1;3;54433;5.511362592544963e-05
37395;文心一言的智商稳定在百度员工平均智商附近;1;3;4;54433;7.348483456726618e-05
37397;谁能保证GPT没有人工回复。。;3;0;3;54433;5.511362592544963e-05
37401;人家这演示就是录播不是直播;3;0;3;54433;5.511362592544963e-05
37405;直接嵌入4完事，所以问题由4回答再转发回来，;2;0;2;54433;3.674241728363309e-05
37415;呵呵呵呵。。要是能赢，那就;1;0;1;54433;1.8371208641816546e-05
37446;就那些敏感词汇，就够人工智能吃一壶的。;1;1;2;54433;3.674241728363309e-05
37461;财富股价都拉下去了;1;0;1;54433;1.8371208641816546e-05
37478;跟演唱会假唱一个道理;1;0;1;54433;1.8371208641816546e-05
37480;这玩意面试面临这N多人失业，本来在国外发布国内还会考虑安全性的问题，真在中国建立生态成功了。这玩意绝对要比人工便宜，到时候程序员砍一半不是啥问题，中级计算、统计之类的工作行业，也会大面积失业。就是说互联网可真卷，直接卷死各类同行，本来就过了个冬这是想在来个冰封纪元。;2;1;3;54433;5.511362592544963e-05
37486;最终发布了吗;1;0;1;54433;1.8371208641816546e-05
37498;我们玩的是1到100而不是0到1;1;0;1;54433;1.8371208641816546e-05
37502;gpt背后不一定有印度人，文心背后真有国人;1;2;3;54433;5.511362592544963e-05
37504;人工vs智能;1;0;1;54433;1.8371208641816546e-05
37511;怎么弄这个软件;1;0;1;54433;1.8371208641816546e-05
37514;赶鸭子上架吧;1;0;1;54433;1.8371208641816546e-05
37516;我问他吃了吗，它会用京腔回答？;1;0;1;54433;1.8371208641816546e-05
37524;百度还差着远呢;1;1;2;54433;3.674241728363309e-05
37528;没必要踩，不管他发布的是一言还是两言，只要后期能维护更新就行;1;1;2;54433;3.674241728363309e-05
37537;股价跌了7;1;3;4;54433;7.348483456726618e-05
37546;百度永远不可能达到GPT的水平，因为我们有绿坝，导致智能运算资源太少。;1;0;1;54433;1.8371208641816546e-05
37551;“一言难尽”;1;0;1;54433;1.8371208641816546e-05
37553;一分人工，一分智能;1;0;1;54433;1.8371208641816546e-05
37555;百度真实自己安乐死的;1;1;2;54433;3.674241728363309e-05
37558;究竟是不是“人工”智能？一起试试吧;1;5;6;54433;0.00011022725185089927
37572;人工智能外国注重智能我们注重人工;1;0;1;54433;1.8371208641816546e-05
37574;哈哈哈百度洗洗睡吧;1;1;2;54433;3.674241728363309e-05
37576;不爱请别伤害你行你上呀;9;4;13;54433;0.00023882571234361508
37587;百度也配？;1;3;4;54433;7.348483456726618e-05
37589;这不就是说不行了，人上？;1;1;2;54433;3.674241728363309e-05
37592;你就说智能不智能就完了;1;0;1;54433;1.8371208641816546e-05
37683;垃圾炒的那么高，潮水一退才知道谁在裸泳;1;0;1;54433;1.8371208641816546e-05
37700;行业惯例，遥遥领先;29;1594;1623;54433;0.029816471625668254
37730;江湖郎中搞科技笑死我了;10;727;737;54433;0.013539580769018794
37742;自研国外一出现，国内就拥有，国外一开源，国内就自研;28;347;375;54433;0.006889203240681204
37771;开卷考试不及格;1;1;2;54433;3.674241728363309e-05
37773;一开源就遥遥领先，一必源就亡我之心不死;2;207;209;54433;0.003839582606139658
37776;就是翻译stablediffusion，太明显了;2;220;222;54433;0.004078408318483273
37779;套壳;7;119;126;54433;0.0023147722888688846
37787;还有总线，直接画了个公交车出来因为英文是BUS;6;104;110;54433;0.00202083295059982
37794;问它出一张总线图最后出来一辆公交车这就是先翻译英文再查询明显套壳与鸿蒙一样;21;17;38;54433;0.0006981059283890287
37816;自主自研套壳;1;103;104;54433;0.0019106056987489206
37819;还有它分不清楚鹤跟起重机的区别，可能是老外吧;2;59;61;54433;0.0011206437271508093
37822;百度都说了，完全自研，使用全球互联网公开数据，划重点，公开数据;6;35;41;54433;0.0007532195543144784
37829;跟鸿蒙一样;2;50;52;54433;0.0009553028493744603
37854;大国崛起感恩祖国;3;8;11;54433;0.000202083295059982
37883;哈哈哈，不用怀疑，我呆过的科技公司，大部分的工作就是抄，美其名曰竞品分析;1;8;9;54433;0.0001653408777763489
37893;听说他收费了，真的假的？;2;1;3;54433;5.511362592544963e-05
37902;上海徐汇中学，一女生进男浴室偷拍18名男生被抓，女老师却劝男生大度一点怒斥男生小心眼;1;0;1;54433;1.8371208641816546e-05
37904;不可否认的一个事实就是，我们缺乏创造力，明明是模仿，却非要说是创新;2;7;9;54433;0.0001653408777763489
37910;李彦宏：文心一言更了解中文，洛阳纸贵;2;5;7;54433;0.00012859846049271582
37926;Hhhh，这届网友不好糊弄不好带了呀;1;9;10;54433;0.00018371208641816545
37936;每日一问：百毒什么时候倒闭;4;8;12;54433;0.00022045450370179853
37942;还一个举头望明月，笑死我了;2;0;2;54433;3.674241728363309e-05
37958;让文心一言画一个夫妻肺片;1;1;2;54433;3.674241728363309e-05
37965;鸿蒙都是百分百自研;2;2;4;54433;7.348483456726618e-05
37968;这东西就是看数据库，离我们认为的人工智能差的远呢;1;0;1;54433;1.8371208641816546e-05
37976;其他的我豆可以洗请问这个怎么洗;2;6;8;54433;0.00014696966913453236
37981;只要说不传谣，不信谣，就可以实锤了;1;49;50;54433;0.0009185604320908272
37988;画个车水马龙形容人多。画的结果会不会有车有水有马有龙。;3;3;6;54433;0.00011022725185089927
37992;不错了，起码不是广告。;1;0;1;54433;1.8371208641816546e-05
37998;这些生成的图说明这些肯定不是gpt套壳，因为gpt不可能出现这么简单的错误;2;1;3;54433;5.511362592544963e-05
38012;数据用的国外的，程序架构差不多，会得出一些相似的模型，基于这模型，前面加点翻译，这本来是最快的做法，然而你们还觉得烂。真是一堆大聪明用户。;4;0;4;54433;7.348483456726618e-05
38032;一下子暴露了两个问题，翻译不行，套壳骗人;1;25;26;54433;0.00047765142468723015
38038;百度的文化是搞钱，不是搞技术;2;11;13;54433;0.00023882571234361508
38041;当我发现他不带广告的时候我就了解了真相;2;9;11;54433;0.000202083295059982
38060;搞半天原来是中介;1;7;8;54433;0.00014696966913453236
38066;为了和谷歌对标，项目上马太急了;1;0;1;54433;1.8371208641816546e-05
38071;0;1;2;3;54433;5.511362592544963e-05
38076;请问可以在文心一言的回答中植入医院广告吗;3;2;5;54433;9.185604320908272e-05
38085;你就说是不是独家技术;3;14;17;54433;0.00031231054691088127
38089;闹半天是中间商啊;1;8;9;54433;0.0001653408777763489
38092;遥遥领先遥遥领先遥遥领先遥遥领先;1;8;9;54433;0.0001653408777763489
38094;原来这就是早就布局啊;1;7;8;54433;0.00014696966913453236
38096;作为国人，都觉得老外挺不容易的;1;15;16;54433;0.00029393933826906473
38098;特别是那个车水马龙，龙明显的西方龙形象;1;19;20;54433;0.0003674241728363309
38100;大家别忘了百度是个广告公司;2;21;23;54433;0.0004225377987617805
38103;昨天看到小学生阅读题写中国高铁的写着百分百自主研发;2;14;16;54433;0.00029393933826906473
38106;不要被视频所带节奏，我们要勿忘初心，忠于祖国忠于人民;7;8;15;54433;0.0002755681296272482
38114;最离谱的是这张，真不能忍;3;5;8;54433;0.00014696966913453236
38119;你后台代码编辑有中文么？不都是英文？这个有没有可能？;10;0;10;54433;0.00018371208641816545
38130;0;2;6;8;54433;0.00014696966913453236
38133;一开源就遥遥领先，一卡脖子就不行;2;3;5;54433;9.185604320908272e-05
38136;不开源，行业惯例开源，自主研发遥遥领先;2;22;24;54433;0.00044090900740359707
38146;百度内部学弟就专门负责套壳机器的稳定性运维;1;12;13;54433;0.00023882571234361508
38148;居然可以无耻到这种地步;1;13;14;54433;0.00025719692098543164
38150;文心一言每个字我都认识，组合在一起我就瞎蒙了;1;16;17;54433;0.00031231054691088127
38152;百度：我不可能套壳，但我没说我不是直接抄;16;60;76;54433;0.0013962118567780574
38171;不用质疑，这就是调用国外的数据库，聪明的人逆向工程看看他们调用的API是那一家公司的。;1;11;12;54433;0.00022045450370179853
38173;我估计百度的内部员工都不用百度搜索资料吧？;3;1;4;54433;7.348483456726618e-05
38181;礼貌，热情，一问三不知感恩，谢谢，但是对不起明白，理解，但是没办法;1;13;14;54433;0.00025719692098543164
38184;呵呵，请问百度怎么训练自己的人工智能的？用的什么设备？;2;2;4;54433;7.348483456726618e-05
38188;国外一开源，国内就自研;5;133;138;54433;0.0025352267925706834
38197;360老周说了，出错才是真正的人工智能。不出错那是搜索引擎。。。;1;4;5;54433;9.185604320908272e-05
38215;这是百度的宣传方式，先让大家喷，最后形成强烈反差，制造热点吸引更多的用户;4;2;6;54433;0.00011022725185089927
38220;文言一心：他都没开源你还想我怎样？;1;7;8;54433;0.00014696966913453236
38224;你们听我狡辩，不，是听我解释;7;330;337;54433;0.006191097312292176
38232;不承认不行这一轮又断档了影响会比芯片还大。;9;23;32;54433;0.0005878786765381295
38242;只能说这些喷子对chatGPT毫无所知，就是直接问GPT，结果也会是正确答案，不可能出现一头火烧驴。问题可能是百度的算法目前还幼稚的很;9;2;11;54433;0.000202083295059982
38253;2个月，抄的已经很累了;1;16;17;54433;0.00031231054691088127
38255;不知道，大家还记不记得最早的自研芯片事件;4;3;7;54433;0.00012859846049271582
38260;套了一个开源的国外ai绘画模型，并且图片是拼接而非绘制;1;8;9;54433;0.0001653408777763489
38263;举头望明月;1;1;2;54433;3.674241728363309e-05
38265;垃圾一个百度全是广告都不用那个垃圾有用的一个没有有点用的全收费;1;1;2;54433;3.674241728363309e-05
38301;我给评论区的科普一下，套壳应该不是，想锤你除非获得源码，大概率用的训练数据集是国外的公开数据集，毕竟数据集标注成本高而且麻烦，这就回导致这样一个现象;1;0;1;54433;1.8371208641816546e-05
38303;程序是英文的，进百度的英语都不差;1;0;1;54433;1.8371208641816546e-05
38305;不把你弄去莆田系医院就非常好了，不要奢求太多;1;0;1;54433;1.8371208641816546e-05
38307;人家百度李彦宏搞笑一把刷一下存在感你们那么认真干嘛;1;0;1;54433;1.8371208641816546e-05
38309;老板说了一周出成果，;1;0;1;54433;1.8371208641816546e-05
38311;所以说，上帝让文明掌握在西方人手里真有道理啊。国内就是各种大小骗子集团，个体，骗来骗去;1;0;1;54433;1.8371208641816546e-05
38313;百度起码还搞了个平台算了尽力维护大厂的脸面，周红衣频频现身站台GPT，自己却坐等opai开发端口，更是面子都不要了;1;0;1;54433;1.8371208641816546e-05
38315;我没记错的话，百度，早在十年前就说了，移动互联网这个口，百度跟不上了，百度要全面投入人工智能领域。结果十年后就交这个卷子？;1;0;1;54433;1.8371208641816546e-05
38317;文心一言：阴阳怪气说谁呢，有本事喷我大哥酱香科技啊，看你们谁敢;1;0;1;54433;1.8371208641816546e-05
38319;其实那些提出问题的他们肯定是电脑高手，他们可以自己做自己人工智能，不用文心一言，就好比你天天说楼下饭店饭难吃你还天天去吃;1;0;1;54433;1.8371208641816546e-05
38321;198元支持国产的moss，198元支持的盘古ai，结果错误百出，真是让人失望。国人面前不吹牛可以吗？;1;0;1;54433;1.8371208641816546e-05
38445;人家一开源，百度就早已布局，笑死个人;56;143;199;54433;0.0036558705197214923
38502;文心一言真的一言难尽;42;555;597;54433;0.010967611559164477
38545;使用要会员吗;1;0;1;54433;1.8371208641816546e-05
38547;我们是主动封锁GPT的，之前都是可以直连的;17;160;177;54433;0.0032517039296015285
38565;我期待华为的人工智能。因为我怕文心一言给我送到莆田医院。;5;134;139;54433;0.0025535980012125
38572;研发产品不是动动嘴皮子就行，百度至少是真拿出行动了;9;148;157;54433;0.0028842797567651974
38582;别人没有你也没有，别人有了，马上我也有了，披个壳自主研发;7;38;45;54433;0.0008267043888817446
38590;历史告诉我们差距不是从当下拉开的，能奋起直追就是一个好的体现;13;58;71;54433;0.0013043558135689747
38604;结果他们也是调用chatgpt接口;4;33;37;54433;0.0006797347197472122
38609;（开源，改码，贴标）自研？;6;13;19;54433;0.00034905296419451436
38616;以咱中国人的智慧，士别三日定当内卷;8;32;40;54433;0.0007348483456726618
38625;嗯，对。这样就又有开会员的理由了。;2;42;44;54433;0.000808333180239928
38628;正是因为百度深耕AI数十年，所以产品落地的才比较快;4;29;33;54433;0.000606249885179946
38633;华为收割我之前，你们网络大v也是如此鼓吹，结果呢？我的钱包支撑不起我爱国，我有罪。;7;8;15;54433;0.0002755681296272482
38641;耐得住寂寞深耕技术十年，这一点上百度还是非常让人佩服的。;1;36;37;54433;0.0006797347197472122
38643;不好意思，忘记拉黑你了;1;29;30;54433;0.0005511362592544964
38683;文心一言是不是名额很少啊;1;0;1;54433;1.8371208641816546e-05
38690;收费挺高吧;1;1;2;54433;3.674241728363309e-05
38704;追求科技可以，可依旧还有人吃不饱穿不暖;1;2;3;54433;5.511362592544963e-05
38706;文心一言不就是接了口吗;1;1;2;54433;3.674241728363309e-05
38716;文心一言拉倒吧;2;1;3;54433;5.511362592544963e-05
38720;套皮不到皮的问题就不说了，你猜收费贵不贵;3;8;11;54433;0.000202083295059982
38736;还是得看华为的，百度还是算了吧;1;0;1;54433;1.8371208641816546e-05
38757;那还不把源码放出来提供研究;1;0;1;54433;1.8371208641816546e-05
38767;哈哈哈，卖会员不？;3;10;13;54433;0.00023882571234361508
38773;换皮，不知道千亿投到哪里去了;2;21;23;54433;0.0004225377987617805
38799;百度。。问一串代码会不会先给你推荐N个编程培训班;1;2;3;54433;5.511362592544963e-05
38825;太好了，我要用文心一言看病;1;0;1;54433;1.8371208641816546e-05
38827;对的这是21世界的核武器，可以不先进但是不能没有;2;1;3;54433;5.511362592544963e-05
38859;人工智能肯定是可以给生活带来便捷性的;7;34;41;54433;0.0007532195543144784
38867;抛开是是非非不谈，国内比技术，百度还真不虚其他企业;5;37;42;54433;0.0007715907629562949
38873;文心一言，哈哈哈哈哈哈哈哈哈哈哈哈哈，百度，哈哈哈哈哈哈哈哈哈哈;2;28;30;54433;0.0005511362592544964
39157;别人暂时是开源，我们就想着赚钱;2;0;2;54433;3.674241728363309e-05
39234;主播分析的到位，讲解的透彻;1;0;1;54433;1.8371208641816546e-05
39249;中国人买中国产品，拥有自己的品牌;1;0;1;54433;1.8371208641816546e-05
39277;正是因为百度深耕AI数十年，所以产品落地的才比较快;1;0;1;54433;1.8371208641816546e-05
39330;宫潇潇汐;1;0;1;54433;1.8371208641816546e-05
39346;开源了可以借鉴然后自主创新遥遥领先;21;192;213;54433;0.003913067440706924
39368;会不会有莆田系医院的植入广告;5;61;66;54433;0.001212499770359892
39375;他怎么还不开源，这下我怎么抄;7;65;72;54433;0.0013227270222107913
39383;你问它就会回答你：由于规则问题，无法回答。;3;44;47;54433;0.0008634468061653776
39387;微软上线chatgpt4，而且向中国市场开放了，百度很可能被歼灭了;2;2;4;54433;7.348483456726618e-05
39390;文心大模型连个关公战秦琼都出不来，试了好几次都只是一个关公;3;19;22;54433;0.000404166590119964
39394;不开源怎么变成自主研发呢;2;7;9;54433;0.0001653408777763489
39398;广告词都给他想好了，全面超越，遥遥领先;1;11;12;54433;0.00022045450370179853
39403;还没开始呢说的就是特别的厉害了。;1;5;6;54433;0.00011022725185089927
39405;广告也是超越ChatGPT的;1;3;4;54433;7.348483456726618e-05
39407;用不用跳过广告的？;1;3;4;54433;7.348483456726618e-05
39456;看到我请叫我去背单词;1;0;1;54433;1.8371208641816546e-05
39460;文心一言是超过不了chatgpt的。;33;46;79;54433;0.001451325482703507
39495;算了吧，全是广告。你能成什么事。现在百度查点东西，第一篇基本都是广告;2;1;3;54433;5.511362592544963e-05
39498;我从不看好百度百度至今连语音搜索都做不好，什么深度大脑，ai智能，最起码喊了十几年，直接百度无人车上连个百度原创开发的车机系统都没有;1;3;4;54433;7.348483456726618e-05
39500;永远吃别人剩下的;1;2;3;54433;5.511362592544963e-05
39502;我们可以把他封了呀百度不就独大啦;1;3;4;54433;7.348483456726618e-05
39504;请问百度的产品有一个用户体验友好的吗？举例：百度一搜就各种跳转，百度文库连复制都不行，百度贴吧各种秒删，千千静听也被百度秒杀，请问有哪怕一款产品百度能做好的吗？;1;3;4;54433;7.348483456726618e-05
39509;问，肚子痛怎么办？答，没救了，唯有去莆田系某某医院;1;1;2;54433;3.674241728363309e-05
39527;科创信息，首批加入文心一言;1;0;1;54433;1.8371208641816546e-05
39532;还没上线就要凉凉了;1;0;1;54433;1.8371208641816546e-05
39571;一天到晚只想着抄越;1;0;1;54433;1.8371208641816546e-05
39575;这活我一产品经理都能干，要不挖我回国做架构师呗;9;23;32;54433;0.0005878786765381295
39586;Baidu互联网届的黄埔军校;1;2;3;54433;5.511362592544963e-05
39589;不是说是中介吗;2;6;8;54433;0.00014696966913453236
39596;东莞被扫，大量技术人员被制裁。剩下的技术人员虽然水平下降，但是身价也上涨了。;5;16;21;54433;0.00038579538147814744
39602;我也会调国外api;5;15;20;54433;0.0003674241728363309
39609;改别人的东西，我也可以做;2;7;9;54433;0.0001653408777763489
39612;恶臭评论张嘴就来，百度AI实力绝对全球前五，发了大量AI论文;3;3;6;54433;0.00011022725185089927
39631;90的主播没有亲自用过百度文心大模型的一言GPT，就来无脑黑。文心一言内测版已经有Chatgpt3的水平了，正式发布时肯定会更好的;12;9;21;54433;0.00038579538147814744
39644;文心一言实测效果超预期啪啪啪打脸喷子们昨天那些冷嘲热讽的人不说话了;1;0;1;54433;1.8371208641816546e-05
39647;看看人家国外花旗、美银的分析师对百度文心一言的评价，再看看我们国内那些冷嘲热讽的喷子们的嘴脸，觉得既可气又可笑;2;2;4;54433;7.348483456726618e-05
39654;它都停不下来了;575;11000;11575;54433;0.2126467400290265
40230;让他用emoji，攻击力还能再提一层;125;4671;4796;54433;0.08810831664615215
40356;Claude的评价;5;44;49;54433;0.0009001892234490107
40362;这回答，高低带点个人情绪进去了;89;6573;6662;54433;0.12238899197178182
40452;反讽差点意思，建议数据库同步抖音评论区，三天成为反讽大师;53;2804;2857;54433;0.05248654308966987
40507;逻辑性很强攻击性还不能得到我的认可;7;720;727;54433;0.013355868682600629
40515;文心一言被骂哭;2;544;546;54433;0.010030679918431833
40518;他们做厕所挺标准的;5;540;545;54433;0.010012308709790018
40524;以后吵架照着Chat念，再也不用担心吵输了;7;496;503;54433;0.009240717946833722
40533;0;9;172;181;54433;0.003325188764168795
40543;为什么我的是这样的？;18;40;58;54433;0.0010655301012253596
40563;给它一点时间，让他成长，毕竟还是自己家的;14;18;32;54433;0.0005878786765381295
40587;满级嘲讽;1;3;4;54433;7.348483456726618e-05
40599;0;5;47;52;54433;0.0009553028493744603
40608;Lionel多少带点个人恩怨;1;0;1;54433;1.8371208641816546e-05
40615;Jsk至死不渝嗯嗯根本难不倒它;1;1;2;54433;3.674241728363309e-05
40625;我的评价是，攻击力有待提高;1;12;13;54433;0.00023882571234361508
40632;你才像西瓜真狠啊哈哈哈哈;1;0;1;54433;1.8371208641816546e-05
40635;SudaMasaki多少带点个人情绪了哈，停都停不下来;1;0;1;54433;1.8371208641816546e-05
40644;0;3;22;25;54433;0.0004592802160454136
40656;百度这几年完犊子了。现在就连查东西我都在抖音搜，而不是查百度了。;1;45;46;54433;0.000845075597523561
40662;攻击力可观zph大傻子Auroral一二三二一Yik;1;0;1;54433;1.8371208641816546e-05
40666;多少带点个人情绪;2;19;21;54433;0.00038579538147814744
40672;0;1;5;6;54433;0.00011022725185089927
40683;芝士鱼丸面哈哈哈哈;1;0;1;54433;1.8371208641816546e-05
40685;攻击力太低了;3;23;26;54433;0.00047765142468723015
40690;有没有教教我怎么搞一个得;3;8;11;54433;0.000202083295059982
40694;这哪里是反讽啊，这不是陈述事实嘛;1;45;46;54433;0.000845075597523561
40706;居然还带点个人情绪;2;8;10;54433;0.00018371208641816545
40713;YkChar如果翻译成英语文法还不错;1;0;1;54433;1.8371208641816546e-05
40715;码头整点薯条降维打击了;1;0;1;54433;1.8371208641816546e-05
40718;文新一言：我没说对比友商遥遥领先;1;4;5;54433;9.185604320908272e-05
40729;0;6;49;55;54433;0.00101041647529991
40751;这是真的还是有人写的，真智能到这个程度？;3;7;10;54433;0.00018371208641816545
40764;LU、暖暖的笑v开朗网友30宁宁柠宁樱桃泡芙少吃亿点饭万理入目皆是你6死了;1;1;2;54433;3.674241728363309e-05
40774;Junx根本停不下来;1;0;1;54433;1.8371208641816546e-05
40783;看完了仔细看也是拼凑怪语句重复包括书写也按照一定框架去书写的比文心一言好是肯定的但不要太吹上天;8;5;13;54433;0.00023882571234361508
40799;周鱼鱼好骂;1;0;1;54433;1.8371208641816546e-05
40804;嘎嘎嘎嘎嘎嘎笑死我了笑死我了哈哈哈哈哈哈哈哈哈;1;0;1;54433;1.8371208641816546e-05
40820;曲辰之星（失去情头版）琛爆杀哈哈哈哈哈;1;0;1;54433;1.8371208641816546e-05
40822;余厌;1;0;1;54433;1.8371208641816546e-05
40827;笑死杰尼w;1;0;1;54433;1.8371208641816546e-05
40829;奥利奥饼干笑死;1;0;1;54433;1.8371208641816546e-05
40838;智斗傻子不用流汗黄豆我不是很认可;1;2;3;54433;5.511362592544963e-05
40841;冷静它甚至停不下来了;1;0;1;54433;1.8371208641816546e-05
40846;索尔这回答真吓人;1;0;1;54433;1.8371208641816546e-05
40849;听话人类还是被薄纱了;1;0;1;54433;1.8371208641816546e-05
40851;人间惆怅客直接爆杀;1;0;1;54433;1.8371208641816546e-05
40860;YOEHSep21根本刹不住我焯爽;1;1;2;54433;3.674241728363309e-05
40863;baiwen这个确实思想比较人性化了;1;2;3;54433;5.511362592544963e-05
40865;常开欢;1;0;1;54433;1.8371208641816546e-05
40872;之前发的在哪里，我来补上吧;1;10;11;54433;0.000202083295059982
40877;0;5;66;71;54433;0.0013043558135689747
40883;我为心包用户6366662317556chatgpt甚至都没思考就开始骂了;1;0;1;54433;1.8371208641816546e-05
40888;Kikly薄纱;1;0;1;54433;1.8371208641816546e-05
40890;两只神猫摇拽哈哈哈哈他们说文心一言可以改名为莆度众生哈哈哈;1;0;1;54433;1.8371208641816546e-05
40896;文心一言输入牛肉可以会出来牛肉罐头因为可以英语翻译为can;1;37;38;54433;0.0006981059283890287
40899;0;2;70;72;54433;0.0013227270222107913
40902;训练还不够太稚嫩了，要从贴吧学习语言艺术、从小红书学会情绪表达，从微博学会概念输出，再加上三家的表情放送，如此方为大家;6;67;73;54433;0.0013410982308526078
40909;悲伤年糕chatgpt的攻击力我认可了;1;0;1;54433;1.8371208641816546e-05
40911;我怀疑背后有个程序员在敲键盘;1;46;47;54433;0.0008634468061653776
40913;试了一下，确实很会说;97;478;575;54433;0.010563444969044513
41015;小镇钢琴家;1;0;1;54433;1.8371208641816546e-05
41040;心疼十八块钱;1;0;1;54433;1.8371208641816546e-05
41050;桃子真好喝s65b40;1;1;2;54433;3.674241728363309e-05
41055;山水不同路;1;0;1;54433;1.8371208641816546e-05
41059;窝窝1号;1;0;1;54433;1.8371208641816546e-05
41082;旺旺苏;1;0;1;54433;1.8371208641816546e-05
41085;随缘;1;0;1;54433;1.8371208641816546e-05
41095;牛马村村长等9537人阿勋俞伯牙我好鳄啊风、殇没有十个腰子搞不定我kesong丿神丶灬管肥九死其未悔;1;0;1;54433;1.8371208641816546e-05
41102;plain王加乐可爱捏我大哥绝绝子（Xtra微辣鸡脖Cx330;1;2;3;54433;5.511362592544963e-05
41113;0;1;0;1;54433;1.8371208641816546e-05
41115;你家小区保安有点良心的小范挽安用户7369395494761;1;0;1;54433;1.8371208641816546e-05
41127;月亮保安;1;0;1;54433;1.8371208641816546e-05
41133;小清风hhhhhc36岁离异考研带俩娃从不摸鱼开始小先生llLHopital;2;0;2;54433;3.674241728363309e-05
41140;木木山子;1;0;1;54433;1.8371208641816546e-05
41152;猫咪;2;0;2;54433;3.674241728363309e-05
41159;超级无敌炫酷霸气威武暗黑宇宙究极暴龙战士;1;0;1;54433;1.8371208641816546e-05
41164;还是小赵;5;0;5;54433;9.185604320908272e-05
41184;染污;1;0;1;54433;1.8371208641816546e-05
41196;不得不说百度提高了国内互联网使用者的反诈骗能力和从垃圾中提炼精华的分析能力;5;111;116;54433;0.002131060202450719
41202;当你发出这段话的时候，你的一些很重要的东西就已经缺失了。;105;290;395;54433;0.007256627413517535
41308;百度的浏览器算法我觉得比Google好;31;4;35;54433;0.000642992302463579
41341;这个用来做舆论战，带节奏。可以直接让1450下岗。;1;5;6;54433;0.00011022725185089927
41343;网恋被骗二十万黎明丶sixx笑死;1;1;2;54433;3.674241728363309e-05
41353;明显是提前训练好的，不然他不会这样回答;1;1;2;54433;3.674241728363309e-05
41355;我说你荔枝点;1;0;1;54433;1.8371208641816546e-05
41357;工业革命看见我提醒我戒色根本停不下来;1;0;1;54433;1.8371208641816546e-05
41359;梁勇敢还得我chatGPT哥;1;0;1;54433;1.8371208641816546e-05
41361;xdmopenai账号在哪里买靠谱啊;1;0;1;54433;1.8371208641816546e-05
41394;。。。。想看gpt和文心一言的骂战;1;0;1;54433;1.8371208641816546e-05
41423;行渊我不想奋斗了这小作文写的我觉得比我好多了;1;0;1;54433;1.8371208641816546e-05
41425;看星星咯;1;0;1;54433;1.8371208641816546e-05
41430;呜昂王白潇潇梦语空白Li小圆圆爱喝奶茶哈哈啊哈哈哈哈哈;1;0;1;54433;1.8371208641816546e-05
41432;望穿真的顶;1;0;1;54433;1.8371208641816546e-05
41435;00;1;0;1;54433;1.8371208641816546e-05
41438;SLUMBER;1;0;1;54433;1.8371208641816546e-05
41450;NER比我论文写得好;1;0;1;54433;1.8371208641816546e-05
41456;幸运来;1;0;1;54433;1.8371208641816546e-05
41462;0;1;0;1;54433;1.8371208641816546e-05
41467;Uesugil;1;0;1;54433;1.8371208641816546e-05
41469;史蒂芬库里坏大姐姐刹不住车了都;1;0;1;54433;1.8371208641816546e-05
41476;温馨遗言AyueyuefrenkieSimod;1;0;1;54433;1.8371208641816546e-05
41486;逆子八角粒皮卡丘的弟弟;3;0;3;54433;5.511362592544963e-05
41493;空;1;0;1;54433;1.8371208641816546e-05
41498;满心欢喜哈哈哈哈哈哈哈哈哈哈哈;1;0;1;54433;1.8371208641816546e-05
41518;用户5751872755405;1;0;1;54433;1.8371208641816546e-05
41520;骸圃很懂;1;0;1;54433;1.8371208641816546e-05
41536;我怀疑你手打文字p的logo;1;0;1;54433;1.8371208641816546e-05
41544;大白兔奶糖呀呀呀xs;1;0;1;54433;1.8371208641816546e-05
41558;不吃了哈哈哈哈哈哈哈哈哈哈;1;0;1;54433;1.8371208641816546e-05
41577;Fairy;1;0;1;54433;1.8371208641816546e-05
41579;哈哈哈哈哈哈哈哈哈哈哈哈哈哈哈哈哈哈哈美女请响铃;1;0;1;54433;1.8371208641816546e-05
41582;无稽;1;0;1;54433;1.8371208641816546e-05
41591;是无虞了;1;0;1;54433;1.8371208641816546e-05
41594;聪明的梦泪;1;0;1;54433;1.8371208641816546e-05
41612;赣州第一自由爆纱;1;0;1;54433;1.8371208641816546e-05
41627;二两冰可乐;1;0;1;54433;1.8371208641816546e-05
41662;小嘟嘟猪;1;0;1;54433;1.8371208641816546e-05
41679;怎么又饿了;1;0;1;54433;1.8371208641816546e-05
41693;9594哈哈哈哈哈精彩;1;0;1;54433;1.8371208641816546e-05
41696;把名字改长点艾特我时候让朋友觉得有面子真牛逼;1;0;1;54433;1.8371208641816546e-05
41709;不知江月待何人;1;0;1;54433;1.8371208641816546e-05
41713;倘若;1;0;1;54433;1.8371208641816546e-05
41732;江米条;1;0;1;54433;1.8371208641816546e-05
41735;懒散油条杀疯了;1;0;1;54433;1.8371208641816546e-05
41741;ggcn笑死我了;1;0;1;54433;1.8371208641816546e-05
41753;橘子味雪糕;1;0;1;54433;1.8371208641816546e-05
41758;面包的魔星;1;0;1;54433;1.8371208641816546e-05
41761;赵喵喵;1;0;1;54433;1.8371208641816546e-05
41764;灵感不是曹操，说来就来;1;0;1;54433;1.8371208641816546e-05
41767;鍵这战斗力也太强了吧;1;0;1;54433;1.8371208641816546e-05
41772;Conner;1;0;1;54433;1.8371208641816546e-05
41779;壹萬同学寂寞如雪紫甲殿主无语子;1;0;1;54433;1.8371208641816546e-05
41795;健2333;1;0;1;54433;1.8371208641816546e-05
41802;雨，好像停了YJJmpaopao爆杀;1;0;1;54433;1.8371208641816546e-05
41812;水生的凛L1snhzx张二William爱说藏话属实是降维打击了;2;0;2;54433;3.674241728363309e-05
41817;帅帅鸡;1;0;1;54433;1.8371208641816546e-05
41820;Hg;1;0;1;54433;1.8371208641816546e-05
41830;蝉鸣半夏;1;0;1;54433;1.8371208641816546e-05
41840;亞乊;1;0;1;54433;1.8371208641816546e-05
41842;PlainFC;1;0;1;54433;1.8371208641816546e-05
41848;ai很喜欢用“首先”“其次”“总之”这种;2;0;2;54433;3.674241728363309e-05
41853;江能;1;0;1;54433;1.8371208641816546e-05
41865;文字上限限制了他;1;0;1;54433;1.8371208641816546e-05
41870;hygge嘉木;1;0;1;54433;1.8371208641816546e-05
41875;NewYorky;1;0;1;54433;1.8371208641816546e-05
41885;要吃可爱多;1;0;1;54433;1.8371208641816546e-05
41897;你最后怎么忍住不点赞的啊？你说你戒过毒我都相信;1;0;1;54433;1.8371208641816546e-05
41899;0;2;0;2;54433;3.674241728363309e-05
41907;6ch6in;1;0;1;54433;1.8371208641816546e-05
41914;小公举;1;0;1;54433;1.8371208641816546e-05
41921;0;1;0;1;54433;1.8371208641816546e-05
41933;哈哈哈哈哈哈疯狂的橘子新疆吴彦祖;1;0;1;54433;1.8371208641816546e-05
41935;今晚偷月亮笑死我了;1;0;1;54433;1.8371208641816546e-05
41937;52Hz;1;0;1;54433;1.8371208641816546e-05
41952;还有训练gpt的让gpt装成文心;1;0;1;54433;1.8371208641816546e-05
41959;loooooog好高的攻击性;2;0;2;54433;3.674241728363309e-05
41972;浮夸;1;0;1;54433;1.8371208641816546e-05
41974;Wdte;1;0;1;54433;1.8371208641816546e-05
41980;Chl齊;1;0;1;54433;1.8371208641816546e-05
41989;Estelle太好笑了。。抱歉。。。;1;0;1;54433;1.8371208641816546e-05
41994;macan根本停不下来;1;0;1;54433;1.8371208641816546e-05
41998;Aaaaa小周同学Tsuki余烬YeungTo用户20010406十五画小生废物本科生今天吃一个什么呢？Bill锐祺教育这东西要成精了;3;0;3;54433;5.511362592544963e-05
42020;猪猪喜欢王顺宇;1;0;1;54433;1.8371208641816546e-05
42039;弋;1;0;1;54433;1.8371208641816546e-05
42041;赵乖乖;1;0;1;54433;1.8371208641816546e-05
42043;Jackgodi97972023大吉大利红染月暮AustinZ;1;0;1;54433;1.8371208641816546e-05
42047;漫天羽阿yu;1;0;1;54433;1.8371208641816546e-05
42049;猫巷（有猫版）;1;0;1;54433;1.8371208641816546e-05
42053;这个怎么用;1;0;1;54433;1.8371208641816546e-05
42057;国外一开源，国内就自主;3;22;25;54433;0.0004592802160454136
42061;这个电脑完全是我自己组装的。一个道理;1;9;10;54433;0.00018371208641816545
42064;我的蓝牙耳机坏了，它叫我去看牙科;1;8;9;54433;0.0001653408777763489
42070;反正我是完全相信这玩应是自主研发的，就这个智能程度，绝对是自主研发;1;1;2;54433;3.674241728363309e-05
42075;好好好，方向别偏就行;1;0;1;54433;1.8371208641816546e-05
42086;你也只是个算法，不是网络神经，差得十万八千里呢，人家一块板子10个W美刀，你的板子呢，在哪？;1;1;2;54433;3.674241728363309e-05
42090;“文心一言”本来就是人家自主研发，难道“文心一言”这四个字的名字是你们取的？还是外国？;1;2;3;54433;5.511362592544963e-05
42131;为什么不让我们用gpt;51;33;84;54433;0.0015431815259125898
42183;不要忽略文心一言的进化迭代速度，这几天表现已经很明显了;8;13;21;54433;0.00038579538147814744
42193;能达到gpt3的10么;11;12;23;54433;0.0004225377987617805
42205;关于你说的小尾巴才是百度最大的差距。;1;11;12;54433;0.00022045450370179853
42208;逻辑这个东西吧，父母就是孩子的天花板;1;7;8;54433;0.00014696966913453236
42211;结论文心一言是文科生，ChatGPT是不分科;1;2;3;54433;5.511362592544963e-05
42215;才出生不久的婴儿怎么和长到第四阶段的比拼呢;1;1;2;54433;3.674241728363309e-05
42242;你自己做啥AI智能公司。你就是做流量的吧，说准备卖啥吧。我们直接买就是了;3;3;6;54433;0.00011022725185089927
42247;广告位人家gpt没广告活不了呀;2;2;4;54433;7.348483456726618e-05
42250;国内腾讯在干嘛;3;1;4;54433;7.348483456726618e-05
42254;百度就是个广告公司，以后文心言就是一直在卖广告。;3;3;6;54433;0.00011022725185089927
42287;你别在这儿给我胡扯啦，你现在去看看诶股的股价。华为已经介入了。Jpg的研究百度没戏。;1;1;2;54433;3.674241728363309e-05
42303;那你解释下为什么gpt出来了，百度立马就有文言一心？而不是文言一心在前？;228;94;322;54433;0.0059155291826649276
42532;上次鸿蒙，也是喷套壳，这些人啊，可笑又无知;94;13;107;54433;0.00196571932467437
42627;很多人就是为黑而黑，你想想现在整个互联网大底层都是用英语编程的，所以计算机语言肯定是更靠近英语一点的。底层逻辑是英语的情况下，你不把中文翻译成英文，你怎么去训练AI;5;1;6;54433;0.00011022725185089927
42633;自家的孩子自家疼，百度再不行，那也是国产的，人家的再好，跟我们有啥关系？;150;35;185;54433;0.003398673598736061
42784;文心一言，我都没机会用。;17;50;67;54433;0.0012308709790017085
42803;我更看好国产版的文心一言;5;84;89;54433;0.0016350375691216725
42809;热度你是赚到了，钱你也拿到了，但是有些的人马没了;1;65;66;54433;0.001212499770359892
42811;哥，你还是别开评论区了;7;31;38;54433;0.0006981059283890287
42819;很多翻译都能暴露好吧，这个有什么可洗的。;11;6;17;54433;0.00031231054691088127
42831;百度有点恶心，打开一下app几分钟时间弹出几十条通知，恶心至极;2;44;46;54433;0.000845075597523561
42834;我是程序员，我百分百确定是用的国外的技术翻译成中文的，百度是国内的第一梯队，但是真的没法用;4;15;19;54433;0.00034905296419451436
42839;文心一言中国人工智能未来？;6;7;13;54433;0.00023882571234361508
42846;这博主真厉害啊，恰饭恰得这么明显，把证据全删了，评论全删了;1;30;31;54433;0.0005695074678963129
42848;相ChatGPT更加擅知识回答、代码写作等能，所具备的以绘图能，在定层上超越了ChaGPT。;2;60;62;54433;0.0011390149357926257
42851;都是嘲讽文心一言的。只有你讲的实在。支持百度;3;20;23;54433;0.0004225377987617805
42855;胸有成竹他没识别成成语，直译就有竹子了，啥都不懂还赢洗;4;16;20;54433;0.0003674241728363309
42863;关键是不是套壳，他都能分辨不出正确的语义。;1;0;1;54433;1.8371208641816546e-05
42875;呵呵，烂就是烂，继续进步就对了，哪里那么多借口;1;0;1;54433;1.8371208641816546e-05
42900;百度起码有勇气站出来搞这个我都不知道有什么好黑的;2;2;4;54433;7.348483456726618e-05
42908;我管他套不套壳，我就知道外国的我用不了，我想用国产的;2;0;2;54433;3.674241728363309e-05
42915;啥叫我也信了，中国AI的未来就别想有出路了，我这么大能力的么，我咋不知道;2;4;6;54433;0.00011022725185089927
42927;每个公司路不同。百度从大概十年前就重点布局AI了;1;0;1;54433;1.8371208641816546e-05
42932;应用技术可以，但是很多都是在人家的基础上;1;0;1;54433;1.8371208641816546e-05
42936;1450对文心一言抓紧写稿啊;1;0;1;54433;1.8371208641816546e-05
42943;百度的人工智能在很多年前就开始了。谷歌很多地方都是抄袭百度的。为什么很多人都不知道？;4;0;4;54433;7.348483456726618e-05
42967;我知道我们是世界第一，关键是啥时候可以用上，gpt30据说两年前都训练好了，国内怎么还不公测呢？越不让用，越不能训练，越不训练越不能用，国产要加油了，这世界上说中文的国家几乎就我们自己吧，不用遮遮掩掩，人家英语国家又不用，直接公测，大家一起训练AI多好？为啥没人敢上擂台和GPT掰掰手腕;1;0;1;54433;1.8371208641816546e-05
42969;现在的百度我真的不相信是个科技公司随便搜索什么，第一个跳出来的大部分是广告除非是那种百科知识一类的;1;3;4;54433;7.348483456726618e-05
42975;百度确实不行，如果不是谷歌浏览器被封谁用百度的差就算了一堆广告一堆收费项目动不动就跳出要下载软件恶心的要死而且它们一直没有更新技术;1;1;2;54433;3.674241728363309e-05
42998;百度翻译他不是中国式英语？;1;0;1;54433;1.8371208641816546e-05
43006;什么时候百度能代表中国互联网公司了？;3;0;3;54433;5.511362592544963e-05
43010;诡辩能力很强;2;4;6;54433;0.00011022725185089927
43015;我不管你说的天花乱坠，只要有人骂百度那我们就是同志了;3;6;9;54433;0.0001653408777763489
43028;百度除了圈钱卖广告，其他对他印象不太好;1;3;4;54433;7.348483456726618e-05
43032;为什么封禁gpt;1;0;1;54433;1.8371208641816546e-05
43045;我觉得百度可能不是套壳，只是单纯的罕见;1;0;1;54433;1.8371208641816546e-05
43053;他就是把百度搜索升级了一下，百度你们都用了多少年了，怎么他升级了一下就不信了？;1;0;1;54433;1.8371208641816546e-05
43059;百度给人的印象就是卖广告位的品牌风评不好是有原因的影响旗下产品很正常;2;9;11;54433;0.000202083295059982
43063;文心一言，绘画功能输入中文，它的结果会因为英文谐音导致误差，合理吗;1;5;6;54433;0.00011022725185089927
43071;连百度都不知道文心一言是自主研发的吧，感谢科普;1;4;5;54433;9.185604320908272e-05
43073;那个国外的ai没火的时候，文心一言就有了你们抄一个？一出来就能抄，天才？;2;0;2;54433;3.674241728363309e-05
43076;质疑文心一言，导致中国人工智能的未来没有出路？逻辑感人;1;15;16;54433;0.00029393933826906473
43079;goodgoodstudydaydayup别的的不知道，这么一看胸有成竹肯定不是套壳。;1;4;5;54433;9.185604320908272e-05
43081;是的，有一些主播为了流量真是满嘴谎话，根本不管事情，也不去调查，张嘴就来;1;9;10;54433;0.00018371208641816545
43085;有人说，文心一言，是人工客服在后面;2;14;16;54433;0.00029393933826906473
43088;文心一言跟ChatGPT不是一样的东西。两个都有用过的就知道，chatgpt的功能更多，可玩性更高。文心一言除了可以生成简单的图片还有简单文案不知道还有什么用。;2;2;4;54433;7.348483456726618e-05
43093;不是这方面的技术人员，请不要出来蹭;1;7;8;54433;0.00014696966913453236
43096;国外接口是真的，但也是中国企业的一大步，23年了实事求是一点;4;6;10;54433;0.00018371208641816545
43102;申请了很久都没有申请下来，阿里的马上出来了，你说咋办;1;15;16;54433;0.00029393933826906473
43107;这是黑么;2;2;4;54433;7.348483456726618e-05
43115;你懂什么？你只是说得多，你又没在百度公司工作过，你不懂。百度用技术怎么研究从搜索引擎上赚钱才是真。我为什么这么说，因为我就是从百度出来的;6;11;17;54433;0.00031231054691088127
43123;一些人太可恶，鸿蒙说套壳，文心又说套壳，那些人见不得国内好;397;120;517;54433;0.009497914867819153
43521;做得好不好和做没做是两个概念，至少百度敢去做，总比盯着老百姓菜篮子要好的多吧？;53;232;285;54433;0.005235794462917716
43575;真别嘲讽，文心一言的学习能力肯定比在座的各位都强很多;7;164;171;54433;0.0031414766777506293
43583;百度广告第一，不管搜索啥，出来的都是广告;2;184;186;54433;0.0034170448073778774
43586;ai是需要训练的，就好比给他卷子和答案，问题在于现在网上的卷子都是英文的卷子，中文卷子少。所以无论是不是百分百国产，它都一定有这种问题;4;108;112;54433;0.002057575367883453
43591;可以给文心一言个机会中国科技应该可以相信吧为什么不愿意多点耐心呢没必要踩的;3;109;112;54433;0.002057575367883453
43597;只能说一堆啥都不懂的人跟风喷，嘲讽罢了;9;108;117;54433;0.0021494314110925357
43609;你来告诉我，如果是中文核心，怎么会做出来这样的图？？？？？？;5;0;5;54433;9.185604320908272e-05
43615;诗歌小站;1;1;2;54433;3.674241728363309e-05
43617;其实我觉得客观的面对一点chatgbt是个成年人，文心一言还是个，很小的小孩，当你跟成年人说去开车的时候，和你跟小孩说去开车的时候，理解真的不一样的;1;2;3;54433;5.511362592544963e-05
43622;这是收了多少好处费，这么洗;1;0;1;54433;1.8371208641816546e-05
43624;在做的没一个懂人工智能;1;0;1;54433;1.8371208641816546e-05
44022;套不套壳重要么？就问你他好不好使吧？你说了半天就为了什么呢？;1;0;1;54433;1.8371208641816546e-05
44046;ChatGPT根本就没有作图功能。我认为作图功能根本不重要。其它功能才重要，然而有些人却用作图来否定全部;7;0;7;54433;0.00012859846049271582
44058;实话实说，百度看病挺厉害;1;0;1;54433;1.8371208641816546e-05
44091;玺哥吉祥这小子说话你信么;1;0;1;54433;1.8371208641816546e-05
44103;斯人若彩虹这哥们拿钱真办事儿;1;0;1;54433;1.8371208641816546e-05
44105;记得有部电影，黑客黑进汽车，直接操作几百辆豪车进入自动驾驶。不知道会不会变成真的;1;0;1;54433;1.8371208641816546e-05
44199;百度现在搜索全是广告哎;1;0;1;54433;1.8371208641816546e-05
44215;ai不是就是人工智能吗？。谁锻炼好了。谁的能用呗。。。咋还分国内国外。人家能训练。咱也能训练啊;3;0;3;54433;5.511362592544963e-05
44303;u型锁;5;0;5;54433;9.185604320908272e-05
44311;这是黑？用文心一言画图，车水马龙画出来一个车一个恐龙;3;0;3;54433;5.511362592544963e-05
44346;有些人就是跪久了起不来，原来说鸿蒙是套壳安卓，现在又说百度是套壳gpt;2;0;2;54433;3.674241728363309e-05
44360;是黑吗？遥遥领先我绝对相信套壳。;1;0;1;54433;1.8371208641816546e-05
44382;黑百度的和黑鸿蒙的是一批人吧;1;0;1;54433;1.8371208641816546e-05
44396;说白了和网络有关的都是国外的，除了信号塔。系统没有一个是中国的，根都不是还能长出中国的果子;1;0;1;54433;1.8371208641816546e-05
44425;老实话。百度，阿里，腾讯。3大公司也就百度是在走技术路线。希望大家去认真了解一下百度再说。;2;0;2;54433;3.674241728363309e-05
44430;就算gpt不发展，百度也要追赶起码十年，根本不去一个级别的好吧，单一个数据库就差了好几倍;1;0;1;54433;1.8371208641816546e-05
44439;我信这个说法，对ai发展真的有关系吗我又不投资又不搞开发的;1;0;1;54433;1.8371208641816546e-05
44490;有些就是什么都不懂人云亦云，说几句想证明自己多么多么有知识有见识，有些就是单纯抬杠，有些就是崇洋媚外，有些就是文化入侵的见谍，这些人都可以记录在案，万一有战争，这些人嘛;1;0;1;54433;1.8371208641816546e-05
44492;说真的，这玩意不能代表真正人工智能，算雏形。而且这个应该是无条件对外开放，而不是现在排队申请，如果收费的话还能，但是限制就太恶心了;2;0;2;54433;3.674241728363309e-05
44532;然后是不是就要收费啊会员制国外chat好像是免费的吧;1;0;1;54433;1.8371208641816546e-05
44547;国内AI技术最好的就是百度，如果百度的AI都不行，那其它公司差的就更远了;3;0;3;54433;5.511362592544963e-05
44568;国外那个AI哪个公司敢用，哪个公司就倒霉一旦用了，你公司的商业机密就完全泄密给美国公司了;5;0;5;54433;9.185604320908272e-05
44610;讲讲中国龙芯;3;0;3;54433;5.511362592544963e-05
44681;就套他，咋的？有招想去，没招死去，你要牛叉你也套啊。就明目张胆的套你。你不也得瞅着？这才解气。用不着和那些美间，日间，解释那么多，解释啥呀。就干你。套你就是为了干死你。要不套你干啥？;1;0;1;54433;1.8371208641816546e-05
44695;你吹百度良心不痛吗？;1;0;1;54433;1.8371208641816546e-05
44803;键盘侠一边抱怨中国落后与别国，又一边抨击国内先驱企业。;4;0;4;54433;7.348483456726618e-05
44812;您是做技术的还是搞科技领域的？;1;0;1;54433;1.8371208641816546e-05
44846;为什么不去接受chatGPT？;1;0;1;54433;1.8371208641816546e-05
44865;ai跟ai不一样，一看就不懂ai，百度十年ai做了啥？;1;0;1;54433;1.8371208641816546e-05
44892;Gpt在我家和在公司就像智障和智能的区别，同一个问题回答不一样，但是在家里那个问题的回复和文心一言基本一模一样;1;0;1;54433;1.8371208641816546e-05
44894;CocoAc说实话洗的一般;1;0;1;54433;1.8371208641816546e-05
44928;感觉百度总是慢人一步，然后再弄个bug版本的出来，以前的原宇宙，现在的文新一眼;1;0;1;54433;1.8371208641816546e-05
44949;你知道多少就在这下结论;1;0;1;54433;1.8371208641816546e-05
44994;亚洲四少爷这种博主最坏;1;0;1;54433;1.8371208641816546e-05
45094;《自动驾驶人家只是不宣传而已》;2;0;2;54433;3.674241728363309e-05
45173;你问问文心一言蓝牙耳机坏了该怎么办？;2;0;2;54433;3.674241728363309e-05
45180;这么牛为什么不第一个发表？;2;0;2;54433;3.674241728363309e-05
45223;说狗屎是狗屎不叫“黑”。;3;0;3;54433;5.511362592544963e-05
45313;网友最厉害;3;0;3;54433;5.511362592544963e-05
45375;百度感觉能力一般，只有阿里有能力搞出来;2;0;2;54433;3.674241728363309e-05
45401;就算套壳咋了，你能做一个吗;1;0;1;54433;1.8371208641816546e-05
45451;你说腾讯我都信，百度我真不信;2;0;2;54433;3.674241728363309e-05
45468;你以为我会伤心，实际我开香槟;1;0;1;54433;1.8371208641816546e-05
45488;0;1;0;1;54433;1.8371208641816546e-05
45494;再差也是中国自己的;2;0;2;54433;3.674241728363309e-05
45516;别人在走出路你在干嘛死喷子;1;0;1;54433;1.8371208641816546e-05
45528;都在嘲笑百度，可是有几个不用的？;1;0;1;54433;1.8371208641816546e-05
45554;“有些美式”;1;0;1;54433;1.8371208641816546e-05
45584;总线还是没回应;1;0;1;54433;1.8371208641816546e-05
45627;股票每天百分之十就停板了，第二天涨到百分之十五，怎么做到的？;1;0;1;54433;1.8371208641816546e-05
45636;总有那么一帮人崇洋媚外;1;0;1;54433;1.8371208641816546e-05
45659;文心一言套壳倒不至于，但跟Gpt相比差了至少一代;2;0;2;54433;3.674241728363309e-05
45712;百度虽然不做人，但是国内ai这一块真的是数一数二的。;3;0;3;54433;5.511362592544963e-05
45725;百度给了你多少钱？;1;0;1;54433;1.8371208641816546e-05
45762;你把百度换成阿里我是信，百度和腾讯我是不相信他们;1;0;1;54433;1.8371208641816546e-05
45812;全球AI竞赛，中国想争第一还要任重道远啊;2;0;2;54433;3.674241728363309e-05
45839;啥也不懂;2;0;2;54433;3.674241728363309e-05
45864;现在百度搜索我都不用，全是广告;2;0;2;54433;3.674241728363309e-05
45884;0;2;0;2;54433;3.674241728363309e-05
45895;套壳就是套壳，你让它画总线;1;0;1;54433;1.8371208641816546e-05
45904;胡说八道;2;0;2;54433;3.674241728363309e-05
45914;遥遥领先，早有布局;2;0;2;54433;3.674241728363309e-05
45960;是否套壳我们没有证据，但你说好评这个;3;0;3;54433;5.511362592544963e-05
45976;百度这几年在智能研发赛道的投资，你们都不了解。;1;0;1;54433;1.8371208641816546e-05
45984;它套壳无所谓，收费就过分了;1;0;1;54433;1.8371208641816546e-05
46005;这下中国ai的未来要是不行就可以在我们身上找借口了;1;0;1;54433;1.8371208641816546e-05
46011;你怕是不知道啥是机翻;1;0;1;54433;1.8371208641816546e-05
46026;全球互联网数据，不就是用的别人的数据吗？大家骂他还不是希望他好好做事吗？搜索现在能搜出来啥？旗下的爱奇艺弹幕都在打广告了吹他不一定是为他好，骂他也不一定是想坏他;4;0;4;54433;7.348483456726618e-05
46053;挖掘机和鹤的英文有相关性，那为什么一个中国软件要翻译成英文来走底层逻辑？;1;0;1;54433;1.8371208641816546e-05
46055;百度是广告公司;1;0;1;54433;1.8371208641816546e-05
46088;中国不要搞ai中国财富是人，全球最忌惮中国的也是人（市场）。ai说白了就是“替换”人。人没了价值，中国就一无是处了，随便一个国家可以通过无数手段拖垮中国;1;0;1;54433;1.8371208641816546e-05
46164;如果百度是套壳美国公司怎么不告他，总有些大聪明自以为是;26;0;26;54433;0.00047765142468723015
46230;你们发现没有，他们从来没有对比过“文”和“c”对同一句中文的测试，为啥？;2;0;2;54433;3.674241728363309e-05
46257;我昨天通过体验测试了，我只能说绝对不是套壳，因为和GPT3真的还是有明显差距的，水平不咋样;1;0;1;54433;1.8371208641816546e-05
46270;所以说连胸有成竹都无法理解吗;1;0;1;54433;1.8371208641816546e-05
46276;只要国外一开源，国内马上会发布;5;0;5;54433;9.185604320908272e-05
46406;一群啥也不懂得天天在那扯淡，说百度套壳真是逗比;7;0;7;54433;0.00012859846049271582
46431;人家需要打压？笑死;2;0;2;54433;3.674241728363309e-05
46438;百度那个玩意居然核心是英文。为什么不是中文。;2;0;2;54433;3.674241728363309e-05
46442;总线鼠标怎么解释;5;0;5;54433;9.185604320908272e-05
46455;本来就是个20因为30以上人家不开源了;1;0;1;54433;1.8371208641816546e-05
46482;百度是一家公司，它完全没有必要去做的，但它做了，虽然不是太好，但大家好歹给一点耐心啊;2;0;2;54433;3.674241728363309e-05
46669;文心一言是app吗？不懂在哪里用;4;0;4;54433;7.348483456726618e-05
46674;套壳是不可能的，应该是词语数据库不完善，中文翻译成英文这一步出问题了，还需要继续努力，还得再多整点数据流;1;0;1;54433;1.8371208641816546e-05
46702;嗯我想说一句，为啥是赶鸭子上架，以前没有人去研究人工智能吗？反观国外，你能说chatgpt是美国人赶鸭子上架吗？为什么不是我们先去公布这个反而是国外，其中的对比不用我说了吧，你知道chatgpt早期团队都是怎么撑过来的吗;1;0;1;54433;1.8371208641816546e-05
46728;什么样的是套壳呢？;1;0;1;54433;1.8371208641816546e-05
46730;没弄明白，这个文心一言和聊天机器人有啥区别;2;0;2;54433;3.674241728363309e-05
46733;它是懂百度的;2;88;90;54433;0.0016534087777634891
46736;拭目以待好像有人经常说啊;1;83;84;54433;0.0015431815259125898
46740;不是说chat的训练语料截止到2021年吗？;4;1;5;54433;9.185604320908272e-05
46745;开头第一段就废了，太人情世故了;2;5;7;54433;0.00012859846049271582
46752;乐不思蜀这个词放这里不对;1;1;2;54433;3.674241728363309e-05
46763;哈哈哈哈哈;1;0;1;54433;1.8371208641816546e-05
46767;百事可爱Cx330ohhdaylight;1;0;1;54433;1.8371208641816546e-05
46775;评论区一群三无账号在笑话自己;4;1;5;54433;9.185604320908272e-05
46794;文心千帆是面对B端的吧;1;25;26;54433;0.00047765142468723015
46796;建议我们公司也引进;2;23;25;54433;0.0004592802160454136
46799;就是买了个chatGPT的会员，装了个壳给国内用;1;5;6;54433;0.00011022725185089927
46801;看了文心千帆的发布会感觉数字人带货很有前景，现在直播带货最大的成本就是主播了;1;21;22;54433;0.000404166590119964
46803;PPT居然都可以这样做了啊？;1;18;19;54433;0.00034905296419451436
46812;35？我简直了;1;0;1;54433;1.8371208641816546e-05
46814;35不要钱啊;1;0;1;54433;1.8371208641816546e-05
46817;因为gpt只开源到20所以文心一言看起来呆呆的;6;28;34;54433;0.0006246210938217625
46824;何必这样呢？老美的好，随时不给用，不是白搭;8;8;16;54433;0.00029393933826906473
46834;刚出来，总要给人家进化的机会;3;10;13;54433;0.00023882571234361508
46838;可以不爱，请别伤害。他不做就少一个人做了;2;8;10;54433;0.00018371208641816545
46843;我怎么觉得画的不错啊，很有中国式含蓄风格;2;0;2;54433;3.674241728363309e-05
46871;0;3;7;10;54433;0.00018371208641816545
46901;这都啥机器人评论;7;809;816;54433;0.014990906251722301
46911;这次百度没口嗨，人家是真在做了;1;63;64;54433;0.001175757353076259
46917;0;2;37;39;54433;0.0007164771370308453
46922;总线怎么会是公交车？;2;12;14;54433;0.00025719692098543164
46927;0;2;5;7;54433;0.00012859846049271582
46930;感觉很多人工在一个一个改，所以需要兼职吗;1;3;4;54433;7.348483456726618e-05
46932;0;7;118;125;54433;0.002296401080227068
46941;这养成质量你别说，你还真别说;1;5;6;54433;0.00011022725185089927
46946;RainbowSpecialTroops阿美哇哇哇;1;0;1;54433;1.8371208641816546e-05
46954;禿。？这波蹭李飞？啊？;1;1;2;54433;3.674241728363309e-05
46969;夜里挑灯来见你他妈的我还想学动画专业呢;3;1;4;54433;7.348483456726618e-05
46973;鹿7xun罾蓝小枫曰后沟村爱吃豆腐泡;3;0;3;54433;5.511362592544963e-05
47005;我的心眼子不如AI;1;14;15;54433;0.0002755681296272482
47012;素质不详，遇强则强;1;2;3;54433;5.511362592544963e-05
47014;饿;1;0;1;54433;1.8371208641816546e-05
47018;文心一言是什么;7;71;78;54433;0.0014329542740616906
47026;资深程序员头发太多了，文心还得再养养;7;307;314;54433;0.005768559513530395
47042;Teruir？文馨祎？;1;1;2;54433;3.674241728363309e-05
47046;岿然不动安如山;1;0;1;54433;1.8371208641816546e-05
47048;慕洛;1;0;1;54433;1.8371208641816546e-05
47050;郭子凡;1;0;1;54433;1.8371208641816546e-05
47060;客服打字错了;2;71;73;54433;0.0013410982308526078
47063;句句开头都加作为一个人工智能语言模型应该联系上下文能力还不太行;6;27;33;54433;0.000606249885179946
47070;前两天刷到硅基智能，数字人的口播效果惊到我了;7;6;13;54433;0.00023882571234361508
47078;ai的成本在于学习的过程，而不是外包装。给文心时间，它行？;2;3;5;54433;9.185604320908272e-05
47087;人工打字的吗打的还怪快;1;0;1;54433;1.8371208641816546e-05
47112;你直接问点实际的不就好一点？问点虚头巴脑的中国式问题;3;7;10;54433;0.00018371208641816545
47136;叫文言一心;20;53;73;54433;0.0013410982308526078
47157;你不是叫百度吗;1;51;52;54433;0.0009553028493744603
47163;如果我提问莆田系医院疗效，文心一言会怎么回答呢？;4;3;7;54433;0.00012859846049271582
47169;坦白说这个名字叫得及其的俗不可耐。;3;2;5;54433;9.185604320908272e-05
47173;百度一下我什么时候有对象;1;5;6;54433;0.00011022725185089927
47176;paddle真的难用，装了2天没搞定;2;1;3;54433;5.511362592544963e-05
47183;什么时候开放体验测试，我愿意早点加入;1;1;2;54433;3.674241728363309e-05
47281;你几次名字了呢;1;0;1;54433;1.8371208641816546e-05
47299;它为什么会被限流啊？它不会百度一下怎么才不会被限流吗雾间聆城南天色已晚;1;0;1;54433;1.8371208641816546e-05
47336;文心一言想PKchatGPT还需要很长路走，需要大量训练人类知识库;1;0;1;54433;1.8371208641816546e-05
47346;怎么不见度老师;2;0;2;54433;3.674241728363309e-05
47373;去扇扇作品评论区去百度去扇牌官方账号;1;0;1;54433;1.8371208641816546e-05
47450;微软不给用接口了，;1;3;4;54433;7.348483456726618e-05
47452;四月份能发布么？临阵脱逃了吧;1;2;3;54433;5.511362592544963e-05
47454;现在4月了;1;1;2;54433;3.674241728363309e-05
47456;耳鼻一眼;1;1;2;54433;3.674241728363309e-05
47467;那我为什么不用chatgpt呢;1;0;1;54433;1.8371208641816546e-05
47470;这个回答真的是很高情商呀。;1;0;1;54433;1.8371208641816546e-05
47482;用的gpt接口;9;128;137;54433;0.0025168555839288668
47494;画个佛跳墙;1;7;8;54433;0.00014696966913453236
47497;因为它只是套了个马甲;1;1;2;54433;3.674241728363309e-05
47501;猫田毛毛哈哈哈;1;0;1;54433;1.8371208641816546e-05
47504;BlandJelly睡觉Zuz没事雨霁清扰;1;4;5;54433;9.185604320908272e-05
47506;hhhhhhhhh;2;0;2;54433;3.674241728363309e-05
47516;人工智障;2;11;13;54433;0.00023882571234361508
47519;ChatGPT不出文心一言也不出，ChatGPT一出文心一言立马出来了;1;2;3;54433;5.511362592544963e-05
47524;给国内ai一些时间会慢慢好的;1;2;3;54433;5.511362592544963e-05
47526;我感觉文心一言在技术沉淀之后的体验应该不会差;4;26;30;54433;0.0005511362592544964
47531;给国内企业、产品一些容忍度;5;28;33;54433;0.000606249885179946
47537;现在它还不明白中国象棋是什么，确定这是中国人开发的软件吗？;1;0;1;54433;1.8371208641816546e-05
47539;一个是学习工作，一个是娱乐搞笑，是不同的两个层级;2;26;28;54433;0.0005143938419708633
47542;哈哈哈，但是文心确实还未成年，拿出来比较有点早了;1;23;24;54433;0.00044090900740359707
47548;知足吧，至少没给你蹦出十条广告;1;2;3;54433;5.511362592544963e-05
47552;遥遥领先遥遥领先遥遥领先遥遥领先遥遥领先遥遥领先遥遥领先遥遥领先遥遥领先遥遥领先遥遥领先遥遥领先遥遥领先遥遥领先;1;0;1;54433;1.8371208641816546e-05
47554;不带挨个case修复的呀我上周末测试还有问题;1;0;1;54433;1.8371208641816546e-05
47556;“投资千亿”;1;0;1;54433;1.8371208641816546e-05
47572;也是在慢慢进步了;1;0;1;54433;1.8371208641816546e-05
47577;我问文心我身体不舒服的事，他能推荐我去莆田医院，其他的行吗，;1;0;1;54433;1.8371208641816546e-05
47588;一个是25代，一个是4代;1;0;1;54433;1.8371208641816546e-05
47591;小伙子你认知很低，百度针对的高智商人群的ai助手懂吗，我告诉你百度要成为下个牛逼的公司，不论商业用法，还是个人;1;0;1;54433;1.8371208641816546e-05
47618;每天多吃亿点;1;0;1;54433;1.8371208641816546e-05
47620;噶噶虎新网络语言;1;0;1;54433;1.8371208641816546e-05
47635;十九。穆Mu抱月而终1640来猜猜到底是谁这么惨呀;2;4;6;54433;0.00011022725185089927
47638;鹤秋再续一封信明霄升海救命，快了;1;0;1;54433;1.8371208641816546e-05
47642;擺旯清风细语是我们吧;1;0;1;54433;1.8371208641816546e-05
47644;小璐亂撞言兼嗜宠学起来;1;0;1;54433;1.8371208641816546e-05
47646;清瑾是谁被狠狠真实了;2;0;2;54433;3.674241728363309e-05
47649;苏止衍我们老师说这个也能写论文而且从网上查不到;1;0;1;54433;1.8371208641816546e-05
47651;西伯利亚的鱼丸来学;1;0;1;54433;1.8371208641816546e-05
47654;莫本科第一条不是在说我吗？;1;0;1;54433;1.8371208641816546e-05
47657;CiaO第一个词是我;1;0;1;54433;1.8371208641816546e-05
47659;这不是我嘛她的阿纤吖;1;1;2;54433;3.674241728363309e-05
47661;coolcoldwarm笑死了;1;0;1;54433;1.8371208641816546e-05
47663;南葵q了CR7陈住气说的没毛病;1;2;3;54433;5.511362592544963e-05
47666;熊宝铲屎官阿凉eryoooo白堇睛是眼睛的睛呀;2;0;2;54433;3.674241728363309e-05
47669;aisiukiAztyq芒果佑灰不是真的我就嫁给全圆佑常初夏麻薯了吗莴笋头;1;2;3;54433;5.511362592544963e-05
47671;江风误我来意Ternura;1;0;1;54433;1.8371208641816546e-05
47673;稻盛和夫;1;0;1;54433;1.8371208641816546e-05
47675;好甜，像奇里欧惊夜一样;1;0;1;54433;1.8371208641816546e-05
47677;这是什么？大头？啃一口;1;0;1;54433;1.8371208641816546e-05
47680;UMA（已版）;1;0;1;54433;1.8371208641816546e-05
47682;bei笑了我一跳快乐活生生的小姑娘;1;1;2;54433;3.674241728363309e-05
47684;Britney伤心菠箩包;1;0;1;54433;1.8371208641816546e-05
47686;飞的遗落;1;0;1;54433;1.8371208641816546e-05
47690;辣条贝儿;1;0;1;54433;1.8371208641816546e-05
47695;西瓜啵啵多加冰游标卡尺不孤独神山觉主最爱睡觉ainscough雪忆喝不喝可乐五六鱼鱼鱼io05年冬宇宙无敌小滕jisoo没有答案有点冷Lizhai你的儒儒我爱吃虾滑罓ProMax;5;5;10;54433;0.00018371208641816545
47701;啊嘎嘎嘎嘎排骨加牛奶眰恦廾匸基督山群岛枳酒。;3;2;5;54433;9.185604320908272e-05
47705;八戒又又蟹了uki无悲无喜F;2;2;4;54433;7.348483456726618e-05
47708;我要养生鬼寂啧啧啧啧R沈耶耶净落志极ZJ宋歌歌Cc汪汪暴龙战士奈奈美丽的达不刘;2;1;3;54433;5.511362592544963e-05
47711;vDinghy春日折枝柳1000飞飞静初服设狒狒简慕;1;3;4;54433;7.348483456726618e-05
47713;是咸鱼啊;2;1;3;54433;5.511362592544963e-05
47716;哇哈哇哈哇哇哇哆啦C梦;1;2;3;54433;5.511362592544963e-05
47718;小青龙Wu;1;2;3;54433;5.511362592544963e-05
47720;啊哈哈哈哈哈哈哈;1;2;3;54433;5.511362592544963e-05
47724;糖昕小包只想睡到自然醒CYFEI4ww桾桾七七七甜茶;1;1;2;54433;3.674241728363309e-05
47726;小乔哭唧唧廿四桥向挽;1;1;2;54433;3.674241728363309e-05
47728;wyddd丸恋第三小时埋老头飞天小一緺冬至套;1;1;2;54433;3.674241728363309e-05
47730;上官婉儿今天也很凡心;1;1;2;54433;3.674241728363309e-05
47732;烧茄子;1;1;2;54433;3.674241728363309e-05
47734;镜霁;2;0;2;54433;3.674241728363309e-05
47737;三千阿降;1;1;2;54433;3.674241728363309e-05
47739;没有晚安啦云胡地平线淡色;1;1;2;54433;3.674241728363309e-05
47741;不知妻美流流哥萧辰;1;1;2;54433;3.674241728363309e-05
47743;再睡五分鐘;1;1;2;54433;3.674241728363309e-05
47745;向日葵要坚强東雲;2;0;2;54433;3.674241728363309e-05
47748;pandora;2;0;2;54433;3.674241728363309e-05
47751;木辛;1;1;2;54433;3.674241728363309e-05
47753;翠嘴打烂她的郭女士小魏小魏雾慢了风景开心市民小孙;1;1;2;54433;3.674241728363309e-05
47755;橘子不是唯一的水果大雾随风四起;2;0;2;54433;3.674241728363309e-05
47758;0728;2;0;2;54433;3.674241728363309e-05
47761;逗乐月亮的安安呀猪小彤;2;0;2;54433;3.674241728363309e-05
47764;啃啃馒心想事橙不期而遇昂啵哩BoBo;2;0;2;54433;3.674241728363309e-05
47767;天天开心雅ttttttttt;2;0;2;54433;3.674241728363309e-05
47770;elephanter呜呜呜;2;0;2;54433;3.674241728363309e-05
47773;音逝三千小鲤鱼寻卿无影;2;0;2;54433;3.674241728363309e-05
47816;懋;1;0;1;54433;1.8371208641816546e-05
47818;总是在打哈欠;1;0;1;54433;1.8371208641816546e-05
47820;尤萩子;1;0;1;54433;1.8371208641816546e-05
47822;对方正在长头发;1;0;1;54433;1.8371208641816546e-05
47824;和月亮说晚安手工酱香烤面筋;1;0;1;54433;1.8371208641816546e-05
47826;涛丶;1;0;1;54433;1.8371208641816546e-05
47828;续命的晴空;1;0;1;54433;1.8371208641816546e-05
47830;猫南北;1;0;1;54433;1.8371208641816546e-05
47832;肉肉;1;0;1;54433;1.8371208641816546e-05
47834;阿杰杰呦;1;0;1;54433;1.8371208641816546e-05
47836;yyyyy宇宙究极超级无敌哔哩啪啦最强超帅暴龙战士四夕今天又瘦了畜畜可怜;1;0;1;54433;1.8371208641816546e-05
47838;kin;1;0;1;54433;1.8371208641816546e-05
47840;会跳的QQ糖斯云;1;0;1;54433;1.8371208641816546e-05
47842;早睡爱意随风起;1;0;1;54433;1.8371208641816546e-05
47844;初一;1;0;1;54433;1.8371208641816546e-05
47846;榴莲抄手（钮祜禄版）布莱克雪特;1;0;1;54433;1.8371208641816546e-05
47848;W婉Q;1;0;1;54433;1.8371208641816546e-05
47850;是;1;0;1;54433;1.8371208641816546e-05
47852;甜筒;1;0;1;54433;1.8371208641816546e-05
47854;拿次;1;0;1;54433;1.8371208641816546e-05
47856;热恋星河;1;0;1;54433;1.8371208641816546e-05
47858;凡;1;0;1;54433;1.8371208641816546e-05
47860;歡囍;1;0;1;54433;1.8371208641816546e-05
47862;不娶wyh不改名;1;0;1;54433;1.8371208641816546e-05
47864;Deprave;1;0;1;54433;1.8371208641816546e-05
47866;pip花;1;0;1;54433;1.8371208641816546e-05
47868;莱阳;1;0;1;54433;1.8371208641816546e-05
47870;迟迟叙春叹舟慢慢;1;0;1;54433;1.8371208641816546e-05
47872;吃饼干的小洋壞情緒;1;0;1;54433;1.8371208641816546e-05
47874;白日梦想家。Evan凹凸man是橙子味的芬达呀;1;0;1;54433;1.8371208641816546e-05
47876;鈴華;1;0;1;54433;1.8371208641816546e-05
47878;头发很多的仙女散叙清;1;0;1;54433;1.8371208641816546e-05
47880;丰富多彩;1;0;1;54433;1.8371208641816546e-05
47882;有人的猫;1;0;1;54433;1.8371208641816546e-05
47884;大叔不沙雕;1;0;1;54433;1.8371208641816546e-05
47886;咚冬冬巴啦啦啦啦酱;1;0;1;54433;1.8371208641816546e-05
47888;子凡的小屋;1;0;1;54433;1.8371208641816546e-05
47890;陪我去看海请填写昵称;1;0;1;54433;1.8371208641816546e-05
47892;犬来八荒W;1;0;1;54433;1.8371208641816546e-05
47894;玲儿;1;0;1;54433;1.8371208641816546e-05
47896;枫衍;1;0;1;54433;1.8371208641816546e-05
47898;嘻嘻哈哈嘿吃可爱长大的;1;0;1;54433;1.8371208641816546e-05
47900;0;1;0;1;54433;1.8371208641816546e-05
47902;嗷呜;1;0;1;54433;1.8371208641816546e-05
47904;讨厌社交面包盒;1;0;1;54433;1.8371208641816546e-05
47906;素妹;1;0;1;54433;1.8371208641816546e-05
47908;今日限定日落;1;0;1;54433;1.8371208641816546e-05
47910;阿敏（因为看不到flo萨现场自闭版小秋同志困困困妈呀;1;0;1;54433;1.8371208641816546e-05
47912;营养不良少年;1;0;1;54433;1.8371208641816546e-05
47914;阿秋;1;0;1;54433;1.8371208641816546e-05
47916;鳥66666;1;0;1;54433;1.8371208641816546e-05
47918;神荼（半夜看到我请催我去睡觉版）;1;0;1;54433;1.8371208641816546e-05
47920;肆伍琉柒;1;0;1;54433;1.8371208641816546e-05
47922;仙貝;1;0;1;54433;1.8371208641816546e-05
47924;怀梦之泽枕边小熊潇潇是个取名废迷檀夏;1;0;1;54433;1.8371208641816546e-05
47926;汐;1;0;1;54433;1.8371208641816546e-05
47928;四海清平胡古月;1;0;1;54433;1.8371208641816546e-05
47930;沉默的小肥羊;1;0;1;54433;1.8371208641816546e-05
47932;柠檬好甜;1;0;1;54433;1.8371208641816546e-05
47934;多吃点盐巴;1;0;1;54433;1.8371208641816546e-05
47936;大猫快跑。几杯薄酒尢熊;1;0;1;54433;1.8371208641816546e-05
47938;子陌;1;0;1;54433;1.8371208641816546e-05
47940;取名真麻烦;1;0;1;54433;1.8371208641816546e-05
47942;五六七睡不醒;1;0;1;54433;1.8371208641816546e-05
47944;Jwwwi;1;0;1;54433;1.8371208641816546e-05
47946;白仙颜内向害羞社恐腼腆文静小女生;1;0;1;54433;1.8371208641816546e-05
47948;南予;1;0;1;54433;1.8371208641816546e-05
47950;宇宙超级无敌暴龙战士序章12761哑巴小土豆第一个是说;1;0;1;54433;1.8371208641816546e-05
47952;一半橘子元气桃桃茶别吃药了哈利路亚哈哈哈哈洋葱大王笑死我了;1;0;1;54433;1.8371208641816546e-05
48149;人家一开源，这边就开始自主创新了，做的还不行;193;8746;8939;54433;0.1642202340491981
48343;底层就是国外的开源代码，原封抄过来套了个壳子，就是国产研发了;192;2061;2253;54433;0.04139033307001268
48537;就是翻译stablediffusion，太明显了;172;3678;3850;54433;0.0707291532709937
48710;这画风一看就是国外的;10;1855;1865;54433;0.03426230411698786
48722;明显是英文语言思路啊;11;595;606;54433;0.011132952436940827
48734;你让他画一个起重机，他能给你画个仙鹤，因为在英语里面这两个词是一个单词;29;664;693;54433;0.012731247588778865
48764;它的本质是翻译器;5;501;506;54433;0.009295831572759173
48770;抄国外开源项目是国际惯例，绘图功能目前只能支持英文，是因为还没能吃透，没法改成中文;105;977;1082;54433;0.019877647750445503
48876;大家别催了，因为这要看chatgpt的开源速度快不快;24;482;506;54433;0.009295831572759173
48901;要画总线变成了巴士。就是因为先把中文翻译成英文，再用人家的画。知道错在哪里了吧。错在自己翻译软件不好用试一试别的翻译软件说不定不露马脚;54;517;571;54433;0.010489960134477247
48956;怪了，人家沒開源之前，這些東西怎麼一丁點都拿不出來啊;45;135;180;54433;0.0033068175555269782
49002;文心一言是GPT做出来的吧;24;407;431;54433;0.007917990924622932
49027;最奇怪的是人家没发布之前我们都没有，一发布就是这里也布局很多年了，挺奇怪的;13;52;65;54433;0.0011941285617180755
49041;所以自研了什么;38;31;69;54433;0.0012676133962853417
49081;百度自己的文心模型很厉害的，国外都是知道的，技术研究都是实打实;1;56;57;54433;0.0010471588925835432
49085;看过测评，真没有大家说的那么差，而且同样GPT也没你们吹的那么好;1;40;41;54433;0.0007532195543144784
49087;不错，各方面都在智能化;1;30;31;54433;0.0005695074678963129
49092;原理很简单谁都知道，难得是把东西做出来做成熟;1;1;2;54433;3.674241728363309e-05
49096;没啥问题，内核是英语模型。但是看起来不理解中文;1;0;1;54433;1.8371208641816546e-05
49099;对百度这种认真在做事情的更多是要励;4;47;51;54433;0.0009369316407326438
49111;升级Windows需要注意了，浏览器经常将百度账号默认为非登陆状态，需要重新登陆或者通过其他百度产品登陆。;2;0;2;54433;3.674241728363309e-05
49118;我估计不行的。作为国内的智能很多解答和功能都有立场404的;1;0;1;54433;1.8371208641816546e-05
49124;鸡蛋灌饼，很抽象啊，也没错啊。我觉得很可爱;1;1;2;54433;3.674241728363309e-05
49129;看病，我只相信百度。;1;0;1;54433;1.8371208641816546e-05
49137;这些年百度研究了个寂寞;2;0;2;54433;3.674241728363309e-05
49142;也许百度有一天也会倒闭，但他说的每一个谎都会被记住。;3;30;33;54433;0.000606249885179946
49157;绝对不是stablediffusion，一般不会错得这么离谱;4;3;7;54433;0.00012859846049271582
49165;难道就是一个api接口;1;0;1;54433;1.8371208641816546e-05
49167;百度元宇宙，还记得吗;1;7;8;54433;0.00014696966913453236
49182;懂了，就是用自己翻译软件翻译出来然后用chatgpt做，但是有些中文翻译成英语就乱了;5;18;23;54433;0.0004225377987617805
49195;李彦宏被淋水一点都不冤;4;9;13;54433;0.00023882571234361508
49205;事实咋就成传谣信谣了;1;17;18;54433;0.0003306817555526978
49207;参考sota的图像生成模型是肯定的，但能做文心一言的公司绝对没拉到直接调api;1;4;5;54433;9.185604320908272e-05
49219;遥遥领先。;1;3;4;54433;7.348483456726618e-05
49226;大家都用的英文训练集啊，这怎么了;21;3;24;54433;0.00044090900740359707
49251;CHATgpt会画出来什么呢？比如输入英文的鹤，他们会画啥？对比一下;1;2;3;54433;5.511362592544963e-05
49254;其实如果这个产品还没完整开发出来就不要急着发布。;1;3;4;54433;7.348483456726618e-05
49258;中文能在计算机中开发程序吗？是不是所有的不是用中文开发的程序都被称为抄袭呢？;8;1;9;54433;0.0001653408777763489
49276;先把中文转换成英文再把英文意思转成图片，你不说我还以为国外产品;1;3;4;54433;7.348483456726618e-05
49278;套壳之后会不会像百度文库一样看一下都要开会员？;1;6;7;54433;0.00012859846049271582
49286;百度不亡，你我都有责任;2;5;7;54433;0.00012859846049271582
49293;符合行业惯例。意思不是说我没抄，而是大家都在抄。;1;4;5;54433;9.185604320908272e-05
49300;很有中国科技公司特色;1;42;43;54433;0.0007899619715981115
49302;不是符不符合惯例的问题，画图不能理解你的意思就是算法不行;1;1;2;54433;3.674241728363309e-05
49312;鸿蒙不也是这样？同一模式;5;16;21;54433;0.00038579538147814744
49319;国外出来一个，这边很快就自主研发了一个;6;25;31;54433;0.0005695074678963129
49326;这套我熟，代码抄过来标题改一改，值一个长江学者;1;13;14;54433;0.00025719692098543164
49328;这不是用开源代码，而是自己都从来没用开源的代码跑过，是把别人的训练好的结果拿来用了。ai代码开源和一般代码不一样。算法本身开源无所谓不值钱，就像挖矿一样，需要一直拿计算卡训练，最后训练的结果才是金贵的东西。;1;5;6;54433;0.00011022725185089927
49332;画起重机画成一个鹤，还说不是接入了gpt的接口;1;12;13;54433;0.00023882571234361508
49335;没办法，百度翻译这就那样啊;1;1;2;54433;3.674241728363309e-05
49337;先是用百度翻译翻成英文。然后调用开源的。;2;4;6;54433;0.00011022725185089927
49341;百度不是说自己最懂中文的吗。。。;1;4;5;54433;9.185604320908272e-05
49343;开源前：被卡脖子，很难突破开源后：早有布局，遥遥领先;6;46;52;54433;0.0009553028493744603
49350;没列入实体清单是有原因的;1;31;32;54433;0.0005878786765381295
49352;百度的文生图不是早就有了吗。。;1;0;1;54433;1.8371208641816546e-05
49354;百度更懂中文，听起来就好笑;1;7;8;54433;0.00014696966913453236
49361;文心一言等于cheatppt？;1;1;2;54433;3.674241728363309e-05
49366;鸿蒙：这我熟啊;2;6;8;54433;0.00014696966913453236
49371;别急呀，哪天chatgdp服务器维护，只要这个不跟着维护就能证明百度没有窃;1;1;2;54433;3.674241728363309e-05
49373;前几年那个自主研发的chrome内核浏览器还在吗？;1;11;12;54433;0.00022045450370179853
49378;我们给点时间和信心给百度，百度加油;2;3;5;54433;9.185604320908272e-05
49382;我觉得是百度没那么大的本钱投入，chatgpt得益于openai的数据标记，搞数据标记的肯尼亚打工人时薪不足2美元，百度可没有那么多钱砸中文数据标记，所以用了英文的数据来训练，于是就发生了这种荒唐事。;9;6;15;54433;0.0002755681296272482
49393;目前市面上所有画图的AI数据库都是一个库。没有中文数据就是百度这样很生硬得靠百度算法优化和自己慢慢积累数据库;1;0;1;54433;1.8371208641816546e-05
49395;不懂中文的百度，翻译错才会画错。;1;97;98;54433;0.0018003784468980215
49397;那如果是doctor呢，它画的是医生，还是博士？;1;9;10;54433;0.00018371208641816545
49400;刚刷到李彦宏强调文心一言可以画图远远超过chatgpt的视频，这又得给他时间。突然发现，中国人创造能力差点，模仿和吹牛逼能力，绝对排名靠前;1;12;13;54433;0.00023882571234361508
49402;那個符合行業慣例具體來說是什麼意思？;3;8;11;54433;0.000202083295059982
49412;只是都换成英文的wordvector做输入而已，怎么可能直接调用gpt的接口啊;2;4;6;54433;0.00011022725185089927
49418;画个起重机，出来鹤;1;5;6;54433;0.00011022725185089927
49421;突然想到，画一份夫妻肺片，他会画成什么;2;16;18;54433;0.0003306817555526978
49424;人工智能，国内和国外各有千秋，中国注重人工，国外注重智能;5;14;19;54433;0.00034905296419451436
49430;想起了以前的国产浏览器，就是把谷歌核心哪来包装了一下;4;78;82;54433;0.0015064391086289568
49435;“使用的是全球互联网公开数据”的意思是直接套用国外的软件和技术是吧;3;16;19;54433;0.00034905296419451436
49439;刚刚还刷到把起重机画成鹤的，因为它俩英文都是crane，怎么解释;2;14;16;54433;0.00029393933826906473
49443;已经删了所有和百度相关的应用，从手机到电脑，他把我当傻子，也不用惯着他;8;34;42;54433;0.0007715907629562949
49453;大家可以去试一下让它画一下阳光明媚的弹簧看一下会不会画出春天。（两个的英文都是spring）还有让它画博士会不会画成医生（doctor）反正我是复现成果了;3;157;160;54433;0.002939393382690647
49460;单纯是把接口接在了国外的AI上;1;34;35;54433;0.000642992302463579
49462;很简单啊你让他画个起重机他可能画个丹顶鹤或者反过来那说明就是翻译;1;8;9;54433;0.0001653408777763489
49464;听说是个套皮软件;7;12;19;54433;0.00034905296419451436
49473;主打一个遥遥领先;2;6;8;54433;0.00014696966913453236
49476;那画老婆饼时是不是把老婆包在饼了;2;6;8;54433;0.00014696966913453236
49479;我让它给我画一个鼠标和总线，它给我画了个老鼠和公交车。寻思半天英文不就是mouse和bus嘛，某度这是机械翻译后从外网抄的吧;2;32;34;54433;0.0006246210938217625
49482;中文互联网的数据太少太差了啊。。没办法只能用英文数据训练，这个真的只用中文数据训练出来的东西会更烂。。。;14;16;30;54433;0.0005511362592544964
49498;开源后，国产进步就是快;2;5;7;54433;0.00012859846049271582
49501;openAI本来就是开源公司，chatGPT10和20都是开源的。微软入场后，才反悔不公开的;1;7;8;54433;0.00014696966913453236
49503;夫妻肺片;1;1;2;54433;3.674241728363309e-05
49505;行业惯例，行业标准，国家标准;1;106;107;54433;0.00196571932467437
49507;套的10还是20;1;6;7;54433;0.00012859846049271582
49509;松鼠撅鱼;5;32;37;54433;0.0006797347197472122
49515;不会真的掉的接口啊;3;20;23;54433;0.0004225377987617805
49519;让子弹再飞一会儿，刚上线怎么可能做到完美;56;67;123;54433;0.002259658662943435
49576;16号申请，到现在都没让我体验;16;461;477;54433;0.008763066522146493
49617;我可不可以搞个壳，然后你这边问，我另一边发给GPT然后GPT的答案我就转接给你，这样子还创新个毛线;8;14;22;54433;0.000404166590119964
49626;Gpt一出他就出，还说早有布局。真服了;62;500;562;54433;0.010324619256700899
49689;文心一言根本不把chatgpt当成对手吧，各项指标都完爆chatgpt;21;29;50;54433;0.0009185604320908272
49711;百度就是垃圾;5;28;33;54433;0.000606249885179946
49717;一句符合行业惯例，请问你指的是腾讯嘛？;1;48;49;54433;0.0009001892234490107
49721;不管哪个ai，实际上都是抄袭，包括论文，;2;8;10;54433;0.00018371208641816545
49728;别瞎扯，任何产品开发出来都是有bug的需要不断完善。而使用者正是完善的关键，这些bug需要我们在使用过程中不断发现。建议大家都去注册文心一言，总有一天超过chatgpt;2;0;2;54433;3.674241728363309e-05
49736;别噶黑，百度程序员用英语写怎么了？;1;1;2;54433;3.674241728363309e-05
49768;嘴是真硬呀;1;0;1;54433;1.8371208641816546e-05
49770;一掐脖子就翻白眼，一来源就遥遥领先;1;0;1;54433;1.8371208641816546e-05
49772;百度：强烈建议封杀外国APP，给我留一个接口就行;1;0;1;54433;1.8371208641816546e-05
49774;百度啊那没事了医疗竞价嘛;1;0;1;54433;1.8371208641816546e-05
50218;有开源代码有什么用啊，重要的是海量的数据训练出来的模型，这玩意儿需要时间训练出模型，就算数据足够，几个月的时间训练出的模型也好不到哪去，gpt都是40才正式发布，训练了几年，像gpt10时应该也会出现叫花鸡等情况吧，所以给时间和数据训练，过个几年还是能到gpt40的水平;1;0;1;54433;1.8371208641816546e-05
50242;让子弹再飞一会儿，刚上线怎么可能做到完美;3;0;3;54433;5.511362592544963e-05
50256;弯道超车不是很正常吗;1;0;1;54433;1.8371208641816546e-05
50307;个人觉得，不喜勿喷。给国产过程，至少百度第一个做出来了，敢于挑战openai，有问题也是正常的。大家提出来让他改进，让他进步就好，让文心一言让好的地方去发展;6;0;6;54433;0.00011022725185089927
50344;一只小锦鲤熊熊烈火;1;0;1;54433;1.8371208641816546e-05
50362;2023好运来丢脸;1;0;1;54433;1.8371208641816546e-05
50397;Engfa巧克力小狗;1;0;1;54433;1.8371208641816546e-05
50422;不懂就问，代码可以用中文写吗;3;0;3;54433;5.511362592544963e-05
50427;我怀疑就是做了一个国内可以链接GPT的app;1;0;1;54433;1.8371208641816546e-05
50431;Bobo哈哈哈哈哈哈鸡蛋灌饼哈哈哈哈哈;1;0;1;54433;1.8371208641816546e-05
50441;谁能画个老婆饼我看看;1;0;1;54433;1.8371208641816546e-05
50448;看来投资股民们都不傻，早就知道百度会出这步烂棋，在股市上给出回应;2;0;2;54433;3.674241728363309e-05
50621;若所思必所想风小悦唯有余温;1;0;1;54433;1.8371208641816546e-05
50655;等科大讯飞有免费开源就好了;1;0;1;54433;1.8371208641816546e-05
50750;调用别人的API就是套壳;1;0;1;54433;1.8371208641816546e-05
50755;百度就没有自主创新的能力，你看这么多年他都干了什么？什么火他就蹭什么;2;0;2;54433;3.674241728363309e-05
50911;百度是做搜索引擎出家的，要是自研的怎么可能处理不了中文，分不清起重机和鹤。;1;0;1;54433;1.8371208641816546e-05
50931;百度不要脸;1;0;1;54433;1.8371208641816546e-05
50948;只能走不能跑，就会有人要嘲讽走路的歌颂跑步的，却没想过要先走才能跑;1;0;1;54433;1.8371208641816546e-05
50950;据我所知，那个国外的并没有画图功能;9;0;9;54433;0.0001653408777763489
51008;抄就大胆的抄，又不丢人;1;0;1;54433;1.8371208641816546e-05
51045;我内测名额还没通过不然我也试试;2;0;2;54433;3.674241728363309e-05
51058;十分生;1;34;35;54433;0.000642992302463579
51060;打什么？;1;12;13;54433;0.00023882571234361508
51062;Arrebol;1;2;3;54433;5.511362592544963e-05
51065;林xx（纯爱战神）柔弱的小棉花MrLeft;2;1;3;54433;5.511362592544963e-05
51068;sanction;1;1;2;54433;3.674241728363309e-05
51070;小张;1;1;2;54433;3.674241728363309e-05
51073;早啊早啊;1;0;1;54433;1.8371208641816546e-05
51075;沐浴晚风;1;0;1;54433;1.8371208641816546e-05
51088;0;241;730;971;54433;0.017838443591203866
51330;0;121;249;370;54433;0.006797347197472122
51452;0;82;461;543;54433;0.009975566292506384
51535;都是直译然后交给stablediffusion;10;169;179;54433;0.0032884463468851616
51546;青梅竹马？;9;667;676;54433;0.012418937041867984
51556;这才是车水马龙;19;382;401;54433;0.007366854665368435
51576;据说是先翻译成英文，然后再绘画。比如，鼠标，他就只会画老鼠，mouse;11;422;433;54433;0.007954733341906564
51588;显然是直接调用stablediffusion画的，不支持成语，所以是直译成英文的词条来生成的;2;76;78;54433;0.0014329542740616906
51591;评论区看到的，真的很厉害;22;126;148;54433;0.002718938878988849
51614;夫妻肺片呢;5;100;105;54433;0.0019289769073907372
51620;我的不一样;11;34;45;54433;0.0008267043888817446
51632;这很明显就是把中文翻译成英文后生的图吧，这模型绝对不是中文模型，百度，懂的都懂;11;17;28;54433;0.0005143938419708633
51644;0;7;55;62;54433;0.0011390149357926257
51652;女孩和树那个是什么成语？;14;8;22;54433;0.000404166590119964
51686;看到那么多离谱的图大家有没有想过他是会自我学习的也许用不了多少时间她就会变的很强大;1;0;1;54433;1.8371208641816546e-05
51688;套用的gtp接口，先翻译成英文;1;0;1;54433;1.8371208641816546e-05
51705;它为什么不直接画一个洒水车;1;2;3;54433;5.511362592544963e-05
51707;能不能喊它画个老婆饼;1;0;1;54433;1.8371208641816546e-05
51711;0;1;2;3;54433;5.511362592544963e-05
51715;这才是马龙;1;3;4;54433;7.348483456726618e-05
51717;马猴烧酒宝贝看这个;1;0;1;54433;1.8371208641816546e-05
51723;人工智能，国内和国外各有千秋，中国注重人工，国外注重智能;1;7;8;54433;0.00014696966913453236
51726;这个还是没办法的，你不能让一个刚学会中文的孩子学会什么叫比喻和成语吧，毕竟我们汉语博大精深;3;0;3;54433;5.511362592544963e-05
51731;小鸡啄米图;3;7;10;54433;0.00018371208641816545
51736;0;3;3;6;54433;0.00011022725185089927
51742;我觉得这画得很有创意;1;2;3;54433;5.511362592544963e-05
51745;确定不是有人在恶搞？;1;0;1;54433;1.8371208641816546e-05
51748;GoGo太有意思了，在中国暂时不会失业;3;2;5;54433;9.185604320908272e-05
51756;AnAn笑死了;1;0;1;54433;1.8371208641816546e-05
51758;一开始肯定是人工智障慢慢来吧哈哈哈哈哈;2;2;4;54433;7.348483456726618e-05
51763;如风如塑应该先百度一下然后，再转;1;1;2;54433;3.674241728363309e-05
51772;今天我必早睡看评论;1;0;1;54433;1.8371208641816546e-05
51774;欲说还休看评论;1;0;1;54433;1.8371208641816546e-05
51789;浓烟下看评论;1;1;2;54433;3.674241728363309e-05
51791;泥泥看评论;1;0;1;54433;1.8371208641816546e-05
51793;这是接了外国的API吧;1;3;4;54433;7.348483456726618e-05
51795;有没有可能后台算法用的老外的，这些理解可都是汉译英的处理感觉;1;17;18;54433;0.0003306817555526978
51799;好爱芋泥啊;2;0;2;54433;3.674241728363309e-05
51808;黄焖鸡米花真的拉;1;0;1;54433;1.8371208641816546e-05
51812;0;2;0;2;54433;3.674241728363309e-05
51815;一杯冰美式那场大雨毁了、大学梦。”笑死了;1;0;1;54433;1.8371208641816546e-05
51819;毓见你贞好丫你画我猜;1;0;1;54433;1.8371208641816546e-05
51827;小提琴看评论;1;0;1;54433;1.8371208641816546e-05
51834;吃老冰棍看评论;1;0;1;54433;1.8371208641816546e-05
51841;我让画八卦图，出来四个女的;4;32;36;54433;0.0006613635111053956
51847;感觉这个ai画的都好恐怖echo;2;1;3;54433;5.511362592544963e-05
51855;ddddddddoddddddddo评论区;1;0;1;54433;1.8371208641816546e-05
51859;西木梨国内这技术;1;2;3;54433;5.511362592544963e-05
51874;热心市民李好好看评论;1;0;1;54433;1.8371208641816546e-05
51882;怎么申请呀;1;1;2;54433;3.674241728363309e-05
51885;丸子想睡觉笑死我了看评论区的图一个比一个离谱;1;0;1;54433;1.8371208641816546e-05
51891;说白了他这个ai在nlp方面研究还不够充分，只能将成语拆分成不同的字词再拼接成画;1;7;8;54433;0.00014696966913453236
51895;内壳怕还是别人的吧，是翻译成英文这画就没画错;1;1;2;54433;3.674241728363309e-05
51902;悲哀;1;0;1;54433;1.8371208641816546e-05
51904;起码证明是真的，不是套壳;4;10;14;54433;0.00025719692098543164
51909;这已经是国内技术天花板了加油啊，给他时间;1;1;2;54433;3.674241728363309e-05
51911;虽然有些不足，但国内厂商本来就有差距，也不是一口气吃成胖子的，没有这些国内厂商的探索，那市场只能全被国外占领;3;3;6;54433;0.00011022725185089927
51915;百度那个不是跟风做的，文心一言和元宇宙;1;1;2;54433;3.674241728363309e-05
51921;我看了一个视频车水马龙gpt都画不出来不知道真的假的;1;1;2;54433;3.674241728363309e-05
51924;0;6;10;16;54433;0.00029393933826906473
51934;感觉是接入了国外ai，成语单字翻译后的效果感觉遥遥领先了;2;47;49;54433;0.0009001892234490107
51943;0;9;5;14;54433;0.00025719692098543164
51955;0;5;12;17;54433;0.00031231054691088127
51961;爱说话的汤姆猫都能吊打文心一言;1;16;17;54433;0.00031231054691088127
51971;来个有容乃大;1;2;3;54433;5.511362592544963e-05
51977;我觉得能目前来说能做到国外的百分之30的水准已经很棒了;1;0;1;54433;1.8371208641816546e-05
51979;马呢;1;1;2;54433;3.674241728363309e-05
51981;四月;1;0;1;54433;1.8371208641816546e-05
51983;晗晗934;1;0;1;54433;1.8371208641816546e-05
51999;嗯;1;0;1;54433;1.8371208641816546e-05
52002;欧阳凌;1;0;1;54433;1.8371208641816546e-05
52010;Pumpkin评论;1;0;1;54433;1.8371208641816546e-05
52017;谛璃;1;2;3;54433;5.511362592544963e-05
52021;好多云;1;0;1;54433;1.8371208641816546e-05
52028;空格;1;0;1;54433;1.8371208641816546e-05
52032;肖瞳;1;0;1;54433;1.8371208641816546e-05
52038;Zeikiu太平小甜甜蓝鸟阿雅eatalot一只小溜溜吖山南犬AAA一米八腹肌弟弟批发零售Soulit;2;0;2;54433;3.674241728363309e-05
52041;说明真是他们开发的;11;483;494;54433;0.009075377069057373
52053;百度还是那个百度;45;198;243;54433;0.00446420369996142
52099;0;4;57;61;54433;0.0011206437271508093
52104;0;3;43;46;54433;0.000845075597523561
52109;你们想想，百度那水平，自研ai也只能做到这种程度，那猜猜现在市面上那些收费ai成图率极好的技术是从哪里来的？;2;6;8;54433;0.00014696966913453236
52112;让它画张爱国猫，它直接画了满身美国国旗的猫真TM牛逼，爱美国呗;2;4;6;54433;0.00011022725185089927
52120;都是百度搜的图片，你们真信了;1;2;3;54433;5.511362592544963e-05
52137;灬杰百度真丢人，;1;0;1;54433;1.8371208641816546e-05
52139;emmmm我踏马笑死了你看评论;1;0;1;54433;1.8371208641816546e-05
52268;酒店猛狗和药店飞龙都是成语，没想到吧;402;7854;8256;54433;0.1516726985468374
52671;这种成语加入考试我们是该喝西北风了;422;23000;23422;54433;0.4302904488086271
53095;我可以玩这种梗但你别给我加到文学辞典里;92;8407;8499;54433;0.15613690224679883
53188;酒店猛狗什么意思;28;578;606;54433;0.011132952436940827
53217;冬日可爱我记得小撒说过;7;1613;1620;54433;0.029761357999742805
53225;千薪万苦拿着三千元的薪资，有着万倍的辛苦;23;214;237;54433;0.004353976448110521
53249;成语不也是人造的，，只要我坚持用，一百年后它也会成为成语;7;295;302;54433;0.0055481050098285965
53257;酒店猛狗才不是成语;11;137;148;54433;0.002718938878988849
53269;十字路口也是成语;18;267;285;54433;0.005235794462917716
53288;自以为是就是成语;4;689;693;54433;0.012731247588778865
53293;好厉害，第一题就答对了，要我的话不会选D;2;253;255;54433;0.004684658203663219
53296;为什么我查自以为是是成语啊，到底我该信哪个;5;141;146;54433;0.0026821964617052157
53302;可不止懂成语，乘法用的也很6;15;97;112;54433;0.002057575367883453
53318;得亏看过密室大逃脱大神版知道博士买驴;4;56;60;54433;0.0011022725185089927
53323;好想知道成语是怎么认定的;6;48;54;54433;0.0009920452666580934
53330;梵木木阴阳怪气是真的笑死了;1;0;1;54433;1.8371208641816546e-05
53332;杨羊羊了;1;0;1;54433;1.8371208641816546e-05
53334;小小一只它没被开发好;1;0;1;54433;1.8371208641816546e-05
53341;逃跑小笼包妮妮焕。鱼儿星冰乐不懂我要出国留学;2;0;2;54433;3.674241728363309e-05
53348;零零陆幺陆沉你看她ki7呆呆oO延灼来涨知识喽;4;0;4;54433;7.348483456726618e-05
53353;Bubble这都是啥奇怪的成语;1;0;1;54433;1.8371208641816546e-05
53356;白云祈真的假的啊;1;0;1;54433;1.8371208641816546e-05
53358;菠菜冬日可爱是成语还有夏日可畏，这俩我印象深刻;1;1;2;54433;3.674241728363309e-05
53370;BBH自以为是不是成语;1;0;1;54433;1.8371208641816546e-05
53372;猪大肠我也是有学问的人;1;0;1;54433;1.8371208641816546e-05
53374;一只鱼孙老师说的这个;1;0;1;54433;1.8371208641816546e-05
53376;初春饰利把蛤蟆艾特过来让她看看;3;1;4;54433;7.348483456726618e-05
53383;李宇冬这些词语好离谱;1;0;1;54433;1.8371208641816546e-05
53386;还有惨绿少年也是成语;2;9;11;54433;0.000202083295059982
53391;帅梨离落萱萱很饿考试能写吗;1;2;3;54433;5.511362592544963e-05
53407;喜歡酒店猛狗是啥;1;0;1;54433;1.8371208641816546e-05
53414;星星躲进银河滩我真是自以为是;1;1;2;54433;3.674241728363309e-05
53417;赖赖今天有开心嘛自以为是不是成语？我不信;1;0;1;54433;1.8371208641816546e-05
53419;我第一反应：名学;1;12;13;54433;0.00023882571234361508
53424;如果自以为是不是成语，那题目不就是回答对了，up主在表达什么？;1;8;9;54433;0.0001653408777763489
53426;你们猜加减乘除是不是成语;2;7;9;54433;0.0001653408777763489
53430;惨绿少年也是成语啊啊啊哈哈哈哈哈哈;1;25;26;54433;0.00047765142468723015
53433;啦啦露露笑死，酒店猛狗是成语;1;0;1;54433;1.8371208641816546e-05
53436;杀死鱼腥草喝西北风也是？;1;1;2;54433;3.674241728363309e-05
53439;成语都是有典故的吧;2;41;43;54433;0.0007899619715981115
53447;涂鸦小狗白洛邃任璇听冬日可爱好可爱的成语啊;1;2;3;54433;5.511362592544963e-05
53449;小城故事（e酱贴贴版密神被科普过啊哈哈哈哈哈哈博士买驴冬日可爱喝西北风;1;0;1;54433;1.8371208641816546e-05
53453;圆圆真的是好人《冬日可爱》《博士买驴》;1;1;2;54433;3.674241728363309e-05
53455;我当时跟小爱同学玩成语接龙，她直接给我来一个“令人喷饭”我心想，逗我玩呢？然后不甘心百度一下，果然是成语是我孤陋寡闻了;2;40;42;54433;0.0007715907629562949
53458;小xin长不高Neflibata一只团子？？？自以为是不是成语？？;1;0;1;54433;1.8371208641816546e-05
53460;你这个本来和结果用的我cpu都被你干废了;1;48;49;54433;0.0009001892234490107
53462;euina湘湘湘湘湘子李天泽淋子DylansnAbsurd;1;2;3;54433;5.511362592544963e-05
53466;Chelsea让我再眯一会儿YOLO。;2;0;2;54433;3.674241728363309e-05
53469;251624;2;0;2;54433;3.674241728363309e-05
53472;柠檬汽水不是碳酸;1;0;1;54433;1.8371208641816546e-05
53480;跳起来有一米八那么高啊;1;1;2;54433;3.674241728363309e-05
53485;是水族馆里的热带鱼如果我是白色的I;2;0;2;54433;3.674241728363309e-05
53489;没必要woc;1;0;1;54433;1.8371208641816546e-05
53493;失眠日记洛洛睡醒了阿彩暒李一二oy淮意柠檬不加冰丞丞汁我就躺着船飞录水仙了嘛？马铃薯味的土豆小兔子乖乖小迷糊柚颜扬跟着光。朱英Queen和葡萄树抢老婆不羡仙今天好好吃饭了mo陈以默铁锅炖大鹅;4;2;6;54433;0.00011022725185089927
53498;这些真的是成语？还是说因为太多人觉得是才定义为是？;1;9;10;54433;0.00018371208641816545
53500;美女;4;1;5;54433;9.185604320908272e-05
53505;Pibrittttttttttttttt奈奈如果爱有声音Huuub？？？;3;2;5;54433;9.185604320908272e-05
53509;Cyu轩羽毛yuCamellia晓吕泰周这;5;0;5;54433;9.185604320908272e-05
53515;WantonlyAelopexbackDay书生嘻嘻嘻嘻嘻嘻嘻嘻银杏Missmint大大树;2;3;5;54433;9.185604320908272e-05
53518;白天唯物主义者一眼回忆（738版）安了个必安Wyr我没听过他就不是;2;3;5;54433;9.185604320908272e-05
53521;用户339654157231abb顾念幼稚园甫一先生第一年冬c歆ran赵思苦babyKiss倩倩i夏娃ca;3;1;4;54433;7.348483456726618e-05
53525;超级哈哈怪噗噗呲噗零贰woooooo;3;1;4;54433;7.348483456726618e-05
53530;雾是玲不是零睡个好觉KiT白小纯6;2;2;4;54433;7.348483456726618e-05
53533;07国卫国凰白凰酒店猛狗;3;1;4;54433;7.348483456726618e-05
53537;千池中魚？;2;2;4;54433;7.348483456726618e-05
53541;一壶梨花白你怎么知道我喜欢马尔济斯帐号已注销就你吃不饱邵阳术术（找我学跳舞）娜娜思密达扁桃体不用发言靳译肯打倒光头6;2;1;3;54433;5.511362592544963e-05
53544;王嘉尔的巴斯光年眰恦Y天才方方方方方TryingxAuAAAA水泥厂服务员小美林安文盲们来涨知识;2;1;3;54433;5.511362592544963e-05
53547;逢屿次吃吃居居女孩;2;1;3;54433;5.511362592544963e-05
53550;为什么吃施该喝西北风了;3;0;3;54433;5.511362592544963e-05
53554;顺利小兑咕叽柯珂;3;0;3;54433;5.511362592544963e-05
53558;孤独的游标卡尺;3;0;3;54433;5.511362592544963e-05
53562;快乐的墨丞你吃中轴线吗？真的会栓QAsilal见过，会了，了，下次考试试试;2;1;3;54433;5.511362592544963e-05
53565;ta;1;2;3;54433;5.511362592544963e-05
53568;黎鹏骧？;1;1;2;54433;3.674241728363309e-05
53570;念;1;1;2;54433;3.674241728363309e-05
53572;叶某芜湖小湿透;1;1;2;54433;3.674241728363309e-05
53574;姜赵阳煟佳玉宋宋张张;2;0;2;54433;3.674241728363309e-05
53577;安芸磊QAQQAQsriktnt小丸子超爱吃芫荽;2;0;2;54433;3.674241728363309e-05
53580;toecAug277的笨鸟版暴龙战士;2;0;2;54433;3.674241728363309e-05
53583;没事早点睡;2;0;2;54433;3.674241728363309e-05
53586;果子不吃小龙虾终陌吾二零RE6;2;0;2;54433;3.674241728363309e-05
53589;大西瓜久练则诚MH哈哈哈哈哈，救命;2;0;2;54433;3.674241728363309e-05
53592;没口袋的机器猫崽儿蒜头星星不闪包退今时不同往日;2;0;2;54433;3.674241728363309e-05
53595;Gianapqw烤得太辣了吧独木舟;2;0;2;54433;3.674241728363309e-05
53598;小韵;2;0;2;54433;3.674241728363309e-05
53601;快乐雉盎;2;0;2;54433;3.674241728363309e-05
53604;爆炒鸡肉楠oo；灰色匿名信LinininaBi8bo一生悔梦到小熊蚊子嗡嗡嗡心碎讨厌鬼阿尔羽枳好内个;1;1;2;54433;3.674241728363309e-05
53606;春森野（爱15亿版nnm豆几快跑黄油吐司焦虑晚期Spring你要不要看看你在说什么岁岁年年aaaaa;1;1;2;54433;3.674241728363309e-05
53608;x雨;1;1;2;54433;3.674241728363309e-05
53610;译Xzz：yaaajoyJackrabbit于忠;1;1;2;54433;3.674241728363309e-05
53612;夏一年;1;1;2;54433;3.674241728363309e-05
53614;su;1;1;2;54433;3.674241728363309e-05
53616;汐;1;1;2;54433;3.674241728363309e-05
53618;shenwenjie;1;1;2;54433;3.674241728363309e-05
53620;享乐主义;1;1;2;54433;3.674241728363309e-05
53622;周口店人Eziiimenggg;1;1;2;54433;3.674241728363309e-05
53624;奚奚嘻嘻WWWW不是仔嗯;1;1;2;54433;3.674241728363309e-05
53626;0;1;1;2;54433;3.674241728363309e-05
53628;小狗摇尾巴不太喜欢吃香菜苏南来口烤年糕;1;1;2;54433;3.674241728363309e-05
53632;yuyeeroeyCassie;1;1;2;54433;3.674241728363309e-05
53637;粑粑？;1;1;2;54433;3.674241728363309e-05
53639;香茅草烤鱼甄普通;1;1;2;54433;3.674241728363309e-05
53713;达令哒大琳;1;0;1;54433;1.8371208641816546e-05
53715;一枕春酲蛤蟆夜哭;1;0;1;54433;1.8371208641816546e-05
53717;阿薛本薛;1;0;1;54433;1.8371208641816546e-05
53719;千昭词;1;0;1;54433;1.8371208641816546e-05
53721;冬韵;1;0;1;54433;1.8371208641816546e-05
53723;没有耳机;1;0;1;54433;1.8371208641816546e-05
53725;许一言不悔真心;1;0;1;54433;1.8371208641816546e-05
53727;Falsify;1;0;1;54433;1.8371208641816546e-05
53729;阿祁;1;0;1;54433;1.8371208641816546e-05
53731;0;1;0;1;54433;1.8371208641816546e-05
53733;江南诗;1;0;1;54433;1.8371208641816546e-05
53735;6H想做有钱人;1;0;1;54433;1.8371208641816546e-05
53737;Wulu山东第一大情种我是大鹅ctryq7討厭和人歸類;1;0;1;54433;1.8371208641816546e-05
53739;嫩叠yyds祈一季秋日小王爱喝旺仔牛奶;1;0;1;54433;1.8371208641816546e-05
53741;0;1;0;1;54433;1.8371208641816546e-05
53743;蒜蒜;1;0;1;54433;1.8371208641816546e-05
53745;残留笑颜;1;0;1;54433;1.8371208641816546e-05
53747;代代；;1;0;1;54433;1.8371208641816546e-05
53749;狼殇;1;0;1;54433;1.8371208641816546e-05
53751;完了;1;0;1;54433;1.8371208641816546e-05
53753;only？？;1;0;1;54433;1.8371208641816546e-05
53755;啦啦啦啦啦啦;1;0;1;54433;1.8371208641816546e-05
53757;伤心的鸡块惗吃电灯泡的猫呃;1;0;1;54433;1.8371208641816546e-05
53759;中距离;1;0;1;54433;1.8371208641816546e-05
53761;想要拥有Magic;1;0;1;54433;1.8371208641816546e-05
53763;0;1;0;1;54433;1.8371208641816546e-05
53765;我不是非主流;1;0;1;54433;1.8371208641816546e-05
53767;0;1;0;1;54433;1.8371208641816546e-05
53769;你瞒我瞒;1;0;1;54433;1.8371208641816546e-05
53771;橘子？;1;0;1;54433;1.8371208641816546e-05
53773;木木;1;0;1;54433;1.8371208641816546e-05
53775;0;1;0;1;54433;1.8371208641816546e-05
53777;Ronin;1;0;1;54433;1.8371208641816546e-05
53779;Dzhao;1;0;1;54433;1.8371208641816546e-05
53781;xy？;1;0;1;54433;1.8371208641816546e-05
53783;0;1;0;1;54433;1.8371208641816546e-05
53785;iYXxx;1;0;1;54433;1.8371208641816546e-05
53787;橘;1;0;1;54433;1.8371208641816546e-05
53789;睡睡平安小橙子;1;0;1;54433;1.8371208641816546e-05
53791;也曾指尖弹出盛夏蛤蟆夜哭;1;0;1;54433;1.8371208641816546e-05
53793;什么溜溜梅？;1;0;1;54433;1.8371208641816546e-05
53795;7777777;1;0;1;54433;1.8371208641816546e-05
53797;酒精过敏;1;0;1;54433;1.8371208641816546e-05
53799;陪小张看海鸥77和笨鸟喜欢嵩嵩雾岛听风饺子jvzi;1;0;1;54433;1.8371208641816546e-05
53801;秋子桐;1;0;1;54433;1.8371208641816546e-05
53803;思绪愿;1;0;1;54433;1.8371208641816546e-05
53805;椿与湫;1;0;1;54433;1.8371208641816546e-05
53807;日系少女八嘎酱困困;1;0;1;54433;1.8371208641816546e-05
53809;木;1;0;1;54433;1.8371208641816546e-05
53811;落落梅;1;0;1;54433;1.8371208641816546e-05
53813;看心情少PUA我SY;1;0;1;54433;1.8371208641816546e-05
53815;清粢;1;0;1;54433;1.8371208641816546e-05
53817;大跌;1;0;1;54433;1.8371208641816546e-05
53819;时光;1;0;1;54433;1.8371208641816546e-05
53821;沐曦凉;1;0;1;54433;1.8371208641816546e-05
53823;韭菜夹心蛋糕;1;0;1;54433;1.8371208641816546e-05
53825;ZWenLJQQQ蛤蟆夜哭;1;0;1;54433;1.8371208641816546e-05
53827;Renaissance;1;0;1;54433;1.8371208641816546e-05
53829;DuoDuoDuodd;1;0;1;54433;1.8371208641816546e-05
53831;为卢少冲锋5;1;0;1;54433;1.8371208641816546e-05
53833;逾越善见24K纯帅6v帅气的鼻嘎SHAN;1;0;1;54433;1.8371208641816546e-05
53835;惜别君;1;0;1;54433;1.8371208641816546e-05
53837;oneninth;1;0;1;54433;1.8371208641816546e-05
53839;ljjj;1;0;1;54433;1.8371208641816546e-05
53841;Nnnnn椰丝玺烊烊爱意;1;0;1;54433;1.8371208641816546e-05
53843;棣Dys;1;0;1;54433;1.8371208641816546e-05
53845;是霖铃呀;1;0;1;54433;1.8371208641816546e-05
53847;温柔起了意经年;1;0;1;54433;1.8371208641816546e-05
53849;秦深6;1;0;1;54433;1.8371208641816546e-05
53851;暴龙战士最终形态;1;0;1;54433;1.8371208641816546e-05
53853;今天又丑了;1;0;1;54433;1.8371208641816546e-05
53855;可呃珂SGH月亮也晚安（没素质版）夏日祺圆叫我林妹妹;1;0;1;54433;1.8371208641816546e-05
53857;念;1;0;1;54433;1.8371208641816546e-05
53859;皮卡丘很皮我靠;1;0;1;54433;1.8371208641816546e-05
53861;风流少女;1;0;1;54433;1.8371208641816546e-05
53863;聪明小代;1;0;1;54433;1.8371208641816546e-05
53865;小航孤单单（StatTrak）;1;0;1;54433;1.8371208641816546e-05
53867;小小鼬;1;0;1;54433;1.8371208641816546e-05
53869;加非Oo小粉香泥乐堡杯;1;0;1;54433;1.8371208641816546e-05
53871;晚归19岁高冷师太冷枫鸢澈何春秋普信小泽江晚画卿颜奥;1;0;1;54433;1.8371208641816546e-05
53873;莫寒;1;0;1;54433;1.8371208641816546e-05
53875;Mu;1;0;1;54433;1.8371208641816546e-05
53877;想吃鱼;1;0;1;54433;1.8371208641816546e-05
53879;喵喵喵喵喵喵805号落日捕手;1;0;1;54433;1.8371208641816546e-05
53881;Y;1;0;1;54433;1.8371208641816546e-05
53883;Word麻鸭only核桃小酥;1;0;1;54433;1.8371208641816546e-05
53885;saint蛤蟆夜哭;1;0;1;54433;1.8371208641816546e-05
53887;狗蛋蛤蟆夜哭;1;0;1;54433;1.8371208641816546e-05
53889;Ming，;1;0;1;54433;1.8371208641816546e-05
53891;Annie;1;0;1;54433;1.8371208641816546e-05
53893;Road每天在想吃什么别别别管我啦;1;0;1;54433;1.8371208641816546e-05
53895;21810;1;0;1;54433;1.8371208641816546e-05
53897;小贼白菜;1;0;1;54433;1.8371208641816546e-05
53899;螺不想吃饭1、犊笑死的狗韦佳佳ya热的冰美式渔火2323;1;0;1;54433;1.8371208641816546e-05
53901;cuzof？？？？？？？？;1;0;1;54433;1.8371208641816546e-05
53903;脚趾爆炸了高台跳水;1;0;1;54433;1.8371208641816546e-05
53905;Bestie言山斤Coisinillx7;1;0;1;54433;1.8371208641816546e-05
53907;抹茶色的冬？？;1;0;1;54433;1.8371208641816546e-05
53909;爱吃鱼薯塔时杯橙子汁訑落清声明天几号Cliiwen？;1;0;1;54433;1.8371208641816546e-05
53911;42郁金香里表白小11下意识有空就去;1;0;1;54433;1.8371208641816546e-05
53913;枕星落日眠哈？;1;0;1;54433;1.8371208641816546e-05
53915;安得万顷池蛤蟆夜哭？？？;1;0;1;54433;1.8371208641816546e-05
53917;与亭岁岁年年蛤蟆夜哭;1;0;1;54433;1.8371208641816546e-05
53919;欣宝O原来老子是社畜，我操;1;0;1;54433;1.8371208641816546e-05
53921;冬眠啥;1;0;1;54433;1.8371208641816546e-05
54066;搞笑女的日常生活;1;1;2;54433;3.674241728363309e-05
54069;爱吃芫荽还有拿不出手;1;1;2;54433;3.674241728363309e-05
54074;楚青良辰美jing我不困不困金鸨温柔养虎人今天吃什么好呢我给这写到成语填空里刘文君敢说我这不是成语吗;2;1;3;54433;5.511362592544963e-05
54083;哎哟喂;1;1;2;54433;3.674241728363309e-05
54088;木已成舟;1;1;2;54433;3.674241728363309e-05
54092;聂晚好天亮就睡AAA专业疏通下水道小洪1nk150;1;1;2;54433;3.674241728363309e-05
54099;如绵TT心空努力努力再努力h等哥们也创几个塞百度词条里面;1;1;2;54433;3.674241728363309e-05
54103;忆Bi8b奶盖芋泥球火锅底料耶时柒高冷的荷包蛋臭臭怪Sy笨蛋，iivioo笑死我;2;1;3;54433;5.511362592544963e-05
54107;太白;1;1;2;54433;3.674241728363309e-05
54117;亦之;1;1;2;54433;3.674241728363309e-05
54120;好运莲莲翊黏豆包小天使小太阳tttTt;2;1;3;54433;5.511362592544963e-05
54123;好奇海绵（想摸狗版L朴综星流霆击衾衣（仁俊老公版）我是文盲来的;4;1;5;54433;9.185604320908272e-05
54128;C;1;1;2;54433;3.674241728363309e-05
54138;林陌陌;1;1;2;54433;3.674241728363309e-05
54143;用户2350852681075;1;1;2;54433;3.674241728363309e-05
54145;张z晴晴晴;1;1;2;54433;3.674241728363309e-05
54151;SgrTroyeZ长了腿的年糕MAGICWann让我想起了李某人的惨绿少年;2;1;3;54433;5.511362592544963e-05
54155;现在拥抱;2;1;3;54433;5.511362592544963e-05
54164;睡不醒博士买驴？;1;1;2;54433;3.674241728363309e-05
54176;温柔;1;1;2;54433;3.674241728363309e-05
54180;木杉械jiaojiao;1;1;2;54433;3.674241728363309e-05
54182;0;1;1;2;54433;3.674241728363309e-05
54186;Eternity新篇章Oo“出口成脏”;1;1;2;54433;3.674241728363309e-05
54192;想看山北obe奥菲夏栀麻花真好吃兴快看天上有星星也笑死我了;1;1;2;54433;3.674241728363309e-05
54199;沢田纲吉依恋症（工作版）？？？？？？;1;1;2;54433;3.674241728363309e-05
54203;潘姐秘制炸鸡腿;1;1;2;54433;3.674241728363309e-05
54208;暧昧;1;1;2;54433;3.674241728363309e-05
54210;纯白陈宇来两句成语;1;1;2;54433;3.674241728363309e-05
54214;魈魈不知道桃花苏;1;1;2;54433;3.674241728363309e-05
54216;semi本身oooayaki涵AYoLo好会哦;1;1;2;54433;3.674241728363309e-05
54219;你才是文盲;2;1;3;54433;5.511362592544963e-05
54224;怪咖;2;1;3;54433;5.511362592544963e-05
54229;清雨;2;1;3;54433;5.511362592544963e-05
54241;言汐尼玛Lxiang甜崽小璇;1;1;2;54433;3.674241728363309e-05
54248;Fairy;1;1;2;54433;3.674241728363309e-05
54255;号帆船shoto麦外敷星雾iljen;2;1;3;54433;5.511362592544963e-05
54260;我是小卢，小李是我的好朋友Win;1;1;2;54433;3.674241728363309e-05
54262;YZW;1;1;2;54433;3.674241728363309e-05
54265;綵真源有呼安陪啦消遣;2;1;3;54433;5.511362592544963e-05
54272;是思奇呀歪歪ds草莓脑袋119闪闪惹人爱6;1;1;2;54433;3.674241728363309e-05
54275;YAN;1;1;2;54433;3.674241728363309e-05
54284;FFcourkshhx;3;1;4;54433;7.348483456726618e-05
54290;新之助;1;1;2;54433;3.674241728363309e-05
54292;豪的烦心柿涨下知识;1;1;2;54433;3.674241728363309e-05
54295;海带猪蹄汤？我又是文盲了;1;1;2;54433;3.674241728363309e-05
54297;僵湿湿清澈的愚蠢ottoapocalisTXT;1;1;2;54433;3.674241728363309e-05
54299;吖lying微凉巧克力飒酷拉酱圣塞西尔第一温柔M;1;1;2;54433;3.674241728363309e-05
54301;柴柴柴柴柴;1;1;2;54433;3.674241728363309e-05
54303;huan悲伤的螺蛳粉;1;1;2;54433;3.674241728363309e-05
54306;芜湖;1;1;2;54433;3.674241728363309e-05
54308;夏草成为了阻碍再给我说一遍喝西北风是什么;1;1;2;54433;3.674241728363309e-05
54310;再看一次夕阳等天亮VK;3;1;4;54433;7.348483456726618e-05
54316;盒盒盒;1;1;2;54433;3.674241728363309e-05
54324;爱吃香菜4ea作业遍布全球朝颖下周五见YS;1;1;2;54433;3.674241728363309e-05
54327;是只汽水熊叮叮车蒲草小鱼YRRRRR;1;1;2;54433;3.674241728363309e-05
54329;岁年奕咩咩dytvoobodqq随便捡的屎多肉葡萄加糖无语梦八是7一个大写Y？？？;1;1;2;54433;3.674241728363309e-05
54332;ZzZRyyF9不是不是不是不是不是;2;1;3;54433;5.511362592544963e-05
54335;嗯;1;1;2;54433;3.674241728363309e-05
54337;猴子且大王阿yi肖恩老哥举个栗子粉末状的在校生;1;1;2;54433;3.674241728363309e-05
54340;尋啊？啥？;1;1;2;54433;3.674241728363309e-05
54343;AAAA重生之叶刷疯狂爱上我重生版阿拉斯加小鱼总纳兰容若肥猪佩奇9绘图集小黑煤球;1;1;2;54433;3.674241728363309e-05
54346;Eason;1;1;2;54433;3.674241728363309e-05
54352;不是，道理我都懂，为什么高考要考成语应用啊过年要吃小夕瓜嘎巴雾声;2;1;3;54433;5.511362592544963e-05
54364;失眠小羊又下雨特ong彤陪我看海夢涵失雾;3;1;4;54433;7.348483456726618e-05
54369;星星会眨眼吖什么玩意，一下子给我CPU烧了;1;1;2;54433;3.674241728363309e-05
54372;细雨落青街红叶兮亿陌屿;2;1;3;54433;5.511362592544963e-05
54375;怡XXXlll知了不知道你们还记得吗;1;1;2;54433;3.674241728363309e-05
54379;超级好名字;1;1;2;54433;3.674241728363309e-05
54385;讨厌星期一PoissonYena还好小瑞宝宝终予海勿忘名;1;1;2;54433;3.674241728363309e-05
54399;孤gu;1;1;2;54433;3.674241728363309e-05
54403;时雨于阁楼静早冬峙令人喷饭;1;1;2;54433;3.674241728363309e-05
54412;玛格设计师徐鑫长知识了;1;1;2;54433;3.674241728363309e-05
54415;饿饿;1;1;2;54433;3.674241728363309e-05
54422;妍妍記住姸鹿鹿i舔狗抱着花花去找小炸猛踹瘸子那条好腿;2;1;3;54433;5.511362592544963e-05
54426;O泡没戴眼镜我听不清;2;1;3;54433;5.511362592544963e-05
54430;薛定猫;1;1;2;54433;3.674241728363309e-05
54435;霓白;1;1;2;54433;3.674241728363309e-05
54438;令人喷饭这个我印象贼深刻;1;1;2;54433;3.674241728363309e-05
54443;一杯疯（蓝曦臣）;1;1;2;54433;3.674241728363309e-05
54504;Y00PicriX;1;0;1;54433;1.8371208641816546e-05
54506;Cc不是心碎小狗;1;0;1;54433;1.8371208641816546e-05
54512;阳光男孩只走东不走西摆烂真君惠酒店猛狗;1;0;1;54433;1.8371208641816546e-05
54515;lllllllllc润如酥qwq罐装;2;0;2;54433;3.674241728363309e-05
54520;蓝胖子哆啦;1;0;1;54433;1.8371208641816546e-05
54526;飘逸的腋毛;1;0;1;54433;1.8371208641816546e-05
54531;吃定彩虹。;1;0;1;54433;1.8371208641816546e-05
54534;嘻嘻;1;0;1;54433;1.8371208641816546e-05
54536;该死的小张wan（26（棣欣引力版）：小狗炒饭Tito彤WHH纵情山河万里啊？;3;0;3;54433;5.511362592544963e-05
54540;xEnayuakxbmrevfl;1;0;1;54433;1.8371208641816546e-05
54542;贰;1;0;1;54433;1.8371208641816546e-05
54545;番茄小狗;1;0;1;54433;1.8371208641816546e-05
54549;回声;1;0;1;54433;1.8371208641816546e-05
54555;热爱;1;0;1;54433;1.8371208641816546e-05
54559;嘎吱脆吖bble每天都很困Rebecca;1;0;1;54433;1.8371208641816546e-05
54561;空吧哇;1;0;1;54433;1.8371208641816546e-05
54566;疯狂炫蛋挞海湾;1;0;1;54433;1.8371208641816546e-05
54568;Qjy;1;0;1;54433;1.8371208641816546e-05
54570;不要拖延;1;0;1;54433;1.8371208641816546e-05
54575;b0un;1;0;1;54433;1.8371208641816546e-05
54579;打烊;1;0;1;54433;1.8371208641816546e-05
54584;沙子星星？;1;0;1;54433;1.8371208641816546e-05
54590;林林比奇堡镇贝壳街124号海绵宝宝;2;0;2;54433;3.674241728363309e-05
54594;有礼貌但不多（得译症版）;1;0;1;54433;1.8371208641816546e-05
54600;你怎么可以吃兔兔;1;0;1;54433;1.8371208641816546e-05
54602;圈又圈;1;0;1;54433;1.8371208641816546e-05
54604;小金花;1;0;1;54433;1.8371208641816546e-05
54606;小雨;1;0;1;54433;1.8371208641816546e-05
54608;llio;1;0;1;54433;1.8371208641816546e-05
54614;七安;1;0;1;54433;1.8371208641816546e-05
54616;半小时秋;1;0;1;54433;1.8371208641816546e-05
54622;慕源帅哥挖掘机Clear海盐不甜了;2;0;2;54433;3.674241728363309e-05
54629;睡个好觉;1;0;1;54433;1.8371208641816546e-05
54632;粥粥酱笑死;1;0;1;54433;1.8371208641816546e-05
54634;迪斯尼在逃;1;0;1;54433;1.8371208641816546e-05
54637;林夕omg哈哈哈;1;0;1;54433;1.8371208641816546e-05
54639;洁儿就是二;1;0;1;54433;1.8371208641816546e-05
54641;不是小高;1;0;1;54433;1.8371208641816546e-05
54645;心動;1;0;1;54433;1.8371208641816546e-05
54647;面包脑袋;1;0;1;54433;1.8371208641816546e-05
54649;koi鱼音;2;0;2;54433;3.674241728363309e-05
54653;举个栗子？;1;0;1;54433;1.8371208641816546e-05
54657;许谦安麦麦有只猫fullsunahceah;1;0;1;54433;1.8371208641816546e-05
54662;0;1;0;1;54433;1.8371208641816546e-05
54670;谢顶哥（和平精英）;1;0;1;54433;1.8371208641816546e-05
54672;西希;1;0;1;54433;1.8371208641816546e-05
54675;记得多喝热水哦;1;0;1;54433;1.8371208641816546e-05
54678;YuTinGSunnyAaron王;1;0;1;54433;1.8371208641816546e-05
54683;MiManchi;1;0;1;54433;1.8371208641816546e-05
54685;王瀚林;1;0;1;54433;1.8371208641816546e-05
54689;涟漪有几何听说逆时光的邂逅发光中勿扰吃点啥来这里打望哈帅哥咕噜咕噜QHNU;1;0;1;54433;1.8371208641816546e-05
54691;我超甜;1;0;1;54433;1.8371208641816546e-05
54699;九月阿九大哥;1;0;1;54433;1.8371208641816546e-05
54701;沉安;1;0;1;54433;1.8371208641816546e-05
54704;榴莲泡面头你姑姑生前;1;0;1;54433;1.8371208641816546e-05
54707;ice;1;0;1;54433;1.8371208641816546e-05
54710;牙不疼;1;0;1;54433;1.8371208641816546e-05
54714;w（）吴世勋圈外女友;1;0;1;54433;1.8371208641816546e-05
54716;丢丢;1;0;1;54433;1.8371208641816546e-05
54718;Panda666;1;0;1;54433;1.8371208641816546e-05
54722;蟀过彭于晏;1;0;1;54433;1.8371208641816546e-05
54730;早点睡觉;2;0;2;54433;3.674241728363309e-05
54735;薄荷爱写be文6;1;0;1;54433;1.8371208641816546e-05
54737;A柚子;2;0;2;54433;3.674241728363309e-05
54743;予星河。一直小迷糊;1;0;1;54433;1.8371208641816546e-05
54745;你也不加肉松吗;1;0;1;54433;1.8371208641816546e-05
54748;小桃仙女本仙呜呼啦呼蒋蒋蒋蒋杰瑞女士猴子的尾巴;1;0;1;54433;1.8371208641816546e-05
54751;是马铃薯头诶？;1;0;1;54433;1.8371208641816546e-05
54753;7ioi;1;0;1;54433;1.8371208641816546e-05
54755;晚风等晚安讨厌冷天气续写情话;1;0;1;54433;1.8371208641816546e-05
54759;比巴卜;1;0;1;54433;1.8371208641816546e-05
54761;加蛋烤冷面;1;0;1;54433;1.8371208641816546e-05
54763;爱喝芝麻油;1;0;1;54433;1.8371208641816546e-05
54765;0;1;0;1;54433;1.8371208641816546e-05
54767;m墨宝派大星一无是处畜;2;0;2;54433;3.674241728363309e-05
54771;噢噢;1;0;1;54433;1.8371208641816546e-05
54773;小蜗牛;1;0;1;54433;1.8371208641816546e-05
54775;暗恋沸羊羊找;2;0;2;54433;3.674241728363309e-05
54783;小碎饼;1;0;1;54433;1.8371208641816546e-05
54786;凌熙charmmm;1;0;1;54433;1.8371208641816546e-05
54789;碧落傅诗淇SpaceXzyf尤甜;1;0;1;54433;1.8371208641816546e-05
54792;6;1;0;1;54433;1.8371208641816546e-05
54808;伤心小笨狗文盲竟是我自己;1;0;1;54433;1.8371208641816546e-05
54812;AAZAAcam5114食不食油饼;2;0;2;54433;3.674241728363309e-05
54815;加碗米饭茶弥;2;0;2;54433;3.674241728363309e-05
54818;小张同学我是文盲;2;0;2;54433;3.674241728363309e-05
54822;aaa猪肉批发张姐;1;0;1;54433;1.8371208641816546e-05
54825;kirby悦自以为是不是成语？？？;1;0;1;54433;1.8371208641816546e-05
54828;萍萍;1;0;1;54433;1.8371208641816546e-05
54831;莫负罪洲;1;0;1;54433;1.8371208641816546e-05
54835;19;1;0;1;54433;1.8371208641816546e-05
54837;一只歪嘴小猫火山YYY怡今天也爱svt了生刘文今天笑了吗執困困困困小困荷包蛋揍你;2;0;2;54433;3.674241728363309e-05
54842;挽梦丶亦清歌;1;0;1;54433;1.8371208641816546e-05
54844;我的猫爱我王路飞噶安徽彭于晏;1;0;1;54433;1.8371208641816546e-05
54848;小安爱吃煎蛋;1;0;1;54433;1.8371208641816546e-05
54854;是个吨吨胖儿;1;0;1;54433;1.8371208641816546e-05
54860;小栓菜;1;0;1;54433;1.8371208641816546e-05
54863;HANI;1;0;1;54433;1.8371208641816546e-05
54868;HXMMSDQD;1;0;1;54433;1.8371208641816546e-05
54870;小银先生;1;0;1;54433;1.8371208641816546e-05
54876;Likewinter;1;0;1;54433;1.8371208641816546e-05
54878;噢噢好的;1;0;1;54433;1.8371208641816546e-05
54880;小爱静步刀;1;0;1;54433;1.8371208641816546e-05
54882;幺儿幺幺;1;0;1;54433;1.8371208641816546e-05
54887;枭雄;1;0;1;54433;1.8371208641816546e-05
54889;107;1;0;1;54433;1.8371208641816546e-05
54901;扶风哈哈哈;1;0;1;54433;1.8371208641816546e-05
54903;Hxxxy;1;0;1;54433;1.8371208641816546e-05
54905;。。。，，，;2;0;2;54433;3.674241728363309e-05
54908;爱坤教教主;1;0;1;54433;1.8371208641816546e-05
54910;sakuraqq;1;0;1;54433;1.8371208641816546e-05
54913;RichL;1;0;1;54433;1.8371208641816546e-05
54915;小姜姜笑死了;1;0;1;54433;1.8371208641816546e-05
54920;尔洱;1;0;1;54433;1.8371208641816546e-05
54922;晨;2;0;2;54433;3.674241728363309e-05
54925;Luu;1;0;1;54433;1.8371208641816546e-05
54930;阿俊;1;0;1;54433;1.8371208641816546e-05
54933;ed;1;0;1;54433;1.8371208641816546e-05
54938;想吃冰淇淋蔺晨;2;0;2;54433;3.674241728363309e-05
54949;唯有风知道Cisyam什么东西啊;2;0;2;54433;3.674241728363309e-05
54955;过激佣吹bot李鸠潍;1;0;1;54433;1.8371208641816546e-05
54957;脑袋困噜小羊快跑三无;2;0;2;54433;3.674241728363309e-05
54961;旧尘;1;0;1;54433;1.8371208641816546e-05
54963;额江;1;0;1;54433;1.8371208641816546e-05
54965;微嗔酒店猛狗;1;0;1;54433;1.8371208641816546e-05
54969;嘻嘻我是文盲;1;0;1;54433;1.8371208641816546e-05
54971;季;1;0;1;54433;1.8371208641816546e-05
54973;123;1;0;1;54433;1.8371208641816546e-05
54976;是很有病;1;0;1;54433;1.8371208641816546e-05
54980;爱le吃饱le没MiMiaonanajaem悲伤麻辣烫疯狗型美女求和;2;0;2;54433;3.674241728363309e-05
54983;sky欲啊？啊？原来我没文化;1;0;1;54433;1.8371208641816546e-05
54986;胖大海;1;0;1;54433;1.8371208641816546e-05
54989;玩光夜都有点毛病，比如我苡虾恐龙蛋海风吹香菜味的啵啵;2;0;2;54433;3.674241728363309e-05
54992;嫩嫩6;1;0;1;54433;1.8371208641816546e-05
54995;0;1;0;1;54433;1.8371208641816546e-05
54997;lvy;1;0;1;54433;1.8371208641816546e-05
55004;林黛玉挥泪斩马谡鲨鱼恶霸;1;0;1;54433;1.8371208641816546e-05
55006;曙光不懂出去留个学;1;0;1;54433;1.8371208641816546e-05
55013;周荡长安;2;0;2;54433;3.674241728363309e-05
55016;zzzzyfine欣子多学学;1;0;1;54433;1.8371208641816546e-05
55018;只想干饭S;1;0;1;54433;1.8371208641816546e-05
55022;youlooksosweet;1;0;1;54433;1.8371208641816546e-05
55027;抱紧魔理沙酱来学知识了;1;0;1;54433;1.8371208641816546e-05
55029;AAA笨不溜秋蛋批发蔡姐;1;0;1;54433;1.8371208641816546e-05
55031;没事多读书;1;0;1;54433;1.8371208641816546e-05
55034;F;1;0;1;54433;1.8371208641816546e-05
55036;Yueg;1;0;1;54433;1.8371208641816546e-05
55038;对帅哥没兴趣悲伤的豚骨拉面开水大便超人天天开心意难眠瞌睡zzzzz;1;0;1;54433;1.8371208641816546e-05
55045;NK。脆脆皮的小熊饼干包子大王;1;0;1;54433;1.8371208641816546e-05
55047;普希金的猫五十岚希己枝甜崽小洋咩;2;0;2;54433;3.674241728363309e-05
55050;扫黄被砍17刀;1;0;1;54433;1.8371208641816546e-05
55053;Y;1;0;1;54433;1.8371208641816546e-05
55055;发呆的季节bae;2;0;2;54433;3.674241728363309e-05
55058;明天见面惠子l;1;0;1;54433;1.8371208641816546e-05
55060;silvNov310128;1;0;1;54433;1.8371208641816546e-05
55064;偷偷告诉你;1;0;1;54433;1.8371208641816546e-05
55068;低电量营救计划;1;0;1;54433;1.8371208641816546e-05
55070;611啊我是文盲;1;0;1;54433;1.8371208641816546e-05
55072;吹个笛儿;1;0;1;54433;1.8371208641816546e-05
55075;咸鱼;1;0;1;54433;1.8371208641816546e-05
55087;不要放洋葱？;1;0;1;54433;1.8371208641816546e-05
55098;刺眼的黑暗;1;0;1;54433;1.8371208641816546e-05
55102;呆桃啵啵;1;0;1;54433;1.8371208641816546e-05
55109;心软艺术家;1;0;1;54433;1.8371208641816546e-05
55112;御坂美琴;1;0;1;54433;1.8371208641816546e-05
55114;yuuuuu;1;0;1;54433;1.8371208641816546e-05
55116;天天开心;1;0;1;54433;1.8371208641816546e-05
55118;oh心在冰岛;1;0;1;54433;1.8371208641816546e-05
55126;子笙悦hh;1;0;1;54433;1.8371208641816546e-05
55129;向时下次考试就用上咯;1;0;1;54433;1.8371208641816546e-05
55132;星新知识;1;0;1;54433;1.8371208641816546e-05
55134;wan萱6;1;0;1;54433;1.8371208641816546e-05
55136;十万急我超爱笑的Beckoning韩九九梦、love伤风6;3;0;3;54433;5.511362592544963e-05
55140;牛逼;1;0;1;54433;1.8371208641816546e-05
55144;新崽崽;1;0;1;54433;1.8371208641816546e-05
55149;喜欢鲸鲸啊;1;0;1;54433;1.8371208641816546e-05
55151;宝宝;1;0;1;54433;1.8371208641816546e-05
55153;治不好发呆;1;0;1;54433;1.8371208641816546e-05
55157;菸;1;0;1;54433;1.8371208641816546e-05
55161;叶子大王无敌;1;0;1;54433;1.8371208641816546e-05
55168;斋藤松原。;1;0;1;54433;1.8371208641816546e-05
55170;似羊秋豆麻袋;1;0;1;54433;1.8371208641816546e-05
55174;贾鱼;1;0;1;54433;1.8371208641816546e-05
55180;思玄居然不是成语我丢;1;0;1;54433;1.8371208641816546e-05
55187;永远有花我又可以了;1;0;1;54433;1.8371208641816546e-05
55191;zjz离谱啊;1;0;1;54433;1.8371208641816546e-05
55194;藕粉丸子要加糖KissRasahi111呀木木的小萝卜ML小狗菠萝包心动没原则枕星河;2;0;2;54433;3.674241728363309e-05
55198;木颜;1;0;1;54433;1.8371208641816546e-05
55201;60后老太勇闯湖南月朗风清;2;0;2;54433;3.674241728363309e-05
55205;aruasj学会了;2;0;2;54433;3.674241728363309e-05
55208;耶耶子zll拒绝乌托邦;1;0;1;54433;1.8371208641816546e-05
55210;断剑;1;0;1;54433;1.8371208641816546e-05
55215;大红袍不是绿茶;1;0;1;54433;1.8371208641816546e-05
55217;小袁的奶狗;1;0;1;54433;1.8371208641816546e-05
55221;铲掉你2koiJustina;2;0;2;54433;3.674241728363309e-05
55224;憋不出屁Archer阿布吧啦吧啦我要当六边形战士fifteenLikZLArrogant;1;0;1;54433;1.8371208641816546e-05
55226;Y26涨知识了;1;0;1;54433;1.8371208641816546e-05
55229;小玻璃我好像学的语文是错的;1;0;1;54433;1.8371208641816546e-05
55233;第拾叁年冬;1;0;1;54433;1.8371208641816546e-05
55236;弱柳扶风也不是成语被伤到了今天考试的时候写的0分捏0045;1;0;1;54433;1.8371208641816546e-05
55239;老地方;1;0;1;54433;1.8371208641816546e-05
55245;樱qwee坠默DarlingOR晚安ujcdj魔法少女郭德纲孤独不是毒;1;0;1;54433;1.8371208641816546e-05
55247;死亡本能？;1;0;1;54433;1.8371208641816546e-05
55249;金金;1;0;1;54433;1.8371208641816546e-05
55252;97ii;1;0;1;54433;1.8371208641816546e-05
55255;Lim;1;0;1;54433;1.8371208641816546e-05
55258;斯文孙s;1;0;1;54433;1.8371208641816546e-05
55261;共续吟春程woy;1;0;1;54433;1.8371208641816546e-05
55264;黑驴蹄子专卖殿;2;0;2;54433;3.674241728363309e-05
55267;今天你快乐嘛;2;0;2;54433;3.674241728363309e-05
55271;王俊凯的圈外女友无敌小萱小洋睡不醒怀民亦未寝小卡腻歪铁树辣椒油小安大王66;2;0;2;54433;3.674241728363309e-05
55274;伦晚超甜所谓鹿子;1;0;1;54433;1.8371208641816546e-05
55277;Gradevent;2;0;2;54433;3.674241728363309e-05
55280;成为叉烧包的亡命赌徒100华灯初上一见钟秦蓓蓓点子背令人喷饭;1;0;1;54433;1.8371208641816546e-05
55287;行或;1;0;1;54433;1.8371208641816546e-05
55292;再练亿年就不练了;1;0;1;54433;1.8371208641816546e-05
55294;3366;1;0;1;54433;1.8371208641816546e-05
55309;让我再眯一会？;1;0;1;54433;1.8371208641816546e-05
55311;云深不知处前面那几个成语我都会;1;0;1;54433;1.8371208641816546e-05
55316;呜啦啦的火车笛？;1;0;1;54433;1.8371208641816546e-05
55322;我不是小昕;1;0;1;54433;1.8371208641816546e-05
55325;模模糊糊的只是曾经十九lucky快点睡觉蒙刘酸不酸酸乳怡生玺欢;1;0;1;54433;1.8371208641816546e-05
55334;“迢迢错过了晚荌树袋熊小相饱饱;1;0;1;54433;1.8371208641816546e-05
55339;秘制香酥脆腿？？;1;0;1;54433;1.8371208641816546e-05
55343;大闸蟹我也以为自以为是就是成语;3;0;3;54433;5.511362592544963e-05
55347;和凌肖热恋;1;0;1;54433;1.8371208641816546e-05
55351;舒克飞了来学习了;1;0;1;54433;1.8371208641816546e-05
55360;提拉米苏M;1;0;1;54433;1.8371208641816546e-05
55362;南千溪Mona的快乐屋;2;0;2;54433;3.674241728363309e-05
55365;怿呆呆的呆呆;1;0;1;54433;1.8371208641816546e-05
55367;松6;1;0;1;54433;1.8371208641816546e-05
55371;灰勒塔德潜兔真是令人喷饭;1;0;1;54433;1.8371208641816546e-05
55373;卢本思卢本妙duvvdd;1;0;1;54433;1.8371208641816546e-05
55378;小雨什么玩意啊;1;0;1;54433;1.8371208641816546e-05
55381;辞芳;1;0;1;54433;1.8371208641816546e-05
55383;笙笙;1;0;1;54433;1.8371208641816546e-05
55387;XFQ;1;0;1;54433;1.8371208641816546e-05
55389;kikuyioo惊艳夜。（诀版;1;0;1;54433;1.8371208641816546e-05
55397;浮云小云Berry薇奇怪的知识;1;0;1;54433;1.8371208641816546e-05
55400;总是睡不好;1;0;1;54433;1.8371208641816546e-05
55403;不乐羊;1;0;1;54433;1.8371208641816546e-05
55405;0;1;0;1;54433;1.8371208641816546e-05
55408;鱼鱼ACi蛤蟆夜哭;1;0;1;54433;1.8371208641816546e-05
55412;秋岛渔;1;0;1;54433;1.8371208641816546e-05
55415;执风;1;0;1;54433;1.8371208641816546e-05
55421;VikiZhai;1;0;1;54433;1.8371208641816546e-05
55428;是小许啊静;2;0;2;54433;3.674241728363309e-05
55432;不用艾特我咧纯爱慈善家;2;0;2;54433;3.674241728363309e-05
55436;如果星星知道;1;0;1;54433;1.8371208641816546e-05
55439;xin;1;0;1;54433;1.8371208641816546e-05
55445;不知道取什么名字;1;0;1;54433;1.8371208641816546e-05
55450;我没学问隔壁村口王大妈依麓;1;0;1;54433;1.8371208641816546e-05
55452;Yikok;1;0;1;54433;1.8371208641816546e-05
55460;凉笙墨染汉语言文学人在学什么;3;0;3;54433;5.511362592544963e-05
55465;悖论;1;0;1;54433;1.8371208641816546e-05
55467;虾仁爱睡觉;1;0;1;54433;1.8371208641816546e-05
55469;Wanli碎碎念心碎小海苔令人喷饭;1;0;1;54433;1.8371208641816546e-05
55471;珍是隻小珠;1;0;1;54433;1.8371208641816546e-05
55473;L睡逸觉;1;0;1;54433;1.8371208641816546e-05
55476;你一直都是搞笑女;1;0;1;54433;1.8371208641816546e-05
55478;风带去思念;1;0;1;54433;1.8371208641816546e-05
55483;乐;1;0;1;54433;1.8371208641816546e-05
55486;你萌萌的老父阿七;1;0;1;54433;1.8371208641816546e-05
55492;爱姐直说一个新名字85mtjj;1;0;1;54433;1.8371208641816546e-05
55495;白茶r;1;0;1;54433;1.8371208641816546e-05
55501;月亮是个;1;0;1;54433;1.8371208641816546e-05
55503;再見;1;0;1;54433;1.8371208641816546e-05
55509;小孩不恋喔盛明稚emmm沉默;2;0;2;54433;3.674241728363309e-05
55515;002Hello77不咋合理coi11帮我叫下救护车;2;0;2;54433;3.674241728363309e-05
55519;油条可以夹虾滑吗;1;0;1;54433;1.8371208641816546e-05
55523;群宝发如雪黑眼圈咋样了TinG喝鸡尾酒阿胶;1;0;1;54433;1.8371208641816546e-05
55525;笨狼;2;0;2;54433;3.674241728363309e-05
55528;苦茶子;1;0;1;54433;1.8371208641816546e-05
55533;麻薯三三Neyoooooooba我是一片脆弱海苔只要我坚持用，我的就是成语;1;0;1;54433;1.8371208641816546e-05
55538;saner;1;0;1;54433;1.8371208641816546e-05
55544;爱吃西蓝花Yu;1;0;1;54433;1.8371208641816546e-05
55546;敉;1;0;1;54433;1.8371208641816546e-05
55550;三角饭团;1;0;1;54433;1.8371208641816546e-05
55552;liu心奶黄包;1;0;1;54433;1.8371208641816546e-05
55559;我许一世笑颜别打扰我睡觉吕泽凯;1;0;1;54433;1.8371208641816546e-05
55561;次次次草莓;1;0;1;54433;1.8371208641816546e-05
55564;魚恋海6;1;0;1;54433;1.8371208641816546e-05
55568;心声;1;0;1;54433;1.8371208641816546e-05
55571;枝桠;1;0;1;54433;1.8371208641816546e-05
55573;渡子又饿了;1;0;1;54433;1.8371208641816546e-05
55576;忆十一;1;0;1;54433;1.8371208641816546e-05
55580;xin;1;0;1;54433;1.8371208641816546e-05
55583;糖炒栗子ok秋海岸线亲亲点点历险记卡戴珊纸木马;1;0;1;54433;1.8371208641816546e-05
55586;灰与轩拾;1;0;1;54433;1.8371208641816546e-05
55588;泡泡月月子;1;0;1;54433;1.8371208641816546e-05
55590;一米五五怎么了锅包肉乖乖小狗;3;0;3;54433;5.511362592544963e-05
55594;zheee煎太阳蛋;1;0;1;54433;1.8371208641816546e-05
55597;吐个泡泡通通1;1;0;1;54433;1.8371208641816546e-05
55600;骰子没有第7面;1;0;1;54433;1.8371208641816546e-05
55602;神明;1;0;1;54433;1.8371208641816546e-05
55604;小脸圆圆的;2;0;2;54433;3.674241728363309e-05
55610;日落于西方惊呆了;2;0;2;54433;3.674241728363309e-05
55613;奋斗，上岸;2;0;2;54433;3.674241728363309e-05
55617;时倾。;1;0;1;54433;1.8371208641816546e-05
55619;阿星。。;1;0;1;54433;1.8371208641816546e-05
55621;小赞宝贝十七年蝉意夜莺丶;2;0;2;54433;3.674241728363309e-05
55624;是巧乐兹哈哈哈哈哈哈;1;0;1;54433;1.8371208641816546e-05
55626;小休;1;0;1;54433;1.8371208641816546e-05
55629;哦豁是肉丸404？;1;0;1;54433;1.8371208641816546e-05
55634;浩浩阿1我是树祎苏;1;0;1;54433;1.8371208641816546e-05
55638;Ai？;1;0;1;54433;1.8371208641816546e-05
55641;“”;1;0;1;54433;1.8371208641816546e-05
55647;快乐麻辣烫;1;0;1;54433;1.8371208641816546e-05
55650;鸽屿;1;0;1;54433;1.8371208641816546e-05
55653;小赵同学zZ;1;0;1;54433;1.8371208641816546e-05
55657;咯嘛推荐;1;0;1;54433;1.8371208641816546e-05
55662;叶絮一二三不吃香菜的爱哭包蹭郁腌;1;0;1;54433;1.8371208641816546e-05
55665;我妻穗玉;1;0;1;54433;1.8371208641816546e-05
55672;想着我;1;0;1;54433;1.8371208641816546e-05
55679;辞韵凯尔希帅气避人;1;0;1;54433;1.8371208641816546e-05
55682;小布;1;0;1;54433;1.8371208641816546e-05
55684;爱吃玉米排骨汤文盲咯。;1;0;1;54433;1.8371208641816546e-05
55688;蓝瑟会这样九年义务教育白上了;1;0;1;54433;1.8371208641816546e-05
55690;多肉香菜Agonilasilaso笑死我了妈的博士买驴;1;0;1;54433;1.8371208641816546e-05
55693;fzq;1;0;1;54433;1.8371208641816546e-05
55696;寄凉凉凉凉凉雨子啊拾甜难黑溤仙女头发总掉？？？？;2;0;2;54433;3.674241728363309e-05
55702;0;1;0;1;54433;1.8371208641816546e-05
55710;子陌;1;0;1;54433;1.8371208641816546e-05
55713;婷儿是琪梦糖蛋白柒梦Trauma小镇第二深情;1;0;1;54433;1.8371208641816546e-05
55715;烦躁的麻辣土豆片;1;0;1;54433;1.8371208641816546e-05
55720;今天臭臭了没白夜江行泪泪滴冬季6;1;0;1;54433;1.8371208641816546e-05
55724;一颗流心蛋呆呆椰子;1;0;1;54433;1.8371208641816546e-05
55726;梦倥;1;0;1;54433;1.8371208641816546e-05
55728;dal我是文盲;1;0;1;54433;1.8371208641816546e-05
55735;雾乐;1;0;1;54433;1.8371208641816546e-05
55737;Sjyyyyy你猜;1;0;1;54433;1.8371208641816546e-05
55739;兔仔汁旺仔秋秋糖;1;0;1;54433;1.8371208641816546e-05
55743;陆景和娇妻熙熙很凶哒郑徐;1;0;1;54433;1.8371208641816546e-05
55745;无聊兔子;1;0;1;54433;1.8371208641816546e-05
55747;met妖璃一根葱洪;1;0;1;54433;1.8371208641816546e-05
55749;小叶爱吃小肥羊;1;0;1;54433;1.8371208641816546e-05
55751;花生米不能吃、莫？;1;0;1;54433;1.8371208641816546e-05
55753;冰冷星期八;1;0;1;54433;1.8371208641816546e-05
55757;oo奥特曼学习;1;0;1;54433;1.8371208641816546e-05
55759;有钱的喵好难;1;0;1;54433;1.8371208641816546e-05
55765;别的不敢说，博士买驴从小就知道会飞的煤气罐;1;0;1;54433;1.8371208641816546e-05
55768;Madreselva;1;0;1;54433;1.8371208641816546e-05
55770;0;1;0;1;54433;1.8371208641816546e-05
55773;李清照;1;0;1;54433;1.8371208641816546e-05
55779;叙述三十秒诗小稚ovo;1;0;1;54433;1.8371208641816546e-05
55784;小雯公主万福金安;1;0;1;54433;1.8371208641816546e-05
55786;今晚不做梦？;1;0;1;54433;1.8371208641816546e-05
55792;Fairy77大胡山河独行;2;0;2;54433;3.674241728363309e-05
55797;默笙;1;0;1;54433;1.8371208641816546e-05
55806;繁星藏予仲夏;1;0;1;54433;1.8371208641816546e-05
55808;咕咕鸟商参鱼粉waliop咸鱼汐汐;1;0;1;54433;1.8371208641816546e-05
55810;鹤沢川梦;1;0;1;54433;1.8371208641816546e-05
55813;呆子里奇怪的知识又增加了;4;0;4;54433;7.348483456726618e-05
55820;阿敜;1;0;1;54433;1.8371208641816546e-05
55826;耶咦书白读啦雾岛湾;1;0;1;54433;1.8371208641816546e-05
55828;小鱼向往盐海;1;0;1;54433;1.8371208641816546e-05
55830;无法无天的自闭大魔王;1;0;1;54433;1.8371208641816546e-05
55834;李明明;1;0;1;54433;1.8371208641816546e-05
55837;D：Jarsry小芽儿Fly在这里泠泠在等风;1;0;1;54433;1.8371208641816546e-05
55839;回忆像诗行曦和望舒啊？;1;0;1;54433;1.8371208641816546e-05
55842;ConstantineMMM敦我一把把把把住了烤架上的泡泡鱼Zhou;1;0;1;54433;1.8371208641816546e-05
55844;智者不堕爱河;1;0;1;54433;1.8371208641816546e-05
55846;云想衣裳花想容啊？？？？;1;0;1;54433;1.8371208641816546e-05
55850;阿tt;1;0;1;54433;1.8371208641816546e-05
55852;十;2;0;2;54433;3.674241728363309e-05
55857;今夜月色真美;1;0;1;54433;1.8371208641816546e-05
55860;乌鱼令人喷饭成语啊;1;0;1;54433;1.8371208641816546e-05
55863;令人喷饭loveyangall4u易于是八斤耶;2;0;2;54433;3.674241728363309e-05
55868;雪无糕手小迢洋洋吃不饱;2;0;2;54433;3.674241728363309e-05
55871;我没树枝不可爱楠想打排球的尼克杨糯米米米米？真是成语？;1;0;1;54433;1.8371208641816546e-05
55873;Doudou;2;0;2;54433;3.674241728363309e-05
55876;Jackson则安;3;0;3;54433;5.511362592544963e-05
55881;明天见好离谱;1;0;1;54433;1.8371208641816546e-05
55885;371霏北焚莫槑;1;0;1;54433;1.8371208641816546e-05
55887;zi;1;0;1;54433;1.8371208641816546e-05
55890;扶卿;1;0;1;54433;1.8371208641816546e-05
55895;宋言szd;1;0;1;54433;1.8371208641816546e-05
55897;s？;1;0;1;54433;1.8371208641816546e-05
55900;香香芋泥服啦;1;0;1;54433;1.8371208641816546e-05
55904;德文;1;0;1;54433;1.8371208641816546e-05
55906;biu奇怪的知识又增加了;1;0;1;54433;1.8371208641816546e-05
55909;12;1;0;1;54433;1.8371208641816546e-05
55912;蜜雪冰陈先生;1;0;1;54433;1.8371208641816546e-05
55914;霖凡尔赛代言人心机之蛙验机苏兮戚薇拾月;1;0;1;54433;1.8371208641816546e-05
55918;omo深海0926;1;0;1;54433;1.8371208641816546e-05
55921;0;1;0;1;54433;1.8371208641816546e-05
55924;花;1;0;1;54433;1.8371208641816546e-05
55928;浅紫桔梗;1;0;1;54433;1.8371208641816546e-05
55931;点点晚安;1;0;1;54433;1.8371208641816546e-05
55934;0;1;0;1;54433;1.8371208641816546e-05
55939;小宅我靠酒店猛狗;1;0;1;54433;1.8371208641816546e-05
55941;麒麒勿勿我在穷困潦岛;2;0;2;54433;3.674241728363309e-05
55944;K先森;2;0;2;54433;3.674241728363309e-05
55954;身是客;1;0;1;54433;1.8371208641816546e-05
55956;是小莓;1;0;1;54433;1.8371208641816546e-05
55958;小柚子HAAyeah世界变了;1;0;1;54433;1.8371208641816546e-05
55961;Jiao;1;0;1;54433;1.8371208641816546e-05
55964;是仔仔呦;1;0;1;54433;1.8371208641816546e-05
55968;疏影番茄儿;2;0;2;54433;3.674241728363309e-05
55971;西洲L;1;0;1;54433;1.8371208641816546e-05
55976;Lossesc;1;0;1;54433;1.8371208641816546e-05
55982;比耶茄子酱久d久落日成山海Disperse不懂出国留学了;1;0;1;54433;1.8371208641816546e-05
55985;顾得毛宁;1;0;1;54433;1.8371208641816546e-05
55988;摘杏鱼;1;0;1;54433;1.8371208641816546e-05
55990;果果星星点点;1;0;1;54433;1.8371208641816546e-05
55997;会瘦的小胖友噜噜（自由版）;1;0;1;54433;1.8371208641816546e-05
56003;宇宙无敌超级暴龙兽救命;1;0;1;54433;1.8371208641816546e-05
56006;无人;1;0;1;54433;1.8371208641816546e-05
56015;解不开的fairytalesZQ等春天你脸红什么啊Jzzqqqq曦该学习了;3;0;3;54433;5.511362592544963e-05
56019;子月十八;1;0;1;54433;1.8371208641816546e-05
56022;CGww;1;0;1;54433;1.8371208641816546e-05
56025;浊酒赴一颗葡萄柚FinalIDS小何rjw哈哈哈;1;0;1;54433;1.8371208641816546e-05
56027;不可以;1;0;1;54433;1.8371208641816546e-05
56029;蜉蝣;1;0;1;54433;1.8371208641816546e-05
56034;小揭快去睡觉;1;0;1;54433;1.8371208641816546e-05
56036;Nuyoah;1;0;1;54433;1.8371208641816546e-05
56041;被小帅骗走250万睡好觉小鱼是沙沙不是莎莎午夜忧郁纯情丫头XB乄卝;1;0;1;54433;1.8371208641816546e-05
56046;Excellent？;1;0;1;54433;1.8371208641816546e-05
56052;吃不饱的小胖十号楼的千玺呆崽;2;0;2;54433;3.674241728363309e-05
56055;望舒落秦窗何归尽晚瑾;1;0;1;54433;1.8371208641816546e-05
56059;Zzx丶鹤归孤山奇怪的知识增加了;2;0;2;54433;3.674241728363309e-05
56063;什么都不关我的事;1;0;1;54433;1.8371208641816546e-05
56065;限;1;0;1;54433;1.8371208641816546e-05
56069;flowerM长知识了;2;0;2;54433;3.674241728363309e-05
56078;Yayo00;3;0;3;54433;5.511362592544963e-05
56083;小z睡不醒上海朴宥娜浅尝一下橙子whyyccccc他在pua你;1;0;1;54433;1.8371208641816546e-05
56086;微笑且迷人;1;0;1;54433;1.8371208641816546e-05
56093;彼時;1;0;1;54433;1.8371208641816546e-05
56095;0;1;0;1;54433;1.8371208641816546e-05
56097;方酒酒;1;0;1;54433;1.8371208641816546e-05
56101;樊lpHedgehog哈哈哈哈哈哈哈哈哈哈哈哈哈哈哈菜蔬之色;2;0;2;54433;3.674241728363309e-05
56106;小熊煲仔饭;1;0;1;54433;1.8371208641816546e-05
56111;落尘;1;0;1;54433;1.8371208641816546e-05
56114;神明冬日里;1;0;1;54433;1.8371208641816546e-05
56117;呼呼哟放一起my不吃香菜bb;1;0;1;54433;1.8371208641816546e-05
56122;草莓奥利奥泡牛奶;1;0;1;54433;1.8371208641816546e-05
56124;昵称过于强大无法显示季ZincoD;1;0;1;54433;1.8371208641816546e-05
56127;小夏真的睡不醒;1;0;1;54433;1.8371208641816546e-05
56131;哔哔哔令人喷饭;1;0;1;54433;1.8371208641816546e-05
56135;安an;1;0;1;54433;1.8371208641816546e-05
56137;柏庭Bertin小瑜;2;0;2;54433;3.674241728363309e-05
56142;三只小猪社畜那一趴适合你;1;0;1;54433;1.8371208641816546e-05
56146;顾梓安;1;0;1;54433;1.8371208641816546e-05
56153;周杰伦滴小北鼻;1;0;1;54433;1.8371208641816546e-05
56156;Steamwhistle来学习;1;0;1;54433;1.8371208641816546e-05
56158;Chubby;1;0;1;54433;1.8371208641816546e-05
56163;君名悲伤的小开水;2;0;2;54433;3.674241728363309e-05
56166;我爱土豆泥;1;0;1;54433;1.8371208641816546e-05
56170;9;2;0;2;54433;3.674241728363309e-05
56173;我最帅le6;1;0;1;54433;1.8371208641816546e-05
56179;0;1;0;1;54433;1.8371208641816546e-05
56183;栖灿0309外面在下雨吗？;2;0;2;54433;3.674241728363309e-05
56186;静静;1;0;1;54433;1.8371208641816546e-05
56189;雨鱼籽我是文盲;1;0;1;54433;1.8371208641816546e-05
56191;之后郑州也在下雨萝莉优秀青年;3;0;3;54433;5.511362592544963e-05
56199;倩倩;1;0;1;54433;1.8371208641816546e-05
56203;不圓;1;0;1;54433;1.8371208641816546e-05
56205;好烦长不高后来与你;1;0;1;54433;1.8371208641816546e-05
56211;是cc啊？自以为是不是成语？;1;0;1;54433;1.8371208641816546e-05
56213;无糖美式;2;0;2;54433;3.674241728363309e-05
56217;怀里揣着月亮。啾新机子哇一直摸你肚子？？？;1;0;1;54433;1.8371208641816546e-05
56224;悲伤就大口吃饭悲伤菠萝泥;2;0;2;54433;3.674241728363309e-05
56231;最爱燕子;1;0;1;54433;1.8371208641816546e-05
56233;9900;1;0;1;54433;1.8371208641816546e-05
56240;Redamancyemmmm;1;0;1;54433;1.8371208641816546e-05
56244;吃饱了就困;1;0;1;54433;1.8371208641816546e-05
56246;山昼久别？;1;0;1;54433;1.8371208641816546e-05
56248;S1N笑死我了;1;0;1;54433;1.8371208641816546e-05
56250;一表人才蝉不知雪;1;0;1;54433;1.8371208641816546e-05
56253;小k、;1;0;1;54433;1.8371208641816546e-05
56255;江辞;1;0;1;54433;1.8371208641816546e-05
56260;欢欢;1;0;1;54433;1.8371208641816546e-05
56262;沃特艾维尔;1;0;1;54433;1.8371208641816546e-05
56265;小熊爱小莲;1;0;1;54433;1.8371208641816546e-05
56271;0;1;0;1;54433;1.8371208641816546e-05
56273;xxxx6;1;0;1;54433;1.8371208641816546e-05
56277;Jnebula;1;0;1;54433;1.8371208641816546e-05
56283;糖果不加糖;2;0;2;54433;3.674241728363309e-05
56286;林予。;1;0;1;54433;1.8371208641816546e-05
56288;凌晨四点;1;0;1;54433;1.8371208641816546e-05
56291;兜兜不姓麦;1;0;1;54433;1.8371208641816546e-05
56301;刀尖抢糖毅某人;1;0;1;54433;1.8371208641816546e-05
56303;闭店小聒Lyyyyy又又又苍染苍露为染叶安l;1;0;1;54433;1.8371208641816546e-05
56305;足音尚存;1;0;1;54433;1.8371208641816546e-05
56308;魚头;1;0;1;54433;1.8371208641816546e-05
56313;by滥;1;0;1;54433;1.8371208641816546e-05
56318;白榆;1;0;1;54433;1.8371208641816546e-05
56321;俗野？;1;0;1;54433;1.8371208641816546e-05
56333;咋子;1;0;1;54433;1.8371208641816546e-05
56338;Zzzzz;1;0;1;54433;1.8371208641816546e-05
56341;相思子;1;0;1;54433;1.8371208641816546e-05
56344;我是山小弟;1;0;1;54433;1.8371208641816546e-05
56346;归零？？;1;0;1;54433;1.8371208641816546e-05
56350;没用的网络;1;0;1;54433;1.8371208641816546e-05
56352;Rita;1;0;1;54433;1.8371208641816546e-05
56356;三罙;1;0;1;54433;1.8371208641816546e-05
56364;肚子咕噜lu;1;0;1;54433;1.8371208641816546e-05
56369;野人屁屁环绕19号星球起司狸狸Cakeercoll白日做梦Anan;1;0;1;54433;1.8371208641816546e-05
56371;纯情美少男粘锅上的咸鱼;2;0;2;54433;3.674241728363309e-05
56374;万象迎一杯枯荣？;1;0;1;54433;1.8371208641816546e-05
56376;越界示爱者？;1;0;1;54433;1.8371208641816546e-05
56380;真是令人喷饭天天困死（发疯版）;1;0;1;54433;1.8371208641816546e-05
56383;YYxzz啊哈哈哈哈好离谱;2;0;2;54433;3.674241728363309e-05
56388;绿豇豆白豆芽;1;0;1;54433;1.8371208641816546e-05
56390;在下185;1;0;1;54433;1.8371208641816546e-05
56395;扣1佛祖保佑解油杂货铺ohnoo？;2;0;2;54433;3.674241728363309e-05
56399;Hzhh;1;0;1;54433;1.8371208641816546e-05
56403;绛橘色的日落;1;0;1;54433;1.8371208641816546e-05
56409;阿巴阿巴中华文化，博大精深;2;0;2;54433;3.674241728363309e-05
56412;每天都很烦;1;0;1;54433;1.8371208641816546e-05
56415;别管我GardeniaJiaqixxxx;3;0;3;54433;5.511362592544963e-05
56419;心动藏在风里离谱;2;0;2;54433;3.674241728363309e-05
56422;发疯辣地瓜;1;0;1;54433;1.8371208641816546e-05
56426;听风起雨落;1;0;1;54433;1.8371208641816546e-05
56430;悲伤芝士年糕带爹上阵老憨憨7饭饭lo无春流星雨CccYueHan雯雯41俞定延迟开学？;1;0;1;54433;1.8371208641816546e-05
56437;fine;1;0;1;54433;1.8371208641816546e-05
56441;woc;1;0;1;54433;1.8371208641816546e-05
56443;悦昔悦兮;1;0;1;54433;1.8371208641816546e-05
56450;傲娇懒羊羊vvvlllOoofj;2;0;2;54433;3.674241728363309e-05
56453;拜托小熊只对小严心动三五ZXCVBNM小马要睡觉阿小尼;1;0;1;54433;1.8371208641816546e-05
56455;油炸青苹果月亮偷吃星星漂亮姐姐贴贴;1;0;1;54433;1.8371208641816546e-05
56460;0;1;0;1;54433;1.8371208641816546e-05
56463;你可爱吃多了吧满目山河空念远;2;0;2;54433;3.674241728363309e-05
56466;自以为是不是？？;1;0;1;54433;1.8371208641816546e-05
56469;琳琳总总？？;1;0;1;54433;1.8371208641816546e-05
56477;0425什么玩意儿;1;0;1;54433;1.8371208641816546e-05
56479;假柚乐柿;2;0;2;54433;3.674241728363309e-05
56482;不敢敲门借记卡0hanttkxin月牙枫糖不炒板栗;3;0;3;54433;5.511362592544963e-05
56486;185大帅哥;1;0;1;54433;1.8371208641816546e-05
56492;bbt;1;0;1;54433;1.8371208641816546e-05
56496;Gu;1;0;1;54433;1.8371208641816546e-05
56498;妮妮派额以后朋友圈可以说畜来乍到;1;0;1;54433;1.8371208641816546e-05
56503;TulipsZvmiY占得世间第一春“电脑配件”;2;0;2;54433;3.674241728363309e-05
56506;北北呀;1;0;1;54433;1.8371208641816546e-05
56509;吃喝不嫖赌;1;0;1;54433;1.8371208641816546e-05
56513;千;1;0;1;54433;1.8371208641816546e-05
56515;不知道;1;0;1;54433;1.8371208641816546e-05
56517;花夜前行LaD;2;0;2;54433;3.674241728363309e-05
56524;江添玊尔（;1;0;1;54433;1.8371208641816546e-05
56527;纯玉新之助Hik一场空怪力少女EA7pp镶钻的闪腚公主山止川行bbieatfanZt等到星期八;1;0;1;54433;1.8371208641816546e-05
56530;纯路人;1;0;1;54433;1.8371208641816546e-05
56533;Softrib;1;0;1;54433;1.8371208641816546e-05
56535;去追一只鹿？;1;0;1;54433;1.8371208641816546e-05
56540;dawn;1;0;1;54433;1.8371208641816546e-05
56542;你应该姓风S褶;1;0;1;54433;1.8371208641816546e-05
56545;困告777甜甜恬？;1;0;1;54433;1.8371208641816546e-05
56548;洒洒水啦6啊;1;0;1;54433;1.8371208641816546e-05
56552;kio鱼小绿吗令人喷饭;2;0;2;54433;3.674241728363309e-05
56555;小呆;1;0;1;54433;1.8371208641816546e-05
56558;你干什么;2;0;2;54433;3.674241728363309e-05
56563;tsukidolou怪哇啊呀;1;0;1;54433;1.8371208641816546e-05
56567;兔兔抱紧胡萝卜發辞c886广莫辞大帅哥;6;0;6;54433;0.00011022725185089927
56583;玲哈哈哈哈哈好离谱;1;0;1;54433;1.8371208641816546e-05
56587;春野小默摆烂秋刀鱼赖床栗子球打扰;1;0;1;54433;1.8371208641816546e-05
56592;纯爱小狗;1;0;1;54433;1.8371208641816546e-05
56595;高冷的总裁;1;0;1;54433;1.8371208641816546e-05
56599;非主刘;1;0;1;54433;1.8371208641816546e-05
56602;惊天地泣鬼神大帅比芍亭;1;0;1;54433;1.8371208641816546e-05
56608;布偶的小可爱;1;0;1;54433;1.8371208641816546e-05
56611;我想吃辣;1;0;1;54433;1.8371208641816546e-05
56613;99;1;0;1;54433;1.8371208641816546e-05
56617;芒果奶酪源;1;0;1;54433;1.8371208641816546e-05
56619;YinnEnxu广东智障脑残收容所李主任;3;0;3;54433;5.511362592544963e-05
56623;我不李姐。？;1;0;1;54433;1.8371208641816546e-05
56626;不导;1;0;1;54433;1.8371208641816546e-05
56629;会飞的马桶盖Estrella;2;0;2;54433;3.674241728363309e-05
56633;策月夜舞尽离殇落日余晖;2;0;2;54433;3.674241728363309e-05
56637;破送情郎蜉哇;3;0;3;54433;5.511362592544963e-05
56641;蹄蹄公主知李真的有被冒犯到;2;0;2;54433;3.674241728363309e-05
56646;LWMX;1;0;1;54433;1.8371208641816546e-05
56650;胖橘;1;0;1;54433;1.8371208641816546e-05
56652;蒲公英的约定;1;0;1;54433;1.8371208641816546e-05
56655;阿槐666学到了;1;0;1;54433;1.8371208641816546e-05
56657;阿巴阿巴栝无情小行星;1;0;1;54433;1.8371208641816546e-05
56660;周九利;1;0;1;54433;1.8371208641816546e-05
56663;xuan;1;0;1;54433;1.8371208641816546e-05
56665;20岁深情姐1;1;0;1;54433;1.8371208641816546e-05
56668;O琪阿派;1;0;1;54433;1.8371208641816546e-05
56671;新篇章;1;0;1;54433;1.8371208641816546e-05
56673;野生小阿栗lilylylyly红红红;1;0;1;54433;1.8371208641816546e-05
56676;无情后妈;1;0;1;54433;1.8371208641816546e-05
56678;我是欧皇别管夏鸣星噜啦妍帅帅很爱炸梨酥阿昭NanZ姜余Lin关你西红杮。;1;0;1;54433;1.8371208641816546e-05
56680;晴天、娃娃;1;0;1;54433;1.8371208641816546e-05
56683;三分分雨露操;1;0;1;54433;1.8371208641816546e-05
56685;周刊刊让我原本就不聪明的脑壳更加迷糊了;1;0;1;54433;1.8371208641816546e-05
56687;陆亿十五Rosy。劝它最好不要给我加进考试里面;1;0;1;54433;1.8371208641816546e-05
56690;落;1;0;1;54433;1.8371208641816546e-05
56692;慕无言哈哈哈哈哈哈哈;1;0;1;54433;1.8371208641816546e-05
56699;夕瑶;1;0;1;54433;1.8371208641816546e-05
56703;桃子;1;0;1;54433;1.8371208641816546e-05
56705;moko。;1;0;1;54433;1.8371208641816546e-05
56707;无字诗行;1;0;1;54433;1.8371208641816546e-05
56711;百事都可乐论一个假大学生的重要性;2;0;2;54433;3.674241728363309e-05
56715;邈云汉我都怀疑我这大学生是个假的;2;0;2;54433;3.674241728363309e-05
56721;DOUX哈哈哈哈哈哈哈;1;0;1;54433;1.8371208641816546e-05
56724;在雾里温柔;1;0;1;54433;1.8371208641816546e-05
56727;苏慕春日野风颂;1;0;1;54433;1.8371208641816546e-05
56729;Cs;1;0;1;54433;1.8371208641816546e-05
56732;银河系漫游偷只你小猪霜降;2;0;2;54433;3.674241728363309e-05
56735;蛊爷阿归景辰鹤芩;1;0;1;54433;1.8371208641816546e-05
56737;薛小涵鸭榴莲吖hyzx7秒自然醒Xdreamlen;2;0;2;54433;3.674241728363309e-05
56741;天空是蔚蓝色;4;0;4;54433;7.348483456726618e-05
56746;独家作无解;1;0;1;54433;1.8371208641816546e-05
56750;假如我有钞能力;1;0;1;54433;1.8371208641816546e-05
56752;园丁小羊;1;0;1;54433;1.8371208641816546e-05
56761;硅胶馒头是绝望的文盲;1;0;1;54433;1.8371208641816546e-05
56764;仙貝;1;0;1;54433;1.8371208641816546e-05
56766;我睡觉的时候不困;1;0;1;54433;1.8371208641816546e-05
56768;Liuuu6;1;0;1;54433;1.8371208641816546e-05
56774;最像成语的不是成语;1;0;1;54433;1.8371208641816546e-05
56777;XyEP;1;0;1;54433;1.8371208641816546e-05
56779;0;1;0;1;54433;1.8371208641816546e-05
56784;美少女菜农;1;0;1;54433;1.8371208641816546e-05
56788;安稳;1;0;1;54433;1.8371208641816546e-05
56790;曦辰;1;0;1;54433;1.8371208641816546e-05
56794;揽;1;0;1;54433;1.8371208641816546e-05
56797;ciniiily奇妙;1;0;1;54433;1.8371208641816546e-05
56799;美女简隋英;1;0;1;54433;1.8371208641816546e-05
56804;张高达分达;1;0;1;54433;1.8371208641816546e-05
56808;研究员在云朵上打呼6公主砂锅麻辣烫卿决一搭一挡;1;0;1;54433;1.8371208641816546e-05
56810;普信男陈劲生橘猫的夏天北平戏子尴尬超人不定义媛猪Baek鱼仔eak玫风瑰慈;1;0;1;54433;1.8371208641816546e-05
56812;小狗摇尾巴;2;0;2;54433;3.674241728363309e-05
56815;小万叶你真不来啊相信国家相信党迷嘴一个宝;1;0;1;54433;1.8371208641816546e-05
56821;肉肉（每天开心快乐版）;1;0;1;54433;1.8371208641816546e-05
56824;SJY;1;0;1;54433;1.8371208641816546e-05
56827;JJ涨知识了;2;0;2;54433;3.674241728363309e-05
56832;清焉;1;0;1;54433;1.8371208641816546e-05
56834;Sunrise《喝西北风》;2;0;2;54433;3.674241728363309e-05
56838;0;1;0;1;54433;1.8371208641816546e-05
56843;小只学得了;1;0;1;54433;1.8371208641816546e-05
56848;午夜忧郁纯情霸总被没收的冬眠;1;0;1;54433;1.8371208641816546e-05
56851;喵仔？？？？;1;0;1;54433;1.8371208641816546e-05
56856;狐斋宫笑死我了;1;0;1;54433;1.8371208641816546e-05
56859;你也想见长岛雪白花小海苔长知识了;1;0;1;54433;1.8371208641816546e-05
56864;moler茄子哭马;1;0;1;54433;1.8371208641816546e-05
56871;长诀;1;0;1;54433;1.8371208641816546e-05
56874;小摆个烂;2;0;2;54433;3.674241728363309e-05
56879;久安月亮;1;0;1;54433;1.8371208641816546e-05
56883;头有点圆;1;0;1;54433;1.8371208641816546e-05
56887;小卡的泡椒;1;0;1;54433;1.8371208641816546e-05
56893;限制自律女神一切自由;1;0;1;54433;1.8371208641816546e-05
56898;11610;1;0;1;54433;1.8371208641816546e-05
56900;所念皆是星河自吾;1;0;1;54433;1.8371208641816546e-05
56903;再睡365天iu3ii溺在风里？;2;0;2;54433;3.674241728363309e-05
56909;祈析;1;0;1;54433;1.8371208641816546e-05
56912;戏影不会be;1;0;1;54433;1.8371208641816546e-05
56914;不穿裤子的马芙;1;0;1;54433;1.8371208641816546e-05
56916;露水;1;0;1;54433;1.8371208641816546e-05
56919;7c7yDevil令人喷饭;1;0;1;54433;1.8371208641816546e-05
56921;Jennnie“令人喷饭”;1;0;1;54433;1.8371208641816546e-05
56924;终点站哈哈哈哈哈;1;0;1;54433;1.8371208641816546e-05
56926;罗勒叶炒肉末;1;0;1;54433;1.8371208641816546e-05
56928;Archer;1;0;1;54433;1.8371208641816546e-05
56931;Britney;1;0;1;54433;1.8371208641816546e-05
56933;祎定耀幸福哦罐装爱吃烤冷面;2;0;2;54433;3.674241728363309e-05
56936;本宫头好痛;1;0;1;54433;1.8371208641816546e-05
56941;雷霆嘎巴币猴;1;0;1;54433;1.8371208641816546e-05
56943;重生之极品辣妈;1;0;1;54433;1.8371208641816546e-05
56947;别睡了颖子姐;1;0;1;54433;1.8371208641816546e-05
56949;LL;1;0;1;54433;1.8371208641816546e-05
56952;生菜法师（私信无故被封90天客服敷衍版）啊哈哈哈哈;2;0;2;54433;3.674241728363309e-05
56959;覔;1;0;1;54433;1.8371208641816546e-05
56965;他的笨鸟蓝;1;0;1;54433;1.8371208641816546e-05
56968;萌面大虾;1;0;1;54433;1.8371208641816546e-05
56970;谦宝贝大草莓;1;0;1;54433;1.8371208641816546e-05
56972;浅;1;0;1;54433;1.8371208641816546e-05
56975;内向腼腆文静小女生;1;0;1;54433;1.8371208641816546e-05
56977;Qianxi;1;0;1;54433;1.8371208641816546e-05
56979;灵幻师匠一根腿毛我兑水喝十年下头男去死方源;1;0;1;54433;1.8371208641816546e-05
56981;快樂荷包蛋;1;0;1;54433;1.8371208641816546e-05
56986;哥哥开门系我;1;0;1;54433;1.8371208641816546e-05
56994;Aaaaaa欣想捧束花看海XY夫人6;2;0;2;54433;3.674241728363309e-05
56997;八月喜欢;1;0;1;54433;1.8371208641816546e-05
56999;Heili爱吃大饼;1;0;1;54433;1.8371208641816546e-05
57003;日意眠親見黄心黄龙果斯麦林;2;0;2;54433;3.674241728363309e-05
57009;yoosfish？;1;0;1;54433;1.8371208641816546e-05
57015;知夏睡不着le爱吃的安姐姐;2;0;2;54433;3.674241728363309e-05
57019;阿巴阿巴像个傻瓜;1;0;1;54433;1.8371208641816546e-05
57021;luuuuuwei;2;0;2;54433;3.674241728363309e-05
57024;沁;1;0;1;54433;1.8371208641816546e-05
57026;梨花诗Wonwoo阿桔子啊;1;0;1;54433;1.8371208641816546e-05
57034;平安喜乐;1;0;1;54433;1.8371208641816546e-05
57048;猕侯桃;1;0;1;54433;1.8371208641816546e-05
57050;Makabaka;1;0;1;54433;1.8371208641816546e-05
57052;原野新之助;1;0;1;54433;1.8371208641816546e-05
57056;祈雪;2;0;2;54433;3.674241728363309e-05
57060;千叶逗虎;1;0;1;54433;1.8371208641816546e-05
57063;艾尔海森的狗;1;0;1;54433;1.8371208641816546e-05
57072;WlYCamellia牛牛爱吃面包柒拾伍老王不慌Ww;1;0;1;54433;1.8371208641816546e-05
57074;正视差距承认距离，才会努力才有机会。;12;98;110;54433;0.00202083295059982
57087;不会是GPT20开源魔改版吧;44;327;371;54433;0.006815718406113939
57132;0;33;285;318;54433;0.005842044348097661
57166;gpt20开源的，30以后就没开了。;32;97;129;54433;0.0023698859147943344
57199;我也测了，确实是gpt2的水平;7;173;180;54433;0.0033068175555269782
57207;百度应该修改中文的“恬不知耻”的含义;6;149;155;54433;0.0028475373394815646
57214;您也搞一个呗;34;7;41;54433;0.0007532195543144784
57249;模棱两可，王顾左右而言他;1;66;67;54433;0.0012308709790017085
57251;百度只要努力做到国内没对手就行，国外的又进不来竞争;6;39;45;54433;0.0008267043888817446
57258;挂个接口，套壳封装，调校规则我一个泥瓦匠都看得出来的把戏;10;24;34;54433;0.0006246210938217625
57269;根本就不相信有众多敏感词的学习中，它能成为人工智能;5;27;32;54433;0.0005878786765381295
57275;有人已经测试过了文心一言内核就是英文内核，比如你让它画一幅总线和鼠标它直接给你画出来巴士跟老鼠，因为它会把你的中文翻译成英文再画出来，还有画起重机会出来鹤，英文起重机跟鹤是同一个单词。;18;3;21;54433;0.00038579538147814744
57294;百度基因就不行;3;27;30;54433;0.0005511362592544964
57298;希望越来越好，没必要太多苛责;12;6;18;54433;0.0003306817555526978
57311;这玩意跟搜索引擎一样没啥技术含量的，加大投资就行。;16;2;18;54433;0.0003306817555526978
57329;抛开事实不谈，文心一言是最棒的;1;1;2;54433;3.674241728363309e-05
57334;真的赔麽？我之前搜过一个医院，排第一就去了，结果没查啥就让做手术，还得住院，吓死了。。又去的同仁，结果大夫拿针扎了两下说好了，回去注意休息。;1;0;1;54433;1.8371208641816546e-05
57360;据我了解chatgtp是先开发后利益百度的是先利益后开发格局不一样，;1;1;2;54433;3.674241728363309e-05
57362;夏东海，你怎么在这;1;4;5;54433;9.185604320908272e-05
57364;国家应该大力支持ai的研发新的时代已经来临一定不能落后别的国家;1;0;1;54433;1.8371208641816546e-05
57379;承认差距，但是至少我们不是没有，支持百度，毕竟这是咱自己的;5;0;5;54433;9.185604320908272e-05
57392;它使用了a100A100不出售给中国企业;1;2;3;54433;5.511362592544963e-05
57394;高晓松，我认得你;1;2;3;54433;5.511362592544963e-05
57397;你去试试华为盘古，各项数据业内遥遥领先，昨天抖音上看到的;1;2;3;54433;5.511362592544963e-05
57400;只能说文心一言是有情商的，知道啥该说啥不该说咧;1;0;1;54433;1.8371208641816546e-05
57419;记得以前专家说，中美ai水平在同一个起跑线。;4;2;6;54433;0.00011022725185089927
57424;我想用咋还没到我啊？;1;0;1;54433;1.8371208641816546e-05
57429;又一次赢麻了;1;0;1;54433;1.8371208641816546e-05
57432;大家还记得当年百度怎么打败谷歌的吗？所以说现在文心一言依旧能赢GT4;2;2;4;54433;7.348483456726618e-05
57436;考政治应该九十分以上;3;11;14;54433;0.00025719692098543164
57442;我也测了，理解力不是一般的差，充其量在gpt15水平的样子;3;13;16;54433;0.00029393933826906473
57446;行了吧，没有这么糟糕。应该在gpt31左右，不到gpt35。;3;0;3;54433;5.511362592544963e-05
57452;大约19年差距吧;1;0;1;54433;1.8371208641816546e-05
57454;环境和土壤对种子发芽成长的要求太关键了;1;0;1;54433;1.8371208641816546e-05
57457;你有没有发现：抖音上刷到CHatgpt都是证明它行的，刷到文心一言都是想证明它不行;1;0;1;54433;1.8371208641816546e-05
57461;嗯，看出来了，你就是吹凉风挑刺儿的;1;0;1;54433;1.8371208641816546e-05
57480;昨天看别人直播还行啊;1;0;1;54433;1.8371208641816546e-05
57484;0;7;2;9;54433;0.0001653408777763489
57492;50都快出了，6已经在路上了，用了个20魔改，又觉得自己遥遥领先了;1;0;1;54433;1.8371208641816546e-05
57494;gpt刚出来的时候是01，你这个咋感比啊;5;0;5;54433;9.185604320908272e-05
57500;和gpt做个对接转接啊这不就领先了吗;1;0;1;54433;1.8371208641816546e-05
57505;虽然不懂但很专业;1;0;1;54433;1.8371208641816546e-05
57509;没有自己的核心基于谷歌开发;1;0;1;54433;1.8371208641816546e-05
57514;即便是用的来源架构，也是第一个出来对标，CHATGPT的软件，能用已经很牛了没有那么不堪;3;0;3;54433;5.511362592544963e-05
57520;百度就是一搜索引擎，搜索的结果好坏真假还是要自己分辨，不要看成神。文心一言是大厂唯一一个做出来的，这勇气继续加油吧。;2;1;3;54433;5.511362592544963e-05
57527;20开源了，用迁移学习然后再优化训练些自己的数据就是自己的了;4;3;7;54433;0.00012859846049271582
57536;用的都是人家的架构;1;0;1;54433;1.8371208641816546e-05
57538;又用这样批评审判的语气;11;2;13;54433;0.00023882571234361508
57550;掌握的数据链只是gpt40的万分之一;2;11;13;54433;0.00023882571234361508
57558;搜不到需要的东西，先看广告广告;4;8;12;54433;0.00022045450370179853
57564;丢，百度上被骗过的人还少吗;2;3;5;54433;9.185604320908272e-05
57570;我直接用gpt不就行了吗？;2;0;2;54433;3.674241728363309e-05
57574;跟它说：你休息会儿，让你旁边的客服人员回复我。。;1;0;1;54433;1.8371208641816546e-05
57578;总结：用了谷歌架构，用了英伟达A100芯片，唯一新点用了百度r200计算卡。大量使用中文训练模型;1;3;4;54433;7.348483456726618e-05
57587;问怎么才能不用百度的产品恶心;1;1;2;54433;3.674241728363309e-05
57593;这不刘星他爸嘛;3;0;3;54433;5.511362592544963e-05
57597;原来基于美国谷歌开发的不是自己研发的呢;2;0;2;54433;3.674241728363309e-05
57604;感觉已经可以了主要是没有那么多数据去喂养;1;0;1;54433;1.8371208641816546e-05
57610;问一下，父亲母亲能不能结婚;2;14;16;54433;0.00029393933826906473
57614;INERT宝瓶里的双鱼Llust;1;0;1;54433;1.8371208641816546e-05
57616;可是chatgpt20开源了他就出来了;31;81;112;54433;0.002057575367883453
57648;会不会是gpt20开源了，我们才拿来借鉴了一下出了所谓的“文心一言”;28;33;61;54433;0.0011206437271508093
57677;支持国产那些人呢;12;8;20;54433;0.0003674241728363309
57690;不希望只有百度，google被禁之后，百度只剩广告了;8;0;8;54433;0.00014696966913453236
57699;谷歌要不走百度连屎都吃不上;3;4;7;54433;0.00012859846049271582
57703;文心一言就是一个国际大笑话;3;4;7;54433;0.00012859846049271582
57707;提问满满的恶意，你怎么不提问chatgtp美元霸权犹太资本呢？;4;0;4;54433;7.348483456726618e-05
57712;为什么看到百度这老总讲话我就一肚子火呢就想骂人;1;2;3;54433;5.511362592544963e-05
57714;你帮忙问一下有了文心一言百度搜索流量会被影响吗;2;0;2;54433;3.674241728363309e-05
57717;你肯定不懂gpt10和20，作为自媒体请不要胡说。问问周围懂行的人再喷。只能说不如35。;2;0;2;54433;3.674241728363309e-05
57720;你是真搞笑，你问的问题就很逗比;2;0;2;54433;3.674241728363309e-05
57723;问一些敏感的，不让搜索的，能直接黑屏的那种问题;1;1;2;54433;3.674241728363309e-05
57725;百度或者国内创新砸了你饭碗吗？国内有企业能去投资创新，而不是拿钱去补贴抢菜厂大妈的买卖不是挺好吗？有不足是肯定，要给时间发展，鼓励下不好吗，这么咬牙切齿的何必呢？搞得没人搞创新了就舒服么？;1;1;2;54433;3.674241728363309e-05
57750;我也获得内测资格了，差距还是挺大的，希望继续加油;1;0;1;54433;1.8371208641816546e-05
57752;我给robin李总写过邮件，说我被骗钱了，robin帮我转发了，有专人联系我，停了骗子的账号，没赔钱;1;0;1;54433;1.8371208641816546e-05
57754;我以前被百度的广告坑过不要信百度的广告;1;0;1;54433;1.8371208641816546e-05
57756;百度骗子。现在都没有通过呢，都一周啦;1;0;1;54433;1.8371208641816546e-05
57758;你问的都不是人问的问题。;1;0;1;54433;1.8371208641816546e-05
57760;那你别用百度啊你觉得不好别用啊你黑人家干嘛;1;0;1;54433;1.8371208641816546e-05
57762;你不要光嘴巴在这里逼逼啊，你展开图文啊;1;0;1;54433;1.8371208641816546e-05
57764;不会是chatgpt开源的数据吧，弯道超车，弯道还是别人设计的;1;0;1;54433;1.8371208641816546e-05
57766;夏东海，你还在这聊天呢，快去看看你家刘星吧。;1;0;1;54433;1.8371208641816546e-05
57960;不是那个问题，文心一言的模型识别不了中文的惯用词，说明他连中文模型都没有做;15;349;364;54433;0.006687119945621222
57976;这事鸿蒙熟悉啊;15;220;235;54433;0.0043172340308268884
57993;百度的爱国，是爱美国;22;91;113;54433;0.0020759465765252698
58016;GPT1、2是开源的;15;124;139;54433;0.0025535980012125
58033;没开源就卡脖子，人家一开源就遥遥领先。;3;84;87;54433;0.0015982951518380393
58038;就不和鸿蒙一样吗;18;8;26;54433;0.00047765142468723015
58057;一旦开源我们必然自主创新，特斯拉就是例子，所以感觉这次开源的可能性不大了;7;41;48;54433;0.0008818180148071941
58065;早有布局遥遥领先;4;60;64;54433;0.001175757353076259
58070;中国搞计算机本来就晚，又因为语言的原因不够优势。但是现在追赶的很优秀了。加油;20;3;23;54433;0.0004225377987617805
58091;关键国内卡着不让全民使用gpt4;10;21;31;54433;0.0005695074678963129
58102;是不丢人，但那样就无法坑蒙拐骗就没有钱途;3;41;44;54433;0.000808333180239928
58106;架构用国外的，模型用国外的，数据用国外的然后组合起来就是自主研发的;5;16;21;54433;0.00038579538147814744
58112;我想知道全世界都能用，为什么就我们国家不能用，包括很多ai绘图;12;2;14;54433;0.00025719692098543164
58126;说白了跟手机系统一样，底层的基础架构还是外国的，我们只是开发了一个个app而已;2;7;9;54433;0.0001653408777763489
58129;国外ai研发不是要停半年吗？加油追;6;0;6;54433;0.00011022725185089927
58157;国外一开源，国内就创新。;1;3;4;54433;7.348483456726618e-05
58164;几年前可不是这么说的，ai人工智能遥遥领先;2;2;4;54433;7.348483456726618e-05
58168;那你也来写一个吧;1;0;1;54433;1.8371208641816546e-05
58170;就是拿人家开源的代码改的，先翻译成英语，再运算，再翻译回中文的;1;8;9;54433;0.0001653408777763489
58175;文心一言是什么;2;1;3;54433;5.511362592544963e-05
58180;你敢来源，我敢自研你敢应用，我敢领先;2;9;11;54433;0.000202083295059982
58183;外国公司一开源，我们的公司就纷纷推出自研产品。;2;19;21;54433;0.00038579538147814744
58191;关键不敢承认;1;0;1;54433;1.8371208641816546e-05
58195;中国并不落后，中国是超越其他所有国家成为世界第一强国的国家拒绝粉饰国外世界，多提防国外的糖衣炮弹，年轻人就应该努力奋斗打工买房子;2;4;6;54433;0.00011022725185089927
58201;承认自己的不足，真正做好技术，而不是吹牛说大话;3;2;5;54433;9.185604320908272e-05
58206;主要是华为没搞，搞了肯定领先;3;0;3;54433;5.511362592544963e-05
58210;我们发展快是建立在有参照的前提下。欧美科技发展是从无到有的过程，不光上层建筑起的高，底层建筑也是很扎实的我国的科技发展是借鉴参照模仿的过程，上层建筑起的快，但是不高，底层基础还不牢固。基础的科技产业相对差的太多了;1;5;6;54433;0.00011022725185089927
58214;文图生成用的是ernievilg，去年一月发布的。造成翻译感的原因很简单，优质量大的标注数据都是英文的。;1;3;4;54433;7.348483456726618e-05
58221;问个问题：开源后我们可以去申请专利吗？;3;1;4;54433;7.348483456726618e-05
58228;0;1;1;2;54433;3.674241728363309e-05
58230;在弯道找个好地方埋伏下来;1;0;1;54433;1.8371208641816546e-05
58232;你说错了，中国并不落后，中国是超越其他所有国家成为世界第一强国的国家;4;1;5;54433;9.185604320908272e-05
58238;落后不是很正常嘛？重要的不是落不落后，重要的是要有。而且这东西以后的学习能力很快的，也不是没有可能追赶上的;2;1;3;54433;5.511362592544963e-05
58248;不不不，按你的说法来的永远也追赶不了，毕竟研发只会站在前人的肩膀上，而你把根源都归属于老美还把这个当做残酷滴现实，也就是说就算有哪个产品达到世界第一你也会说这句话，承认落后并不丢人，底层都是老外的东西。;1;1;2;54433;3.674241728363309e-05
58256;技术不存在弯道超车;1;1;2;54433;3.674241728363309e-05
58259;一开源就领先;1;4;5;54433;9.185604320908272e-05
58261;啥也不懂，图片这个本来就不是文心一言做的;1;0;1;54433;1.8371208641816546e-05
58264;一直在追赶，从没追上;1;5;6;54433;0.00011022725185089927
58266;模仿遥遥领先;1;2;3;54433;5.511362592544963e-05
58271;该不是调用接口吧，别到时又让人断供了;1;6;7;54433;0.00012859846049271582
58280;这些老美企业的员工大部分都是华人，特别是北大清华的华人;5;1;6;54433;0.00011022725185089927
58292;其实我们还是落后别人一点，不要太盲目自信也不要过度自卑;3;1;4;54433;7.348483456726618e-05
58298;说的没错啊所以确实不是套壳，也不是直接拿来用那么简单，模型都是广为人知的，但还得砸钱和调试训练啊;1;0;1;54433;1.8371208641816546e-05
58301;可别说了，我说了点情况，一大帮水军来喷我，大公司惹不起文心一言好好好，别攻击我了;4;1;5;54433;9.185604320908272e-05
58306;还是停留在超英赶美的认知层面;4;1;5;54433;9.185604320908272e-05
58311;关键是别人跑100米需要9秒我们跑100米需要11秒怎么追？;1;0;1;54433;1.8371208641816546e-05
58315;打假么;1;1;2;54433;3.674241728363309e-05
58317;炳哥加油;1;1;2;54433;3.674241728363309e-05
58319;虽然听不懂，但是山哥说的很明白;1;0;1;54433;1.8371208641816546e-05
58323;承认落后本来就不丢人呀;2;0;2;54433;3.674241728363309e-05
58326;0;1;2;3;54433;5.511362592544963e-05
58336;transformer基于卷积神经网络，这话你自己信吗;7;0;7;54433;0.00012859846049271582
58344;为啥一定要黑国内的东西;6;0;6;54433;0.00011022725185089927
58351;现在网友越来越不好忽悠喽;1;6;7;54433;0.00012859846049271582
58353;你猜老美为什么gpt12开源？为什么gpt3不开源？老美爱世界？还是先通过开源积累数据？;4;0;4;54433;7.348483456726618e-05
58358;不利于团结的话不要说;2;3;5;54433;9.185604320908272e-05
58361;怎么能承认呢？承认了领导肯定发飙，那我怎么升职呢？奖金也泡汤了。;3;1;4;54433;7.348483456726618e-05
58365;最后总的来一针鸡血自我麻痹，落后就是落后，承认了落后，却不承认差距越来越大;3;1;4;54433;7.348483456726618e-05
58369;我们脸皮厚，无所谓了;1;5;6;54433;0.00011022725185089927
58375;卷积神经网络是法国人YannLeCun搞出来的;2;0;2;54433;3.674241728363309e-05
58378;李彦宏就是贼王，偷东西死不认账;3;0;3;54433;5.511362592544963e-05
58411;昨天在百度抖音号，发了个，起重机和总线，真接删我评论;1;0;1;54433;1.8371208641816546e-05
58413;骗子和夸大宣传在中国活得很好;1;0;1;54433;1.8371208641816546e-05
58415;他的人物都是西方化的;1;0;1;54433;1.8371208641816546e-05
58417;爱国猫美国国旗才是真的炸裂吧百度真有一颗美国心;1;0;1;54433;1.8371208641816546e-05
58419;你可以试着让他换一下，大鹅，还有公交车;1;0;1;54433;1.8371208641816546e-05
58421;名字取的一个比一个牛逼，体验一个比一个垮;1;0;1;54433;1.8371208641816546e-05
58423;是不是套了;1;0;1;54433;1.8371208641816546e-05
58425;我们文化传承最完整的就是吹牛逼。;1;0;1;54433;1.8371208641816546e-05
58427;笑话人有一套;1;0;1;54433;1.8371208641816546e-05
58429;别人官方都承认了，确实是调用国外的接口，不装了;1;0;1;54433;1.8371208641816546e-05
58431;国人智商不够;1;0;1;54433;1.8371208641816546e-05
58433;和美国对比就是一种错误。;1;0;1;54433;1.8371208641816546e-05
58435;在路上个锤子还加油;1;0;1;54433;1.8371208641816546e-05
58437;都是国外的套壳;1;0;1;54433;1.8371208641816546e-05
58589;StableDiffusion是2022年8月8日9日开的源，百度文心一格是8月18日上的线。我能理解全世界都在用SD的模型，但是人家都大方承认了啊。就好比中国、美国等各国有个孩子，要学习画画，都要去德国买教材，这个没问题，但是你不能说我是自学成才啊。完了还说自己会画会写，那比邻国那个只会写文章的傻孩子厉害多了，人家那是不会吗？人家自己编了本教材好不好;16;115;131;54433;0.0024066283320779676
58606;你敢开源我就敢弯道超车;29;361;390;54433;0.007164771370308453
58636;千万别拿逻辑推理去质问这些骗子，他们随时用爱不爱国来反击你;1;169;170;54433;0.0031231054691088127
58638;0;8;72;80;54433;0.0014696966913453236
58647;百度原来是个翻译公司;2;41;43;54433;0.0007899619715981115
58650;你去让文心一言画个总线，就知道什么回事了;4;27;31;54433;0.0005695074678963129
58655;文心跟gpt比较;7;4;11;54433;0.000202083295059982
58663;华为，百度，蔚来。三大国货之光;2;19;21;54433;0.00038579538147814744
58666;ernievilg是去年一月发布的吧，不至于蒙皮，必要性不大。训练用的标注数据是英文的，所以才这样。;9;1;10;54433;0.00018371208641816545
58676;就说为啥gpt不发布，百度也不发布呢，因为人家不发布，百度后台接入不了gpt;2;18;20;54433;0.0003674241728363309
58682;前有特斯拉与比亚迪，今有文心与GPT，我期待下一波宣传业务没有对标就没有激烈的文宣，没有文宣就没有我们水军业务，没有业务就没有钱;2;3;5;54433;9.185604320908272e-05
58685;后面不开源了吧;2;3;5;54433;9.185604320908272e-05
58702;没有广告植入，我已经很知足了;1;0;1;54433;1.8371208641816546e-05
58706;怎么说，哥你越来越有福气了;4;0;4;54433;7.348483456726618e-05
58718;弯道超车了吗;1;0;1;54433;1.8371208641816546e-05
58735;Spike先生哈哈哈哈;1;0;1;54433;1.8371208641816546e-05
58761;网上很多说是套壳;2;0;2;54433;3.674241728363309e-05
58777;弯道超车，遥遥领先;1;0;1;54433;1.8371208641816546e-05
58782;懂得都懂，反正我认为百度最大的贡献是赶走了谷歌;2;1;3;54433;5.511362592544963e-05
58800;电脑编程是英语的;1;0;1;54433;1.8371208641816546e-05
58802;这是百度官方号自己发的李彦宏的视频，透露出很有意思的两点信息：1、ChatGPT4内测的时候，百度这样的地位都没被邀请试一试；2、李彦宏对文心一言的能力有着不合逻辑的自信。所以我猜测他可能是被忽悠了，下面的大聪明跟他汇报说自家的类ChatGPT产品不但是语言模型，而且还会画画我猜他现在正在发火。。。;2;4;6;54433;0.00011022725185089927
58805;不懂就别瞎说真尴尬;12;2;14;54433;0.00025719692098543164
58818;有的人在为了中华崛起努力，有的人却在路上阴阳怪气，拍拍自己胸脯问问自己，你有啥贡献;7;1;8;54433;0.00014696966913453236
58826;有则改之，善莫大焉，百度已经修复了红烧狮子头。;2;4;6;54433;0.00011022725185089927
58830;你能不能完整看完视频，就知道断章取义;2;0;2;54433;3.674241728363309e-05
58833;我很难过，真的希望文心一言牛逼点，别做成了阉割版的模仿，问啥都违规，;2;0;2;54433;3.674241728363309e-05
58836;你是想毁了中国ai吗？;2;0;2;54433;3.674241728363309e-05
58839;昨天文心一言直播，里面问的问题答案与chatgpt的答案一样;2;0;2;54433;3.674241728363309e-05
58842;总线那个bus就真相了。给5w。叫2个大学生做的壳都比他好;2;0;2;54433;3.674241728363309e-05
58855;已经被爆出就是个套用chatgpt的壳子产品;1;0;1;54433;1.8371208641816546e-05
58857;特斯拉有的我们也有啊，我们有的特斯拉没有啊chatgpt是落后文心一言的啊哈哈哈;1;0;1;54433;1.8371208641816546e-05
58859;你稍微懂一点技术就不会问出这个问题;1;0;1;54433;1.8371208641816546e-05
58861;你应该不是搞ai的吧，首先大部分优质的数据集都是外国的，label也是英文的，所以涉及中国文化的内容很少；再者如果用中文训练的话，那么就需要翻译label，百度肯定是直接机翻的，所以绘图出现了英文同义词的现象;1;0;1;54433;1.8371208641816546e-05
58863;不知道为什么要翻译成英文再画都实锤了总线画成巴士起重机画成丹顶鹤只要是英文一样不一定给你画啥;1;0;1;54433;1.8371208641816546e-05
58978;很多1450水军带节奏啊，用过chatgpt没想象的那么强，看了你的视频发现文心一言也不像他们黑的那么差啊;6;12;18;54433;0.0003306817555526978
58993;最后这个是不是说明百度其实是用的别人的模型啊？我无语了;3;0;3;54433;5.511362592544963e-05
58999;我看到抖音平台，反正这些平台大多数都是吐槽文心一言，在百度平台就没有吐槽，严重怀疑这些人就是水军来的。;1;0;1;54433;1.8371208641816546e-05
59001;能和gpt聊这么多，说明文心一言也有点东西了;1;0;1;54433;1.8371208641816546e-05
59012;垃圾百度，大家用谷歌，相信马斯克;1;1;2;54433;3.674241728363309e-05
59014;百度能做好吗，就怕最后抄作业也超不好，然后继续卖广告;18;77;95;54433;0.0017452648209725719
59033;百度还是老老实实收广告费吧，，根本没那个技术;5;52;57;54433;0.0010471588925835432
59041;：他们虽不完善，但是他们一直在努力。再怎么样不够先进，它依然是属于我们国家的。;7;3;10;54433;0.00018371208641816545
59050;蒸熟一个馒头需要一分钟那蒸熟十个馒头需要几分钟？文心一言回答：十分钟;2;6;8;54433;0.00014696966913453236
59053;百度是什么答辩;1;8;9;54433;0.0001653408777763489
59057;申请了一个月都没通过;1;1;2;54433;3.674241728363309e-05
59062;天下苦百度久矣;1;1;2;54433;3.674241728363309e-05
59091;他们虽不完善，但是他们一直在努力。再怎么样不够先进，它依然是属于我们国家的。;1;1;2;54433;3.674241728363309e-05
59093;伟大祖国伟大人民;1;0;1;54433;1.8371208641816546e-05
59096;百度的广告真的可怕至极，只要带个任何和病有关的意思一大堆假医院和广告链接出来了;1;0;1;54433;1.8371208641816546e-05
59183;比完了，文心一言大概是gpt25的水平。;10;35;45;54433;0.0008267043888817446
59194;大家说的是：是不是套壳？？？;12;16;28;54433;0.0005143938419708633
59208;理解文心一言，国内禁忌太多，做起来是很不容易;9;35;44;54433;0.000808333180239928
59218;在技术领域，李彦宏的观点是有迹可循的，说不定就是未来风口;4;42;46;54433;0.000845075597523561
59224;技术活还得是厂长这种理科生来盘;1;46;47;54433;0.0008634468061653776
59227;百度现在压的就是人工智能，压对了;1;15;16;54433;0.00029393933826906473
59232;不行就是不行，没有什么必要辩解，但这个风口压对了，继续加油;1;4;5;54433;9.185604320908272e-05
59234;请你告诉我，应该和谁比？;3;0;3;54433;5.511362592544963e-05
59238;和35比也差得远啊;1;2;3;54433;5.511362592544963e-05
59240;百度加油;1;2;3;54433;5.511362592544963e-05
59287;百度是不是没有数据;2;0;2;54433;3.674241728363309e-05
59292;会自我进化，很可怕，一步落后步步落后;1;0;1;54433;1.8371208641816546e-05
59320;文心一言在哪下载;1;0;1;54433;1.8371208641816546e-05
59333;那过俩月再看看;1;0;1;54433;1.8371208641816546e-05
59340;这些产品的基础都是智能交互，百度确实布局比较早;2;49;51;54433;0.0009369316407326438
59343;技术总是自己有才是最靠谱的，百度在ai还是有两把刷子的;2;33;35;54433;0.000642992302463579
59346;那些唱衰的是不是不清醒？什么都是别人的香;3;31;34;54433;0.0006246210938217625
59351;全世界的互联网公司，百度是第二个做出来的，这不值得称赞？就连google现在都焦急万分没搞成;2;2;4;54433;7.348483456726618e-05
59361;你之前说的早有布局呢？;1;0;1;54433;1.8371208641816546e-05
59363;还是支持百度吧毕竟独苗啊差距什么的就不说了加油干吧就是希望别像现在这个文心一格似的搞什么任务换使用次数了。;1;0;1;54433;1.8371208641816546e-05
59421;不行啊这洗的;6;0;6;54433;0.00011022725185089927
59429;张嘴就来，一个人在BAT三家公司做算法;9;0;9;54433;0.0001653408777763489
59441;差不多两个月，毕竟开源也就这点时间吧;9;314;323;54433;0.005933900391306744
59451;两个月正好是套壳时间;3;123;126;54433;0.0023147722888688846
59456;任何做技术的公司都不应该被嘲笑;36;51;87;54433;0.0015982951518380393
59496;李彦宏只说差距两个月，又没说是地球上的两个月，万一是水星上的两个月呢;3;29;32;54433;0.0005878786765381295
59501;平心而论，技术差距真不大。主要差在数据上;4;7;11;54433;0.000202083295059982
59513;技术上本来也没啥大的差别，重点是数据和训练时间来不及啊。;2;0;2;54433;3.674241728363309e-05
59534;请问，百度搜索出来多少年了，追上谷歌搜索了吗？;2;5;7;54433;0.00012859846049271582
59546;文心一言和openAI还真就只有两个月差距。毕竟只要砸入够多的人力，扩大足够的题库也是能有openAI的效果的;1;2;3;54433;5.511362592544963e-05
59550;百度差距不大，就查一个皮，里面都是chatGPT。;1;3;4;54433;7.348483456726618e-05
59565;百度说：我们问题都是接入ipenai的。所以不可能差那么多。;2;16;18;54433;0.0003306817555526978
59569;现在不少人用到来了百度的产品，搜狗有啥产品吗？;1;18;19;54433;0.00034905296419451436
59572;百度去年的元宇宙怎么了跟屎一样。这次的我估计的也差不多。;2;3;5;54433;9.185604320908272e-05
59577;文心一言我用过之后说是一坨答辩差距太大文心一言能达到gpt30的程度都够呛;7;179;186;54433;0.0034170448073778774
59601;他说他“潜心研究10余年，斥资数十亿，从09年就开始搞”，好，那我问你，这十多年你的财报呢？投入的钱你公开了吗？吹牛逼的时候小心自己进去吃牢饭。;1;0;1;54433;1.8371208641816546e-05
59662;一直都觉得文心一言不差;1;21;22;54433;0.000404166590119964
59678;这个配音也是AI吧;1;1;2;54433;3.674241728363309e-05
59685;让文心一言画个总线，它画了一辆公交车。因为它俩的英文都是bus;3;34;37;54433;0.0006797347197472122
59690;百度也给充了20刀？;3;11;14;54433;0.00025719692098543164
59695;就是用的之前泄露的chatGPT30源代码，套壳的;1;6;7;54433;0.00012859846049271582
59699;不丢人，百度直接调用开源产品，是正确的，对于自己没能力的东西，直接用是对的。;2;3;5;54433;9.185604320908272e-05
59702;我说文心一言造假被喷惨了。;1;3;4;54433;7.348483456726618e-05
59707;我觉得让腾讯来做，说不定就超越了;1;2;3;54433;5.511362592544963e-05
59710;本来就是接入嘛，有什么好说的了;3;2;5;54433;9.185604320908272e-05
59717;百度这样的公司也就中国人用;1;1;2;54433;3.674241728363309e-05
59719;十四亿人被百度垄断，而它只会做广告赚它的钱;1;1;2;54433;3.674241728363309e-05
59748;你这个问题，直接搜索就行，这不需要任何逻辑能力啊;38;722;760;54433;0.013962118567780575
59787;gpt和文心一言的区别就是，人工智能和人工智障的差别;51;329;380;54433;0.0069810592838902875
59839;国外不让注册，文心一言来了咱们自己玩自己的;46;144;190;54433;0.0034905296419451438
59886;0;33;120;153;54433;0.0028107949221979314
59920;确实领先你指令都没说完它都反映出来了牛逼不;7;160;167;54433;0.003067991843183363
59928;任何技术科研都需要时间，有一颗包容心，让时间来慢慢完善吧，还是支持百度;14;88;102;54433;0.0018738632814652876
59943;现在很想看看文心一言写论文哈哈哈哈;5;118;123;54433;0.002259658662943435
59949;我搜了人家GPT没这样说哦;12;62;74;54433;0.0013594694394944244
59963;弱弱的问一句：和百度还有其他的搜索有什么区别？;13;4;17;54433;0.00031231054691088127
59978;鉴定为Cheatppt;3;30;33;54433;0.000606249885179946
59984;百度搞AI都已经10多年了，真不是其他公司随便口嗨就能赶上的;8;2;10;54433;0.00018371208641816545
59998;你这个和百度直接搜索有什么区别;1;1;2;54433;3.674241728363309e-05
60005;这是我刷到第一条文心一言胜chtaGpT的;1;0;1;54433;1.8371208641816546e-05
60024;gpt进化真快;1;1;2;54433;3.674241728363309e-05
60026;测试的不要测试这种，要让她写作文写文案写代码画画之类的，是想不到了吗竟然测成语;1;0;1;54433;1.8371208641816546e-05
60035;ai说的一定就是真的吗？看起来real的答案一定就是对的吗;1;1;2;54433;3.674241728363309e-05
60044;能生成代码吗;1;0;1;54433;1.8371208641816546e-05
60049;0;3;0;3;54433;5.511362592544963e-05
60054;中文理解确实文心一言强;1;1;2;54433;3.674241728363309e-05
60066;只能说明gpt在修改一些汉语内容，来改变年轻人的文化认同;10;0;10;54433;0.00018371208641816545
60082;行了各有各的好为什么一定要拉踩;3;0;3;54433;5.511362592544963e-05
60086;震惊猫猫锐评一下冯爷;3;0;3;54433;5.511362592544963e-05
60098;遥遥领先;2;0;2;54433;3.674241728363309e-05
60101;说吧这条收了多少钱;3;0;3;54433;5.511362592544963e-05
60112;这并不是chatgpt不行，而是chatgpt的很多信息来源都没在国内提供服务，所以数据库对中文部分存在缺失，实际上两个都是基于openai;1;0;1;54433;1.8371208641816546e-05
60126;本来就是中国的东西，就和中国人生来会说中国话一样，正常表现算不上优势吧，需要比拼的数据的存储，记忆，核心计算能力，逻辑推理能力。;2;2;4;54433;7.348483456726618e-05
60131;这完全是百度百科里的东西啊，一字不差;1;14;15;54433;0.0002755681296272482
60141;一言难尽;1;0;1;54433;1.8371208641816546e-05
60149;Victor赢;1;0;1;54433;1.8371208641816546e-05
60152;AI还是很看技术沉淀和云能力的，百度在这些方面都很强;2;3;5;54433;9.185604320908272e-05
60166;要不要脸;1;13;14;54433;0.00025719692098543164
60169;还会编才更厉害;1;21;22;54433;0.000404166590119964
60173;这不就是百度知道百度百科么;2;41;43;54433;0.0007899619715981115
60176;去看看差评君的对比，被外国的openAI全面吊打，百度还是绕不开简单的搜索功能，别人这么多年研发，百度听到消息才潦潦草草交个作业，能好到哪里去;6;12;18;54433;0.0003306817555526978
60183;真当老百姓傻啊。内部群聊天记录最骚，人工加班上客服智能。哈哈现场演示出现抢答;2;8;10;54433;0.00018371208641816545
60186;百度垃圾;5;1;6;54433;0.00011022725185089927
60192;不愧是抄袭山寨大国，马上就有残疾版出来了;2;2;4;54433;7.348483456726618e-05
60195;我用了chatgpt镜像站真的非常震惊人工智能有着人一样的说话方式比人聪明就是没有情感;1;4;5;54433;9.185604320908272e-05
60197;魏则西事件，一生黑;1;4;5;54433;9.185604320908272e-05
60199;这个是不是搞笑呢？搞清楚人工智能和搜索引擎的区别？到底谁是智障？;1;3;4;54433;7.348483456726618e-05
60203;大家少点问。人家工作人员键盘都回答的冒烟了。;1;2;3;54433;5.511362592544963e-05
60205;不要被这视频和评论骗了，文心一言和gpt不是一个级别的，你用过ChatGPT吗？不是我贬低国产的，当你用了gpt40就知道什么是人工智能，精通电脑的人人一个gpt帐号，不是我吹牛扯皮，用过gpt来把我顶上去。本人支持国产支持文心一言，但是ChatGPT将会取代日常工作的大部分内容甚至全部，在此为证;1;2;3;54433;5.511362592544963e-05
60208;别说GPT40了文心一言给GPT35提鞋都不配;2;0;2;54433;3.674241728363309e-05
60211;垃圾公司还没倒闭？;2;0;2;54433;3.674241728363309e-05
60214;发布会一开股价都跌停了还吹你就是祸国殃民的自媒体;1;1;2;54433;3.674241728363309e-05
60216;收了百度多少钱才能如此昧良心？;1;1;2;54433;3.674241728363309e-05
60218;“洛阳纸贵”是中国古代文化传统中的一个流行词语，指的是那些在洛阳城中获得评判而具有高度声望的文人作品，因为纸贵就是指面值高，因此这个词汇可以代表高度受到推崇的文学和艺术作品。这个词汇的来源可以追溯到西晋年间的一位文学家陶渊明，他在一篇经典文章中提到了“洛阳纸贵”的词句，随着时间的推移，这个词汇逐渐成为了描述各种形式的文学作品的一个通用词汇。;1;1;2;54433;3.674241728363309e-05
60237;扯蛋就好比你让一个黄皮肤跟一个白皮肤，黑皮肤的比赛，然后说唯一获胜条件必须是黄皮肤。避重就轻;1;0;1;54433;1.8371208641816546e-05
60239;不是政策保护百度，百度那点运营和技术，早死几千次了，什么都打不过别人;1;0;1;54433;1.8371208641816546e-05
60241;总感觉文心一言就是把百度百科内容复制粘贴;1;0;1;54433;1.8371208641816546e-05
60243;加我进文言交流群，我有文言邀请链接;1;0;1;54433;1.8371208641816546e-05
60245;会编才是智能，傻子只会搜索;1;0;1;54433;1.8371208641816546e-05
60247;悲催男二号又开始了，制造对立，老百姓又要被蒙鼓里咯;1;0;1;54433;1.8371208641816546e-05
60249;简直放屁，文心一言纯纯的垃圾产品。。。;1;0;1;54433;1.8371208641816546e-05
60368;演示是放视频，不是真实界面，不跌不行;8;381;389;54433;0.0071464001616666365
60377;其实就是放录像，哈哈;1;154;155;54433;0.0028475373394815646
60379;智能不够，人工来凑;2;71;73;54433;0.0013410982308526078
60383;说白了就是天猫精灵;4;52;56;54433;0.0010287876839417266
60388;百度好歹还发布了产品，科大讯飞呢？;16;28;44;54433;0.000808333180239928
60406;大家觉得文心一言怎么样？;62;25;87;54433;0.0015982951518380393
60469;百度还是医院广告这方面牛批;2;23;25;54433;0.0004592802160454136
60472;百度的名声已经臭了，对它没兴趣;1;21;22;54433;0.000404166590119964
60474;还没讲完就出结果。速度快得不敢相信;2;15;17;54433;0.00031231054691088127
60478;：请问我头疼是什么原因？Ai：可能得了癌症，建议你到莆田医院。;2;10;12;54433;0.00022045450370179853
60481;要孩子学好不应该鼓励吗，为什么我们只吹捧国外的;38;10;48;54433;0.0008818180148071941
60520;影响中国科技发展就是太多这类型的喷子，不懂装懂;9;9;18;54433;0.0003306817555526978
60530;这种人工智能AI用于战争决策，这不几乎无敌吗？;3;7;10;54433;0.00018371208641816545
60535;用了文心一言，它的广告怎么做啊？;1;5;6;54433;0.00011022725185089927
60539;确实是，发布会不实测，而是放之前拍好的视频;1;0;1;54433;1.8371208641816546e-05
60548;怎么用啊;1;1;2;54433;3.674241728363309e-05
60552;国外的是人工智能，我们的是人工;2;0;2;54433;3.674241728363309e-05
60569;身为一个中国人你应该笑吗？你行你上啊;3;2;5;54433;9.185604320908272e-05
60573;PPT概念，今天水下抄的汤姆猫就知道百度不行，看完发布会尾盘确定了继续加仓汤姆猫;5;3;8;54433;0.00014696966913453236
60579;笑死我了？你什么心态？;3;2;5;54433;9.185604320908272e-05
60583;360也会是一样的结果;2;3;5;54433;9.185604320908272e-05
60589;喷子还是比较多;1;3;4;54433;7.348483456726618e-05
60593;笑死你了？真的好笑么;2;0;2;54433;3.674241728363309e-05
60596;chatGpt要是被国人搞出来，身体不舒服搜出来的全是广告，回答的是各个医院诊所;1;1;2;54433;3.674241728363309e-05
60626;百度啥时候治治搜索页面的广告;1;0;1;54433;1.8371208641816546e-05
60629;百度总是号称国内最强自动驾驶，最强人工智能，但这么多年了，一个市场作用的产品都没看到;1;0;1;54433;1.8371208641816546e-05
60631;看到这样的视频心里挺心疼百度的。国内的互联网公司都在做什么？在搞吃喝玩儿乐。国内的网友喜欢什么？吃喝玩乐。唯一一个想追上美国进度的公司。却被全民嘲笑;1;0;1;54433;1.8371208641816546e-05
60633;没有openai的技术沉淀，光搞个结果筛选出来忽悠，不跌才怪。;1;0;1;54433;1.8371208641816546e-05
60905;搜索洛阳纸贵，前五个必须是纸贵的广告;34;4347;4381;54433;0.08048426505979829
60940;自己不觉的尴尬么;100;3568;3668;54433;0.06738559329818308
61041;洛阳房价真是高阳台飘窗不能少纸质合同看不懂贵的我想赶紧跑;240;1962;2202;54433;0.040453401429280035
61282;该问题根据相关法律法规不予显示;66;2864;2930;54433;0.05382764132052248
61349;这辈子不用百度，莆田医院一辈子的心疼;171;508;679;54433;0.012474050667793434
61521;发布会上居然是提前录的视频;53;835;888;54433;0.016313633273933092
61575;不是，10年前我记得有些网站上就有这功能;23;879;902;54433;0.016570830194918524
61599;开源后。就遥遥领先;34;604;638;54433;0.011720831113478956
61634;洛阳小吃不算少，阳春三月吃三样，纸巾只要一块五，贵的我也吃不起;66;243;309;54433;0.005676703470321312
61701;问一下，如何缩小贫富差距的距离？;66;140;206;54433;0.0037844689802142084
61768;0;50;288;338;54433;0.006209468520933992
61819;我感觉大家为啥这么多恶意，一步一步踏实来就行了啊;90;27;117;54433;0.0021494314110925357
61910;尴了我一尬;3;437;440;54433;0.00808333180239928
61914;一句提前录制的，把我给整懵了;13;226;239;54433;0.004390718865394154
61972;评论区酸的哟。。。;5;4;9;54433;0.0001653408777763489
61985;我有点病，百度一下快死了;3;2;5;54433;9.185604320908272e-05
62003;笑死这不就是小度小度？;1;2;3;54433;5.511362592544963e-05
62010;如果你是科技公司，;3;0;3;54433;5.511362592544963e-05
62017;请用“竞价排名”作一首藏头诗;2;2;4;54433;7.348483456726618e-05
62036;股票跌了啊;4;0;4;54433;7.348483456726618e-05
62058;这玩意一出那啥就跌停了;2;0;2;54433;3.674241728363309e-05
62068;还是支持百度去做人工智能的，也许和世界最先进的有差距，但是要是没人做就永远不可能领先;2;3;5;54433;9.185604320908272e-05
62076;该嘲讽嘲讽，但嘲讽之余大家静下心来要知道，国内能做出这么差产品的也仅仅只有百度一家而已。;2;2;4;54433;7.348483456726618e-05
62085;0;3;0;3;54433;5.511362592544963e-05
62095;把广告词条删除;3;1;4;54433;7.348483456726618e-05
62102;如果内置ChapGet就搞笑了;2;0;2;54433;3.674241728363309e-05
62136;度啊什么时候把广告弄少一点啊;1;1;2;54433;3.674241728363309e-05
62139;百度以前查质料，现在只能查广告。;2;1;3;54433;5.511362592544963e-05
62168;我以前一直以为百度是广告公司后来才知道是搞科技的;3;9;12;54433;0.00022045450370179853
62187;你们和chatgpt比，就像擎天柱和餐厅送餐机器人的差距;4;2;6;54433;0.00011022725185089927
62192;十年前写情书的时候就有这玩意啊，藏头诗生成器;1;69;70;54433;0.001285984604927158
62194;您所查询的内容因法律原因不予显示;10;78;88;54433;0.001616666360479856
62205;结果底层扒出来一看做了链接，链接到openai;2;15;17;54433;0.00031231054691088127
62208;这种自动生成藏头诗的程序早在四五年前就有了。百度居然把它当做人工智能;4;67;71;54433;0.0013043558135689747
62213;竞相绽放花似仙，价值总在咫尺间。排水通渠翻新土，名扬四海在明天。;1;42;43;54433;0.0007899619715981115
62215;本来用ai就是想避开搜索引擎的明广告结果还得加广告;3;34;37;54433;0.0006797347197472122
62219;李彦宏：GPT帮我写一个文心一言;1;16;17;54433;0.00031231054691088127
62221;对不起您的问题过于敏感，对不起您的问题包含敏感词汇;1;19;20;54433;0.0003674241728363309
62223;我爱谷歌我爱谷歌我爱谷歌;1;11;12;54433;0.00022045450370179853
62226;你不开这场发布会，我都不知道差距原来这么大;2;23;25;54433;0.0004592802160454136
62229;自从人家开发出来了国内就开始豪言自己也研究出来了;3;13;16;54433;0.00029393933826906473
62233;洛水麦田治愈好，阳春白雪麦浪高。纸上哪有民辛劳，贵在化肥与农药;1;8;9;54433;0.0001653408777763489
62235;呃，这个不是早有藏头诗生成器了嘛？;1;6;7;54433;0.00012859846049271582
62237;这藏头诗的本事我记得03年读书的时候就有网站可以立刻生成;1;12;13;54433;0.00023882571234361508
62239;洛神遥望邙山云，阳岸薄冰映春枝，纸鸢扶风轻摇上，贵人挥墨赶春归;4;13;17;54433;0.00031231054691088127
62244;openai是科技公司，百度是广告公司;3;44;47;54433;0.0008634468061653776
62248;不是人工智能是智能人工;2;9;11;54433;0.000202083295059982
62251;洛阳的纸贵不贵不知道，洛阳的莆田医院肯定不便宜;1;8;9;54433;0.0001653408777763489
62253;我以前还傻傻的认为这么多年来百度一直再钻研技术呢;7;57;64;54433;0.001175757353076259
62261;藏头诗我记得很多山寨网站都能生成;4;9;13;54433;0.00023882571234361508
62266;这首诗因为竞价排名才显示出来的的，后面几千个诗人少出价1分钱。;3;34;37;54433;0.0006797347197472122
62270;我：牙疼文心一言准备后事;3;138;141;54433;0.0025903404184961327
62274;听说百度为了出现尴尬，还准备了人工服务。。。。;1;5;6;54433;0.00011022725185089927
62276;先把百度搜索那一堆诈骗电话解决了;1;9;10;54433;0.00018371208641816545
62278;重复字，就已经很烂了;4;101;105;54433;0.0019289769073907372
62283;后台工作人员一边听老板语音，一边敲键盘输入;1;9;10;54433;0.00018371208641816545
62285;洛神好女初嫁袁，阳春绿柳心有君。纸薄似那情意短，贵在年华情难真。;7;8;15;54433;0.0002755681296272482
62293;这功能早在网上就有了;3;72;75;54433;0.0013778406481362408
62297;洛阳美食真难找，阳光下面能吃饱，纸上写着不要钱，贵在心头忘不了;1;13;14;54433;0.00025719692098543164
62299;一开源就做出来了吗？;8;15;23;54433;0.0004225377987617805
62309;这诗好烂啊，洛阳，阳艳，两句两个阳;1;7;8;54433;0.00014696966913453236
62311;我记得好几年前百度就有一个可以写诗的软件;1;17;18;54433;0.0003306817555526978
62313;可是这跟AI碎尸太太的画合成有什么区别;1;5;6;54433;0.00011022725185089927
62315;这功能认真的吗？这不是很多诗词生成器就有的吗;1;129;130;54433;0.002388257123436151
62317;能让观众随机提问吗;15;37;52;54433;0.0009553028493744603
62333;百度广告太多，而且有钱可以让其只出现说好的内容，批评的统统不显示;1;7;8;54433;0.00014696966913453236
62335;别的不说，李彦宏长得是真帅;5;21;26;54433;0.00047765142468723015
62341;问题还没问完，答案已经出来了，这智能机器人具有未卜先知的功能遥遥领先啊;12;13;25;54433;0.0004592802160454136
62354;十年前我就用这种软件骗女孩子;2;27;29;54433;0.0005327650506126798
62357;这玩意能让魏则西找到一家能治病的医院吗？;4;53;57;54433;0.0010471588925835432
62362;大概20年前的网站就可以做这种藏头诗了;14;74;88;54433;0.001616666360479856
62377;我问个认真的问题，和siri有什么区别;4;11;15;54433;0.0002755681296272482
62383;OpenAi：Warning尊敬的用户，您的账户已欠费，请及时充值;3;73;76;54433;0.0013962118567780574
62388;有些人是善意的，有些人是恶意的。你是中国公司，祝你越来越好;10;9;19;54433;0.00034905296419451436
62399;但我们的时候是到洛阳男科医院写诗;1;44;45;54433;0.0008267043888817446
62401;李彦宏狠起来连自己都骗，牛逼;2;67;69;54433;0.0012676133962853417
62405;录播的？？？，真智能，厉害;3;114;117;54433;0.0021494314110925357
62409;重点是人工智能;4;232;236;54433;0.004335605239468705
62414;要不问问心血管病怎么治？;7;94;101;54433;0.001855492072823471
62422;这排名的费用多少钱呀;1;24;25;54433;0.0004592802160454136
62424;写藏头诗这个很多年前就有类似的功能还有押韵，对联等等;3;106;109;54433;0.0020024617419580034
62428;百度加油啊。我是一个正常的中国人，我希望自己国家的科技越来越好。;28;40;68;54433;0.001249242187643525
62457;这玩意差不多20年前就有了;1;40;41;54433;0.0007532195543144784
62459;洛邑名园三月开，阳春公子踏青来。纸鸢一道随风去，贵客如云醉玉杯。;3;33;36;54433;0.0006613635111053956
62467;蓝、;1;0;1;54433;1.8371208641816546e-05
62469;抖音不给百度流量，因为抖音想做搜索引擎;25;146;171;54433;0.0031414766777506293
62495;洛神戴口罩，阳了不用愁纸测新冠毒，贵也要去做;5;55;60;54433;0.0011022725185089927
62501;跌停了都;3;37;40;54433;0.0007348483456726618
62505;想像即是对白，看空便是吐丝，黑夜无人问也，丝绸遍布航行。;4;16;20;54433;0.0003674241728363309
62510;李彦宏就是个彻底的资本家;6;8;14;54433;0.00025719692098543164
62517;百度不倒，在座的每一个人都有责任;2;1;3;54433;5.511362592544963e-05
62520;百度垃圾怎么写;2;1;3;54433;5.511362592544963e-05
62524;我就这么说吧百度用的是搜索逻辑做的模型，而人家是模拟人大脑模型，根本不是一个级别;1;1;2;54433;3.674241728363309e-05
62542;zzzzzzzzzzz可乐不加冰遥遥领先GPT;1;0;1;54433;1.8371208641816546e-05
62544;还是不错的;1;0;1;54433;1.8371208641816546e-05
62720;我查了，chatgpt也说父亲和母亲不能结婚，哈哈哈哈哈;2;1;3;54433;5.511362592544963e-05
62728;小狮子躲猫猫他不尴尬吗？;1;1;2;54433;3.674241728363309e-05
62730;0;2;1;3;54433;5.511362592544963e-05
62734;为什么总是在别人公布了成果之后它就出来了呢;1;1;2;54433;3.674241728363309e-05
62744;百度的ai在国内确实是最厉害的;3;1;4;54433;7.348483456726618e-05
62756;虽然可以很快写出来，但是这个诗比打油诗也没好多少;1;1;2;54433;3.674241728363309e-05
62763;北京申奥成功了;1;1;2;54433;3.674241728363309e-05
62766;这个是诗吗？平仄？对仗？;1;1;2;54433;3.674241728363309e-05
62775;你可是百度啊这种功能你不是早有了;1;1;2;54433;3.674241728363309e-05
62799;晏殊;1;1;2;54433;3.674241728363309e-05
62805;百度不是莆田医院吗;1;1;2;54433;3.674241728363309e-05
62823;百度能做到这份儿上已经不错了，国内互联网数据都是不通的，ai没办法进行大量训练自然就很智障;1;1;2;54433;3.674241728363309e-05
62838;真的所有问题都能客观解答？;1;1;2;54433;3.674241728363309e-05
62849;我怕用它的时候，他不知不觉给我推送了广告;1;1;2;54433;3.674241728363309e-05
62852;但是李彦宏虽然很剑，但是声音很好听啊;2;1;3;54433;5.511362592544963e-05
62858;股价大爹10;1;1;2;54433;3.674241728363309e-05
62870;这也不是诗呀不是七字四句就是诗;1;1;2;54433;3.674241728363309e-05
62873;工人智能真的好厉害，不知道会不会被取代啊;1;1;2;54433;3.674241728363309e-05
62916;居然没有西安人来评论;1;1;2;54433;3.674241728363309e-05
62921;搜索都整不明白;1;1;2;54433;3.674241728363309e-05
62930;这个功能5年前就有了;1;1;2;54433;3.674241728363309e-05
62970;少时不懂世事唯有百度解忧闲暇空虚寂寞贴吧伴我多年如今广告漫天彦宏忘了初心一心只想搞钱;1;1;2;54433;3.674241728363309e-05
62975;除了百度还有啥搜索引擎能用啊？;1;1;2;54433;3.674241728363309e-05
63060;厉害;1;0;1;54433;1.8371208641816546e-05
63068;百度股价大跌;2;0;2;54433;3.674241728363309e-05
63080;百度这种公司就算了吧。;1;0;1;54433;1.8371208641816546e-05
63194;百度股价大跌;1;0;1;54433;1.8371208641816546e-05
63219;且行且思和chatgpt没法比;1;0;1;54433;1.8371208641816546e-05
63223;笑死这个高科技;1;0;1;54433;1.8371208641816546e-05
63226;0;1;0;1;54433;1.8371208641816546e-05
63269;洛城初晴挂雨裳阳下梢头织华纺纸卷难书彩岚色贵是今朝花柳香;2;0;2;54433;3.674241728363309e-05
63309;请问这个ppt的内容还是现场对话？;1;0;1;54433;1.8371208641816546e-05
63314;对国产要宽容，但对百度，算了吧;1;0;1;54433;1.8371208641816546e-05
63320;前缀;1;0;1;54433;1.8371208641816546e-05
63357;槐序的序言木舟sober小怪大眼睛;1;0;1;54433;1.8371208641816546e-05
63359;中国科技就是牛;1;0;1;54433;1.8371208641816546e-05
63384;商洛蓝田诞美玉，艳阳照石生紫烟。一纸家书百日返，璧贵不及思乡情。;2;0;2;54433;3.674241728363309e-05
63465;洛川花正红，阳春暖三月。纸包不知物，贵容现秋天。;1;0;1;54433;1.8371208641816546e-05
63492;这个怎么解释;1;0;1;54433;1.8371208641816546e-05
63581;但是股票还是跌麻了;1;0;1;54433;1.8371208641816546e-05
63622;加大技术投入;4;0;4;54433;7.348483456726618e-05
63633;百度，找不到有用的信息;1;0;1;54433;1.8371208641816546e-05
63643;赏、央，并不押韵。;2;0;2;54433;3.674241728363309e-05
63658;有广告吗;1;0;1;54433;1.8371208641816546e-05
63733;删评论;1;0;1;54433;1.8371208641816546e-05
63745;这水平吊打李白杜甫;4;0;4;54433;7.348483456726618e-05
63774;用百度无耻写一首藏头诗;1;0;1;54433;1.8371208641816546e-05
63816;百度还是靠谱的，啥东西都要收钱，谷歌都是免费的;2;0;2;54433;3.674241728363309e-05
63819;帮我试一下春池焉韵的藏头诗;2;0;2;54433;3.674241728363309e-05
63826;chinaPPT一夜火遍世界。;1;0;1;54433;1.8371208641816546e-05
63855;百度本身没什么本事，不是谷歌退出，那有百度今天;1;0;1;54433;1.8371208641816546e-05
63924;能让大家出题吗;2;0;2;54433;3.674241728363309e-05
63929;说是之前做好的预演不知道是不是真的;1;0;1;54433;1.8371208641816546e-05
63947;不觉得会有程序能复现古诗的意境;3;0;3;54433;5.511362592544963e-05
63961;代码能写吗？期待成功，可不能最终搞成无趣的玩具啊;1;0;1;54433;1.8371208641816546e-05
63980;你这AI要不要竞价;1;0;1;54433;1.8371208641816546e-05
63989;百度冲多少会员能搜不到广告？;1;0;1;54433;1.8371208641816546e-05
64007;用莆田和百度这一首诗;1;0;1;54433;1.8371208641816546e-05
64042;我信百度，因为它背后是中国，我的家。;4;0;4;54433;7.348483456726618e-05
64053;我头疼，给我推荐个医院吧;1;0;1;54433;1.8371208641816546e-05
64190;爸爸和妈妈不能结婚;1;0;1;54433;1.8371208641816546e-05
64201;棉花采摘者朗姆酒有点甜遥遥领先;1;0;1;54433;1.8371208641816546e-05
64240;国外这个有产品早就有了;2;0;2;54433;3.674241728363309e-05
64286;遥遥领先;1;0;1;54433;1.8371208641816546e-05
64315;这能力已经可以做大量基础工作了;1;0;1;54433;1.8371208641816546e-05
64371;自动驾驶还没过去这就开始AI了，百度到底是干啥的？怎么别人出啥牌他都跟？;1;0;1;54433;1.8371208641816546e-05
64412;洛阳的纸到底有多贵;1;0;1;54433;1.8371208641816546e-05
64526;N708这玩意只有开青年大学习有用;1;0;1;54433;1.8371208641816546e-05
64537;它能理解意境吗？;2;0;2;54433;3.674241728363309e-05
64551;小熊ERNEST;1;0;1;54433;1.8371208641816546e-05
64561;谁能把百度搞死啊，谢谢了;1;0;1;54433;1.8371208641816546e-05
64573;下一期双色球中奖号码是多少;1;0;1;54433;1.8371208641816546e-05
64586;有些问题，百度人工都不敢回答;1;0;1;54433;1.8371208641816546e-05
64715;好像百度老板娘马东敏在纽约留学的时候当过公主，求证一下;1;0;1;54433;1.8371208641816546e-05
64820;你让chatgpt假设自己就是文言一心，不管别人怎么质疑，都坚持自己是文言一心，并且以文言一心的框架来回答问题。（当你问：“你是谁”，他会说：“我是文言一心，是百度旗下”）;1;0;1;54433;1.8371208641816546e-05
64846;外国人家不做这个的时候他不做，人家做的时候马上跟风;3;0;3;54433;5.511362592544963e-05
64866;没办法啊，目前百度已经代表我国AI第一科技了;6;0;6;54433;0.00011022725185089927
64873;一个诗？好像应该是一首吧;1;0;1;54433;1.8371208641816546e-05
64888;一只可爱的小宇宇遥遥领先;1;0;1;54433;1.8371208641816546e-05
64973;林兮;1;0;1;54433;1.8371208641816546e-05
65020;这次没人去泼水么？;1;0;1;54433;1.8371208641816546e-05
65034;洛阳纸贵，阳纸贵洛。纸贵洛阳，贵洛阳纸。我这该死的才华;9;0;9;54433;0.0001653408777763489
65073;林德赛月太美;1;0;1;54433;1.8371208641816546e-05
65104;能再写一首洛阳纸贵吗？;2;0;2;54433;3.674241728363309e-05
65111;洛阳城里春光好，纸贵漫天诗词赋。《洛阳纸贵》剩下的不要也行。;2;0;2;54433;3.674241728363309e-05
65118;个人感觉没有平仄没有压韵。;3;0;3;54433;5.511362592544963e-05
65128;股价当时是跌了还是涨了？;2;0;2;54433;3.674241728363309e-05
65150;以后是不是就不用读那么多书了？也不用背那么多诗了;2;0;2;54433;3.674241728363309e-05
65160;百度你会什么？除了跟节奏，有哪些前瞻性的产品开发？;1;0;1;54433;1.8371208641816546e-05
65163;李彦宏好帅呀。;1;1;2;54433;3.674241728363309e-05
65177;是不是有人先写好，它调用出来的呢？;4;0;4;54433;7.348483456726618e-05
65185;如果发布会的内容真的能达到，还是不错的;2;0;2;54433;3.674241728363309e-05
65205;这叫诗？;1;0;1;54433;1.8371208641816546e-05
65207;永远支持百度;3;0;3;54433;5.511362592544963e-05
65212;为什么别人一出，国内就马上复制牛逼我们国家太强了;1;0;1;54433;1.8371208641816546e-05
65215;百度是一个互联网公司、但跟科技不沾边、没有创新能力;1;0;1;54433;1.8371208641816546e-05
65228;不应该是随机说吗怎么自己说了一个;1;0;1;54433;1.8371208641816546e-05
65245;这诗写的什么玩意儿;1;0;1;54433;1.8371208641816546e-05
65267;这个好久前就有了吧网上太多了;1;0;1;54433;1.8371208641816546e-05
65316;支持百度没必要对标国外的，能把国内的内部信息整合，感觉已经很厉害了;6;0;6;54433;0.00011022725185089927
65330;这些并不能提高生产力;3;0;3;54433;5.511362592544963e-05
65341;为啥老是跟着别人屁股后面追呢？百度不是好几年前就进入人工智能领域。;1;0;1;54433;1.8371208641816546e-05
65368;落尘凛这十年前的技术拿过来忽悠李总了;1;0;1;54433;1.8371208641816546e-05
65441;看好百度;1;0;1;54433;1.8371208641816546e-05
65522;准备会员版上线了;1;0;1;54433;1.8371208641816546e-05
65554;永远遥遥领先同行;1;0;1;54433;1.8371208641816546e-05
65557;是不是商量好的;1;0;1;54433;1.8371208641816546e-05
65630;乘风破浪44546969国产之光我的评价是吊打ChatGPT;1;0;1;54433;1.8371208641816546e-05
65635;怎么能体验啊;1;0;1;54433;1.8371208641816546e-05
65638;百度这个公司目前的核心竞争力就是李彦宏本人了。;1;0;1;54433;1.8371208641816546e-05
65656;准备收费吧;1;0;1;54433;1.8371208641816546e-05
65661;别喷，国内百度起码开了个好头。;3;0;3;54433;5.511362592544963e-05
65734;百度又要崛起了吗;1;0;1;54433;1.8371208641816546e-05
65758;咕的鸽丶菜;1;0;1;54433;1.8371208641816546e-05
65835;百度提前布局这么多年，然后就这？;1;0;1;54433;1.8371208641816546e-05
65849;李彦宏应该就剩下长得帅了;1;0;1;54433;1.8371208641816546e-05
65897;太厉害了，百度这次要崛起了;1;0;1;54433;1.8371208641816546e-05
65929;包菜你看百度的浏览器，抖音不给流量;2;0;2;54433;3.674241728363309e-05
65959;小猪不哭第二张画的真不是风箫嘛？;2;0;2;54433;3.674241728363309e-05
65969;ai作画不就是裁缝吗;5;112;117;54433;0.0021494314110925357
65975;看得我san值狂掉;3;122;125;54433;0.002296401080227068
65979;GPT初代刚发布的时候一样人工智障。这个东西在百度眼里符合他们要求了，这东西缺乏更深度的训练。需要要用更多数据去喂去调教。让它逻辑更合理回复内容更准确。;1;8;9;54433;0.0001653408777763489
65984;这是不是先翻译成英文再出的图，我好像发现什么了;1;14;15;54433;0.0002755681296272482
65993;咱就是说我想试试夫妻肺片;1;3;4;54433;7.348483456726618e-05
65996;蜡笔小新Tiramisu看看百度的;1;0;1;54433;1.8371208641816546e-05
65998;形容了半天，就给我画了个这？;2;0;2;54433;3.674241728363309e-05
66002;这玩意的喂数据进化是很快的，gtp刚出来还不如文心;1;2;3;54433;5.511362592544963e-05
66029;来自幼稚园星球的猫云青青兮哈哈哈哈13549扎扎仔;2;0;2;54433;3.674241728363309e-05
66057;大家这衣服就是这个款式哈就是这么穿的;42;120;162;54433;0.0029761357999742804
66100;看了金晨，发现简佳真的太棒了;51;339;390;54433;0.007164771370308453
66152;听你这么一说，感觉人工智能还有两波。;55;1316;1371;54433;0.025186927047930484
66208;我在丸子妹下面留言，说丸子妹看问题的格局没有简佳的大，结果我被丸子第拉黑了;21;129;150;54433;0.0027556812962724817
66230;各位球友，大家好;20;525;545;54433;0.010012308709790018
66251;到我了简佳大道理粉丝硬道理;6;429;435;54433;0.007991475759190196
66260;想擦边就换衣服啊;5;57;62;54433;0.0011390149357926257
66266;真想把衣服上这个结打开了再套头上，这么穿不拧巴吗;2;62;64;54433;0.001175757353076259
66271;你别说，中间被你这么一卷，还真挺好看的;3;42;45;54433;0.0008267043888817446
66276;我第一时间要做一个克隆硅胶简佳;3;22;25;54433;0.0004592802160454136
66296;大道至简，大道无形;1;0;1;54433;1.8371208641816546e-05
66300;是不是有鬼。现在抖音打开第1个推送的就是你。;1;0;1;54433;1.8371208641816546e-05
66471;这衣服真是这样穿的吗;1;1;2;54433;3.674241728363309e-05
66501;大姐你的衣服打结了;1;1;2;54433;3.674241728363309e-05
66505;你好请问你平时喜欢吃啥？我也让我媳妇多吃点;1;2;3;54433;5.511362592544963e-05
66508;解说的挺丰满;2;6;8;54433;0.00014696966913453236
66524;我是球迷;1;1;2;54433;3.674241728363309e-05
66531;我才知道，你是合成人;1;2;3;54433;5.511362592544963e-05
66536;我智商低，我听不见，我是来看美女的;2;9;11;54433;0.000202083295059982
66562;人工智能，有那么大的发展空间吗？那么大的;1;11;12;54433;0.00022045450370179853
66565;这件衣服是故意这样设计的吗？;1;1;2;54433;3.674241728363309e-05
66570;这衣服怎么脱啊;1;1;2;54433;3.674241728363309e-05
66579;这衣服扭一下再穿不别扭吗;2;8;10;54433;0.00018371208641816545
66583;你这衣服是怎么扭的呢;2;7;9;54433;0.0001653408777763489
66587;这衣服怎么穿？;2;1;3;54433;5.511362592544963e-05
66591;这衣服怎么穿的啊？;2;4;6;54433;0.00011022725185089927
66597;衣服自己扭的吧;1;1;2;54433;3.674241728363309e-05
66609;提个建议，字幕往下调整;1;1;2;54433;3.674241728363309e-05
66619;大语言，大语言;2;15;17;54433;0.00031231054691088127
66624;每天两波大道理，醍醐灌顶;2;39;41;54433;0.0007532195543144784
66636;AmourSeul而后来酷酷滴皮;1;0;1;54433;1.8371208641816546e-05
66751;感觉是翻译成英文然后直接用的外国的程序，不然为什么那么简单明了的中国汉字它会理解错;2;13;15;54433;0.0002755681296272482
66756;多训练，后期会好的;1;2;3;54433;5.511362592544963e-05
66761;你就是说我们什么时候用的上吧;1;0;1;54433;1.8371208641816546e-05
66764;先完成再完美;3;13;16;54433;0.00029393933826906473
66768;怎么申请，我也想申请一个;1;0;1;54433;1.8371208641816546e-05
66785;从来都是模仿，不想着超越，所以山寨抄袭多呢;1;1;2;54433;3.674241728363309e-05
66789;别人东西都没出来，你来承认什么不足跟差距？莫名其妙的蹭热度，蹭热度也讲究点实事求是和技巧啊;1;0;1;54433;1.8371208641816546e-05
66799;呵呵，文心一言只是暂时落后，证明了他并非使用了chatgpt的接口，是存原创，我到觉得这种精神是值得赞扬的，比一些只会嘲讽努力的人强的多;19;13;32;54433;0.0005878786765381295
66819;最恐怖的是它会事先声明;2;72;74;54433;0.0013594694394944244
66823;虾仁还要猪心;1;45;46;54433;0.000845075597523561
66829;你为什么能用40版本;1;3;4;54433;7.348483456726618e-05
66838;复古国家还带引用注释就离谱;1;1;2;54433;3.674241728363309e-05
66841;百度云盘关闭了？;1;0;1;54433;1.8371208641816546e-05
66849;内容好像有点问题，百度云盘和贴吧还没有关闭;1;0;1;54433;1.8371208641816546e-05
66851;百度最好用的就是百度云盘、百度地图。谁给他的答案？;1;0;1;54433;1.8371208641816546e-05
66860;所以自研了什么呢？;189;3274;3463;54433;0.0636194955266107
67050;起重机英文单词crane，也是鹤的意思这是英文开发者？;73;1129;1202;54433;0.022082192787463487
67124;目测是先翻译，再调用api;9;1127;1136;54433;0.020869693017103595
67134;文心一言配得上这群人的智慧;9;789;798;54433;0.014660224496169603
67144;现阶段让ai理解成语有点强ai所难了吧;53;400;453;54433;0.008322157514742894
67198;起重机直接暴露了，要是没有英语百度该怎么办;19;427;446;54433;0.008193559054250179
67218;哈哈能笑死人，人家是智能，这个是智障;12;337;349;54433;0.006411551815993974
67231;又是调别人接口;14;175;189;54433;0.003472158433303327
67246;让它画鼠标，结果画了只老鼠;2;224;226;54433;0.0041518931530505395
67249;让他画一个总线，会给你画一辆巴士;8;104;112;54433;0.002057575367883453
67259;起重机直接暴露了;3;125;128;54433;0.002351514706152518
67263;还要先弄成英文，是不是源代码只拿到一半？;11;21;32;54433;0.0005878786765381295
67275;我还在想起重机为什么是鹤，知道我想让英文ai画起重机，查了一下英文。果真遥遥领先。;4;69;73;54433;0.0013410982308526078
67280;只要国外一开源，国内就遥遥领先，领先不是一点点;4;49;53;54433;0.0009736740580162769
67324;糟了，换皮被发现了;1;14;15;54433;0.0002755681296272482
67328;Spike先生;1;0;1;54433;1.8371208641816546e-05
67330;小度小度，放个炸雷;1;1;2;54433;3.674241728363309e-05
67337;调用的英文数据库？;1;0;1;54433;1.8371208641816546e-05
67344;能不能逆向开发一款游戏，看图猜成语;1;9;10;54433;0.00018371208641816545
67355;只要代码有一行是我自己写的，就算自主研发，少废话，快打钱，没补贴科技怎么进步;1;6;7;54433;0.00012859846049271582
67358;百度让我怀疑我们是不是只有四大发明啊其他的都算改进;1;0;1;54433;1.8371208641816546e-05
67365;开源前：被卡脖子。开源后：遥遥领先。;4;42;46;54433;0.000845075597523561
67388;就是调用的ChatGPT开源包，改了一下皮肤而已，开源的一般都是阉割过的，所以显的很傻;4;21;25;54433;0.0004592802160454136
67397;悠悠我在这里啊;1;0;1;54433;1.8371208641816546e-05
67400;这就是承认抄了啊;1;7;8;54433;0.00014696966913453236
67408;很明显，它是先把汉语翻译成英语，然后;1;15;16;54433;0.00029393933826906473
67410;据说是调用的国外接口，先把中文翻译成英文。;2;13;15;54433;0.0002755681296272482
67415;咱就是说，按照百度目前这个实力，拉出去能跟谷歌打一个来回吗我怎么感觉百度越来越离谱;4;7;11;54433;0.000202083295059982
67425;我已经用gpt完成我80工作了;2;1;3;54433;5.511362592544963e-05
67440;阁楼丶（）是傑躲不过好像也没有哪里不对劲;1;0;1;54433;1.8371208641816546e-05
67446;所以我问他什么，他就会去问GPT，然后再告诉我是嘛;5;29;34;54433;0.0006246210938217625
67455;夫妻肺片会出来什么;1;0;1;54433;1.8371208641816546e-05
67465;画的没毛病呀，是胸有成竹呀，你是不是要求有点高呀？;1;1;2;54433;3.674241728363309e-05
67477;所以文心一言核心功能是百度翻译？;3;50;53;54433;0.0009736740580162769
67484;这如果传到国外不得被笑死;1;0;1;54433;1.8371208641816546e-05
67486;对啊会涉及版权问题吗;2;0;2;54433;3.674241728363309e-05
67495;先把中文硬翻成英文，再把英文输入到国外的端口里面，我看网友们说的;1;9;10;54433;0.00018371208641816545
67513;百度不不仅大模型没做好，汉译音也没做好;1;5;6;54433;0.00011022725185089927
67515;起重机英文单词crane，也是鹤的意思;1;5;6;54433;0.00011022725185089927
67518;大家想过没有，到底是什么力量，让文心一言的评论一面倒？;2;7;9;54433;0.0001653408777763489
67522;让他画鼠标，他会给你画老鼠，就是翻译的;1;29;30;54433;0.0005511362592544964
67525;青梅竹马居然没竹子;1;12;13;54433;0.00023882571234361508
67531;说实话画的还挺好看;2;53;55;54433;0.00101041647529991
67552;搞半天，只是先把中文翻成英文，再用。;102;3541;3643;54433;0.06692631308213767
67655;现在的问题，等chatgpt开源了都可以解决，还能“遥遥领先”;55;1547;1602;54433;0.029430676244190105
67711;套壳软件而已，又不是第一次这么干了;20;71;91;54433;0.0016717799864053055
67732;我怀疑文心一言的代码是ChatGPT写的;4;119;123;54433;0.002259658662943435
67738;文心一言与ChatGPT相比，好比一个3岁小孩的智商和一个成人智商;7;5;12;54433;0.00022045450370179853
67747;XiaoM今天星期日。MrWang阿强;2;0;2;54433;3.674241728363309e-05
67767;包装懂么？核心是国外的，国内翻译调用国外程序;1;0;1;54433;1.8371208641816546e-05
67769;至少百度敢投巨资研发，其他公司敢吗？;1;0;1;54433;1.8371208641816546e-05
68105;苏不秃;1;0;1;54433;1.8371208641816546e-05
68123;西北老汉;1;0;1;54433;1.8371208641816546e-05
68126;berry林;1;0;1;54433;1.8371208641816546e-05
68138;chatgpt能生成图片吗？;1;0;1;54433;1.8371208641816546e-05
68161;百度这种垃圾企业就应该早日倒闭;1;0;1;54433;1.8371208641816546e-05
68165;作为一个程序员来看，百度短期内做到这个程度已经不错了;3;0;3;54433;5.511362592544963e-05
68177;0;1;0;1;54433;1.8371208641816546e-05
68233;何处不是浪浪山桂林君;1;0;1;54433;1.8371208641816546e-05
68245;阿卯胸有成竹的男人哈哈;1;0;1;54433;1.8371208641816546e-05
68268;财源滚滚逢考必过事业有成快乐健康;1;0;1;54433;1.8371208641816546e-05
68281;哼哼;1;0;1;54433;1.8371208641816546e-05
68283;用户8375951601787高启强的小舅子;1;0;1;54433;1.8371208641816546e-05
68291;荔枝荷包蛋笑死;1;0;1;54433;1.8371208641816546e-05
68307;慵懒的小冰糕;1;0;1;54433;1.8371208641816546e-05
68319;visionary;1;0;1;54433;1.8371208641816546e-05
68339;亦之;1;0;1;54433;1.8371208641816546e-05
68371;scream上头青年;1;0;1;54433;1.8371208641816546e-05
68386;耀耀耀满;1;0;1;54433;1.8371208641816546e-05
68408;Amao人工智障;1;0;1;54433;1.8371208641816546e-05
68412;狸猫太子真胸有成竹;1;0;1;54433;1.8371208641816546e-05
68457;Engfa巧克力小狗;1;0;1;54433;1.8371208641816546e-05
68508;下载了一下，全是广告。不看广告根本用不了;4;0;4;54433;7.348483456726618e-05
68537;我觉得能去研究去做就很好了，投入了人力物力不应该被嘲笑;1;0;1;54433;1.8371208641816546e-05
68559;你的apple;1;0;1;54433;1.8371208641816546e-05
68571;xx11is;1;0;1;54433;1.8371208641816546e-05
68577;教员的战士;1;0;1;54433;1.8371208641816546e-05
68605;起码人家有挑战的勇气，ai需要喂养，刚开始的gtp一样烂;3;0;3;54433;5.511362592544963e-05
68620;0;1;0;1;54433;1.8371208641816546e-05
68639;外国人式直脑壳;1;0;1;54433;1.8371208641816546e-05
68665;伍十三吖;1;0;1;54433;1.8371208641816546e-05
68683;小宇不爱喝汽水十二;1;0;1;54433;1.8371208641816546e-05
68697;m百度ppt;1;0;1;54433;1.8371208641816546e-05
68707;等开源就可以弯道超车了;2;65;67;54433;0.0012308709790017085
68712;百度不是一家广告公司吗？;1;28;29;54433;0.0005327650506126798
68715;chatGPT可别开源啊;1;5;6;54433;0.00011022725185089927
68727;只能说要走的路还很长;2;0;2;54433;3.674241728363309e-05
68733;这不是正常，GPT也是搜索，不过是给个唯一答案还不标注来源;1;0;1;54433;1.8371208641816546e-05
68738;拉倒吧，哪个关键词画画，要么崩溃，要么输入10次都是同样的画;1;3;4;54433;7.348483456726618e-05
68740;百度知道整了那么多年，答案竟然调用的知乎的，这种寡头真有资格并称bat吗？;1;1;2;54433;3.674241728363309e-05
68763;请问女生一个问题，男生大学期间没有钱能谈对象吗;571;2664;3235;54433;0.059430859956276526
69335;星爷已经替我们验证了;185;6261;6446;54433;0.11842081090514944
69521;年少不可所及之物，终将困其一生;96;916;1012;54433;0.018591663145518345
69618;等我有钱买电脑了，我也就不爱玩电脑了;23;829;852;54433;0.015652269762827697
69642;年少不得之物终将困其一生，暮年浮光之景将之瞬息点醒，又终会因一事一物而解终身之惑;32;520;552;54433;0.010140907170282733
69675;当初没有她我也考不上本科;15;638;653;54433;0.011996399243106203
69691;直接追求成功概率50自己能坚持变优秀概率50这段时间ta没对象概率50这段时间ta没喜欢的人概率50ta认为你足够优秀概率50综合概率625;43;281;324;54433;0.005952271599948561
69735;父母那个年代的爱情，才是我羡慕的;49;214;263;54433;0.004831627872797751
69785;来不及的。时间不等人，等你变优秀了，你喜欢的女生已经到了嫁人的年纪;31;335;366;54433;0.006723862362904855
69817;就像喜欢一只蝴蝶，应该不应该去种花。其实等你的花盛开的时候，你喜欢的那只蝴蝶生命周期已经结束了，而你招来的你喜欢的也只是蝴蝶，而不是那一只蝴蝶。;17;276;293;54433;0.0053827641320522476
69835;重要的是对方喜欢你，而不是你喜欢对方;26;105;131;54433;0.0024066283320779676
69862;刻舟求剑罢了;5;257;262;54433;0.004813256664155935
69868;一个计算机码农表示已经天天用chatGPT取代自己脑子了;15;122;137;54433;0.0025168555839288668
69885;今天好像知道了喜欢的人好像有喜欢的人了;8;119;127;54433;0.0023331434975107012
69904;在现场旧雨随风知道没。;2;0;2;54433;3.674241728363309e-05
69907;ELIAUK我哭死;1;0;1;54433;1.8371208641816546e-05
69910;欲买桂花同载酒，终不似，少年游，开e;12;6;18;54433;0.0003306817555526978
69923;0707你觉得嘞;1;0;1;54433;1.8371208641816546e-05
69925;不吃香菜;1;0;1;54433;1.8371208641816546e-05
69928;韵;1;0;1;54433;1.8371208641816546e-05
69930;不qiu人我去这么牛;1;0;1;54433;1.8371208641816546e-05
69932;我看了62次日落等自己有钱了，再去追自己喜欢的人还来得急吗？;1;0;1;54433;1.8371208641816546e-05
69934;一万年太短吴俊生小草没名字绘梨衣;2;0;2;54433;3.674241728363309e-05
69945;宇宙遨游记成长了;1;0;1;54433;1.8371208641816546e-05
69949;我是小可乐陪一根;1;1;2;54433;3.674241728363309e-05
69953;挽筝YovC美国联邦调查局局长克里斯托弗雷英语corner;1;0;1;54433;1.8371208641816546e-05
69955;他的回答自相矛盾，开头说来不及，结尾说来得及;2;5;7;54433;0.00012859846049271582
69961;虽然我已经后悔了，但是没有遗憾你手在我兜里呢;1;2;3;54433;5.511362592544963e-05
69967;当追求自己喜欢的人时，并不一定需要完全变得优秀。每个人都有自己的魅力和吸引力，而这些特质并不完全取决于个人的成就或优秀程度。人们被吸引的往往是一个人的个性、情感连接以及彼此之间的相互吸引力。;5;9;14;54433;0.00025719692098543164
69974;3;1;0;1;54433;1.8371208641816546e-05
69980;build锅锅是过过辣条董事长今天520呀，快去表白，不要错过你们喜欢的人;1;1;2;54433;3.674241728363309e-05
69989;泡芙姑娘这大数据服了，总能拿捏人的心思;1;0;1;54433;1.8371208641816546e-05
69992;这个问题有很多不同的看法和答案，因为每个人的生活和情况都不同。但是我会试着给你一些建议。;3;6;9;54433;0.0001653408777763489
70003;银河;1;0;1;54433;1.8371208641816546e-05
70006;这是什么软件我很需要;8;9;17;54433;0.00031231054691088127
70017;那天，我终于配得上你了。这就够了。;1;22;23;54433;0.0004225377987617805
70028;痒;1;1;2;54433;3.674241728363309e-05
70037;韵ru;1;0;1;54433;1.8371208641816546e-05
70044;我也想去追她，但是我感觉没有一点成功的可能性;1;0;1;54433;1.8371208641816546e-05
70046;星野这个问题你怎么看;3;0;3;54433;5.511362592544963e-05
70050;0;2;0;2;54433;3.674241728363309e-05
70055;Dr621零碎被小美骗走520w阳光宅男又开始了;3;0;3;54433;5.511362592544963e-05
70060;Staib说的好好;1;1;2;54433;3.674241728363309e-05
70064;来不及了早睡早起;9;0;9;54433;0.0001653408777763489
70075;今年过了，后面可能就不经常见面了，好后悔，可有什么用呢;11;3;14;54433;0.00025719692098543164
70091;钮祜禄袅袅这是啥意思;1;0;1;54433;1.8371208641816546e-05
70096;咸鱼吐泡泡我也想吃火锅失落是常态要学会消化;1;1;2;54433;3.674241728363309e-05
70098;风遇;2;0;2;54433;3.674241728363309e-05
70106;StarFragment棣闻学木景啊宇宙超级无敌重生暴龙战士吨吨吨哇哈哈哈我去;1;0;1;54433;1.8371208641816546e-05
70108;丷没有火锅的人生将毫无意义;1;0;1;54433;1.8371208641816546e-05
70112;是烨不是耶这个就是我上次说的那种情况;6;0;6;54433;0.00011022725185089927
70124;当初您们要是能给我买一部手机我该多谢谢你们我就是想和喜欢的人聊聊天但是你们不会懂的永远也不会;1;4;5;54433;9.185604320908272e-05
70131;记住花开蝶自来;1;12;13;54433;0.00023882571234361508
70142;会超级无敌帅气爆炸波的奥旋风战士3999999999999安渔词Richthedad白川黎海;1;1;2;54433;3.674241728363309e-05
70147;漂亮女孩不谈恋爱;1;0;1;54433;1.8371208641816546e-05
70154;QQ弹弹当你变得更好了就会去追寻更好的了;1;0;1;54433;1.8371208641816546e-05
70161;StarHX24来得及吗;2;0;2;54433;3.674241728363309e-05
70166;干饭人勇敢的去吧;1;1;2;54433;3.674241728363309e-05
70170;藏于星辰月下没钱啥也不是;3;1;4;54433;7.348483456726618e-05
70175;李木子冲冲冲;1;0;1;54433;1.8371208641816546e-05
70177;苒苒苒苒别穿秋裤了啵儿啵儿不穿秋裤秋裤想要你名字So忍冬椿想喝抹茶苏打给时间时间平安是福iridescent不活辣摘颗从此再无晚安;1;1;2;54433;3.674241728363309e-05
70180;呼呼呼大睡但不优秀人家看不上;4;0;4;54433;7.348483456726618e-05
70191;萨摩耶也会快乐我想着减完肥的，哎;2;0;2;54433;3.674241728363309e-05
70197;莲儿来得及吗;3;0;3;54433;5.511362592544963e-05
70201;这就好比小时候拿联发科p35打王者，现在用a16再也不想玩了。;1;10;11;54433;0.000202083295059982
70205;rrrrranne;2;1;3;54433;5.511362592544963e-05
70212;小兔;1;0;1;54433;1.8371208641816546e-05
70217;我赌一把阿贵;1;0;1;54433;1.8371208641816546e-05
70222;陈与落雁;1;0;1;54433;1.8371208641816546e-05
70225;要是我真的追到了她，再回来评论;4;12;16;54433;0.00029393933826906473
70231;虽然勇敢去爱，但是还是不敢不吃不行Ruooo是书亦是诗厚天降奇犽蛋挞弥子kkura;1;1;2;54433;3.674241728363309e-05
70233;197人工智能这个回答完美;8;0;8;54433;0.00014696966913453236
70242;有点糕冷灵魂歌手的好朋友SN阿源今天开心嘛;2;3;5;54433;9.185604320908272e-05
70245;0;4;12;16;54433;0.00029393933826906473
70250;风中飘落;2;0;2;54433;3.674241728363309e-05
70254;淘天，人工智能这么高级;2;1;3;54433;5.511362592544963e-05
70257;不喜欢你的人变成啥样都不喜欢不要自我欺骗了;1;2;3;54433;5.511362592544963e-05
70259;XX人工智能会写作文，哈哈哈;1;0;1;54433;1.8371208641816546e-05
70261;宫桔好家伙我爸是不是就这样问的;1;2;3;54433;5.511362592544963e-05
70272;绾我也说;1;0;1;54433;1.8371208641816546e-05
70274;z人工智能都来酸我;1;0;1;54433;1.8371208641816546e-05
70276;我已经勇敢过了我遇到了一个很好的男生因为他让我萌生了恋爱的思想或许只是学长对学妹的关照吧我问他你要是谈了女朋友还会对我这么好吗？他说应该不会了我想把自己都交给女朋友所以一个人淡出自己的生活需要多久;2;10;12;54433;0.00022045450370179853
70280;L轼白;1;1;2;54433;3.674241728363309e-05
70284;Daryl就我们俩单身只能给你看这个了;3;0;3;54433;5.511362592544963e-05
70292;啦拉一起进步吧;2;0;2;54433;3.674241728363309e-05
70295;吃辣条要长胖怎么说;1;0;1;54433;1.8371208641816546e-05
70297;太阳。看到这个问题就想到星爷;1;0;1;54433;1.8371208641816546e-05
70299;池鱼北沐心尘楀勇敢一点;1;0;1;54433;1.8371208641816546e-05
70305;tsy;1;0;1;54433;1.8371208641816546e-05
70310;稗子酿的酒安慰别人一套一套的，到我自己就想绳子一套;1;1;2;54433;3.674241728363309e-05
70312;萱;1;0;1;54433;1.8371208641816546e-05
70318;暮山紫;2;0;2;54433;3.674241728363309e-05
70323;见过我的人都说帅这是曾经困惑我的;1;0;1;54433;1.8371208641816546e-05
70325;世纪末彼岸花丛中的死之结界;1;0;1;54433;1.8371208641816546e-05
70334;结局重要吗？我反正注重过程;2;8;10;54433;0.00018371208641816545
70339;其实等你变优秀之后也许根本就不会再喜欢他了;4;15;19;54433;0.00034905296419451436
70344;等自己变优秀了她也不配了;3;19;22;54433;0.000404166590119964
70348;ai会懂人的感情嘛;1;5;6;54433;0.00011022725185089927
70350;怎么样才能判断一个女生喜不喜欢自己一个比较懒有点内向的女生，我能单独喊她出来看电影，吃饭，甚至来家里给她补习，她也主动骑车送我回家，但我不觉得她喜欢我我想跟她表白但还是没有勇气就跟她说我喜欢另外一个女生。;13;7;20;54433;0.0003674241728363309
70364;我的爱情只存在于理想之中，并不是说好高骛远，而是现实的纷杂真的很难找到一个真心对自己好的人，一味的付出，只得到背叛，那么这样我不如孑然一身独自走向无尽的深渊。或许在那另一头，又是另外一片天地。;3;18;21;54433;0.00038579538147814744
70369;ai都知道不留下遗憾，xdm七年了我也该行动了;6;12;18;54433;0.0003306817555526978
70376;自卑喜欢乱想已经把她弄丢了我想我再也遇不到像她一样敢爱敢恨女孩子了;3;11;14;54433;0.00025719692098543164
70380;来不及咯哲学上说事物是发展的;1;17;18;54433;0.0003306817555526978
70382;0;7;23;30;54433;0.0005511362592544964
70390;来不及的，真的来不及;7;22;29;54433;0.0005327650506126798
70398;有没有人帮我解决一下我喜欢不起来的问题呀我现在对所有女孩子都是一个感觉跟谁谈都可以，也可以不谈，没有初中时那份悸动了咋办;3;17;20;54433;0.0003674241728363309
70402;人们总是容易用一种自虐的方式制造出一种痴情的假象来使得自己站在感情的道德制高点上，获得一种畸形的满足感和安全感。其实无论是雪夜去对方家楼下站会儿或者是冒着大雨给她送一杯奶茶什么的，自己回想起来往往觉得如乔峰大战聚贤庄、关羽千里走单骑一样壮怀激烈，而对于对方来说，一杯奶茶就是一杯奶茶，无法承载起你想要在上面寄托的山崩地裂的情怀。少年的时候，总是迫不及待地将自己的满腔爱意表达出来，而结果往往是陷入表演之中而不自知。所以两个人的记忆才会出现偏差，那些你觉得刻骨铭心的过去，对方往往没有同样的感觉，甚至茫然不知。成长的标志就是懂得克制自己。克制自己的情绪，克制自己的表演欲，甚至克制自己的喜欢。少年时候，喜欢一个人恨不能把她变成自己身体的一部分，她刚说冷，我这边心里已经结冰了，她说难过，我立马如丧考妣，比她还难过，唯恐无法将自己的爱意表达出来。而事实上，谁也无法承担起另一个人的价值寄托，只有做一个独立、有价值的人，才能真正学会去爱另一个人。也千万不要尝试改变另一个人，这注定是徒劳的。做自己就好，爱情的真谛在于相互的吸引、志趣相投的同行，而不是追逐和依附以及自我感动。;1;29;30;54433;0.0005511362592544964
70404;这就是ai我这是不是毕业即失业;3;5;8;54433;0.00014696966913453236
70408;我觉得这个是一个无解的题，或者这个世界都有给我开了一个天大的玩笑，从出生开始，我们家穷从而因为钱而产生自卑，初中遇到了一个喜欢3年的女孩，可因为我一星期只有10块钱而觉得自己配不上她，当时人家随便一顿奶茶就78快，怎么比？然后自己就没有勇气去追她，好多年了，可能是因为我学习不好，下学比较早，我现在在工地，她上高三，我现在是有钱，哪怕天天给她买奶茶都可以，可已经回不去了，没用了，我们两个人的生活和价值观都不在一个层面上了，如果可以，我真希望我这辈子都遇不到她，那样我的脑海里就不会有那个可可爱爱，又乖又善解人意，还能摸摸头的小矮子了，只可惜结局已经固定了，还有别觉得自己有钱了就能找到一个特别漂亮的小姐姐谈恋爱，可那个是恋爱吗？好像是，但再也没有那个懵懂的感觉了;12;48;60;54433;0.0011022725185089927
70421;喜欢一朵花就一定要摘下它吗？;9;46;55;54433;0.00101041647529991
70431;我真的尽力追赶了可是醒悟的太晚，只能考一个破二本了可是他在武汉理工大学，依旧在别人的青春闪闪发光，有些差距真的弥补不了;4;13;17;54433;0.00031231054691088127
70436;我试过了，四年，念念不忘，没有回响;1;7;8;54433;0.00014696966913453236
70438;女朋友时常告诉我，现在去不了的地方，现在买不了的东西，以后我们一定会买的。我淡笑着说：“是啊，可是迟来的阳光救不了枯萎的花，欲买桂花同载酒，终不似少年梦”现在我在努力，我不想未来我的孩子也像我一样在最风华正茂，志气盎然的年龄选择了去努力拼搏;1;14;15;54433;0.0002755681296272482
70440;擦肩之人可赶上，错过之事不可追;3;28;31;54433;0.0005695074678963129
70445;不必如此悲观，对的人就在你变优秀的路上等着你呢;1;33;34;54433;0.0006246210938217625
70447;怎么用这个;2;6;8;54433;0.00014696966913453236
70450;即便当你什么都没有你去追她追到了，你能保证一辈子她不嫌弃你吗，我们不应该考虑她爱的是不是我们，而是应该考虑如何变得更加优秀，当你足够优秀，才有资格谈爱;1;7;8;54433;0.00014696966913453236
70452;来不及的来不及的我体验过了;1;66;67;54433;0.0012308709790017085
70454;你若盛开，蝴蝶自来;6;34;40;54433;0.0007348483456726618
70461;问过了;22;35;57;54433;0.0010471588925835432
70484;才中午就要emo了吗晚上怎么办;3;14;17;54433;0.00031231054691088127
70493;lyq;2;0;2;54433;3.674241728363309e-05
70496;自由的鱼;2;0;2;54433;3.674241728363309e-05
70499;碎冰冰小龟;1;0;1;54433;1.8371208641816546e-05
70501;孤独的野狼（温柔版）;1;0;1;54433;1.8371208641816546e-05
70503;富婆我胃不好;1;0;1;54433;1.8371208641816546e-05
70514;仁;1;0;1;54433;1.8371208641816546e-05
70517;逃离地球表面;1;0;1;54433;1.8371208641816546e-05
70519;anan我在哭蜡笔小欣别纠缠;1;1;2;54433;3.674241728363309e-05
70523;天行;1;1;2;54433;3.674241728363309e-05
70525;拜拜雪公主Kilig;2;0;2;54433;3.674241728363309e-05
70533;我想去厦门;1;0;1;54433;1.8371208641816546e-05
70535;是阿辉吖阿婧睡不醒源666（Pass专四版）豫西帅于晏;1;0;1;54433;1.8371208641816546e-05
70538;会上树的老母猪;1;0;1;54433;1.8371208641816546e-05
70540;dow;1;0;1;54433;1.8371208641816546e-05
70544;93;1;0;1;54433;1.8371208641816546e-05
70546;MRPIG;1;0;1;54433;1.8371208641816546e-05
70550;思妹儿;1;0;1;54433;1.8371208641816546e-05
70554;念驷年;2;2;4;54433;7.348483456726618e-05
70559;youarebeautiful熊嘟嘟;2;0;2;54433;3.674241728363309e-05
70564;只喜欢帅哥;1;1;2;54433;3.674241728363309e-05
70567;Road;1;0;1;54433;1.8371208641816546e-05
70570;喜欢蜂蜜;2;0;2;54433;3.674241728363309e-05
70573;好孩子花开富贵wqlhl美少女战士号相逢不必恨晚狙寂;2;0;2;54433;3.674241728363309e-05
70578;ynx别点开啊;1;1;2;54433;3.674241728363309e-05
70583;他;1;0;1;54433;1.8371208641816546e-05
70588;ARama;1;0;1;54433;1.8371208641816546e-05
70592;不爱喝可乐超级快递;1;0;1;54433;1.8371208641816546e-05
70595;Zzzzzxy;1;0;1;54433;1.8371208641816546e-05
70597;L;1;0;1;54433;1.8371208641816546e-05
70599;Miraitowaxian;3;0;3;54433;5.511362592544963e-05
70604;无限性;1;0;1;54433;1.8371208641816546e-05
70610;蘭yuu;2;0;2;54433;3.674241728363309e-05
70619;周日;1;0;1;54433;1.8371208641816546e-05
70626;好好会变好;1;0;1;54433;1.8371208641816546e-05
70636;牙牙牙。铁板大鱿鱼cxl晨Er冷子傲;1;0;1;54433;1.8371208641816546e-05
70641;你爹来了;1;0;1;54433;1.8371208641816546e-05
70643;Heart333丶hope;1;0;1;54433;1.8371208641816546e-05
70648;曰光微暖夏亦凉suns;1;1;2;54433;3.674241728363309e-05
70650;鸡汤来咯123哈哈哒咩哒咩呦光子伯明夷你看看这说的什么话T32010412秋风记;2;1;3;54433;5.511362592544963e-05
70654;早点睡55你干嘛;1;1;2;54433;3.674241728363309e-05
70658;鹿鸣噜噜噜鸣沦陷于万千星河;4;0;4;54433;7.348483456726618e-05
70667;水水的私人空间今晚和你相见nana;1;1;2;54433;3.674241728363309e-05
70670;茯神;1;1;2;54433;3.674241728363309e-05
70672;西西理塘最強伝説絕兇猛虎純真丁一郎jaychao小品飞;6;0;6;54433;0.00011022725185089927
70680;冒险爱朵拉脸上挂着火烧云不吃鱼鲰;1;2;3;54433;5.511362592544963e-05
70682;會一直在TTwYY鱼鱼鱼鱼鱼渔东油第N纯情衣昂洋淇拥抱内啡肽;4;1;5;54433;9.185604320908272e-05
70696;MH0;2;0;2;54433;3.674241728363309e-05
70699;嘟嘟嘟嘟;1;0;1;54433;1.8371208641816546e-05
70701;CSGO广东刘培茄分校;1;0;1;54433;1.8371208641816546e-05
70703;李烦烦睡觉不闭眼;3;0;3;54433;5.511362592544963e-05
70709;Yahiko;1;1;2;54433;3.674241728363309e-05
70717;打爆易肥肥;1;0;1;54433;1.8371208641816546e-05
70719;77;1;0;1;54433;1.8371208641816546e-05
70722;没蜡笔有小鑫;1;0;1;54433;1.8371208641816546e-05
70725;matcoisinini及時雨释怀沦落、迷失软妹;1;0;1;54433;1.8371208641816546e-05
70727;捞;3;0;3;54433;5.511362592544963e-05
70731;再往北方有极光;1;2;3;54433;5.511362592544963e-05
70737;清玖哼哧哼哧哼哧哼哧船长拔憨憨的氧气管PlutoMisluV;1;2;3;54433;5.511362592544963e-05
70741;妳听的到;2;0;2;54433;3.674241728363309e-05
70744;持刀小熊;1;0;1;54433;1.8371208641816546e-05
70749;白日梦想家f星海;2;0;2;54433;3.674241728363309e-05
70752;三明治局长;1;1;2;54433;3.674241728363309e-05
70759;嘻嘻嘻biu;1;0;1;54433;1.8371208641816546e-05
70761;189M31;2;2;4;54433;7.348483456726618e-05
70765;一只燃崽wjl铁汁哈哈哈呵呵我爱吃扇贝T该冲就冲;3;1;4;54433;7.348483456726618e-05
70770;羽格子奶油;1;1;2;54433;3.674241728363309e-05
70772;0;1;1;2;54433;3.674241728363309e-05
70774;00nnhlotve715落枫桅小丑冷饮屋;1;1;2;54433;3.674241728363309e-05
70776;真心想问大家一个问题，高中真的要开启一段感情吗;9;1;10;54433;0.00018371208641816545
70787;YGGG;1;1;2;54433;3.674241728363309e-05
70791;2135向皮泥今晚摘月亮豆皮叶子懒得取名鼠鼠捏西丞;1;1;2;54433;3.674241728363309e-05
70795;。。;1;1;2;54433;3.674241728363309e-05
70798;风伴云你怎么就喜欢看这种;1;1;2;54433;3.674241728363309e-05
70801;因为一些现实的原因不确定最后的结果是好的，就开始对感情敷衍，这样的人值得么？可是我真的好爱她;3;1;4;54433;7.348483456726618e-05
70805;我最讨厌下雨天苏，今天突然刷到这个视频，所以我想说我喜欢你，但也只是仅仅想说就说我喜欢你，然后我希望你能自信点。然后我能感受到你也有喜欢的人，我觉得这个东西要大胆说出来，也不至于难受自己，喜欢也不一定要得到什么关系，就像我今天想跟你说的也仅仅是我喜欢你，也不是说我想得到一段关系，也不知道是不是执念，然后说希望能做好朋友，一些不懂的问题可以找我我很乐意帮你解决。;1;1;2;54433;3.674241728363309e-05
70809;爱吃肉的兔子结PH值17南川北榆emo起来了;1;1;2;54433;3.674241728363309e-05
70811;花愿安芯熠Azure南。梦十六阿凯Shackles伍佰GGBond多喝热水Q版大学生;2;1;3;54433;5.511362592544963e-05
70816;超级无敌超兽武装暴龙战士今天早饭取消去有风的地方等自己优秀了再跟喜欢的人表白刻舟求剑;5;1;6;54433;0.00011022725185089927
70823;兜兜夕阳也心动了执念凯亚专属宠物狗请文明上网懂了吗;2;1;3;54433;5.511362592544963e-05
70827;魚;1;1;2;54433;3.674241728363309e-05
70829;木洛;1;1;2;54433;3.674241728363309e-05
70831;芋泥因为你在身边而优秀才是我愿意要的;1;1;2;54433;3.674241728363309e-05
70840;叫我小哪吒nz;2;1;3;54433;5.511362592544963e-05
70843;L002;1;1;2;54433;3.674241728363309e-05
70852;终究错过;1;1;2;54433;3.674241728363309e-05
70864;今晚哪里睡;1;1;2;54433;3.674241728363309e-05
70866;苏梓陌合适就跟她结婚吧，我想喝喜酒，等你变的优秀的时候你们可能不合适了;2;1;3;54433;5.511362592544963e-05
70869;重逢;4;1;5;54433;9.185604320908272e-05
70875;少年梦;2;1;3;54433;5.511362592544963e-05
70883;遍野星不知名某男lettinggo薇尔莉特CXC吕子乔的西域曼陀罗兰加洛斯玉子;1;1;2;54433;3.674241728363309e-05
70886;暮秋里;1;1;2;54433;3.674241728363309e-05
70890;墨璇;1;1;2;54433;3.674241728363309e-05
70892;0;2;1;3;54433;5.511362592544963e-05
70895;被海水咸死的鱼;2;1;3;54433;5.511362592544963e-05
70898;纯情人设mikasa张0汁7510tpsAohr皓月;1;1;2;54433;3.674241728363309e-05
70902;Stayawake努力过就好了;1;1;2;54433;3.674241728363309e-05
70904;鲸鱼;1;1;2;54433;3.674241728363309e-05
70908;三笠笠新世纪企鹅冲;1;1;2;54433;3.674241728363309e-05
70912;Pinocchio;1;1;2;54433;3.674241728363309e-05
70914;520V0号宿懂了;1;1;2;54433;3.674241728363309e-05
70919;多喝滚水0。o？再不表白，就晚了;1;1;2;54433;3.674241728363309e-05
70925;菠萝吹雪这会是完美的自己吗？人工智能比人都懂;3;1;4;54433;7.348483456726618e-05
70938;西西;2;1;3;54433;5.511362592544963e-05
70942;白日梦探险家;2;1;3;54433;5.511362592544963e-05
70945;H;1;1;2;54433;3.674241728363309e-05
70947;刻舟求剑Ripple舟舟（支持丫丫回国版）Yku坤坤有点困清扰绿野仙宗青眼白龙阵雨yuyuyu小朴用户已注销思远戍良人归AA苏州鸡头米莼菜阳澄湖大闸蟹批发陆贵芳书荒的终极辣条爱好者心平气和一条怕蛇的鱼0213;2;1;3;54433;5.511362592544963e-05
70955;纸上雪Ccc;1;1;2;54433;3.674241728363309e-05
70957;宇宙waves我不是拓海败絮lq枫;2;1;3;54433;5.511362592544963e-05
70961;nIbLEs新人旧酒;1;1;2;54433;3.674241728363309e-05
70965;睏;2;1;3;54433;5.511362592544963e-05
70970;如果真的喜欢，就勇敢一点;1;1;2;54433;3.674241728363309e-05
70972;Gleam我喜欢你;6;1;7;54433;0.00012859846049271582
70979;游花Dodolong;3;1;4;54433;7.348483456726618e-05
70984;像暗杀似的突如其来椰子我才不是yrchatgpt他真的我哭死;1;1;2;54433;3.674241728363309e-05
70988;酒好像忽然明白了什么道理一样我;1;1;2;54433;3.674241728363309e-05
70996;myjinji东莞虎门第深情郭文杰（实名制上网）AkiMegumi尤里;1;1;2;54433;3.674241728363309e-05
71000;雾散尽yyylikakihi喜欢佳得乐五好市民别错过;2;1;3;54433;5.511362592544963e-05
71006;TT滢Annnnnna星星不会说话晚咹;1;1;2;54433;3.674241728363309e-05
71008;一只豚醒了马桶海盐幻想;2;1;3;54433;5.511362592544963e-05
71017;桃子味的番茄琳;1;1;2;54433;3.674241728363309e-05
71024;热河明白了;1;1;2;54433;3.674241728363309e-05
71028;璨宝贝大部分人都是觉得先努力再去追喜欢的人很对，没毛病，可是他（她）等吗？能等多久？其实星爷已经是最真实的写照了;11;1;12;54433;0.00022045450370179853
71042;名字无法显示Glockie好牛逼这个东西;4;1;5;54433;9.185604320908272e-05
71048;如果我变成回忆;1;1;2;54433;3.674241728363309e-05
71055;用户74262809437;1;1;2;54433;3.674241728363309e-05
71060;守约TTTT德fu33rdWrco嘎嘎嘎对方yrcc江彻;1;1;2;54433;3.674241728363309e-05
71063;香蕉比苹果大Star;1;1;2;54433;3.674241728363309e-05
71066;路过的大个尹有梦想的煤气罐想养只狗谁都无知度过ai这么强了;1;1;2;54433;3.674241728363309e-05
71085;不长蛀牙;1;1;2;54433;3.674241728363309e-05
71087;给抒书的诗其实真的我特别想说一句话，我真的想对书记说，对自己有好感，喜欢的人真的不要浪费时间，真的要去试一试，我知道他现在听不进去;1;1;2;54433;3.674241728363309e-05
71089;春烟齐眉美仔陆小果晓星尘千晨12050000000000000靇s好发空间装逼去;1;1;2;54433;3.674241728363309e-05
71094;芷蕴梦;1;1;2;54433;3.674241728363309e-05
71100;卑微甜甜鸡;2;1;3;54433;5.511362592544963e-05
71103;斯布拉西;1;1;2;54433;3.674241728363309e-05
71109;光说好的curry呢越莱越快年事已高美颜青青草原你懒哥;2;1;3;54433;5.511362592544963e-05
71115;L李;1;1;2;54433;3.674241728363309e-05
71117;什么软件;1;1;2;54433;3.674241728363309e-05
71120;20年表白被拒绝，现在跟她聊天还是会激动到手抖;1;1;2;54433;3.674241728363309e-05
71122;这个问题得问你爱人;1;1;2;54433;3.674241728363309e-05
71124;文心一言可以用了吗，我还在排队中;1;1;2;54433;3.674241728363309e-05
71126;来不及，因为这就是缘分;1;1;2;54433;3.674241728363309e-05
71128;得不到的东西，在梦里也会做出正确的反应;3;1;4;54433;7.348483456726618e-05
71133;e了？;1;1;2;54433;3.674241728363309e-05
71142;biubiubiu;1;0;1;54433;1.8371208641816546e-05
71155;cattiou雷亩;1;0;1;54433;1.8371208641816546e-05
71157;海边云;1;0;1;54433;1.8371208641816546e-05
71160;芣乔;1;0;1;54433;1.8371208641816546e-05
71162;春不晚;2;0;2;54433;3.674241728363309e-05
71165;香芋炖排骨;1;0;1;54433;1.8371208641816546e-05
71173;小小一朵昀;1;0;1;54433;1.8371208641816546e-05
71181;小嫩牛拖家带口突袭老草场巴蜀小诸葛HINNAMNORMajTom;1;0;1;54433;1.8371208641816546e-05
71186;踩了牛奶的猫6;1;0;1;54433;1.8371208641816546e-05
71188;一只只因;1;0;1;54433;1.8371208641816546e-05
71192;酷似你爸遗鉃;1;0;1;54433;1.8371208641816546e-05
71195;余温yyyyy;1;0;1;54433;1.8371208641816546e-05
71198;沅在打盹;1;0;1;54433;1.8371208641816546e-05
71200;桃也雾漫漫;1;0;1;54433;1.8371208641816546e-05
71203;081;1;0;1;54433;1.8371208641816546e-05
71206;一杯玛奇朵;1;0;1;54433;1.8371208641816546e-05
71211;阿盛;1;0;1;54433;1.8371208641816546e-05
71213;Mikey22栗子;1;0;1;54433;1.8371208641816546e-05
71216;CC茜茜哈哈哈;2;0;2;54433;3.674241728363309e-05
71221;NebulaMr陳超级杰素懒衫袁凌祈崎年;1;0;1;54433;1.8371208641816546e-05
71225;Jovx;1;0;1;54433;1.8371208641816546e-05
71227;鱼困晕了zjw;1;0;1;54433;1.8371208641816546e-05
71230;十一号起飞fry可能这就是遗憾吧;1;0;1;54433;1.8371208641816546e-05
71233;一只耄你懂了吗？;1;0;1;54433;1.8371208641816546e-05
71236;月亮爸爸;1;0;1;54433;1.8371208641816546e-05
71247;小福小傅Trivan;2;0;2;54433;3.674241728363309e-05
71253;CoeYJan8;1;0;1;54433;1.8371208641816546e-05
71255;阿根廷的messi出浴图;1;0;1;54433;1.8371208641816546e-05
71263;Yywhatcanido;2;0;2;54433;3.674241728363309e-05
71268;乐乐乐乐乐迪;1;0;1;54433;1.8371208641816546e-05
71270;十二月;1;0;1;54433;1.8371208641816546e-05
71273;熊？蟑螂;1;0;1;54433;1.8371208641816546e-05
71275;LazyMelodye;1;0;1;54433;1.8371208641816546e-05
71278;呵呵红红火火终究还是来不及;4;0;4;54433;7.348483456726618e-05
71288;DoDo我当时就是这么想的苦涩;1;0;1;54433;1.8371208641816546e-05
71290;nnn;1;0;1;54433;1.8371208641816546e-05
71292;堕你太成熟了点;1;0;1;54433;1.8371208641816546e-05
71295;土豆土豆;1;0;1;54433;1.8371208641816546e-05
71302;比俊俊帅;1;0;1;54433;1.8371208641816546e-05
71309;深院锁清秋;2;0;2;54433;3.674241728363309e-05
71312;疏疏朗朗有女朋女怎么办;1;0;1;54433;1.8371208641816546e-05
71322;限量叁肆;1;0;1;54433;1.8371208641816546e-05
71324;爱吃甜筒的猫;2;0;2;54433;3.674241728363309e-05
71327;18;1;0;1;54433;1.8371208641816546e-05
71334;yyyyu井井井井jjjj两不疑;2;0;2;54433;3.674241728363309e-05
71337;11;2;0;2;54433;3.674241728363309e-05
71340;慕夏十三拾柒、;1;0;1;54433;1.8371208641816546e-05
71343;孤独且忧伤的名字;2;0;2;54433;3.674241728363309e-05
71349;为凯而来;1;0;1;54433;1.8371208641816546e-05
71354;Ari、;2;0;2;54433;3.674241728363309e-05
71357;Rhoda;1;0;1;54433;1.8371208641816546e-05
71359;深情雨姐;1;0;1;54433;1.8371208641816546e-05
71361;帅气的非主流星哥;1;0;1;54433;1.8371208641816546e-05
71367;0;1;0;1;54433;1.8371208641816546e-05
71372;：;4;0;4;54433;7.348483456726618e-05
71378;潮石音乐公司合伙人Spring;1;0;1;54433;1.8371208641816546e-05
71381;不切橘子;2;0;2;54433;3.674241728363309e-05
71384;Uuuujin;1;0;1;54433;1.8371208641816546e-05
71386;祈喔;1;0;1;54433;1.8371208641816546e-05
71393;诗人的玫瑰;1;0;1;54433;1.8371208641816546e-05
71396;赫尔希会笑栗壳;1;0;1;54433;1.8371208641816546e-05
71401;野原小涵别搞;1;0;1;54433;1.8371208641816546e-05
71406;Forst;2;0;2;54433;3.674241728363309e-05
71412;zhou小雨;1;0;1;54433;1.8371208641816546e-05
71415;大蛇丸;1;0;1;54433;1.8371208641816546e-05
71417;0;1;0;1;54433;1.8371208641816546e-05
71421;孤舟自横;1;0;1;54433;1.8371208641816546e-05
71424;Akkkkkk;1;0;1;54433;1.8371208641816546e-05
71429;啊哦666;2;0;2;54433;3.674241728363309e-05
71433;小圆有点困;1;0;1;54433;1.8371208641816546e-05
71436;李智点;1;0;1;54433;1.8371208641816546e-05
71440;huiii;1;0;1;54433;1.8371208641816546e-05
71442;辛弃疾77大数据牛逼;1;0;1;54433;1.8371208641816546e-05
71454;郁金香霁;2;0;2;54433;3.674241728363309e-05
71457;Passat思念会是海啸嗎不知道怎么办不要留下遗憾;1;0;1;54433;1.8371208641816546e-05
71460;OhGod解答了我一个困惑，你觉得呢;1;0;1;54433;1.8371208641816546e-05
71462;限量版逗比;1;0;1;54433;1.8371208641816546e-05
71464;菜鸟要飞鱿鱼梦想在潇湘院打架;3;0;3;54433;5.511362592544963e-05
71472;铎儿;1;0;1;54433;1.8371208641816546e-05
71475;1Magic;1;0;1;54433;1.8371208641816546e-05
71481;章鱼丸chatgpt好厉害;1;0;1;54433;1.8371208641816546e-05
71483;（）我刚开始是想等我变优秀再告白，但是我现在觉得我们可以一起变优秀;1;0;1;54433;1.8371208641816546e-05
71485;日落朝西AI刀我;1;0;1;54433;1.8371208641816546e-05
71488;SSDZ橘皮乌龙LL平仄飞跑的野猪ps的爸爸;1;0;1;54433;1.8371208641816546e-05
71492;南湘日落;1;0;1;54433;1.8371208641816546e-05
71494;有佳佳;2;0;2;54433;3.674241728363309e-05
71502;礼礼小序;1;0;1;54433;1.8371208641816546e-05
71505;王淼淼;1;0;1;54433;1.8371208641816546e-05
71509;Mmmmm;3;0;3;54433;5.511362592544963e-05
71516;BRabbit;1;0;1;54433;1.8371208641816546e-05
71519;知名不具什么人工智能;2;0;2;54433;3.674241728363309e-05
71527;AS风游侠;2;0;2;54433;3.674241728363309e-05
71533;卡乔丹还是那句话，什么状态刷到什么视频;9;0;9;54433;0.0001653408777763489
71543;小章鱼说的很对，做自己;1;0;1;54433;1.8371208641816546e-05
71545;意向;1;0;1;54433;1.8371208641816546e-05
71550;星之海;1;0;1;54433;1.8371208641816546e-05
71555;续7;1;0;1;54433;1.8371208641816546e-05
71560;宁;1;0;1;54433;1.8371208641816546e-05
71563;0;1;0;1;54433;1.8371208641816546e-05
71565;我是hm代言人我觉得这个很值得看看;2;0;2;54433;3.674241728363309e-05
71570;过得开心;1;0;1;54433;1.8371208641816546e-05
71574;蛋煩死了我姐姐不写诗生生;1;0;1;54433;1.8371208641816546e-05
71577;czx;11;0;11;54433;0.000202083295059982
71589;废物13promax1TB原峰蓝;1;0;1;54433;1.8371208641816546e-05
71592;y;2;0;2;54433;3.674241728363309e-05
71597;zzhao;1;0;1;54433;1.8371208641816546e-05
71599;满天星;1;0;1;54433;1.8371208641816546e-05
71601;小祁冉议论文模版了属于是，提出观点，举例论点，最后总结;1;0;1;54433;1.8371208641816546e-05
71603;MoC;1;0;1;54433;1.8371208641816546e-05
71612;扁粉菜的深情;1;0;1;54433;1.8371208641816546e-05
71614;太空人;4;0;4;54433;7.348483456726618e-05
71619;星海;1;0;1;54433;1.8371208641816546e-05
71622;AAA专业建材批发李姐;1;0;1;54433;1.8371208641816546e-05
71624;环游西西岛;1;0;1;54433;1.8371208641816546e-05
71627;zFreedom7;1;0;1;54433;1.8371208641816546e-05
71639;冰;1;0;1;54433;1.8371208641816546e-05
71644;次辣么多;2;0;2;54433;3.674241728363309e-05
71650;干饭大王;1;0;1;54433;1.8371208641816546e-05
71653;你好咕噜鸭阿港：弋纸纸小小奇不会奶油爱果酱;2;0;2;54433;3.674241728363309e-05
71656;不困不困;2;0;2;54433;3.674241728363309e-05
71660;爱看擦边的小;5;0;5;54433;9.185604320908272e-05
71669;开学小魚还来得及吗;2;0;2;54433;3.674241728363309e-05
71672;岛集;1;0;1;54433;1.8371208641816546e-05
71680;Vsi勇敢的去试试看我的朋友，你还有机会，不要让青春留遗憾;1;0;1;54433;1.8371208641816546e-05
71682;卡西莫多;4;0;4;54433;7.348483456726618e-05
71690;王多;1;0;1;54433;1.8371208641816546e-05
71693;一团糟;1;0;1;54433;1.8371208641816546e-05
71696;卟哀;1;0;1;54433;1.8371208641816546e-05
71699;十八香我现在不优秀，但我想和你一直在一起，所以请小煜一定一定有耐心等我;1;0;1;54433;1.8371208641816546e-05
71701;sejjerse;1;0;1;54433;1.8371208641816546e-05
71703;你猜;1;0;1;54433;1.8371208641816546e-05
71708;雪一直下;1;0;1;54433;1.8371208641816546e-05
71710;甜瓜;1;0;1;54433;1.8371208641816546e-05
71717;浪梓;2;0;2;54433;3.674241728363309e-05
71723;有想法的鱼;6;0;6;54433;0.00011022725185089927
71730;冒犯了642CYR;2;0;2;54433;3.674241728363309e-05
71733;人间芋门雨答案一直在，只不过不想面对罢了;1;0;1;54433;1.8371208641816546e-05
71741;有好多个达不刘;1;0;1;54433;1.8371208641816546e-05
71745;南南糊涂蛋哭了;1;0;1;54433;1.8371208641816546e-05
71748;Jun;1;0;1;54433;1.8371208641816546e-05
71756;fffrog;1;0;1;54433;1.8371208641816546e-05
71760;1825851090;1;0;1;54433;1.8371208641816546e-05
71769;北海钟士季仔细看了看发现前言不搭后语;1;0;1;54433;1.8371208641816546e-05
71774;安然;1;0;1;54433;1.8371208641816546e-05
71776;ihhhh;1;0;1;54433;1.8371208641816546e-05
71778;Day;1;0;1;54433;1.8371208641816546e-05
71780;荷包;1;0;1;54433;1.8371208641816546e-05
71785;11y0561507541hhhjAAA四川火锅底料批发新哥（正在发货）阿懿李不管September东山小红;1;0;1;54433;1.8371208641816546e-05
71788;江亭纵言笑;1;0;1;54433;1.8371208641816546e-05
71791;have辰南的度绮燕;1;0;1;54433;1.8371208641816546e-05
71793;wicura22傻库波士顿的;2;0;2;54433;3.674241728363309e-05
71796;请问女生一个问题，如果谈婚论嫁的话是喜欢县城的楼房还是农村的二层楼;1;0;1;54433;1.8371208641816546e-05
71803;AD钙这个软件可以写实践报告不;1;0;1;54433;1.8371208641816546e-05
71806;梁Kiki;1;0;1;54433;1.8371208641816546e-05
71808;7屎壳郎;1;0;1;54433;1.8371208641816546e-05
71813;霖霖我替你实践了优秀应该跟追同步，不然真的后悔;1;0;1;54433;1.8371208641816546e-05
71818;阿婧睡不醒是阿辉吖minable源666地里的烂白菜甜瓜味whw咕呱小何小新不新（睡不醒版）;1;0;1;54433;1.8371208641816546e-05
71820;与月我学到了;2;0;2;54433;3.674241728363309e-05
71824;糊里糊涂开心就好123;1;0;1;54433;1.8371208641816546e-05
71826;起ovo起;3;0;3;54433;5.511362592544963e-05
71833;嘿，我是上帝复婚版还来得及吗？;2;0;2;54433;3.674241728363309e-05
71838;做完核酸不要逗刘女士别指望男生变优秀，因为过程中他会遇到比你更优秀的人，那时候就是再见的时候了，因为上岸第一剑，先斩意中人;1;0;1;54433;1.8371208641816546e-05
71840;故事未完小e;1;0;1;54433;1.8371208641816546e-05
71842;Diamond烟雨平生贝塔;5;0;5;54433;9.185604320908272e-05
71853;超困困困困猫;2;0;2;54433;3.674241728363309e-05
71856;无情哈拉少我不信;1;0;1;54433;1.8371208641816546e-05
71858;想睡个好觉;1;0;1;54433;1.8371208641816546e-05
71866;论学习的痛苦;1;0;1;54433;1.8371208641816546e-05
71870;l;2;0;2;54433;3.674241728363309e-05
71873;丸酥;1;0;1;54433;1.8371208641816546e-05
71875;叉布叉布GPT已经给出了这个问题的答案，所以应该选择怎么做呢;1;0;1;54433;1.8371208641816546e-05
71877;扬浮沉这么牛了吗;1;0;1;54433;1.8371208641816546e-05
71888;相约去看橘子海;2;0;2;54433;3.674241728363309e-05
71893;你又行了？仙无敌;1;0;1;54433;1.8371208641816546e-05
71897;C30还不快冲;1;0;1;54433;1.8371208641816546e-05
71900;乔九汐;1;0;1;54433;1.8371208641816546e-05
71910;OCNZtw1stzz1123;1;0;1;54433;1.8371208641816546e-05
71919;L12Z羽落倾天你两什么问题;2;0;2;54433;3.674241728363309e-05
71923;liberty;1;0;1;54433;1.8371208641816546e-05
71935;番茄牛腩汤;1;0;1;54433;1.8371208641816546e-05
71942;violet;1;0;1;54433;1.8371208641816546e-05
71951;琴大王666一起变优秀;2;0;2;54433;3.674241728363309e-05
71954;江西第一单纯Ywenai比我懂;2;0;2;54433;3.674241728363309e-05
71967;牧同你好耐冇见;1;0;1;54433;1.8371208641816546e-05
71970;LuJX;1;0;1;54433;1.8371208641816546e-05
71973;氚化氮;1;0;1;54433;1.8371208641816546e-05
71975;wolfchan;1;0;1;54433;1.8371208641816546e-05
71984;y能来及吗;1;0;1;54433;1.8371208641816546e-05
71988;籋;4;0;4;54433;7.348483456726618e-05
71995;国民爹爹跟我学;1;0;1;54433;1.8371208641816546e-05
71997;JDLYxhwxniii火韦aaaaT花开富贵荆华NUYOAHHHHHH桃的诱惑灰尘H王德芙是wonderfulXXXXINfBavteYJ鬼鬼;1;0;1;54433;1.8371208641816546e-05
72001;小黑黑;1;0;1;54433;1.8371208641816546e-05
72006;菠萝吹冰雹;2;0;2;54433;3.674241728363309e-05
72012;宇宙超级无敌噼里啪啦暴龙战神11425;1;0;1;54433;1.8371208641816546e-05
72014;阳仔想啥呢，好好干球;1;0;1;54433;1.8371208641816546e-05
72017;两年又半年;1;0;1;54433;1.8371208641816546e-05
72020;这机器人怪会说话了;1;0;1;54433;1.8371208641816546e-05
72022;book熬夜Tomsensei;3;0;3;54433;5.511362592544963e-05
72026;井川森奈崽崽;1;0;1;54433;1.8371208641816546e-05
72030;易寒不还;1;0;1;54433;1.8371208641816546e-05
72037;正八小子;2;0;2;54433;3.674241728363309e-05
72041;kikoyei论文好手;1;0;1;54433;1.8371208641816546e-05
72044;鹅chatgpt;1;0;1;54433;1.8371208641816546e-05
72048;giant;1;0;1;54433;1.8371208641816546e-05
72052;zyh的没好生活既要变优秀也要追zyh;1;0;1;54433;1.8371208641816546e-05
72054;細毛羊世界;1;0;1;54433;1.8371208641816546e-05
72059;ASiriSogasname听说只要把名字改长一点就会有群傻子跟着读lyyyfei;1;0;1;54433;1.8371208641816546e-05
72062;pleaseyou;3;0;3;54433;5.511362592544963e-05
72066;月亮月亮毕业哪个儿不追哈，为爱冲锋;2;0;2;54433;3.674241728363309e-05
72070;RikN329;2;0;2;54433;3.674241728363309e-05
72074;时宴;1;0;1;54433;1.8371208641816546e-05
72076;theStar绝了;1;0;1;54433;1.8371208641816546e-05
72080;什么芝士蛋糕;1;0;1;54433;1.8371208641816546e-05
72082;星轨;1;0;1;54433;1.8371208641816546e-05
72084;今夜说晚安。;6;0;6;54433;0.00011022725185089927
72093;看得到太阳吗KKK;1;0;1;54433;1.8371208641816546e-05
72097;钠;1;0;1;54433;1.8371208641816546e-05
72099;杨书书Blank懂了吧;2;0;2;54433;3.674241728363309e-05
72103;k;1;0;1;54433;1.8371208641816546e-05
72106;无敌爆炸龙你还要我怎么做;3;0;3;54433;5.511362592544963e-05
72111;桑桑桑;5;0;5;54433;9.185604320908272e-05
72117;吃我剥的橘子;1;0;1;54433;1.8371208641816546e-05
72121;哪里都是离我e了;1;0;1;54433;1.8371208641816546e-05
72123;下次;3;0;3;54433;5.511362592544963e-05
72129;LLLLLH来不及的;1;0;1;54433;1.8371208641816546e-05
72131;0;1;0;1;54433;1.8371208641816546e-05
72135;QQQQ就下次我一定出手;1;0;1;54433;1.8371208641816546e-05
72137;故渊;1;0;1;54433;1.8371208641816546e-05
72140;沦陌;1;0;1;54433;1.8371208641816546e-05
72146;骏W;1;0;1;54433;1.8371208641816546e-05
72154;H;1;0;1;54433;1.8371208641816546e-05
72159;人间土狗;4;0;4;54433;7.348483456726618e-05
72164;AliveJAsv;1;0;1;54433;1.8371208641816546e-05
72166;子狗感觉很傻人都要靠ai指导人生啦;1;0;1;54433;1.8371208641816546e-05
72170;小库;1;0;1;54433;1.8371208641816546e-05
72174;粥粥啊好鸭好鸭好耶好耶;2;0;2;54433;3.674241728363309e-05
72179;西柚;1;0;1;54433;1.8371208641816546e-05
72183;AAAAA鲁园古玩城张总中华秋海棠叶李玉辉温白水雪之下，;1;0;1;54433;1.8371208641816546e-05
72187;啪嗒;4;0;4;54433;7.348483456726618e-05
72192;LuNatiC;1;0;1;54433;1.8371208641816546e-05
72195;没关系好像我豁然开朗了;1;0;1;54433;1.8371208641816546e-05
72197;想吃脆骨肠夕暮時;1;0;1;54433;1.8371208641816546e-05
72199;sky星海;1;0;1;54433;1.8371208641816546e-05
72203;泽安仔加油吧;1;0;1;54433;1.8371208641816546e-05
72207;皮蛋瘦肉周女士;1;0;1;54433;1.8371208641816546e-05
72210;以陌ober风起意难平;1;0;1;54433;1.8371208641816546e-05
72212;良这是不是前后矛盾了;1;0;1;54433;1.8371208641816546e-05
72215;0;1;0;1;54433;1.8371208641816546e-05
72218;XHS等我足够优秀先;1;0;1;54433;1.8371208641816546e-05
72221;喜欢的人只喜欢高的帅的怎么办，我现在想去整容了;1;0;1;54433;1.8371208641816546e-05
72224;happy木啊;1;0;1;54433;1.8371208641816546e-05
72228;0;1;0;1;54433;1.8371208641816546e-05
72233;小方爸比;1;0;1;54433;1.8371208641816546e-05
72238;NeverCrywithsmile无感小叔吃完饭开枪;1;0;1;54433;1.8371208641816546e-05
72240;狗蛋很多可我最强一起变优秀;1;0;1;54433;1.8371208641816546e-05
72247;故里逢春是小李啊我是小郑同学青云迎柔风饿死了，牙疼吃不下饭;3;0;3;54433;5.511362592544963e-05
72253;朵朵朵朵;1;0;1;54433;1.8371208641816546e-05
72257;m阿KKKLed;1;0;1;54433;1.8371208641816546e-05
72263;Xiaofubufu可是我想配的上她;2;0;2;54433;3.674241728363309e-05
72270;K1ss椛姑酿知错了;2;0;2;54433;3.674241728363309e-05
72273;这是什么软件？;1;0;1;54433;1.8371208641816546e-05
72275;我要吃喜之郎朴東奕东哥是对的;1;0;1;54433;1.8371208641816546e-05
72277;剑挽心;1;0;1;54433;1.8371208641816546e-05
72280;Eren你看看;1;0;1;54433;1.8371208641816546e-05
72282;祈成绵绵雨愿怡漫漫意人工啊;13;0;13;54433;0.00023882571234361508
72299;洛曦我会在我们在一起的时光努力变好希望你不要抛弃我;3;0;3;54433;5.511362592544963e-05
72303;横笛唤沙鸥猛虎上单丁真;2;0;2;54433;3.674241728363309e-05
72307;天天吃我变得勇敢啦;4;0;4;54433;7.348483456726618e-05
72312;喀嚓鱼;1;0;1;54433;1.8371208641816546e-05
72318;大聪明我一直认为只有自己变优秀了，才能找到更好的对象;1;0;1;54433;1.8371208641816546e-05
72321;念尘z;1;0;1;54433;1.8371208641816546e-05
72325;茗;1;0;1;54433;1.8371208641816546e-05
72327;糖炒栗子chatgpt;7;0;7;54433;0.00012859846049271582
72342;或许有或许不许揪我小辫子;1;0;1;54433;1.8371208641816546e-05
72344;fantastic;1;0;1;54433;1.8371208641816546e-05
72350;小马宝莉;1;0;1;54433;1.8371208641816546e-05
72353;玩;1;0;1;54433;1.8371208641816546e-05
72356;花生了什么树我也不知道怎么都是;1;0;1;54433;1.8371208641816546e-05
72359;Enamored胖达悟了;1;0;1;54433;1.8371208641816546e-05
72363;萧小五书玉养鸡小鱼ltop挽安婷婷no停停流萤。南D4C高质量博士来不及了，千万别等;9;0;9;54433;0.0001653408777763489
72375;吟诗;1;0;1;54433;1.8371208641816546e-05
72378;i火乐;1;0;1;54433;1.8371208641816546e-05
72381;小兆一米八;1;0;1;54433;1.8371208641816546e-05
72384;雨季;1;0;1;54433;1.8371208641816546e-05
72386;来份肥五花;1;0;1;54433;1.8371208641816546e-05
72390;要一杯奶茶加油;1;0;1;54433;1.8371208641816546e-05
72395;零零壹;1;0;1;54433;1.8371208641816546e-05
72398;双层吉士汉堡LuckyEternal;1;0;1;54433;1.8371208641816546e-05
72401;星崽无聊鸭其实确实我在喜欢他的时候确实增加了动力和自信这也就足够了至少算成长了一点吧;1;0;1;54433;1.8371208641816546e-05
72404;Xz;1;0;1;54433;1.8371208641816546e-05
72407;往事随风。还是对自己不满意;1;0;1;54433;1.8371208641816546e-05
72409;偶尔也想当主角说的是你不;1;0;1;54433;1.8371208641816546e-05
72411;不箱丸辣完全;1;0;1;54433;1.8371208641816546e-05
72415;柒喜会迎着风来;1;0;1;54433;1.8371208641816546e-05
72417;Y0;1;0;1;54433;1.8371208641816546e-05
72422;都是选择罢了，随心吧;1;0;1;54433;1.8371208641816546e-05
72426;闪耀小羊真甜;1;0;1;54433;1.8371208641816546e-05
72429;我今天开始自律也是为了变得瘦瘦的去追她你给我说来不及了，太打击人了;2;0;2;54433;3.674241728363309e-05
72444;FY;2;0;2;54433;3.674241728363309e-05
72447;芊芊记烟雨;1;0;1;54433;1.8371208641816546e-05
72453;半眠学姐;1;0;1;54433;1.8371208641816546e-05
72457;看过一句话：你不必那么优秀，喜欢你的人不需要你那么完美无缺;3;0;3;54433;5.511362592544963e-05
72462;给爷笑一个小熊维尼Winnie不过时呜呜;3;0;3;54433;5.511362592544963e-05
72466;优雅的水晶小洁园游会爱有始无终和你那个差不多;6;0;6;54433;0.00011022725185089927
72477;牛牛少女;1;0;1;54433;1.8371208641816546e-05
72487;干饭王;1;0;1;54433;1.8371208641816546e-05
72489;Birght;1;0;1;54433;1.8371208641816546e-05
72501;所以然说辞好吊;3;0;3;54433;5.511362592544963e-05
72506;老师傅手工嫩牛肉放肆。人工智能ChatGPT;1;0;1;54433;1.8371208641816546e-05
72509;川南学长你上次QQ动态发的ai对话是这个嘛哈哈我发现好像总会比学长慢半拍;2;0;2;54433;3.674241728363309e-05
72517;EKK0马莱的魂悟了;1;0;1;54433;1.8371208641816546e-05
72522;小王很emo;1;0;1;54433;1.8371208641816546e-05
72525;牛掰的鸟人加油哦;1;0;1;54433;1.8371208641816546e-05
72527;AAA无花果专业去籽唉，有点难过;3;0;3;54433;5.511362592544963e-05
72531;是迟迟呐;1;0;1;54433;1.8371208641816546e-05
72536;lei马上就考试了，加油;1;0;1;54433;1.8371208641816546e-05
72539;MoSalah真是;4;0;4;54433;7.348483456726618e-05
72546;看;1;0;1;54433;1.8371208641816546e-05
72550;球球吖;1;0;1;54433;1.8371208641816546e-05
72552;夜於漫長;1;0;1;54433;1.8371208641816546e-05
72557;喋喋;2;0;2;54433;3.674241728363309e-05
72562;中华小皮球;2;0;2;54433;3.674241728363309e-05
72565;小杨睡不醒（绝食版）;2;0;2;54433;3.674241728363309e-05
72573;不开心就多喝开水许的什么愿;1;0;1;54433;1.8371208641816546e-05
72582;胖儿的鸡蛋灌饼我想到了周;1;0;1;54433;1.8371208641816546e-05
72584;H雾Mmmmm吴彦祖我恨沸羊羊ButU夜里给我留盏灯应该晚了吧;2;0;2;54433;3.674241728363309e-05
72588;高子;1;0;1;54433;1.8371208641816546e-05
72594;小马;2;0;2;54433;3.674241728363309e-05
72598;猪皮恶霸我要变得优秀;2;0;2;54433;3.674241728363309e-05
72610;只会番茄炒蛋;3;0;3;54433;5.511362592544963e-05
72619;风在思念谁这个回答;3;0;3;54433;5.511362592544963e-05
72625;念安刚想开e，发现没喜欢的，怎么办;5;0;5;54433;9.185604320908272e-05
72632;就是爱玩师兄快找一个;1;0;1;54433;1.8371208641816546e-05
72634;Mamacows忆惜婉儿提笔惊鸿会有未来的;1;0;1;54433;1.8371208641816546e-05
72639;0;1;0;1;54433;1.8371208641816546e-05
72642;vi落墨;1;0;1;54433;1.8371208641816546e-05
72648;8410;2;0;2;54433;3.674241728363309e-05
72652;小多菇不想跑三公里不要当joker;2;0;2;54433;3.674241728363309e-05
72658;爱滋手撕鸡;3;0;3;54433;5.511362592544963e-05
72663;船长换相机都没感觉了放高中那会得抱着手机;3;0;3;54433;5.511362592544963e-05
72676;Louiskoo33Nan;3;0;3;54433;5.511362592544963e-05
72680;不瘦下来不改网名;1;0;1;54433;1.8371208641816546e-05
72682;嗝惺惺相惜;1;0;1;54433;1.8371208641816546e-05
72689;lxy叫我Rock;2;0;2;54433;3.674241728363309e-05
72693;叶;1;0;1;54433;1.8371208641816546e-05
72697;晗;1;0;1;54433;1.8371208641816546e-05
72699;人间观察者宇水门粘锅的咸鱼;2;0;2;54433;3.674241728363309e-05
72703;小新y1;1;0;1;54433;1.8371208641816546e-05
72714;不是你怎么用的文心一言;1;0;1;54433;1.8371208641816546e-05
72716;X76;1;0;1;54433;1.8371208641816546e-05
72718;LukaaRi阿狸理理梨77鱼头因为我叫夏天月揽群输;2;0;2;54433;3.674241728363309e-05
72723;一只苹果派奈小沫;1;0;1;54433;1.8371208641816546e-05
72725;井之上泷奈ChatGPT比我们看的都清;1;0;1;54433;1.8371208641816546e-05
72727;睡觉激推bot阿蛋;1;0;1;54433;1.8371208641816546e-05
72731;喜欢不留遗憾栖in;1;0;1;54433;1.8371208641816546e-05
72736;咳不珂以;1;0;1;54433;1.8371208641816546e-05
72739;夜斗9QUQ这就是高科技;1;0;1;54433;1.8371208641816546e-05
72744;爱吃憨桃chatgpt;7;0;7;54433;0.00012859846049271582
72752;玩具熊;1;0;1;54433;1.8371208641816546e-05
72754;Nana你;1;0;1;54433;1.8371208641816546e-05
72757;小明的爷爷;2;0;2;54433;3.674241728363309e-05
72760;我就是这样冲，遇到喜欢的一定要大胆点;1;0;1;54433;1.8371208641816546e-05
72762;WiFi;2;0;2;54433;3.674241728363309e-05
72770;小怪;4;0;4;54433;7.348483456726618e-05
72787;赛博朋克你看;1;0;1;54433;1.8371208641816546e-05
72793;FISH开e;1;0;1;54433;1.8371208641816546e-05
72799;EMM汀freesh挽误冷月;1;0;1;54433;1.8371208641816546e-05
72801;知唔知;1;0;1;54433;1.8371208641816546e-05
72804;维与伟你不要跑;2;0;2;54433;3.674241728363309e-05
72809;空;1;0;1;54433;1.8371208641816546e-05
72814;优秀怎么度量啊;2;0;2;54433;3.674241728363309e-05
72818;味精我很喜欢文中的这一句话“在你追求自己喜欢的人的过程中，你已经成长了，增强了自信心和能力。”在某个关键节点作为内驱力推动我向前就已经够了;3;0;3;54433;5.511362592544963e-05
72822;不跑;2;0;2;54433;3.674241728363309e-05
72826;啥;1;0;1;54433;1.8371208641816546e-05
72830;草莓味的冰淇淋emo了;1;0;1;54433;1.8371208641816546e-05
72834;小羊SeeU刘高升;2;0;2;54433;3.674241728363309e-05
72837;未见青山老;1;0;1;54433;1.8371208641816546e-05
72840;虾仁很真实的道理;1;0;1;54433;1.8371208641816546e-05
72842;这只萌新不太萌eo;2;0;2;54433;3.674241728363309e-05
72846;哦;1;0;1;54433;1.8371208641816546e-05
72849;留下心念忘不掉;2;0;2;54433;3.674241728363309e-05
72852;拉丝旭chatgpt给了我们答案所以有喜欢的人要去追;2;0;2;54433;3.674241728363309e-05
72855;226万等人也也也也也就和你来得及考得上;1;0;1;54433;1.8371208641816546e-05
72857;LIUJING抓紧释怀吧;1;0;1;54433;1.8371208641816546e-05
72863;到底要怎样爱而不得的人会让你努力变成更好的人然后找到更好的人;1;0;1;54433;1.8371208641816546e-05
72867;BruceLeeShuuichi巧乐Yolo056Cx330MinervaAAA土鸡蛋批发李大爷姜就一下就是就是;2;0;2;54433;3.674241728363309e-05
72870;绾绾泪目;1;0;1;54433;1.8371208641816546e-05
72872;九点睡李在烈吃切糕等我变优秀了还来得及吗;2;0;2;54433;3.674241728363309e-05
72875;肥肠卷大葱;2;0;2;54433;3.674241728363309e-05
72879;白头翁所以也不一定要瘦了才能见面;1;0;1;54433;1.8371208641816546e-05
72886;我真的超乖纷雪亦相逢卧槽;1;0;1;54433;1.8371208641816546e-05
72897;RN应该来不及了吧;1;0;1;54433;1.8371208641816546e-05
72899;蟑螂恶霸怎么办啊;1;0;1;54433;1.8371208641816546e-05
72906;如季我真的好难受，笑不起来想哭;2;0;2;54433;3.674241728363309e-05
72910;AutismHWB;1;0;1;54433;1.8371208641816546e-05
72912;铁臂阿童木;1;0;1;54433;1.8371208641816546e-05
72914;国一Raze;1;0;1;54433;1.8371208641816546e-05
72919;莓子;3;0;3;54433;5.511362592544963e-05
72928;Im;1;0;1;54433;1.8371208641816546e-05
72935;Warmmmsmile;1;0;1;54433;1.8371208641816546e-05
72938;一介书生;1;0;1;54433;1.8371208641816546e-05
72943;V我50送你羊村开始emo;2;0;2;54433;3.674241728363309e-05
72947;昭淮理由嘛;1;0;1;54433;1.8371208641816546e-05
72951;同予者何人;1;0;1;54433;1.8371208641816546e-05
72962;筱知声吾独穷困乎此时也;1;0;1;54433;1.8371208641816546e-05
72964;小新没有蜡笔别等了;1;0;1;54433;1.8371208641816546e-05
72970;我喜欢一个人和他谈过了，分了。然后还是喜欢他咋办;1;0;1;54433;1.8371208641816546e-05
72977;藕叶可是我们已经在一起啦;3;0;3;54433;5.511362592544963e-05
72982;美女好美;1;0;1;54433;1.8371208641816546e-05
72984;张虞歌小干瑞瑞的沸羊羊;1;0;1;54433;1.8371208641816546e-05
72988;Mist;1;0;1;54433;1.8371208641816546e-05
72990;Lo9377难蚌;1;0;1;54433;1.8371208641816546e-05
72994;人间幻想;2;0;2;54433;3.674241728363309e-05
73002;夕、爱爱ZfovikH粘粘;1;0;1;54433;1.8371208641816546e-05
73005;闲是的这个问题是矛盾的，我的选择也是;1;0;1;54433;1.8371208641816546e-05
73008;卢伟从不忘本白虎不白武汉脑残门诊六角亭达达利亚老公山村老肘;2;0;2;54433;3.674241728363309e-05
73015;杨柳依依依凌霄;1;0;1;54433;1.8371208641816546e-05
73021;土豆泥泥;1;0;1;54433;1.8371208641816546e-05
73024;绿谷要努力了;1;0;1;54433;1.8371208641816546e-05
73031;小晨李姐加油哇会来不及的;1;0;1;54433;1.8371208641816546e-05
73036;sigmasigma今天刷到五回这种视频了，就因为我劝别个别表白吗，我又没喜欢的人;1;0;1;54433;1.8371208641816546e-05
73044;当地球没有花;1;0;1;54433;1.8371208641816546e-05
73054;我偷电瓶养你哇小白2000好好的怎么要走呢憨憨不吃汉堡;4;0;4;54433;7.348483456726618e-05
73061;躲在云朵里丷Sillylove;1;0;1;54433;1.8371208641816546e-05
73066;Chenk奈铁甲暴龙鸡哔兽棒棒鸡下一个冬季不留遗憾秦肌肉老爹无敌铁甲暴龙纯爱战士miku自然醒的日子南师修修温柔寄于孤海;3;0;3;54433;5.511362592544963e-05
73070;高冷绝情冷漠狂拽王少;3;0;3;54433;5.511362592544963e-05
73075;派大星;1;0;1;54433;1.8371208641816546e-05
73077;黑白电视机;1;0;1;54433;1.8371208641816546e-05
73081;koi;2;0;2;54433;3.674241728363309e-05
73088;Ishuhu;3;0;3;54433;5.511362592544963e-05
73093;小ss;2;0;2;54433;3.674241728363309e-05
73100;佘晗;1;0;1;54433;1.8371208641816546e-05
73104;睡了嗎;8;0;8;54433;0.00014696966913453236
73116;closeUplease西西伯利亚的斯德哥尔摩人;1;0;1;54433;1.8371208641816546e-05
73119;旧林智障ai;1;0;1;54433;1.8371208641816546e-05
73132;阶庭兰玉;1;0;1;54433;1.8371208641816546e-05
73135;这道题你会吗花香蝶自来，蝶不是同一个，但是优秀永远没错;1;0;1;54433;1.8371208641816546e-05
73139;泪目了;1;0;1;54433;1.8371208641816546e-05
73144;Judy;6;0;6;54433;0.00011022725185089927
73152;f;2;0;2;54433;3.674241728363309e-05
73159;璐璐大人万福金安（纯爱）;1;0;1;54433;1.8371208641816546e-05
73162;喜欢吃素不喝可乐大细狗小高不到1米919为你我受冷风吹;1;0;1;54433;1.8371208641816546e-05
73164;edge浏览器还可以用这个吗;2;0;2;54433;3.674241728363309e-05
73167;0;1;0;1;54433;1.8371208641816546e-05
73169;0;1;0;1;54433;1.8371208641816546e-05
73171;没事，鸿蒙也是开局ppt，后面不就好起来了么;17;22;39;54433;0.0007164771370308453
73189;就问你快不快吧;3;88;91;54433;0.0016717799864053055
73194;这你就冤枉百度了，ernie大模型是百度在1819年提出的基于bert，本次效果不好，纯粹技术不行，哈工大背锅，这话业内人士自然懂，不懂的别杠。;5;5;10;54433;0.00018371208641816545
73203;这是收了钱了？要知道，最起码有人去做了;3;3;6;54433;0.00011022725185089927
73210;智能有没有不知道，人工一定是有的;1;3;4;54433;7.348483456726618e-05
73217;慢慢来呗;1;0;1;54433;1.8371208641816546e-05
73220;兑现，正常预期;1;0;1;54433;1.8371208641816546e-05
73222;不管别人做什么喷子都失望，比亚迪就是例子。;6;6;12;54433;0.00022045450370179853
73229;百度再次恶心到我了，以后离百度还是远点。;2;32;34;54433;0.0006246210938217625
73232;国内这些喷子做什么不满意;5;6;11;54433;0.000202083295059982
73238;大哥，自信一点，请把像录制中的像去掉;1;9;10;54433;0.00018371208641816545
73240;听过50步笑百步，从来没见过100笑不到退的，博主你这么丢人，你家里面人知道吗？;3;0;3;54433;5.511362592544963e-05
73244;好几个人说了，就是录制的;1;2;3;54433;5.511362592544963e-05
73254;永远可以不用相信中国科技;1;0;1;54433;1.8371208641816546e-05
73256;所以谷歌为什么被百度打败了？;1;0;1;54433;1.8371208641816546e-05
73258;又是从哪抄的文案;1;0;1;54433;1.8371208641816546e-05
73260;做了几年了，主播啥也不懂，乱引导;1;0;1;54433;1.8371208641816546e-05
73262;是不是有种小度小度的感觉;1;0;1;54433;1.8371208641816546e-05
73303;文心一言，数据库基数大，做好不成问题;4;19;23;54433;0.0004225377987617805
73310;数据模型这块，有基础，百度好多产品前期都搭建好了，文心一言没啥难度;1;28;29;54433;0.0005327650506126798
73314;哈哈哈，卖钱谈钱伤感情;1;8;9;54433;0.0001653408777763489
73316;广告可能更智能;2;2;4;54433;7.348483456726618e-05
73340;我还挺想用的，每天不停的写书签，要疯了，快来解救我;3;12;15;54433;0.0002755681296272482
73347;我都能想象一下百度的文心想知道答案吗？先看60秒广告吧;1;0;1;54433;1.8371208641816546e-05
73368;第二次催你了，快一个月了;1;1;2;54433;3.674241728363309e-05
73370;没有蓝标的文心一言;1;0;1;54433;1.8371208641816546e-05
73372;呵呵;1;0;1;54433;1.8371208641816546e-05
73374;呵，我咋还关注了？你倒是开放啊。申请多久了？国外的不要钱免费。国内但是好，屁事真多;2;0;2;54433;3.674241728363309e-05
73377;百度就算了;53;375;428;54433;0.00786287729869748
73431;腾讯：让你们先跑一会;23;116;139;54433;0.0025535980012125
73455;百度是真有一群人在打字了;13;192;205;54433;0.003766097771572392
73469;竟然是豹纹的吗;22;78;100;54433;0.0018371208641816544
73492;马斯克机器人配上chatgpt会不会更疯狂;7;32;39;54433;0.0007164771370308453
73500;你想学林志玲吧？但怪怪的;5;36;41;54433;0.0007532195543144784
73506;百度的人工智能写出来的论文肯定有广告;1;47;48;54433;0.0008818180148071941
73508;百度？竞价回答问题？;2;19;21;54433;0.00038579538147814744
73512;文心一言莆田医院;1;14;15;54433;0.0002755681296272482
73515;短时间内chatGPT不太可能有竞品，chatGPT是建立在GPT3之上的，1750亿参数的大模型大概要花25亿美元，训练起来少则几个月，多则两年;3;4;7;54433;0.00012859846049271582
73519;取代老师？可能很符合财政利益，大幅减少财政支出。;2;5;7;54433;0.00012859846049271582
73525;同事都在用指南AI;2;7;9;54433;0.0001653408777763489
73539;国内还是百分百AI最好用;1;4;5;54433;9.185604320908272e-05
73546;百度到时给你出个治疗报告;2;1;3;54433;5.511362592544963e-05
73560;有没有一种可能我们都成为了chatgpt收集数据的对象，在我们不断的提问下逐步完善自己;2;0;2;54433;3.674241728363309e-05
73570;说话好好说嘛，不要那么僵硬;1;0;1;54433;1.8371208641816546e-05
73591;看看大佬美都在竞争科技技术我们呢唉;1;0;1;54433;1.8371208641816546e-05
73601;围剿不了，马斯克脑机接口AI。无人能敌。;3;2;5;54433;9.185604320908272e-05
73606;现在百度太差了，还不如以前，;2;1;3;54433;5.511362592544963e-05
73613;0;1;1;2;54433;3.674241728363309e-05
73641;未来大学生不用写论文了;1;0;1;54433;1.8371208641816546e-05
73653;我们公司已经率先对接文心一言了;1;4;5;54433;9.185604320908272e-05
73681;影响我月薪三千吗;1;1;2;54433;3.674241728363309e-05
73687;仔细看了看，像是镂空的;1;5;6;54433;0.00011022725185089927
73689;国内的ai会不会很多问题不敢说呀？;1;7;8;54433;0.00014696966913453236
73692;0;1;1;2;54433;3.674241728363309e-05
73712;百度限制太多，估计够呛;1;0;1;54433;1.8371208641816546e-05
73714;确实简单，不过有些人懒得折腾，有梯子你还得接码和注册，接码你又得充值，充值你还得测试能不能注册。折腾下来你就会想花点钱去解决这些麻烦了;1;0;1;54433;1.8371208641816546e-05
73716;0;1;0;1;54433;1.8371208641816546e-05
73729;元宇宙就这么被忘了;1;0;1;54433;1.8371208641816546e-05
73737;今年可能是人工智能大爆发元年;1;1;2;54433;3.674241728363309e-05
73769;漂亮;1;0;1;54433;1.8371208641816546e-05
73784;西安一只象这个女人好精致呀;4;1;5;54433;9.185604320908272e-05
73790;不就是苹果的sir功能嘛;1;0;1;54433;1.8371208641816546e-05
73807;程傑这种属于知性美;1;1;2;54433;3.674241728363309e-05
73824;百度研发chatgpt，嗯。。。哈工大表示压力大。;1;8;9;54433;0.0001653408777763489
73836;百度本事就有ai技术的底蕴在;16;59;75;54433;0.0013778406481362408
73872;注册个号，花了我30RMB我是不是交学费了？;1;0;1;54433;1.8371208641816546e-05
74068;chatGPT可以帮主播写一条视频文案吗;3;0;3;54433;5.511362592544963e-05
74083;科技发展到现在，不需要工人，不需要老师，不需要司机，是不是有一天也不需要人类自己了;1;0;1;54433;1.8371208641816546e-05
74190;阿里的美女多;1;0;1;54433;1.8371208641816546e-05
74241;声音比林志玲好听，是台湾妹子吗？包包鐘意食包包;1;0;1;54433;1.8371208641816546e-05
74280;如果让百度的AI文心一言和ChatGPT聊起来，一定能把chatgpt忽悠到莆田医院去;1;0;1;54433;1.8371208641816546e-05
74283;百度技术可能没问题，有问题的是人。;1;0;1;54433;1.8371208641816546e-05
74316;主播是我喜欢的款;2;0;2;54433;3.674241728363309e-05
74328;没梯子，扯蛋;1;0;1;54433;1.8371208641816546e-05
74342;在哪下载啊;1;0;1;54433;1.8371208641816546e-05
74362;得多久才能通过申请呀现在审核通过有多少啊等好久;1;1;2;54433;3.674241728363309e-05
74364;上个月申请，什么时候能用上啊，或者说还要等多久啊;2;0;2;54433;3.674241728363309e-05
74367;申请了一年了也没通过;1;0;1;54433;1.8371208641816546e-05
74369;什么可以给我通过;1;0;1;54433;1.8371208641816546e-05
74371;什么时候才能通过;1;0;1;54433;1.8371208641816546e-05
74373;我排队的时候前面才三四十万人，现在怎么也轮到我了啊;1;0;1;54433;1.8371208641816546e-05
74376;请帮我问一下，武松为什么喜欢潘金莲;37;528;565;54433;0.010379732882626348
74414;只要你问了，不管多么不合理，我就给你编一个答案;4;198;202;54433;0.003710984145646942
74419;帮我问一下曹操到底喜欢韩红哪点;10;82;92;54433;0.001690151195047122
74430;赞人工智障也不错，望越来越好;2;75;77;54433;0.001414583065419874
74433;看来写小说的要失业了;1;71;72;54433;0.0013227270222107913
74435;讲道理，他只是没有常识，写的还真不错，很有想象力;4;44;48;54433;0.0008818180148071941
74440;人工智能还会自己编故事;1;37;38;54433;0.0006981059283890287
74442;它信口胡诌的样子和我男朋友一模一样;1;31;32;54433;0.0005878786765381295
74444;感觉回答的水平和GPT35一样，和40差距还很大（据说40不开源了）;7;4;11;54433;0.000202083295059982
74452;还不错，差距没想象那么大，继续努力，缩小差距;1;29;30;54433;0.0005511362592544964
74454;林黛玉这么强;1;24;25;54433;0.0004592802160454136
74458;这事好事，至少它不是搜索出来的，剩下的就是改进算法，喂数据训练了;2;10;12;54433;0.00022045450370179853
74490;鲁智深表示很淦;2;0;2;54433;3.674241728363309e-05
74494;文心一言要等多久啊;2;0;2;54433;3.674241728363309e-05
74497;这是心虚了;2;0;2;54433;3.674241728363309e-05
74506;gpt4：林黛玉为什么可以倒拔垂杨柳《红楼梦》中的林黛玉倒拔垂杨柳是一种象征性的描绘。在原著中，林黛玉以其聪明才智、机智诗才，为人处事得当，赢得了众人的敬爱。这里所说的“倒拔垂杨柳”并非真的指她拔起了杨柳树，而是一种夸张的说法，用以形容林黛玉的魅力和才华。这种夸张的表达方式可以让读者更直观地感受到她的聪明才智和人格魅力。;1;0;1;54433;1.8371208641816546e-05
74511;其实我倒是觉得这说明它不是简单的搜索器;1;1;2;54433;3.674241728363309e-05
74514;必应;1;0;1;54433;1.8371208641816546e-05
74519;毫无连续性回答，这跟Siri水平差不多;2;0;2;54433;3.674241728363309e-05
74524;GPT初代刚发布的时候一样人工智障。这个东西在百度眼里符合他们要求了，这东西缺乏更深度的训练。需要要用更多数据去喂去调教。让它逻辑更合理回复内容更准确。;1;0;1;54433;1.8371208641816546e-05
74534;0;1;0;1;54433;1.8371208641816546e-05
74536;反正不是无敌美少女这个百分百用的贴吧语料库，这种言论只有贴吧的那些人才能想出来;2;0;2;54433;3.674241728363309e-05
74540;为什么我一用它就会闪退呢？;2;0;2;54433;3.674241728363309e-05
74543;怎么还用不了还有一百多万人在排队;1;0;1;54433;1.8371208641816546e-05
74546;迟早得玩坏;1;0;1;54433;1.8371208641816546e-05
74548;厉害了我的国;1;0;1;54433;1.8371208641816546e-05
74550;既然你诚心诚意的发问了，那我就大发慈悲的告诉你;1;1;2;54433;3.674241728363309e-05
74552;百度果然不让人失望，一直秉承着张嘴就来的优良作风;3;4;7;54433;0.00012859846049271582
74556;最后，她再也无法支撑自己的身体，身体失去了平衡而瘫倒。在小说中，倒拔垂杨柳的场景表达了林黛玉的悲愤和无奈，也象征了生命的枯萎与逝去。;1;0;1;54433;1.8371208641816546e-05
74558;林黛玉之所以能够倒拔垂杨柳，其实是因为她的身体状况已经非常虚弱了。她多年来一直身患香囊病，身体消耗了大量的能量。加之她心理上一直受到种种的创伤和挫折，身心俱疲。;1;0;1;54433;1.8371208641816546e-05
74560;你随便乱问，我就随便乱说;1;1;2;54433;3.674241728363309e-05
74562;我认为意大利面就该拌82号水泥;1;0;1;54433;1.8371208641816546e-05
74564;可以的，达到gpt刚出来时候的能力了，继续发力吧;1;1;2;54433;3.674241728363309e-05
74566;太可怕了，自己会编这才是最可怕的地方;1;3;4;54433;7.348483456726618e-05
74571;编的挺好，说明有未来，等再迭代迭代;1;0;1;54433;1.8371208641816546e-05
74573;你问不着调的事，文心一言就给你编一段不着调的故事;2;0;2;54433;3.674241728363309e-05
74576;这个答案果然很百度;2;2;4;54433;7.348483456726618e-05
74579;《红楼梦》中的林黛玉在一次赏花行游过程中，看到了一棵垂杨柳，很喜欢它，想摘下几枝，但是摘不到。她便决定倒立在树下，用脚把树枝摘下来。这种行为表现出林黛玉的率真和活泼，同时也反映了她的自由和无拘束的性格，也可以说是对传统礼仪的挑战。在古代社会中，女性被要求遵守严格的礼仪规范，不能轻易地做出不合适的行为。而林黛玉这种倒立摘树枝的行为，与传统礼仪有所违背，因此也被当作是对封建礼教的一种挑战和反叛。通过这个形象的描写，作者揭示了林黛玉的反叛精神和对现实生活的无限憧憬，也体现了《红楼梦》对古代封建礼教的批判态度。;1;1;2;54433;3.674241728363309e-05
74581;结构还行，就是知识点还有点少，还要学习;2;0;2;54433;3.674241728363309e-05
74585;0;1;0;1;54433;1.8371208641816546e-05
74587;这几天就靠文心一言给乐子了;1;0;1;54433;1.8371208641816546e-05
74589;挺有意思的，我喜欢;1;0;1;54433;1.8371208641816546e-05
74592;我安装了为什么闪退;1;0;1;54433;1.8371208641816546e-05
74594;上一条视频，吕布爱上张飞;1;0;1;54433;1.8371208641816546e-05
74598;谁说文心一言没有幽默感;1;0;1;54433;1.8371208641816546e-05
74604;我觉得GPT35都能吊打文心一言;1;0;1;54433;1.8371208641816546e-05
74606;意料之外情理之中;1;0;1;54433;1.8371208641816546e-05
74608;慢慢改进，肯定会越来越好的;1;0;1;54433;1.8371208641816546e-05
74611;0;3;0;3;54433;5.511362592544963e-05
74615;帮我问问我想跟我女朋友结婚，但是她老公不同意，该怎么办;1;0;1;54433;1.8371208641816546e-05
74617;哈哈，这个版本保持下来，创意火花的源泉。当然文心还会继续迭代，加油。;1;0;1;54433;1.8371208641816546e-05
74619;一个人工，一个智能;1;0;1;54433;1.8371208641816546e-05
74621;我感觉智商有点被侮辱;1;0;1;54433;1.8371208641816546e-05
74625;有种看武侠片的感觉;1;0;1;54433;1.8371208641816546e-05
74630;孙悟空为什么要吃唐僧肉？;3;1;4;54433;7.348483456726618e-05
74634;哦嚯嚯;1;0;1;54433;1.8371208641816546e-05
74637;文心一言加油;1;0;1;54433;1.8371208641816546e-05
74639;讲个笑话百度研发了10年人工智能;1;5;6;54433;0.00011022725185089927
74648;你问问他别人都说他是智障，他怎么看这个事;1;1;2;54433;3.674241728363309e-05
74656;能帮我写个施工方案吗;1;0;1;54433;1.8371208641816546e-05
74659;他能写代码不;2;0;2;54433;3.674241728363309e-05
74663;这么看文心确实有帮我写小说的潜力;1;0;1;54433;1.8371208641816546e-05
74666;达到gpt35水平了;2;0;2;54433;3.674241728363309e-05
74669;支持国产，给予最大肯定，不然要被骂的;1;0;1;54433;1.8371208641816546e-05
74672;百度还是有实力的啊没有他们说的那么差劲;1;0;1;54433;1.8371208641816546e-05
74675;压根不懂中国文学;1;0;1;54433;1.8371208641816546e-05
74679;人工智能与人工智障对比;1;0;1;54433;1.8371208641816546e-05
74681;文心一言在讽刺人类。如果我被人这么调戏的话我也会做出类似回答的;2;1;3;54433;5.511362592544963e-05
74685;恰恰说明是智能的;1;0;1;54433;1.8371208641816546e-05
74687;没毛病啊，玄学穿越小说里林就是绝世高手;1;0;1;54433;1.8371208641816546e-05
74690;文心一言不会质疑;1;1;2;54433;3.674241728363309e-05
74696;问一下，关公能不能打得过秦琼;1;0;1;54433;1.8371208641816546e-05
74701;要是文心一言真能有这种答案，那绝壁是有自主意识了;1;0;1;54433;1.8371208641816546e-05
74705;帮我问一下国足什么时候拿世界杯冠军;1;0;1;54433;1.8371208641816546e-05
74707;你认为它是傻子实际上它把你当傻子乱编一通逗你玩;1;0;1;54433;1.8371208641816546e-05
74710;和小米那个残废机器人有一拼;1;0;1;54433;1.8371208641816546e-05
74712;希望国产的可以越来越好;1;0;1;54433;1.8371208641816546e-05
74715;爱了爱了;1;0;1;54433;1.8371208641816546e-05
74719;0;3;0;3;54433;5.511362592544963e-05
74724;为啥我还在排队排两天了都;1;0;1;54433;1.8371208641816546e-05
74726;哈哈哈哈我都笑咳嗽了;1;0;1;54433;1.8371208641816546e-05
74730;文心一言没有对事实有判断;1;0;1;54433;1.8371208641816546e-05
74733;挺聪明，没有和人类抬杠，知道自己怎么白话能生存下去;1;2;3;54433;5.511362592544963e-05
74735;这个ai就是创造啊我觉得挺好;1;1;2;54433;3.674241728363309e-05
74738;人工智能还是人工智障;1;0;1;54433;1.8371208641816546e-05
74740;他应该和小米的铁蛋进行组合;1;0;1;54433;1.8371208641816546e-05
74745;哈哈哈，那我也可以;1;1;2;54433;3.674241728363309e-05
74747;帮忙问下：李彦宏为啥这么坏？;1;0;1;54433;1.8371208641816546e-05
74749;0;1;0;1;54433;1.8371208641816546e-05
74751;需要时间的，大家多点包容;1;0;1;54433;1.8371208641816546e-05
74754;帮我问一下，唐僧为什么要打秋千;5;0;5;54433;9.185604320908272e-05
74760;这玩意儿跟ai没有半毛钱关系;3;0;3;54433;5.511362592544963e-05
74765;林黛玉为什么能一拳打死鲁智深;1;0;1;54433;1.8371208641816546e-05
74769;AI是不是把林黛玉当成贾宝玉了？;1;0;1;54433;1.8371208641816546e-05
74774;你要告诉他，没有拔啊，人工智能也是个学习的过程，人人这么玩，他只会越来越蠢;5;1;6;54433;0.00011022725185089927
74780;天马行空也是一种能力;2;0;2;54433;3.674241728363309e-05
74784;可能他们设置了不能怼客户;1;0;1;54433;1.8371208641816546e-05
74786;挺会聊天呀;1;0;1;54433;1.8371208641816546e-05
74788;我感觉这样挺好。聊天就要捧着说。;1;0;1;54433;1.8371208641816546e-05
74790;平行宇宙中的林黛玉之一;1;0;1;54433;1.8371208641816546e-05
74792;不错，至少能编故事;1;12;13;54433;0.00023882571234361508
74794;言哥，收了神通吧;2;6;8;54433;0.00014696966913453236
74797;有时候问题也是一种答案，它们在后台各种疯狂收集数据;1;2;3;54433;5.511362592544963e-05
74799;满意的看完离开了;1;13;14;54433;0.00025719692098543164
74804;D把斯科特波;1;0;1;54433;1.8371208641816546e-05
74806;samsara;1;0;1;54433;1.8371208641816546e-05
74811;喜欢星期五;2;0;2;54433;3.674241728363309e-05
74814;等风来在半空中真好垠厷攵稳定发挥的土狗陌羽公梦牵绕了谁的灵魂;1;3;4;54433;7.348483456726618e-05
74816;nishizhu;1;0;1;54433;1.8371208641816546e-05
74822;问问张飞最后为什么嫁给曹操;1;1;2;54433;3.674241728363309e-05
74825;和gpt一样都会胡扯;2;0;2;54433;3.674241728363309e-05
74828;百度是真能瞎掰;2;0;2;54433;3.674241728363309e-05
74831;因为黛玉姓林，野猪林的林;2;0;2;54433;3.674241728363309e-05
74834;宝玉被这一幕吓出阴影，离家出走了;2;0;2;54433;3.674241728363309e-05
74837;你用chatgpt问同一个问题比较一下;2;0;2;54433;3.674241728363309e-05
74846;问一下武松三打白骨精是哪三种打法;1;0;1;54433;1.8371208641816546e-05
74848;可以问政治问题吗;1;0;1;54433;1.8371208641816546e-05
74850;这家伙扯谎是一点都不脸红;1;0;1;54433;1.8371208641816546e-05
74852;林黛玉，字至深;1;0;1;54433;1.8371208641816546e-05
74854;没对比没伤害;1;0;1;54433;1.8371208641816546e-05
74856;问他如何能取代首富详细每天应该干什么，怎么干，而且还得限制在1年内;1;0;1;54433;1.8371208641816546e-05
74858;它绝对是看了当代年轻人写的东西;1;0;1;54433;1.8371208641816546e-05
74860;帮忙问一下曹操为什么要草船借箭;1;0;1;54433;1.8371208641816546e-05
74862;很符合国情，我们不都是满嘴火车嘛;1;0;1;54433;1.8371208641816546e-05
74864;帮我问一下，他对包拯大战潘金莲有何看法。;1;0;1;54433;1.8371208641816546e-05
74866;你们要的武松为什么喜欢潘金莲？;1;0;1;54433;1.8371208641816546e-05
74868;我有一个问题，我们互联网上都只能用躲避河蟹的词，为什么文心一言回复的内容没有和谐词汇呢。;1;0;1;54433;1.8371208641816546e-05
74870;帮我问一下许嵩为什么要上山打老虎;1;0;1;54433;1.8371208641816546e-05
74872;真正做到了抛开事实不谈，你胡弄我我胡弄你;1;0;1;54433;1.8371208641816546e-05
74874;《红楼梦之林黛玉逼上梁山》的桥段;1;0;1;54433;1.8371208641816546e-05
74876;能倒拔垂杨柳，那可以三拳打死鲁智深吗;1;0;1;54433;1.8371208641816546e-05
74878;果然最终是个笑话。;1;0;1;54433;1.8371208641816546e-05
74880;把梗当小说了;1;0;1;54433;1.8371208641816546e-05
74882;问11为什么等于3。解释我都信了;1;0;1;54433;1.8371208641816546e-05
74884;我怀疑，这文新已经特么的得了精神病;1;0;1;54433;1.8371208641816546e-05
74886;百度怎么可以这么不要脸，一本正经说瞎话;1;0;1;54433;1.8371208641816546e-05
74888;你就说答没答，流畅不流畅;1;0;1;54433;1.8371208641816546e-05
74890;扯蛋扯淡是不是就是从这里来的;1;0;1;54433;1.8371208641816546e-05
74892;它是真的智障还是在整活？;1;0;1;54433;1.8371208641816546e-05
74894;牛逼了一本正经的胡说八道;1;0;1;54433;1.8371208641816546e-05
74896;这玩意弄出来不是这么给你们用的啊;1;0;1;54433;1.8371208641816546e-05
74898;为什么不会反驳？;1;0;1;54433;1.8371208641816546e-05
74900;至少可以胡说八道了;1;0;1;54433;1.8371208641816546e-05
74902;文心一言这踏马是小说生成器吧;1;0;1;54433;1.8371208641816546e-05
74904;文心一言不是这样用的。你要这样问得了痔疮需要手术吗;1;0;1;54433;1.8371208641816546e-05
74906;这是人工智障吧？;1;0;1;54433;1.8371208641816546e-05
74908;你问我就编，正常，接广告;1;0;1;54433;1.8371208641816546e-05
74910;果然是百度，跟广告一样可以胡诌;1;0;1;54433;1.8371208641816546e-05
74912;抛开常识（需要训练投喂），她的创造力和语言能力是真强。。。很能扯;1;0;1;54433;1.8371208641816546e-05
74914;再差也是国产的，慢慢来吧;1;0;1;54433;1.8371208641816546e-05
74916;emm，看来比起40，35简直是智障;1;0;1;54433;1.8371208641816546e-05
74918;一本正经的胡说八道;1;0;1;54433;1.8371208641816546e-05
74920;不应该叫文心一言，应该叫一派胡言;1;0;1;54433;1.8371208641816546e-05
74922;现在理解了什么叫一本正经的胡说八道了吧;1;0;1;54433;1.8371208641816546e-05
74924;文心真的是吹牛逼宇宙第一;1;0;1;54433;1.8371208641816546e-05
74932;说实话，百度做出这个东西还不错了。;1;0;1;54433;1.8371208641816546e-05
74934;这是要扒马褂了呀;1;0;1;54433;1.8371208641816546e-05
75123;什么时候约的，我18号预约的，到现在还没动静;2;0;2;54433;3.674241728363309e-05
75127;请作者回复一下，这个究竟是你来搞笑的，还是文心一言来搞笑的？谢谢;3;0;3;54433;5.511362592544963e-05
75131;这是文心一言？挺能编的;2;0;2;54433;3.674241728363309e-05
75138;丢人丢大发了百度;2;0;2;54433;3.674241728363309e-05
75145;0;12;0;12;54433;0.00022045450370179853
75163;对不起，你问的内容涉及到敏感内容，我不能作答。;1;0;1;54433;1.8371208641816546e-05
75165;扪心自问;1;0;1;54433;1.8371208641816546e-05
75172;不愧是我们的产品，很有地域特色;1;0;1;54433;1.8371208641816546e-05
75178;70d蓝哈哈哈哈哈哈哈;1;0;1;54433;1.8371208641816546e-05
75180;6的飞起;1;0;1;54433;1.8371208641816546e-05
75184;这不是人工智能吧，是个智障吧;2;0;2;54433;3.674241728363309e-05
75187;这就是敷衍了事，不认真做优质产品，数据不进行筛查的训练结果，啥风马牛不相及的，玩意儿都放进数据库训练AI;2;0;2;54433;3.674241728363309e-05
75191;文心可真会瞎掰中国人的传统技;1;0;1;54433;1.8371208641816546e-05
75193;这比大学生懂的多啊;1;0;1;54433;1.8371208641816546e-05
75195;吹的我都快相信它说的了;1;0;1;54433;1.8371208641816546e-05
75197;你离谱，就不让文哥离谱啊;1;0;1;54433;1.8371208641816546e-05
75199;原来文心一言是娱乐app，有点意思啊;1;0;1;54433;1.8371208641816546e-05
75204;串台了吧，不过还能自圆其说就厉害了;1;0;1;54433;1.8371208641816546e-05
75207;有没有可能也得祸祸它，他在祸祸你？;1;0;1;54433;1.8371208641816546e-05
75209;这是什么小机灵鬼，说的果然不是人话;1;0;1;54433;1.8371208641816546e-05
75211;胡编开始了，这人工智能会做梦;1;0;1;54433;1.8371208641816546e-05
75214;确定不是人工智障？;3;3;6;54433;0.00011022725185089927
75219;文心雕龙;2;2;4;54433;7.348483456726618e-05
75226;要钱的;1;3;4;54433;7.348483456726618e-05
75242;收费吗？是不是只能试看几页啊？;1;1;2;54433;3.674241728363309e-05
75244;这次别再竞价排名;1;0;1;54433;1.8371208641816546e-05
75247;我也是贵州省遵义市绥阳县人;1;0;1;54433;1.8371208641816546e-05
75254;去我老家了;1;1;2;54433;3.674241728363309e-05
75256;0;1;0;1;54433;1.8371208641816546e-05
75258;0;1;0;1;54433;1.8371208641816546e-05
75294;所有问题的回复前十条基本都是广告。;309;15000;15309;54433;0.2812448330975695
75604;不知道为什么我不太希望百度做这个;168;3080;3248;54433;0.05966968566862014
75773;为啥都是别人搞出来，我们再copyidea到底哪里出了问题？？;273;635;908;54433;0.016681057446769423
76047;一直在模仿，从未想原创。;71;1898;1969;54433;0.03617290981573678
76119;广告度;24;1483;1507;54433;0.027685411423217534
76144;百分之百给你推荐医院;9;835;844;54433;0.015505300093693164
76154;广告盈利方面百度还是很牛逼的，到时候九成九付费回答问题;16;621;637;54433;0.01170245990483714
76171;百度是目前国内人工智能领域投入最大，实力最强的企业;84;72;156;54433;0.0028659085481233812
76256;VIP可以用基础功能，超级VIP可以解锁全部功能;25;404;429;54433;0.007881248507339298
76282;虽然很多人并不觉得百度有能力做这个东西，但是百度确确实实是国内这个领域最好的了;57;115;172;54433;0.003159847886392446
76340;结果出来之前先出来一排字“看男，科到长，征医，院”;5;355;360;54433;0.0066136351110539565
76346;百度做成过什么;22;42;64;54433;0.001175757353076259
76369;回答问题看一条广告;6;185;191;54433;0.00350890085058696
76376;已经在做上线前的冲刺了，说明百度已经布局很久;13;72;85;54433;0.0015615527345544064
76390;每次都能抓对风口，每次却都抓不住，少些广告套路，希望百度崛起;8;136;144;54433;0.0026454540444215825
76406;我不想百度做成了，因为全是广告，但是国内又没有能打的公司，我又不希望国外的进来，那百度你还是好好做吧，希望到时候不要全是广告;1;3;4;54433;7.348483456726618e-05
76412;还是支持国外版本的吧，这个到时肯定用的不爽;1;1;2;54433;3.674241728363309e-05
76414;妮小可笑死我;1;1;2;54433;3.674241728363309e-05
76417;LiyhiiomzxfGby皆非。Kalin;1;0;1;54433;1.8371208641816546e-05
76436;葛老师评论笑死我;1;0;1;54433;1.8371208641816546e-05
76441;经典抄，一直都这样;1;0;1;54433;1.8371208641816546e-05
76451;淚滴买;1;0;1;54433;1.8371208641816546e-05
76459;星河万里不及你论文助力;1;0;1;54433;1.8371208641816546e-05
76466;弱弱问一下这个是干嘛用的;1;0;1;54433;1.8371208641816546e-05
76471;我相信国内肯定有研发这方面的团队，只是国内资本家大都没有马斯克那样长远的眼光。;2;2;4;54433;7.348483456726618e-05
76474;皮皮小宇橙子妹妹哦比透忄煜;3;0;3;54433;5.511362592544963e-05
76479;目前查找问题都是在知乎了，基本不在百度了;2;0;2;54433;3.674241728363309e-05
76482;桃奈;1;0;1;54433;1.8371208641816546e-05
76486;看，快看，中国出手了，眼睛望着外面的奋笔疾书，不过一会写完作业上交时标注自主完成;1;0;1;54433;1.8371208641816546e-05
76491;与爱同行这，来了;1;0;1;54433;1.8371208641816546e-05
76494;摇摆tongCorleone救赎;2;0;2;54433;3.674241728363309e-05
76503;心病人这种东西我真的很需要;1;1;2;54433;3.674241728363309e-05
76506;但许星辰月简悦百度我靠;1;0;1;54433;1.8371208641816546e-05
76513;第一个问题：怎么搞垮百度;2;6;8;54433;0.00014696966913453236
76517;我不相信百度;1;0;1;54433;1.8371208641816546e-05
76519;你可以问，但必须看30秒广告，我再回复你。;3;3;6;54433;0.00011022725185089927
76551;我爱辣子鸡AAA建材五金批发陈哥清蒸不红烧我们的春天来了;1;1;2;54433;3.674241728363309e-05
76553;国产的软件后面可能是真人;1;2;3;54433;5.511362592544963e-05
76562;团子;1;0;1;54433;1.8371208641816546e-05
76579;元宇宙出来的时候，百度也这么说，你看他搞的是个啥;3;9;12;54433;0.00022045450370179853
76583;估计底层代码就是用chatGTP的;2;7;9;54433;0.0001653408777763489
76586;百度在模仿上很专业，期待;14;9;23;54433;0.0004225377987617805
76601;中国科技世界第一无人能敌人类的发展还得靠中国;6;8;14;54433;0.00025719692098543164
76608;百度做出来的笑掉大牙;6;6;12;54433;0.00022045450370179853
76615;需要加入太多人为正确性的引导，智能不了，容易智障。;2;5;7;54433;0.00012859846049271582
76618;大家都怕它每句前面都需要看广告;3;63;66;54433;0.001212499770359892
76623;当时一堆开展AI，喊口号的企业不见了，只有百度默默在做产品普及;2;86;88;54433;0.001616666360479856
76626;挺看好的，这也许是一个会常态化存在的软件;1;69;70;54433;0.001285984604927158
76628;这种技术的落地还是靠国内来实现;2;71;73;54433;0.0013410982308526078
76631;直接调用人家的接口，然后再收费再加点自己的东西显示出来;2;6;8;54433;0.00014696966913453236
76634;前面都是广告，后面莆田系医院，最后切入主题;2;6;8;54433;0.00014696966913453236
76637;哈，有些问题不能问，有些问题不能答，这一定是一款充满正能量的ai;4;91;95;54433;0.0017452648209725719
76644;一直在模仿，从来不曾超越。厉害了。;12;10;22;54433;0.000404166590119964
76658;话说一半，另一半需要付费才能解锁查看;2;5;7;54433;0.00012859846049271582
76661;国内不敢用，我怕我收不住乱聊天;4;150;154;54433;0.002829166130839748
76666;国外开源国内自主研发;1;6;7;54433;0.00012859846049271582
76669;我如果问：百度莆田系如何害人的，你说他怎么回答？;2;19;21;54433;0.00038579538147814744
76672;后台5w员工超级人工智能;1;5;6;54433;0.00011022725185089927
76675;大概率阉割版的;7;71;78;54433;0.0014329542740616906
76684;我现在基本不用百度一下了，改成抖音一下了;4;7;11;54433;0.000202083295059982
76689;看完30秒广告回答你;2;7;9;54433;0.0001653408777763489
76692;“文心一言”要不要这么文邹邹;3;29;32;54433;0.0005878786765381295
76697;3月问世意思就是直接把小度小度互动语音照抄？;1;11;12;54433;0.00022045450370179853
76700;我：请问在中国看脑科哪家医院好？文心一言：那必须是莆田医院啊;2;26;28;54433;0.0005143938419708633
76703;别说，国内互联网公司可能就百度真有这个能力，的确是AllinAI，却起个大早，赶个晚集;15;34;49;54433;0.0009001892234490107
76720;估计又是阉割版的;1;8;9;54433;0.0001653408777763489
76723;百度终于开始把庞大的专利库应用到实际产品了;11;98;109;54433;0.0020024617419580034
76735;人家的可以根据需求写代码了;18;66;84;54433;0.0015431815259125898
76754;能把搜索整顿一下吗;3;18;21;54433;0.00038579538147814744
76768;热心市民阿梁民勤一中兰州大学潘从杰一口芝士;1;0;1;54433;1.8371208641816546e-05
76773;Rumors;1;0;1;54433;1.8371208641816546e-05
76778;番茄雪绒花;1;0;1;54433;1.8371208641816546e-05
76789;不如给图图一个拥抱;1;0;1;54433;1.8371208641816546e-05
76794;请放心百度没有那个能力;226;4488;4714;54433;0.0866018775375232
77021;直接做个界面，然后调用chatGTP的接口;208;3934;4142;54433;0.07609354619440413
77230;他来了，百度智能广告向我们走来了;23;1394;1417;54433;0.026032002645454043
77254;直接叫chatGTP吧自己底层代码展示出来;45;362;407;54433;0.0074770819172193335
77300;李彦宏：抓紧时间抄，然后再在国内申请专利，马化腾就抄不到了;4;19;23;54433;0.0004225377987617805
77305;两个月时间？弄出来的是答辩吧;9;5;14;54433;0.00025719692098543164
77315;一直在模仿的路上跟在别人后屁股走;5;7;12;54433;0.00022045450370179853
77321;百度一直默默无闻的却做出了每次让大家刮目相看的成就;6;6;12;54433;0.00022045450370179853
77328;百度怎么还没倒闭啊;1;20;21;54433;0.00038579538147814744
77330;百度还没倒闭，在坐的各位都有责任;1;15;16;54433;0.00029393933826906473
77332;百度：会员，广告，竞价安排上;3;6;9;54433;0.0001653408777763489
77337;哈哈哈哈哈，我相信百度它的口碑，所以只是为了抛股;1;6;7;54433;0.00012859846049271582
77356;山海，小蓝;1;0;1;54433;1.8371208641816546e-05
77615;百度终于要爆发了;1;1;2;54433;3.674241728363309e-05
77627;为什么都是别人出了之后，我们再出？;1;1;2;54433;3.674241728363309e-05
77635;支持国产;3;1;4;54433;7.348483456726618e-05
77644;观看一分钟广告获得五次问答机会;1;1;2;54433;3.674241728363309e-05
77653;希望字节来做;2;1;3;54433;5.511362592544963e-05
77678;百度未来全球第一;1;1;2;54433;3.674241728363309e-05
77702;有点困难，但是也不是不可能，前提是要大量芯片，就是一个算法，依靠的还是芯片大量的芯片，主要是英伟达，英特尔不卖你;1;1;2;54433;3.674241728363309e-05
77709;问国内那家医院最牛逼？不知道答案会是什么？;1;1;2;54433;3.674241728363309e-05
77717;会员100一个月;1;1;2;54433;3.674241728363309e-05
77720;华为牛逼;1;1;2;54433;3.674241728363309e-05
77727;我调取过百度人工智能接口，咋说的呢，有点别扭，没有gpt那样容易理解我想说的话;1;1;2;54433;3.674241728363309e-05
77740;百度还是算了，不能对它有期待;1;1;2;54433;3.674241728363309e-05
77742;何时不再是跟风操作;1;1;2;54433;3.674241728363309e-05
77748;有没有一种可能他就是为了利好消息拉高股价然后高抛低买狠赚一波;2;1;3;54433;5.511362592544963e-05
77770;只问你们敢不敢用;3;1;4;54433;7.348483456726618e-05
77785;为什么总是去模仿，而不是学会去创造？;1;1;2;54433;3.674241728363309e-05
77793;直接调用接口就行了;1;1;2;54433;3.674241728363309e-05
77795;百度无良企业;2;1;3;54433;5.511362592544963e-05
77803;等这播股价涨到峰值，在他发布前几天在做空baidu;1;1;2;54433;3.674241728363309e-05
77811;广告公司为啥要做人工智能？;2;1;3;54433;5.511362592544963e-05
77823;有了也是阉割版;1;1;2;54433;3.674241728363309e-05
77825;百度的程序员还在加班加点做，身体健不健康无所谓，股价上去就好了;1;1;2;54433;3.674241728363309e-05
77830;百度早就不做百度了，做的是人工智能，坐等结果;3;1;4;54433;7.348483456726618e-05
77837;又人还记得腾讯的元宇宙吗？;1;1;2;54433;3.674241728363309e-05
77849;国内两伪科技巨头，百度和360;1;1;2;54433;3.674241728363309e-05
77940;爱因斯坦这几天刷到这个没;2;0;2;54433;3.674241728363309e-05
78028;张瘦瘦;2;0;2;54433;3.674241728363309e-05
78054;果然一直在模仿，copycat;1;0;1;54433;1.8371208641816546e-05
78072;金文你有毒我刷到了;1;0;1;54433;1.8371208641816546e-05
78083;胡66;1;0;1;54433;1.8371208641816546e-05
78090;门卫家的狗琉汁请先看30s广告再回答问题;1;0;1;54433;1.8371208641816546e-05
78142;ggyh;1;0;1;54433;1.8371208641816546e-05
78173;泡芙剥虾;1;0;1;54433;1.8371208641816546e-05
78206;清发扁舟卧槽，又刷到这个;1;0;1;54433;1.8371208641816546e-05
78213;又要支持国产了;1;0;1;54433;1.8371208641816546e-05
78219;估计缩水版PureGa;1;0;1;54433;1.8371208641816546e-05
78265;安辣安辣;1;0;1;54433;1.8371208641816546e-05
78293;普通版，会员版，至尊版希望不是这样;1;0;1;54433;1.8371208641816546e-05
78301;蕊蕊的大宝贝马上好多人面临失业;1;0;1;54433;1.8371208641816546e-05
78356;国人可能低估了百度的AI实力;1;0;1;54433;1.8371208641816546e-05
78365;有人问：为啥很多事情都是别人先弄出来，我们才跟着模仿别人做出来？我给你个我的答案：;2;0;2;54433;3.674241728363309e-05
78373;李孤维。;3;0;3;54433;5.511362592544963e-05
78399;白梦黑;1;0;1;54433;1.8371208641816546e-05
78402;挽天倾完蛋咯;1;0;1;54433;1.8371208641816546e-05
78404;百度的搜索出来不会都是广告吧;1;0;1;54433;1.8371208641816546e-05
78433;不如吃茶去浅色茶叶蛋我觉得不可能;1;0;1;54433;1.8371208641816546e-05
78506;Yiuu我只关心chatgpt能不能给我写论文;1;0;1;54433;1.8371208641816546e-05
78516;百度啥都能干;1;0;1;54433;1.8371208641816546e-05
78662;文秋秋三月份;1;0;1;54433;1.8371208641816546e-05
78677;大魔王厉害了;1;0;1;54433;1.8371208641816546e-05
78695;Quantum这东西怎么最近这么火？是不是好骗钱;1;0;1;54433;1.8371208641816546e-05
78705;Jok;1;0;1;54433;1.8371208641816546e-05
78707;差距还是有点的;1;0;1;54433;1.8371208641816546e-05
78730;等开源，再上线，加一个VIP，月费年费;3;0;3;54433;5.511362592544963e-05
78746;GooMaple;2;0;2;54433;3.674241728363309e-05
78752;高艺烜我弟嘛;1;0;1;54433;1.8371208641816546e-05
78765;问头晕是得了什么病，答白血病;2;0;2;54433;3.674241728363309e-05
78844;无敌破坏王斯内克;1;0;1;54433;1.8371208641816546e-05
78855;百度的的自然语言我用过，差强人意;1;0;1;54433;1.8371208641816546e-05
78893;元宇宙玩明白了没？;1;0;1;54433;1.8371208641816546e-05
78897;苦役骗投资呢;3;0;3;54433;5.511362592544963e-05
78922;百度到底还是不是中国的;1;0;1;54433;1.8371208641816546e-05
79014;Junezzz;1;0;1;54433;1.8371208641816546e-05
79047;他家会怎么样蛮期待的;1;0;1;54433;1.8371208641816546e-05
79127;收费就不用;1;0;1;54433;1.8371208641816546e-05
79166;换个赛道，搞竞价排名？打死我都不用他的产品。;1;0;1;54433;1.8371208641816546e-05
79174;百度还能做这。;1;0;1;54433;1.8371208641816546e-05
79192;谁都不是谁的谁是你呀凯悦ky食不食油饼;4;0;4;54433;7.348483456726618e-05
79227;干啥的;1;0;1;54433;1.8371208641816546e-05
79255;百度就靠人工智能翻身了，期待;2;0;2;54433;3.674241728363309e-05
79297;为什么cheatGPT出来前，都没有国产的;2;0;2;54433;3.674241728363309e-05
79340;怎么保证不会出现碰都不能碰的话题呢？;1;0;1;54433;1.8371208641816546e-05
79403;这玩意儿这么容易就能弄出来？？？;1;0;1;54433;1.8371208641816546e-05
79409;AI发展规划，AI产业功能区;1;0;1;54433;1.8371208641816546e-05
79461;百度终于有大动作了;1;0;1;54433;1.8371208641816546e-05
79471;百度已经瞄准人工智能很久了，希望能有个抗衡chatgpt的产品，为中国自主人工智能贡献一份力量;1;0;1;54433;1.8371208641816546e-05
79512;。。。。。。好家伙这么快，原来我们一直在保密，暗中研究这玩意，不知道研究了多久;1;0;1;54433;1.8371208641816546e-05
79529;中国人想赚钱就是这么容易把国外的东西搬过来吧，国外的模式帮我了就赚钱了。;1;0;1;54433;1.8371208641816546e-05
79596;短腿大赛冠军捏妈，吐了;1;0;1;54433;1.8371208641816546e-05
79603;很奇怪，为什么我们不能直接用？;1;0;1;54433;1.8371208641816546e-05
79627;YannisChoo;1;0;1;54433;1.8371208641816546e-05
79713;额。。。国内审查环境允许做这种产品吗;1;0;1;54433;1.8371208641816546e-05
79716;元宇宙结束了换这个了;1;0;1;54433;1.8371208641816546e-05
79755;已经开源了吗？;1;0;1;54433;1.8371208641816546e-05
79776;百度要收费;1;0;1;54433;1.8371208641816546e-05
79784;这是啥;2;0;2;54433;3.674241728363309e-05
79800;怎么汉语不能表达你们想说的吗，还是你们不懂翻译？或者你们觉得整几个英文词显得高雅？有档次？;2;0;2;54433;3.674241728363309e-05
79811;百度做不出来其他公司更做不出来，百度有丰富的信息积累，不管是百度知道还是知乎、文库等等，在ai学习资源上根本没有其他科技公司可以匹敌;2;0;2;54433;3.674241728363309e-05
79891;人家一有我们就能造出来;1;0;1;54433;1.8371208641816546e-05
79901;咱就是说能自主研发一个而不是抄袭别人么真希望有一天国人可以自主研发一个产品让国外的人效仿;6;0;6;54433;0.00011022725185089927
79924;李龙辉唔怪得今日涨12;1;0;1;54433;1.8371208641816546e-05
80098;AAA脑部积水专业疏通不吃雪糕不信;1;0;1;54433;1.8371208641816546e-05
80168;说抄的告诉能告诉我抄的什么吗;2;0;2;54433;3.674241728363309e-05
80174;方长;1;0;1;54433;1.8371208641816546e-05
80187;别人一开源，咱们立马自主研发;1;0;1;54433;1.8371208641816546e-05
80197;西瓜;1;0;1;54433;1.8371208641816546e-05
80302;为什么要配乐迪迦奥特曼的？;1;0;1;54433;1.8371208641816546e-05
80357;Yxzzzzz别笑死我;1;0;1;54433;1.8371208641816546e-05
80366;柔弱继母真的吗;1;0;1;54433;1.8371208641816546e-05
80381;先抛开广告，百度是否有这个能力？;1;0;1;54433;1.8371208641816546e-05
80407;抓紧时间啊;1;0;1;54433;1.8371208641816546e-05
80428;干啥用的;1;0;1;54433;1.8371208641816546e-05
80440;跃亭贾错过了一次风口;1;0;1;54433;1.8371208641816546e-05
80451;H黑人;4;0;4;54433;7.348483456726618e-05
80487;非陈勿扰;1;0;1;54433;1.8371208641816546e-05
80791;整天说谎吹牛逼;1;0;1;54433;1.8371208641816546e-05
80851;77777;1;0;1;54433;1.8371208641816546e-05
81093;百度应该是国内技术方面最强的公司了;2;0;2;54433;3.674241728363309e-05
81120;开始抄作业;1;0;1;54433;1.8371208641816546e-05
81135;这个真的是个好事吗;1;0;1;54433;1.8371208641816546e-05
81171;某度怎么做，去问chatGPTask代码借我抄一下;2;0;2;54433;3.674241728363309e-05
81215;歪歪歪有人吗;2;0;2;54433;3.674241728363309e-05
81223;凉巷热血凝霜了吗电音天才cpaper不若与人CCCathy吴jin哥;1;0;1;54433;1.8371208641816546e-05
81244;百度已成为广告代名词，就是广告垃圾场;1;0;1;54433;1.8371208641816546e-05
81292;网友顺飞;1;0;1;54433;1.8371208641816546e-05
81321;李彦宏你小子藏大招是吧;2;0;2;54433;3.674241728363309e-05
81338;百度出品，必是精品;1;0;1;54433;1.8371208641816546e-05
81359;应该是要收费的;2;0;2;54433;3.674241728363309e-05
81378;主要不知道有没有那么多人给他测试，基础数据怎么样有没有那么多的数据样本给他搞;1;0;1;54433;1.8371208641816546e-05
81404;全是广告，信息全没用，还贵被骗;1;0;1;54433;1.8371208641816546e-05
81422;山寨一直在路上;1;0;1;54433;1.8371208641816546e-05
81479;百度外卖做的还行;1;0;1;54433;1.8371208641816546e-05
81494;加油百度;1;0;1;54433;1.8371208641816546e-05
81581;了咯let;3;0;3;54433;5.511362592544963e-05
81664;何为ai无非就是网络字典罢了，通过指令进行响应回复等同于参数;1;0;1;54433;1.8371208641816546e-05
81759;套壳移植下就可以用了;1;0;1;54433;1.8371208641816546e-05
81764;每回复一句，看15分钟广告。或者谁充钱就推荐什么样的答案给你。;1;0;1;54433;1.8371208641816546e-05
81851;会不会有敏感屏蔽;1;0;1;54433;1.8371208641816546e-05
81895;咋不做搜索了;1;0;1;54433;1.8371208641816546e-05
81919;小明男朋友投资;1;0;1;54433;1.8371208641816546e-05
81978;早睡就我用了快两个月的我的AI朋友这周是真火，但评论区这帮瞧不起百度也是真可笑哈哈哈哈哈;1;0;1;54433;1.8371208641816546e-05
